codpcia,dpto,radio,departamen,PROVINCIA,HOGARES,VIVIENDAS,MUJERES,VARONES,POBLACION_
90,90077,900770404,Río Chico,TUCUMÁN,286,275,576,599,1175
90,90077,900770202,Río Chico,TUCUMÁN,287,270,582,600,1182
90,90077,900770211,Río Chico,TUCUMÁN,252,284,521,483,1004
90,90077,900770213,Río Chico,TUCUMÁN,270,295,542,520,1062
90,90077,900770119,Río Chico,TUCUMÁN,262,278,534,504,1038
90,90077,900770116,Río Chico,TUCUMÁN,321,315,629,552,1181
90,90077,900770602,Río Chico,TUCUMÁN,200,223,453,460,913
90,90077,900770208,Río Chico,TUCUMÁN,5,6,7,10,17
90,90077,900770405,Río Chico,TUCUMÁN,207,250,366,389,755
90,90077,900770417,Río Chico,TUCUMÁN,301,314,584,625,1209
90,90077,900770121,Río Chico,TUCUMÁN,307,316,599,592,1191
90,90077,900770413,Río Chico,TUCUMÁN,171,178,347,352,699
90,90077,900770101,Río Chico,TUCUMÁN,331,341,657,672,1329
90,90077,900770117,Río Chico,TUCUMÁN,278,306,529,481,1010
90,90077,900770601,Río Chico,TUCUMÁN,202,222,404,417,821
90,90077,900770201,Río Chico,TUCUMÁN,62,61,144,140,284
90,90077,900770407,Río Chico,TUCUMÁN,278,264,593,612,1205
90,90077,900770416,Río Chico,TUCUMÁN,129,143,272,325,597
90,90077,900770414,Río Chico,TUCUMÁN,371,381,758,813,1571
90,90077,900770123,Río Chico,TUCUMÁN,222,231,451,412,863
90,90077,900770122,Río Chico,TUCUMÁN,232,237,441,400,841
90,90077,900770108,Río Chico,TUCUMÁN,243,276,438,366,804
90,90077,900770214,Río Chico,TUCUMÁN,159,172,311,299,610
90,90077,900770120,Río Chico,TUCUMÁN,299,292,607,634,1241
90,90077,900770603,Río Chico,TUCUMÁN,56,57,123,124,247
90,90077,900770412,Río Chico,TUCUMÁN,74,78,168,179,347
90,90077,900770409,Río Chico,TUCUMÁN,142,120,288,321,609
90,90077,900770302,Río Chico,TUCUMÁN,145,178,278,314,592
90,90077,900770203,Río Chico,TUCUMÁN,222,245,431,440,871
90,90077,900770418,Río Chico,TUCUMÁN,150,177,259,312,571
90,90077,900770210,Río Chico,TUCUMÁN,372,386,857,854,1711
90,90077,900770115,Río Chico,TUCUMÁN,355,364,757,729,1486
90,90077,900770114,Río Chico,TUCUMÁN,156,166,312,304,616
90,90077,900770605,Río Chico,TUCUMÁN,180,192,348,387,735
90,90077,900770406,Río Chico,TUCUMÁN,144,154,337,337,674
90,90077,900770607,Río Chico,TUCUMÁN,393,360,855,780,1635
90,90077,900770109,Río Chico,TUCUMÁN,253,283,504,437,941
90,90077,900770104,Río Chico,TUCUMÁN,423,429,903,884,1787
90,90077,900770103,Río Chico,TUCUMÁN,328,324,604,591,1195
90,90077,900770212,Río Chico,TUCUMÁN,122,157,189,221,410
90,90077,900770301,Río Chico,TUCUMÁN,103,134,193,234,427
90,90077,900770124,Río Chico,TUCUMÁN,237,262,482,464,946
90,90077,900770113,Río Chico,TUCUMÁN,237,253,473,454,927
90,90077,900770107,Río Chico,TUCUMÁN,244,246,511,473,984
90,90077,900770112,Río Chico,TUCUMÁN,231,228,458,393,851
90,90077,900770111,Río Chico,TUCUMÁN,246,253,459,362,821
90,90077,900770207,Río Chico,TUCUMÁN,61,55,138,147,285
90,90077,900770206,Río Chico,TUCUMÁN,51,54,97,108,205
90,90077,900770204,Río Chico,TUCUMÁN,69,74,139,166,305
90,90077,900770411,Río Chico,TUCUMÁN,144,139,309,376,685
90,90077,900770415,Río Chico,TUCUMÁN,247,268,515,528,1043
90,90077,900770209,Río Chico,TUCUMÁN,308,311,657,694,1351
90,90077,900770105,Río Chico,TUCUMÁN,412,428,804,807,1611
90,90077,900770102,Río Chico,TUCUMÁN,328,313,669,645,1314
90,90077,900770106,Río Chico,TUCUMÁN,332,338,700,648,1348
90,90077,900770118,Río Chico,TUCUMÁN,188,189,345,311,656
90,90077,900770408,Río Chico,TUCUMÁN,72,80,156,158,314
90,90077,900770402,Río Chico,TUCUMÁN,8,10,8,12,20
90,90077,900770401,Río Chico,TUCUMÁN,2,2,4,6,10
90,90077,900770205,Río Chico,TUCUMÁN,11,25,19,19,38
90,90077,900770403,Río Chico,TUCUMÁN,208,219,473,542,1015
90,90077,900770606,Río Chico,TUCUMÁN,340,356,708,667,1375
90,90077,900770419,Río Chico,TUCUMÁN,176,162,400,394,794
90,90077,900770110,Río Chico,TUCUMÁN,322,375,615,518,1133
90,90077,900770604,Río Chico,TUCUMÁN,55,68,108,108,216
90,90077,900770501,Río Chico,TUCUMÁN,169,201,347,357,704
90,90077,900770410,Río Chico,TUCUMÁN,97,90,204,236,440
90,90063,900630412,Lules,TUCUMÁN,136,146,331,326,657
90,90063,900630508,Lules,TUCUMÁN,271,254,567,532,1099
90,90063,900630507,Lules,TUCUMÁN,381,372,805,811,1616
90,90063,900630504,Lules,TUCUMÁN,288,297,567,541,1108
90,90063,900630219,Lules,TUCUMÁN,283,243,613,624,1237
90,90063,900630111,Lules,TUCUMÁN,404,448,848,740,1588
90,90063,900630213,Lules,TUCUMÁN,268,262,590,491,1081
90,90063,900630405,Lules,TUCUMÁN,53,61,121,137,258
90,90063,900630204,Lules,TUCUMÁN,29,91,42,55,97
90,90063,900630207,Lules,TUCUMÁN,123,108,237,280,517
90,90063,900630404,Lules,TUCUMÁN,348,300,707,784,1491
90,90063,900630513,Lules,TUCUMÁN,336,306,694,661,1355
90,90063,900630511,Lules,TUCUMÁN,299,301,636,629,1265
90,90063,900630505,Lules,TUCUMÁN,336,334,650,587,1237
90,90063,900630417,Lules,TUCUMÁN,216,213,433,421,854
90,90063,900630502,Lules,TUCUMÁN,213,213,442,364,806
90,90063,900630114,Lules,TUCUMÁN,335,337,683,667,1350
90,90063,900630112,Lules,TUCUMÁN,284,281,543,514,1057
90,90063,900630110,Lules,TUCUMÁN,387,390,781,753,1534
90,90063,900630106,Lules,TUCUMÁN,275,279,569,490,1059
90,90063,900630416,Lules,TUCUMÁN,67,244,153,149,302
90,90063,900630305,Lules,TUCUMÁN,499,514,1053,1104,2157
90,90063,900630402,Lules,TUCUMÁN,20,18,41,38,79
90,90063,900630211,Lules,TUCUMÁN,38,28,79,94,173
90,90063,900630101,Lules,TUCUMÁN,253,257,506,516,1022
90,90063,900630411,Lules,TUCUMÁN,128,130,287,316,603
90,90063,900630103,Lules,TUCUMÁN,248,272,503,516,1019
90,90063,900630503,Lules,TUCUMÁN,389,382,821,788,1609
90,90063,900630108,Lules,TUCUMÁN,387,386,811,833,1644
90,90063,900630107,Lules,TUCUMÁN,161,159,332,328,660
90,90063,900630104,Lules,TUCUMÁN,334,350,788,772,1560
90,90063,900630205,Lules,TUCUMÁN,18,21,39,31,70
90,90063,900630203,Lules,TUCUMÁN,18,15,34,34,68
90,90063,900630501,Lules,TUCUMÁN,318,309,729,658,1387
90,90063,900630419,Lules,TUCUMÁN,356,340,767,787,1554
90,90063,900630216,Lules,TUCUMÁN,267,266,601,564,1165
90,90063,900630218,Lules,TUCUMÁN,296,291,634,628,1262
90,90063,900630303,Lules,TUCUMÁN,151,147,298,300,598
90,90063,900630210,Lules,TUCUMÁN,26,48,53,76,129
90,90063,900630202,Lules,TUCUMÁN,91,87,186,191,377
90,90063,900630208,Lules,TUCUMÁN,5,8,11,8,19
90,90063,900630302,Lules,TUCUMÁN,495,495,990,1019,2009
90,90063,900630206,Lules,TUCUMÁN,201,231,451,483,934
90,90063,900630509,Lules,TUCUMÁN,441,432,921,903,1824
90,90063,900630215,Lules,TUCUMÁN,332,309,721,656,1377
90,90063,900630214,Lules,TUCUMÁN,169,401,317,329,646
90,90063,900630217,Lules,TUCUMÁN,275,272,623,624,1247
90,90063,900630113,Lules,TUCUMÁN,307,303,647,638,1285
90,90063,900630109,Lules,TUCUMÁN,292,278,604,585,1189
90,90063,900630403,Lules,TUCUMÁN,143,155,293,328,621
90,90063,900630409,Lules,TUCUMÁN,1,2,3,4,7
90,90063,900630408,Lules,TUCUMÁN,145,148,320,279,599
90,90063,900630304,Lules,TUCUMÁN,37,38,86,102,188
90,90063,900630510,Lules,TUCUMÁN,360,386,797,780,1577
90,90063,900630506,Lules,TUCUMÁN,341,345,718,653,1371
90,90063,900630418,Lules,TUCUMÁN,262,260,551,571,1122
90,90063,900630420,Lules,TUCUMÁN,212,233,458,441,899
90,90063,900630105,Lules,TUCUMÁN,383,402,790,742,1532
90,90063,900630415,Lules,TUCUMÁN,207,217,509,494,1003
90,90063,900630406,Lules,TUCUMÁN,81,87,200,193,393
90,90063,900630201,Lules,TUCUMÁN,42,68,68,106,174
90,90063,900630413,Lules,TUCUMÁN,422,424,913,909,1822
90,90063,900630512,Lules,TUCUMÁN,321,312,706,687,1393
90,90063,900630212,Lules,TUCUMÁN,345,352,796,809,1605
90,90063,900630414,Lules,TUCUMÁN,213,211,460,450,910
90,90063,900630401,Lules,TUCUMÁN,8,14,7,16,23
90,90063,900630410,Lules,TUCUMÁN,57,70,108,130,238
90,90063,900630102,Lules,TUCUMÁN,314,431,655,639,1294
90,90063,900630301,Lules,TUCUMÁN,578,440,1150,1144,2294
90,90063,900630209,Lules,TUCUMÁN,15,15,23,26,49
90,90063,900630407,Lules,TUCUMÁN,27,30,59,67,126
90,90007,900070403,Burruyacú,TUCUMÁN,126,147,237,255,492
90,90007,900070410,Burruyacú,TUCUMÁN,331,317,697,711,1408
90,90007,900070611,Burruyacú,TUCUMÁN,258,290,489,533,1022
90,90007,900070605,Burruyacú,TUCUMÁN,73,57,160,163,323
90,90007,900070501,Burruyacú,TUCUMÁN,73,80,143,149,292
90,90007,900070402,Burruyacú,TUCUMÁN,62,59,91,120,211
90,90007,900070305,Burruyacú,TUCUMÁN,32,48,62,46,108
90,90007,900070707,Burruyacú,TUCUMÁN,59,81,140,156,296
90,90007,900070405,Burruyacú,TUCUMÁN,235,343,530,515,1045
90,90007,900070509,Burruyacú,TUCUMÁN,113,138,230,241,471
90,90007,900070408,Burruyacú,TUCUMÁN,349,394,702,738,1440
90,90007,900071005,Burruyacú,TUCUMÁN,217,250,453,508,961
90,90007,900071004,Burruyacú,TUCUMÁN,50,67,74,97,171
90,90007,900070808,Burruyacú,TUCUMÁN,183,213,371,405,776
90,90007,900070807,Burruyacú,TUCUMÁN,295,311,629,648,1277
90,90007,900070804,Burruyacú,TUCUMÁN,37,49,74,69,143
90,90007,900070801,Burruyacú,TUCUMÁN,107,143,245,254,499
90,90007,900070204,Burruyacú,TUCUMÁN,133,153,195,244,439
90,90007,900070102,Burruyacú,TUCUMÁN,19,30,33,40,73
90,90007,900070608,Burruyacú,TUCUMÁN,74,86,150,127,277
90,90007,900071007,Burruyacú,TUCUMÁN,315,335,682,727,1409
90,90007,900070712,Burruyacú,TUCUMÁN,417,411,974,881,1855
90,90007,900071006,Burruyacú,TUCUMÁN,45,53,95,110,205
90,90007,900070902,Burruyacú,TUCUMÁN,84,100,175,199,374
90,90007,900070803,Burruyacú,TUCUMÁN,86,137,150,170,320
90,90007,900070802,Burruyacú,TUCUMÁN,29,35,63,72,135
90,90007,900070603,Burruyacú,TUCUMÁN,41,42,82,80,162
90,90007,900070303,Burruyacú,TUCUMÁN,18,22,45,50,95
90,90007,900070104,Burruyacú,TUCUMÁN,85,171,160,189,349
90,90007,900070503,Burruyacú,TUCUMÁN,88,100,181,181,362
90,90007,900070407,Burruyacú,TUCUMÁN,93,101,179,226,405
90,90007,900070101,Burruyacú,TUCUMÁN,14,20,29,20,49
90,90007,900070404,Burruyacú,TUCUMÁN,78,88,140,155,295
90,90007,900070506,Burruyacú,TUCUMÁN,87,91,183,210,393
90,90007,900070103,Burruyacú,TUCUMÁN,40,58,74,93,167
90,90007,900070409,Burruyacú,TUCUMÁN,300,346,656,649,1305
90,90007,900071003,Burruyacú,TUCUMÁN,65,84,131,117,248
90,90007,900071002,Burruyacú,TUCUMÁN,54,85,111,124,235
90,90007,900070702,Burruyacú,TUCUMÁN,104,119,204,227,431
90,90007,900070609,Burruyacú,TUCUMÁN,131,156,264,287,551
90,90007,900070502,Burruyacú,TUCUMÁN,52,59,90,112,202
90,90007,900070401,Burruyacú,TUCUMÁN,70,73,125,170,295
90,90007,900070904,Burruyacú,TUCUMÁN,202,230,468,485,953
90,90007,900070607,Burruyacú,TUCUMÁN,184,205,388,420,808
90,90007,900070905,Burruyacú,TUCUMÁN,55,86,116,141,257
90,90007,900070809,Burruyacú,TUCUMÁN,64,76,121,136,257
90,90007,900070610,Burruyacú,TUCUMÁN,110,122,216,235,451
90,90007,900070304,Burruyacú,TUCUMÁN,18,19,32,28,60
90,90007,900070202,Burruyacú,TUCUMÁN,26,29,54,55,109
90,90007,900070705,Burruyacú,TUCUMÁN,57,65,120,134,254
90,90007,900070504,Burruyacú,TUCUMÁN,67,71,116,140,256
90,90007,900070805,Burruyacú,TUCUMÁN,186,222,364,365,729
90,90007,900070903,Burruyacú,TUCUMÁN,150,239,252,308,560
90,90007,900070701,Burruyacú,TUCUMÁN,112,105,246,235,481
90,90007,900070602,Burruyacú,TUCUMÁN,91,112,181,206,387
90,90007,900070507,Burruyacú,TUCUMÁN,71,90,130,152,282
90,90007,900070709,Burruyacú,TUCUMÁN,63,67,123,138,261
90,90007,900071001,Burruyacú,TUCUMÁN,166,191,260,314,574
90,90007,900070901,Burruyacú,TUCUMÁN,23,30,36,33,69
90,90007,900070806,Burruyacú,TUCUMÁN,70,114,140,139,279
90,90007,900070703,Burruyacú,TUCUMÁN,137,167,301,322,623
90,90007,900070606,Burruyacú,TUCUMÁN,122,125,252,250,502
90,90007,900070604,Burruyacú,TUCUMÁN,136,144,316,328,644
90,90007,900070302,Burruyacú,TUCUMÁN,17,23,36,34,70
90,90007,900070206,Burruyacú,TUCUMÁN,78,89,177,197,374
90,90007,900070203,Burruyacú,TUCUMÁN,21,25,31,35,66
90,90007,900070406,Burruyacú,TUCUMÁN,13,19,12,16,28
90,90007,900070505,Burruyacú,TUCUMÁN,97,109,195,201,396
90,90007,900070710,Burruyacú,TUCUMÁN,360,374,827,793,1620
90,90007,900070105,Burruyacú,TUCUMÁN,83,179,133,154,287
90,90007,900070704,Burruyacú,TUCUMÁN,147,163,335,335,670
90,90007,900070306,Burruyacú,TUCUMÁN,120,141,248,244,492
90,90007,900070601,Burruyacú,TUCUMÁN,126,146,257,258,515
90,90007,900070508,Burruyacú,TUCUMÁN,87,106,145,177,322
90,90007,900070301,Burruyacú,TUCUMÁN,29,30,43,58,101
90,90007,900070201,Burruyacú,TUCUMÁN,31,54,49,55,104
90,90007,900070706,Burruyacú,TUCUMÁN,16,18,21,33,54
90,90007,900070708,Burruyacú,TUCUMÁN,69,83,149,170,319
90,90007,900070711,Burruyacú,TUCUMÁN,131,146,304,315,619
90,90007,900070205,Burruyacú,TUCUMÁN,150,179,280,272,552
90,90105,901050504,Tafí Viejo,TUCUMÁN,457,489,999,993,1992
90,90105,901050702,Tafí Viejo,TUCUMÁN,252,251,519,542,1061
90,90105,901050701,Tafí Viejo,TUCUMÁN,511,528,1123,1085,2208
90,90105,901051017,Tafí Viejo,TUCUMÁN,430,432,906,842,1748
90,90105,901051016,Tafí Viejo,TUCUMÁN,270,209,569,554,1123
90,90105,901051012,Tafí Viejo,TUCUMÁN,245,216,490,483,973
90,90105,901051010,Tafí Viejo,TUCUMÁN,324,352,687,697,1384
90,90105,901051007,Tafí Viejo,TUCUMÁN,290,255,582,546,1128
90,90105,901050912,Tafí Viejo,TUCUMÁN,347,335,656,642,1298
90,90105,901050811,Tafí Viejo,TUCUMÁN,333,357,640,634,1274
90,90105,901050805,Tafí Viejo,TUCUMÁN,363,328,741,803,1544
90,90105,901050704,Tafí Viejo,TUCUMÁN,278,264,705,679,1384
90,90105,901050620,Tafí Viejo,TUCUMÁN,310,287,683,655,1338
90,90105,901050618,Tafí Viejo,TUCUMÁN,240,220,550,484,1034
90,90105,901050808,Tafí Viejo,TUCUMÁN,477,455,1001,936,1937
90,90105,901050617,Tafí Viejo,TUCUMÁN,212,190,456,409,865
90,90105,901050714,Tafí Viejo,TUCUMÁN,254,299,480,457,937
90,90105,901050816,Tafí Viejo,TUCUMÁN,241,238,492,462,954
90,90105,901050813,Tafí Viejo,TUCUMÁN,361,373,663,620,1283
90,90105,901050506,Tafí Viejo,TUCUMÁN,297,362,603,529,1132
90,90105,901050916,Tafí Viejo,TUCUMÁN,229,220,614,569,1183
90,90105,901050604,Tafí Viejo,TUCUMÁN,325,345,669,624,1293
90,90105,901050103,Tafí Viejo,TUCUMÁN,32,42,56,67,123
90,90105,901050301,Tafí Viejo,TUCUMÁN,12,20,11,19,30
90,90105,901050601,Tafí Viejo,TUCUMÁN,188,181,360,394,754
90,90105,901050913,Tafí Viejo,TUCUMÁN,356,345,748,729,1477
90,90105,901050817,Tafí Viejo,TUCUMÁN,252,254,567,490,1057
90,90105,901051001,Tafí Viejo,TUCUMÁN,340,322,659,563,1222
90,90105,901050708,Tafí Viejo,TUCUMÁN,255,237,580,569,1149
90,90105,901050625,Tafí Viejo,TUCUMÁN,220,210,430,423,853
90,90105,901050607,Tafí Viejo,TUCUMÁN,166,155,331,360,691
90,90105,901050614,Tafí Viejo,TUCUMÁN,118,117,249,266,515
90,90105,901050402,Tafí Viejo,TUCUMÁN,207,379,433,432,865
90,90105,901050810,Tafí Viejo,TUCUMÁN,292,266,667,646,1313
90,90105,901050809,Tafí Viejo,TUCUMÁN,306,280,660,618,1278
90,90105,901050302,Tafí Viejo,TUCUMÁN,125,147,278,283,561
90,90105,901050505,Tafí Viejo,TUCUMÁN,173,202,308,315,623
90,90105,901050503,Tafí Viejo,TUCUMÁN,223,252,466,464,930
90,90105,901050206,Tafí Viejo,TUCUMÁN,81,252,209,189,398
90,90105,901051021,Tafí Viejo,TUCUMÁN,330,319,667,614,1281
90,90105,901051008,Tafí Viejo,TUCUMÁN,110,113,229,239,468
90,90105,901050706,Tafí Viejo,TUCUMÁN,286,233,617,553,1170
90,90105,901050703,Tafí Viejo,TUCUMÁN,155,147,290,265,555
90,90105,901050712,Tafí Viejo,TUCUMÁN,407,404,893,811,1704
90,90105,901050624,Tafí Viejo,TUCUMÁN,111,122,253,239,492
90,90105,901050717,Tafí Viejo,TUCUMÁN,3,341,0,3,3
90,90105,901050815,Tafí Viejo,TUCUMÁN,219,220,495,478,973
90,90105,901051004,Tafí Viejo,TUCUMÁN,412,346,913,931,1844
90,90105,901050204,Tafí Viejo,TUCUMÁN,150,434,308,306,614
90,90105,901050801,Tafí Viejo,TUCUMÁN,72,67,175,181,356
90,90105,901050401,Tafí Viejo,TUCUMÁN,102,152,156,170,326
90,90105,901050205,Tafí Viejo,TUCUMÁN,178,267,323,342,665
90,90105,901051024,Tafí Viejo,TUCUMÁN,321,329,725,739,1464
90,90105,901051022,Tafí Viejo,TUCUMÁN,273,250,590,559,1149
90,90105,901051013,Tafí Viejo,TUCUMÁN,262,272,503,446,949
90,90105,901051006,Tafí Viejo,TUCUMÁN,320,339,652,637,1289
90,90105,901050907,Tafí Viejo,TUCUMÁN,306,322,568,526,1094
90,90105,901050711,Tafí Viejo,TUCUMÁN,385,397,730,725,1455
90,90105,901050705,Tafí Viejo,TUCUMÁN,215,208,473,404,877
90,90105,901050623,Tafí Viejo,TUCUMÁN,426,450,907,800,1707
90,90105,901050605,Tafí Viejo,TUCUMÁN,317,329,685,653,1338
90,90105,901050713,Tafí Viejo,TUCUMÁN,243,291,431,414,845
90,90105,901050611,Tafí Viejo,TUCUMÁN,299,293,692,609,1301
90,90105,901050616,Tafí Viejo,TUCUMÁN,205,190,435,384,819
90,90105,901051003,Tafí Viejo,TUCUMÁN,297,294,657,640,1297
90,90105,901050812,Tafí Viejo,TUCUMÁN,374,391,716,637,1353
90,90105,901050910,Tafí Viejo,TUCUMÁN,147,167,260,215,475
90,90105,901050104,Tafí Viejo,TUCUMÁN,13,13,22,27,49
90,90105,901050207,Tafí Viejo,TUCUMÁN,48,180,100,124,224
90,90105,901050102,Tafí Viejo,TUCUMÁN,18,21,62,53,115
90,90105,901051020,Tafí Viejo,TUCUMÁN,167,172,332,342,674
90,90105,901051014,Tafí Viejo,TUCUMÁN,4,4,6,10,16
90,90105,901051011,Tafí Viejo,TUCUMÁN,253,231,541,555,1096
90,90105,901050911,Tafí Viejo,TUCUMÁN,186,203,328,263,591
90,90105,901050909,Tafí Viejo,TUCUMÁN,276,311,500,449,949
90,90105,901050905,Tafí Viejo,TUCUMÁN,323,327,655,672,1327
90,90105,901050903,Tafí Viejo,TUCUMÁN,477,490,1017,977,1994
90,90105,901050710,Tafí Viejo,TUCUMÁN,207,186,523,497,1020
90,90105,901050709,Tafí Viejo,TUCUMÁN,273,252,593,607,1200
90,90105,901050707,Tafí Viejo,TUCUMÁN,144,149,264,264,528
90,90105,901050621,Tafí Viejo,TUCUMÁN,427,412,1019,968,1987
90,90105,901050606,Tafí Viejo,TUCUMÁN,230,227,520,494,1014
90,90105,901050613,Tafí Viejo,TUCUMÁN,226,299,512,473,985
90,90105,901050715,Tafí Viejo,TUCUMÁN,153,324,292,278,570
90,90105,901050612,Tafí Viejo,TUCUMÁN,275,289,647,633,1280
90,90105,901050901,Tafí Viejo,TUCUMÁN,15,13,39,33,72
90,90105,901051023,Tafí Viejo,TUCUMÁN,302,215,628,593,1221
90,90105,901051015,Tafí Viejo,TUCUMÁN,320,287,635,649,1284
90,90105,901050806,Tafí Viejo,TUCUMÁN,244,215,548,513,1061
90,90105,901050804,Tafí Viejo,TUCUMÁN,348,309,773,734,1507
90,90105,901050718,Tafí Viejo,TUCUMÁN,25,284,45,35,80
90,90105,901050622,Tafí Viejo,TUCUMÁN,123,132,265,236,501
90,90105,901051019,Tafí Viejo,TUCUMÁN,195,152,433,430,863
90,90105,901051009,Tafí Viejo,TUCUMÁN,416,429,850,862,1712
90,90105,901051005,Tafí Viejo,TUCUMÁN,440,469,883,837,1720
90,90105,901050917,Tafí Viejo,TUCUMÁN,166,192,312,321,633
90,90105,901050915,Tafí Viejo,TUCUMÁN,277,310,523,400,923
90,90105,901050914,Tafí Viejo,TUCUMÁN,339,302,652,639,1291
90,90105,901050807,Tafí Viejo,TUCUMÁN,313,319,598,543,1141
90,90105,901050803,Tafí Viejo,TUCUMÁN,340,308,665,624,1289
90,90105,901050603,Tafí Viejo,TUCUMÁN,379,399,819,729,1548
90,90105,901050608,Tafí Viejo,TUCUMÁN,132,133,282,288,570
90,90105,901050615,Tafí Viejo,TUCUMÁN,236,226,502,446,948
90,90105,901050202,Tafí Viejo,TUCUMÁN,11,12,14,18,32
90,90105,901050201,Tafí Viejo,TUCUMÁN,31,37,81,94,175
90,90105,901050602,Tafí Viejo,TUCUMÁN,248,273,534,573,1107
90,90105,901050502,Tafí Viejo,TUCUMÁN,27,35,48,52,100
90,90105,901050501,Tafí Viejo,TUCUMÁN,146,155,327,321,648
90,90105,901050208,Tafí Viejo,TUCUMÁN,181,248,377,406,783
90,90105,901050902,Tafí Viejo,TUCUMÁN,303,336,590,581,1171
90,90105,901051018,Tafí Viejo,TUCUMÁN,408,305,857,861,1718
90,90105,901050908,Tafí Viejo,TUCUMÁN,280,290,535,501,1036
90,90105,901050906,Tafí Viejo,TUCUMÁN,394,378,784,704,1488
90,90105,901050904,Tafí Viejo,TUCUMÁN,367,354,752,654,1406
90,90105,901051002,Tafí Viejo,TUCUMÁN,218,194,494,476,970
90,90105,901050802,Tafí Viejo,TUCUMÁN,414,342,866,805,1671
90,90105,901050610,Tafí Viejo,TUCUMÁN,230,227,487,475,962
90,90105,901050609,Tafí Viejo,TUCUMÁN,261,223,529,540,1069
90,90105,901050716,Tafí Viejo,TUCUMÁN,0,288,0,0,0
90,90105,901050814,Tafí Viejo,TUCUMÁN,325,313,655,607,1262
90,90105,901050619,Tafí Viejo,TUCUMÁN,221,217,459,435,894
90,90105,901050203,Tafí Viejo,TUCUMÁN,58,101,133,137,270
90,90105,901050101,Tafí Viejo,TUCUMÁN,22,26,61,57,118
90,90084,900842408,Capital,TUCUMÁN,394,367,864,812,1676
90,90084,900842406,Capital,TUCUMÁN,344,347,623,542,1165
90,90084,900842220,Capital,TUCUMÁN,326,327,692,683,1375
90,90084,900842107,Capital,TUCUMÁN,366,483,618,455,1073
90,90084,900842414,Capital,TUCUMÁN,283,269,551,528,1079
90,90084,900842412,Capital,TUCUMÁN,298,262,561,527,1088
90,90084,900843006,Capital,TUCUMÁN,205,221,449,415,864
90,90084,900842915,Capital,TUCUMÁN,293,258,680,679,1359
90,90084,900842908,Capital,TUCUMÁN,437,463,1015,981,1996
90,90084,900842907,Capital,TUCUMÁN,256,243,571,561,1132
90,90084,900842903,Capital,TUCUMÁN,276,251,571,512,1083
90,90084,900842823,Capital,TUCUMÁN,308,284,591,564,1155
90,90084,900842822,Capital,TUCUMÁN,337,345,688,606,1294
90,90084,900842807,Capital,TUCUMÁN,275,266,654,675,1329
90,90084,900842804,Capital,TUCUMÁN,269,299,483,509,992
90,90084,900842712,Capital,TUCUMÁN,216,196,470,463,933
90,90084,900842403,Capital,TUCUMÁN,385,336,665,610,1275
90,90084,900842303,Capital,TUCUMÁN,159,172,287,257,544
90,90084,900842222,Capital,TUCUMÁN,133,122,330,314,644
90,90084,900842215,Capital,TUCUMÁN,427,363,977,940,1917
90,90084,900842207,Capital,TUCUMÁN,481,440,1005,1059,2064
90,90084,900842201,Capital,TUCUMÁN,402,353,935,840,1775
90,90084,900842116,Capital,TUCUMÁN,166,138,303,283,586
90,90084,900841801,Capital,TUCUMÁN,447,565,692,570,1262
90,90084,900841710,Capital,TUCUMÁN,128,121,257,214,471
90,90084,900841404,Capital,TUCUMÁN,371,388,700,626,1326
90,90084,900840606,Capital,TUCUMÁN,257,234,512,484,996
90,90084,900841306,Capital,TUCUMÁN,331,512,403,317,720
90,90084,900840315,Capital,TUCUMÁN,168,191,300,238,538
90,90084,900840310,Capital,TUCUMÁN,340,283,713,621,1334
90,90084,900840304,Capital,TUCUMÁN,358,310,724,682,1406
90,90084,900840208,Capital,TUCUMÁN,380,377,767,698,1465
90,90084,900840207,Capital,TUCUMÁN,183,198,383,347,730
90,90084,900840203,Capital,TUCUMÁN,275,267,570,601,1171
90,90084,900840202,Capital,TUCUMÁN,304,290,712,693,1405
90,90084,900840126,Capital,TUCUMÁN,376,408,756,710,1466
90,90084,900840113,Capital,TUCUMÁN,379,417,767,695,1462
90,90084,900840104,Capital,TUCUMÁN,343,375,693,598,1291
90,90084,900840110,Capital,TUCUMÁN,271,290,533,465,998
90,90084,900840112,Capital,TUCUMÁN,342,349,672,610,1282
90,90084,900840506,Capital,TUCUMÁN,310,310,663,641,1304
90,90084,900841221,Capital,TUCUMÁN,294,404,415,269,684
90,90084,900841220,Capital,TUCUMÁN,299,462,419,349,768
90,90084,900841403,Capital,TUCUMÁN,190,184,315,288,603
90,90084,900841402,Capital,TUCUMÁN,267,289,484,404,888
90,90084,900841007,Capital,TUCUMÁN,173,155,418,440,858
90,90084,900841019,Capital,TUCUMÁN,157,169,295,292,587
90,90084,900840914,Capital,TUCUMÁN,263,295,444,357,801
90,90084,900840910,Capital,TUCUMÁN,200,214,351,326,677
90,90084,900840903,Capital,TUCUMÁN,217,244,419,316,735
90,90084,900840902,Capital,TUCUMÁN,290,323,520,438,958
90,90084,900840802,Capital,TUCUMÁN,194,187,382,397,779
90,90084,900840711,Capital,TUCUMÁN,224,218,441,368,809
90,90084,900842012,Capital,TUCUMÁN,268,405,429,291,720
90,90084,900840218,Capital,TUCUMÁN,228,267,417,351,768
90,90084,900841208,Capital,TUCUMÁN,357,491,520,426,946
90,90084,900842004,Capital,TUCUMÁN,136,266,222,155,377
90,90084,900841806,Capital,TUCUMÁN,357,397,543,459,1002
90,90084,900841501,Capital,TUCUMÁN,265,242,492,422,914
90,90084,900842101,Capital,TUCUMÁN,169,209,317,264,581
90,90084,900842509,Capital,TUCUMÁN,258,275,462,423,885
90,90084,900841312,Capital,TUCUMÁN,339,467,485,313,798
90,90084,900842019,Capital,TUCUMÁN,303,389,498,398,896
90,90084,900841912,Capital,TUCUMÁN,206,273,477,366,843
90,90084,900841907,Capital,TUCUMÁN,296,359,498,413,911
90,90084,900841905,Capital,TUCUMÁN,185,246,319,254,573
90,90084,900841807,Capital,TUCUMÁN,332,348,581,543,1124
90,90084,900841613,Capital,TUCUMÁN,186,216,335,293,628
90,90084,900841605,Capital,TUCUMÁN,337,324,682,587,1269
90,90084,900841502,Capital,TUCUMÁN,351,389,647,562,1209
90,90084,900840808,Capital,TUCUMÁN,329,290,670,634,1304
90,90084,900841022,Capital,TUCUMÁN,257,258,496,433,929
90,90084,900840815,Capital,TUCUMÁN,228,214,496,471,967
90,90084,900840807,Capital,TUCUMÁN,259,279,517,499,1016
90,90084,900840409,Capital,TUCUMÁN,244,183,544,560,1104
90,90084,900840413,Capital,TUCUMÁN,248,249,583,601,1184
90,90084,900840408,Capital,TUCUMÁN,101,89,219,211,430
90,90084,900840404,Capital,TUCUMÁN,334,327,701,660,1361
90,90084,900840403,Capital,TUCUMÁN,305,289,662,528,1190
90,90084,900840223,Capital,TUCUMÁN,205,206,390,363,753
90,90084,900842803,Capital,TUCUMÁN,466,448,986,900,1886
90,90084,900842802,Capital,TUCUMÁN,309,326,666,593,1259
90,90084,900842418,Capital,TUCUMÁN,298,280,613,597,1210
90,90084,900841915,Capital,TUCUMÁN,164,177,267,228,495
90,90084,900842411,Capital,TUCUMÁN,217,207,412,384,796
90,90084,900843010,Capital,TUCUMÁN,271,258,653,694,1347
90,90084,900843008,Capital,TUCUMÁN,266,251,566,578,1144
90,90084,900842914,Capital,TUCUMÁN,626,634,1297,1176,2473
90,90084,900842812,Capital,TUCUMÁN,369,367,758,731,1489
90,90084,900842809,Capital,TUCUMÁN,242,237,506,453,959
90,90084,900842801,Capital,TUCUMÁN,416,437,871,829,1700
90,90084,900842701,Capital,TUCUMÁN,255,261,523,468,991
90,90084,900842517,Capital,TUCUMÁN,275,225,578,609,1187
90,90084,900842401,Capital,TUCUMÁN,255,241,555,539,1094
90,90084,900842313,Capital,TUCUMÁN,201,181,380,373,753
90,90084,900842217,Capital,TUCUMÁN,389,360,930,918,1848
90,90084,900842212,Capital,TUCUMÁN,194,168,457,434,891
90,90084,900842210,Capital,TUCUMÁN,292,247,627,523,1150
90,90084,900842218,Capital,TUCUMÁN,164,161,397,386,783
90,90084,900842118,Capital,TUCUMÁN,217,162,450,434,884
90,90084,900841704,Capital,TUCUMÁN,315,341,601,568,1169
90,90084,900841409,Capital,TUCUMÁN,215,260,368,341,709
90,90084,900840613,Capital,TUCUMÁN,160,172,251,247,498
90,90084,900840609,Capital,TUCUMÁN,210,202,409,421,830
90,90084,900840602,Capital,TUCUMÁN,391,334,776,702,1478
90,90084,900840502,Capital,TUCUMÁN,208,236,421,379,800
90,90084,900840314,Capital,TUCUMÁN,160,165,312,261,573
90,90084,900840313,Capital,TUCUMÁN,266,279,456,394,850
90,90084,900840303,Capital,TUCUMÁN,362,362,747,661,1408
90,90084,900840212,Capital,TUCUMÁN,403,416,787,741,1528
90,90084,900840206,Capital,TUCUMÁN,270,270,551,485,1036
90,90084,900840108,Capital,TUCUMÁN,321,603,671,611,1282
90,90084,900840204,Capital,TUCUMÁN,191,178,397,356,753
90,90084,900840510,Capital,TUCUMÁN,177,180,371,357,728
90,90084,900840124,Capital,TUCUMÁN,346,371,656,642,1298
90,90084,900840507,Capital,TUCUMÁN,228,207,531,512,1043
90,90084,900840220,Capital,TUCUMÁN,211,236,369,314,683
90,90084,900841303,Capital,TUCUMÁN,177,252,281,308,589
90,90084,900841218,Capital,TUCUMÁN,203,308,278,198,476
90,90084,900841401,Capital,TUCUMÁN,337,319,646,630,1276
90,90084,900841206,Capital,TUCUMÁN,169,211,276,204,480
90,90084,900842009,Capital,TUCUMÁN,246,347,317,224,541
90,90084,900840513,Capital,TUCUMÁN,285,333,424,386,810
90,90084,900842121,Capital,TUCUMÁN,209,309,324,239,563
90,90084,900841511,Capital,TUCUMÁN,171,188,324,289,613
90,90084,900841317,Capital,TUCUMÁN,242,412,375,285,660
90,90084,900840111,Capital,TUCUMÁN,254,267,535,521,1056
90,90084,900842103,Capital,TUCUMÁN,165,238,264,182,446
90,90084,900841904,Capital,TUCUMÁN,184,238,254,192,446
90,90084,900841611,Capital,TUCUMÁN,352,337,686,622,1308
90,90084,900841603,Capital,TUCUMÁN,310,344,582,532,1114
90,90084,900840817,Capital,TUCUMÁN,213,173,370,333,703
90,90084,900840402,Capital,TUCUMÁN,349,360,717,621,1338
90,90084,900842008,Capital,TUCUMÁN,207,294,348,218,566
90,90084,900842612,Capital,TUCUMÁN,248,191,561,488,1049
90,90084,900841108,Capital,TUCUMÁN,297,274,687,689,1376
90,90084,900841104,Capital,TUCUMÁN,198,264,303,220,523
90,90084,900841016,Capital,TUCUMÁN,264,295,426,349,775
90,90084,900840912,Capital,TUCUMÁN,145,170,247,209,456
90,90084,900840905,Capital,TUCUMÁN,252,275,470,418,888
90,90084,900840820,Capital,TUCUMÁN,274,262,531,565,1096
90,90084,900840709,Capital,TUCUMÁN,304,304,533,486,1019
90,90084,900840707,Capital,TUCUMÁN,304,309,556,487,1043
90,90084,900841207,Capital,TUCUMÁN,257,332,377,292,669
90,90084,900840512,Capital,TUCUMÁN,218,251,384,301,685
90,90084,900841211,Capital,TUCUMÁN,266,399,409,316,725
90,90084,900842616,Capital,TUCUMÁN,356,298,766,740,1506
90,90084,900841411,Capital,TUCUMÁN,282,282,557,466,1023
90,90084,900842608,Capital,TUCUMÁN,245,295,435,374,809
90,90084,900841913,Capital,TUCUMÁN,209,245,357,276,633
90,90084,900841911,Capital,TUCUMÁN,364,489,470,324,794
90,90084,900841609,Capital,TUCUMÁN,263,270,493,490,983
90,90084,900841608,Capital,TUCUMÁN,338,364,594,526,1120
90,90084,900841802,Capital,TUCUMÁN,287,383,485,434,919
90,90084,900841604,Capital,TUCUMÁN,445,474,787,718,1505
90,90084,900841602,Capital,TUCUMÁN,248,286,449,364,813
90,90084,900841023,Capital,TUCUMÁN,402,411,767,660,1427
90,90084,900840814,Capital,TUCUMÁN,518,473,1104,1106,2210
90,90084,900841307,Capital,TUCUMÁN,120,175,191,179,370
90,90084,900840810,Capital,TUCUMÁN,254,264,459,453,912
90,90084,900840412,Capital,TUCUMÁN,219,221,429,382,811
90,90084,900840407,Capital,TUCUMÁN,276,252,632,558,1190
90,90084,900842815,Capital,TUCUMÁN,334,348,731,715,1446
90,90084,900842605,Capital,TUCUMÁN,325,292,718,677,1395
90,90084,900842602,Capital,TUCUMÁN,224,193,515,523,1038
90,90084,900842601,Capital,TUCUMÁN,412,349,901,771,1672
90,90084,900842404,Capital,TUCUMÁN,391,347,703,661,1364
90,90084,900843016,Capital,TUCUMÁN,349,426,740,781,1521
90,90084,900843011,Capital,TUCUMÁN,362,363,738,767,1505
90,90084,900843002,Capital,TUCUMÁN,309,328,633,624,1257
90,90084,900842906,Capital,TUCUMÁN,254,236,541,578,1119
90,90084,900842904,Capital,TUCUMÁN,278,238,570,574,1144
90,90084,900842902,Capital,TUCUMÁN,397,364,843,788,1631
90,90084,900842819,Capital,TUCUMÁN,273,302,552,522,1074
90,90084,900842818,Capital,TUCUMÁN,278,297,539,490,1029
90,90084,900842810,Capital,TUCUMÁN,271,257,553,544,1097
90,90084,900842808,Capital,TUCUMÁN,275,295,514,554,1068
90,90084,900842711,Capital,TUCUMÁN,286,249,650,578,1228
90,90084,900842710,Capital,TUCUMÁN,382,332,820,792,1612
90,90084,900842709,Capital,TUCUMÁN,369,360,835,920,1755
90,90084,900842518,Capital,TUCUMÁN,288,231,635,587,1222
90,90084,900842507,Capital,TUCUMÁN,407,379,833,737,1570
90,90084,900842506,Capital,TUCUMÁN,180,157,326,344,670
90,90084,900842314,Capital,TUCUMÁN,228,185,424,389,813
90,90084,900842214,Capital,TUCUMÁN,391,341,862,815,1677
90,90084,900842213,Capital,TUCUMÁN,310,270,723,673,1396
90,90084,900842123,Capital,TUCUMÁN,0,0,1,5,6
90,90084,900842119,Capital,TUCUMÁN,393,346,881,776,1657
90,90084,900841705,Capital,TUCUMÁN,283,263,505,432,937
90,90084,900841615,Capital,TUCUMÁN,374,397,742,710,1452
90,90084,900841408,Capital,TUCUMÁN,267,280,407,338,745
90,90084,900841406,Capital,TUCUMÁN,287,315,511,462,973
90,90084,900840302,Capital,TUCUMÁN,409,372,906,918,1824
90,90084,900840114,Capital,TUCUMÁN,297,296,635,531,1166
90,90084,900840103,Capital,TUCUMÁN,350,398,680,644,1324
90,90084,900840216,Capital,TUCUMÁN,199,211,368,301,669
90,90084,900840219,Capital,TUCUMÁN,281,329,473,421,894
90,90084,900841302,Capital,TUCUMÁN,237,318,397,340,737
90,90084,900841301,Capital,TUCUMÁN,216,249,336,286,622
90,90084,900842016,Capital,TUCUMÁN,233,355,267,234,501
90,90084,900841102,Capital,TUCUMÁN,282,405,377,320,697
90,90084,900841011,Capital,TUCUMÁN,350,366,734,680,1414
90,90084,900841005,Capital,TUCUMÁN,363,328,772,775,1547
90,90084,900840909,Capital,TUCUMÁN,170,185,306,280,586
90,90084,900840714,Capital,TUCUMÁN,217,250,343,369,712
90,90084,900840701,Capital,TUCUMÁN,320,293,715,621,1336
90,90084,900842015,Capital,TUCUMÁN,291,431,385,272,657
90,90084,900840811,Capital,TUCUMÁN,298,309,556,478,1034
90,90084,900842011,Capital,TUCUMÁN,178,242,243,162,405
90,90084,900841217,Capital,TUCUMÁN,235,321,365,248,613
90,90084,900841701,Capital,TUCUMÁN,292,289,548,511,1059
90,90084,900841225,Capital,TUCUMÁN,290,458,299,222,521
90,90084,900841512,Capital,TUCUMÁN,167,294,286,262,548
90,90084,900841314,Capital,TUCUMÁN,231,321,402,274,676
90,90084,900841313,Capital,TUCUMÁN,105,221,117,91,208
90,90084,900841910,Capital,TUCUMÁN,263,373,400,260,660
90,90084,900841909,Capital,TUCUMÁN,356,494,479,345,824
90,90084,900841812,Capital,TUCUMÁN,273,363,322,282,604
90,90084,900841607,Capital,TUCUMÁN,388,418,748,617,1365
90,90084,900841805,Capital,TUCUMÁN,334,399,530,425,955
90,90084,900841612,Capital,TUCUMÁN,213,216,410,370,780
90,90084,900841513,Capital,TUCUMÁN,192,229,335,270,605
90,90084,900841508,Capital,TUCUMÁN,154,198,304,248,552
90,90084,900841503,Capital,TUCUMÁN,227,242,438,385,823
90,90084,900841021,Capital,TUCUMÁN,94,114,173,151,324
90,90084,900841020,Capital,TUCUMÁN,303,324,611,527,1138
90,90084,900840819,Capital,TUCUMÁN,333,296,712,651,1363
90,90084,900840806,Capital,TUCUMÁN,273,253,551,525,1076
90,90084,900840410,Capital,TUCUMÁN,247,226,597,584,1181
90,90084,900840406,Capital,TUCUMÁN,286,285,696,575,1271
90,90084,900842913,Capital,TUCUMÁN,360,314,743,753,1496
90,90084,900842613,Capital,TUCUMÁN,198,174,412,361,773
90,90084,900842603,Capital,TUCUMÁN,209,192,467,404,871
90,90084,900842501,Capital,TUCUMÁN,427,375,958,934,1892
90,90084,900842420,Capital,TUCUMÁN,261,274,509,462,971
90,90084,900842407,Capital,TUCUMÁN,166,180,330,299,629
90,90084,900842106,Capital,TUCUMÁN,299,304,573,468,1041
90,90084,900842105,Capital,TUCUMÁN,159,194,278,256,534
90,90084,900841918,Capital,TUCUMÁN,173,220,226,190,416
90,90084,900842413,Capital,TUCUMÁN,270,313,456,442,898
90,90084,900843009,Capital,TUCUMÁN,299,296,683,725,1408
90,90084,900843001,Capital,TUCUMÁN,320,299,690,652,1342
90,90084,900842901,Capital,TUCUMÁN,412,345,862,849,1711
90,90084,900842813,Capital,TUCUMÁN,271,264,614,566,1180
90,90084,900842811,Capital,TUCUMÁN,314,318,704,639,1343
90,90084,900842705,Capital,TUCUMÁN,348,335,766,669,1435
90,90084,900842704,Capital,TUCUMÁN,323,312,683,569,1252
90,90084,900842516,Capital,TUCUMÁN,207,196,449,414,863
90,90084,900842515,Capital,TUCUMÁN,262,240,508,490,998
90,90084,900842512,Capital,TUCUMÁN,387,334,829,769,1598
90,90084,900842209,Capital,TUCUMÁN,260,236,542,478,1020
90,90084,900842208,Capital,TUCUMÁN,266,257,601,575,1176
90,90084,900842112,Capital,TUCUMÁN,235,236,407,320,727
90,90084,900841620,Capital,TUCUMÁN,317,319,615,555,1170
90,90084,900840614,Capital,TUCUMÁN,158,182,252,211,463
90,90084,900840612,Capital,TUCUMÁN,129,125,222,207,429
90,90084,900840605,Capital,TUCUMÁN,352,357,668,582,1250
90,90084,900840415,Capital,TUCUMÁN,448,396,1033,1105,2138
90,90084,900840306,Capital,TUCUMÁN,350,335,704,621,1325
90,90084,900840301,Capital,TUCUMÁN,455,411,984,1042,2026
90,90084,900840221,Capital,TUCUMÁN,406,401,878,797,1675
90,90084,900840214,Capital,TUCUMÁN,258,243,481,417,898
90,90084,900840122,Capital,TUCUMÁN,207,223,369,345,714
90,90084,900840117,Capital,TUCUMÁN,196,163,369,366,735
90,90084,900840116,Capital,TUCUMÁN,257,246,548,500,1048
90,90084,900840106,Capital,TUCUMÁN,392,413,785,760,1545
90,90084,900840105,Capital,TUCUMÁN,309,332,598,578,1176
90,90084,900842017,Capital,TUCUMÁN,231,435,288,200,488
90,90084,900841222,Capital,TUCUMÁN,170,219,247,152,399
90,90084,900841219,Capital,TUCUMÁN,373,537,493,364,857
90,90084,900841203,Capital,TUCUMÁN,305,437,406,329,735
90,90084,900841109,Capital,TUCUMÁN,321,300,764,718,1482
90,90084,900841413,Capital,TUCUMÁN,270,270,548,424,972
90,90084,900841025,Capital,TUCUMÁN,86,78,162,167,329
90,90084,900841308,Capital,TUCUMÁN,240,314,355,271,626
90,90084,900841012,Capital,TUCUMÁN,231,249,466,397,863
90,90084,900841003,Capital,TUCUMÁN,240,235,561,525,1086
90,90084,900840911,Capital,TUCUMÁN,292,325,515,441,956
90,90084,900840908,Capital,TUCUMÁN,200,207,375,338,713
90,90084,900840805,Capital,TUCUMÁN,488,415,1077,987,2064
90,90084,900840803,Capital,TUCUMÁN,340,341,734,691,1425
90,90084,900840812,Capital,TUCUMÁN,351,305,704,616,1320
90,90084,900842014,Capital,TUCUMÁN,187,334,242,173,415
90,90084,900842006,Capital,TUCUMÁN,191,306,256,180,436
90,90084,900842003,Capital,TUCUMÁN,185,301,264,162,426
90,90084,900843004,Capital,TUCUMÁN,231,226,467,416,883
90,90084,900842104,Capital,TUCUMÁN,224,342,323,239,562
90,90084,900841908,Capital,TUCUMÁN,193,237,313,243,556
90,90084,900841906,Capital,TUCUMÁN,174,173,267,207,474
90,90084,900841610,Capital,TUCUMÁN,217,248,398,341,739
90,90084,900841804,Capital,TUCUMÁN,144,187,233,180,413
90,90084,900841606,Capital,TUCUMÁN,211,246,382,332,714
90,90084,900841024,Capital,TUCUMÁN,352,315,735,584,1319
90,90084,900840813,Capital,TUCUMÁN,271,235,575,500,1075
90,90084,900841506,Capital,TUCUMÁN,328,342,640,524,1164
90,90084,900840816,Capital,TUCUMÁN,329,287,654,561,1215
90,90084,900840414,Capital,TUCUMÁN,205,198,429,459,888
90,90084,900840809,Capital,TUCUMÁN,226,202,499,457,956
90,90084,900840411,Capital,TUCUMÁN,200,190,391,364,755
90,90084,900840405,Capital,TUCUMÁN,288,294,570,538,1108
90,90084,900840511,Capital,TUCUMÁN,164,177,314,272,586
90,90084,900840222,Capital,TUCUMÁN,324,279,721,666,1387
90,90084,900842912,Capital,TUCUMÁN,200,184,446,444,890
90,90084,900842614,Capital,TUCUMÁN,320,333,747,726,1473
90,90084,900842609,Capital,TUCUMÁN,214,215,432,417,849
90,90084,900842610,Capital,TUCUMÁN,241,220,515,519,1034
90,90084,900842417,Capital,TUCUMÁN,215,196,511,425,936
90,90084,900842416,Capital,TUCUMÁN,485,445,988,933,1921
90,90084,900842204,Capital,TUCUMÁN,200,198,430,410,840
90,90084,900842108,Capital,TUCUMÁN,223,320,332,283,615
90,90084,900841914,Capital,TUCUMÁN,193,241,302,256,558
90,90084,900842415,Capital,TUCUMÁN,482,433,1098,970,2068
90,90084,900843018,Capital,TUCUMÁN,473,479,1042,968,2010
90,90084,900842905,Capital,TUCUMÁN,235,209,549,478,1027
90,90084,900842820,Capital,TUCUMÁN,232,251,486,429,915
90,90084,900842806,Capital,TUCUMÁN,294,280,667,646,1313
90,90084,900842805,Capital,TUCUMÁN,295,299,670,636,1306
90,90084,900842714,Capital,TUCUMÁN,396,408,788,729,1517
90,90084,900842702,Capital,TUCUMÁN,455,403,998,917,1915
90,90084,900842511,Capital,TUCUMÁN,480,421,1067,1037,2104
90,90084,900842504,Capital,TUCUMÁN,276,281,565,518,1083
90,90084,900842307,Capital,TUCUMÁN,243,235,446,338,784
90,90084,900842306,Capital,TUCUMÁN,391,385,771,731,1502
90,90084,900842301,Capital,TUCUMÁN,220,241,388,360,748
90,90084,900842223,Capital,TUCUMÁN,222,229,477,495,972
90,90084,900841712,Capital,TUCUMÁN,297,266,573,494,1067
90,90084,900841706,Capital,TUCUMÁN,280,252,551,531,1082
90,90084,900841702,Capital,TUCUMÁN,348,358,656,563,1219
90,90084,900841622,Capital,TUCUMÁN,165,154,307,302,609
90,90084,900842018,Capital,TUCUMÁN,375,538,548,434,982
90,90084,900840611,Capital,TUCUMÁN,206,229,352,323,675
90,90084,900840501,Capital,TUCUMÁN,333,343,624,568,1192
90,90084,900840401,Capital,TUCUMÁN,397,379,877,810,1687
90,90084,900840312,Capital,TUCUMÁN,201,173,398,439,837
90,90084,900840213,Capital,TUCUMÁN,221,232,403,360,763
90,90084,900840211,Capital,TUCUMÁN,186,196,334,291,625
90,90084,900840125,Capital,TUCUMÁN,268,318,570,527,1097
90,90084,900840121,Capital,TUCUMÁN,215,229,405,349,754
90,90084,900840107,Capital,TUCUMÁN,357,385,715,646,1361
90,90084,900840101,Capital,TUCUMÁN,187,190,404,430,834
90,90084,900841304,Capital,TUCUMÁN,220,331,354,236,590
90,90084,900841202,Capital,TUCUMÁN,269,406,422,319,741
90,90084,900841113,Capital,TUCUMÁN,243,227,507,383,890
90,90084,900841110,Capital,TUCUMÁN,228,231,505,429,934
90,90084,900841017,Capital,TUCUMÁN,221,220,438,380,818
90,90084,900841008,Capital,TUCUMÁN,379,323,860,799,1659
90,90084,900841006,Capital,TUCUMÁN,298,258,738,663,1401
90,90084,900840703,Capital,TUCUMÁN,285,264,677,498,1175
90,90084,900840706,Capital,TUCUMÁN,357,342,683,654,1337
90,90084,900842010,Capital,TUCUMÁN,249,331,340,259,599
90,90084,900842005,Capital,TUCUMÁN,198,281,263,176,439
90,90084,900841212,Capital,TUCUMÁN,349,487,453,360,813
90,90084,900841209,Capital,TUCUMÁN,357,474,446,332,778
90,90084,900842410,Capital,TUCUMÁN,325,342,584,522,1106
90,90084,900842405,Capital,TUCUMÁN,251,220,439,417,856
90,90084,900842202,Capital,TUCUMÁN,369,309,820,824,1644
90,90084,900841919,Capital,TUCUMÁN,380,435,766,577,1343
90,90084,900843015,Capital,TUCUMÁN,435,450,947,886,1833
90,90084,900842909,Capital,TUCUMÁN,335,320,734,695,1429
90,90084,900842821,Capital,TUCUMÁN,221,235,432,405,837
90,90084,900842817,Capital,TUCUMÁN,285,286,610,616,1226
90,90084,900842703,Capital,TUCUMÁN,283,284,545,521,1066
90,90084,900842615,Capital,TUCUMÁN,388,402,785,735,1520
90,90084,900842513,Capital,TUCUMÁN,403,407,747,673,1420
90,90084,900842510,Capital,TUCUMÁN,264,269,563,516,1079
90,90084,900842505,Capital,TUCUMÁN,352,383,737,611,1348
90,90084,900842402,Capital,TUCUMÁN,338,271,607,532,1139
90,90084,900842309,Capital,TUCUMÁN,317,345,615,577,1192
90,90084,900842304,Capital,TUCUMÁN,328,321,637,527,1164
90,90084,900842206,Capital,TUCUMÁN,333,294,738,658,1396
90,90084,900842115,Capital,TUCUMÁN,234,217,508,511,1019
90,90084,900842111,Capital,TUCUMÁN,177,166,383,405,788
90,90084,900841621,Capital,TUCUMÁN,268,274,530,488,1018
90,90084,900841618,Capital,TUCUMÁN,323,309,701,669,1370
90,90084,900840608,Capital,TUCUMÁN,301,253,623,581,1204
90,90084,900840215,Capital,TUCUMÁN,197,211,366,299,665
90,90084,900840209,Capital,TUCUMÁN,278,273,556,496,1052
90,90084,900840205,Capital,TUCUMÁN,497,464,1000,920,1920
90,90084,900840120,Capital,TUCUMÁN,221,230,412,361,773
90,90084,900840109,Capital,TUCUMÁN,247,240,472,421,893
90,90084,900840217,Capital,TUCUMÁN,229,249,423,384,807
90,90084,900841226,Capital,TUCUMÁN,309,480,435,332,767
90,90084,900841224,Capital,TUCUMÁN,105,137,125,95,220
90,90084,900841223,Capital,TUCUMÁN,235,351,397,275,672
90,90084,900841318,Capital,TUCUMÁN,313,381,537,477,1014
90,90084,900841414,Capital,TUCUMÁN,267,266,540,497,1037
90,90084,900841107,Capital,TUCUMÁN,319,278,710,698,1408
90,90084,900841310,Capital,TUCUMÁN,258,353,318,255,573
90,90084,900841101,Capital,TUCUMÁN,229,315,341,300,641
90,90084,900841018,Capital,TUCUMÁN,265,257,528,476,1004
90,90084,900841004,Capital,TUCUMÁN,362,360,824,735,1559
90,90084,900841002,Capital,TUCUMÁN,502,441,1053,1056,2109
90,90084,900840913,Capital,TUCUMÁN,158,206,173,151,324
90,90084,900840904,Capital,TUCUMÁN,210,187,377,348,725
90,90084,900840708,Capital,TUCUMÁN,387,390,744,582,1326
90,90084,900841215,Capital,TUCUMÁN,172,237,230,174,404
90,90084,900841210,Capital,TUCUMÁN,293,422,403,301,704
90,90084,900842122,Capital,TUCUMÁN,196,203,355,246,601
90,90084,900841315,Capital,TUCUMÁN,176,300,260,137,397
90,90084,900842102,Capital,TUCUMÁN,329,512,495,374,869
90,90084,900841902,Capital,TUCUMÁN,285,392,451,323,774
90,90084,900841803,Capital,TUCUMÁN,167,152,279,217,496
90,90084,900841614,Capital,TUCUMÁN,253,280,449,455,904
90,90084,900843013,Capital,TUCUMÁN,402,411,845,843,1688
90,90084,900842816,Capital,TUCUMÁN,289,286,611,644,1255
90,90084,900842607,Capital,TUCUMÁN,280,309,566,550,1116
90,90084,900842604,Capital,TUCUMÁN,340,323,714,662,1376
90,90084,900840915,Capital,TUCUMÁN,306,339,527,487,1014
90,90084,900842219,Capital,TUCUMÁN,341,328,772,784,1556
90,90084,900842203,Capital,TUCUMÁN,229,204,526,512,1038
90,90084,900842002,Capital,TUCUMÁN,207,327,292,187,479
90,90084,900841916,Capital,TUCUMÁN,296,392,326,276,602
90,90084,900843019,Capital,TUCUMÁN,117,120,231,217,448
90,90084,900843014,Capital,TUCUMÁN,329,300,704,676,1380
90,90084,900843012,Capital,TUCUMÁN,375,401,814,799,1613
90,90084,900843005,Capital,TUCUMÁN,252,252,505,466,971
90,90084,900842916,Capital,TUCUMÁN,202,170,438,437,875
90,90084,900842910,Capital,TUCUMÁN,249,230,582,528,1110
90,90084,900842824,Capital,TUCUMÁN,417,459,860,821,1681
90,90084,900842706,Capital,TUCUMÁN,383,364,824,748,1572
90,90084,900842514,Capital,TUCUMÁN,329,309,679,627,1306
90,90084,900842502,Capital,TUCUMÁN,163,162,364,351,715
90,90084,900842312,Capital,TUCUMÁN,264,282,518,430,948
90,90084,900842310,Capital,TUCUMÁN,336,309,643,564,1207
90,90084,900842305,Capital,TUCUMÁN,306,311,606,505,1111
90,90084,900842211,Capital,TUCUMÁN,228,212,503,500,1003
90,90084,900842114,Capital,TUCUMÁN,450,436,1019,1014,2033
90,90084,900842113,Capital,TUCUMÁN,384,325,837,738,1575
90,90084,900841708,Capital,TUCUMÁN,371,374,707,611,1318
90,90084,900841707,Capital,TUCUMÁN,187,164,384,329,713
90,90084,900841703,Capital,TUCUMÁN,311,283,518,480,998
90,90084,900841407,Capital,TUCUMÁN,311,400,514,478,992
90,90084,900840607,Capital,TUCUMÁN,255,247,507,460,967
90,90084,900840604,Capital,TUCUMÁN,294,297,581,524,1105
90,90084,900840601,Capital,TUCUMÁN,155,126,304,290,594
90,90084,900840416,Capital,TUCUMÁN,383,366,880,848,1728
90,90084,900840311,Capital,TUCUMÁN,196,178,388,356,744
90,90084,900840309,Capital,TUCUMÁN,217,201,537,396,933
90,90084,900840308,Capital,TUCUMÁN,293,288,553,504,1057
90,90084,900840305,Capital,TUCUMÁN,272,255,549,533,1082
90,90084,900840210,Capital,TUCUMÁN,316,325,558,495,1053
90,90084,900840119,Capital,TUCUMÁN,193,219,301,293,594
90,90084,900840123,Capital,TUCUMÁN,425,416,840,734,1574
90,90084,900840508,Capital,TUCUMÁN,184,147,428,404,832
90,90084,900841305,Capital,TUCUMÁN,292,391,478,448,926
90,90084,900841204,Capital,TUCUMÁN,255,334,463,379,842
90,90084,900841201,Capital,TUCUMÁN,268,362,416,341,757
90,90084,900841111,Capital,TUCUMÁN,318,305,575,543,1118
90,90084,900841106,Capital,TUCUMÁN,325,291,740,769,1509
90,90084,900841309,Capital,TUCUMÁN,310,502,421,292,713
90,90084,900841015,Capital,TUCUMÁN,180,155,341,338,679
90,90084,900841014,Capital,TUCUMÁN,207,188,468,389,857
90,90084,900840901,Capital,TUCUMÁN,193,166,356,316,672
90,90084,900840801,Capital,TUCUMÁN,208,175,429,409,838
90,90084,900840710,Capital,TUCUMÁN,188,221,350,328,678
90,90084,900840705,Capital,TUCUMÁN,253,269,468,425,893
90,90084,900841617,Capital,TUCUMÁN,277,262,580,646,1226
90,90084,900843017,Capital,TUCUMÁN,198,209,420,384,804
90,90084,900842120,Capital,TUCUMÁN,247,362,319,245,564
90,90084,900841917,Capital,TUCUMÁN,160,222,213,145,358
90,90084,900840704,Capital,TUCUMÁN,364,384,663,595,1258
90,90084,900840118,Capital,TUCUMÁN,162,182,261,236,497
90,90084,900841510,Capital,TUCUMÁN,305,281,575,481,1056
90,90084,900841903,Capital,TUCUMÁN,292,447,348,248,596
90,90084,900841901,Capital,TUCUMÁN,233,357,346,255,601
90,90084,900841811,Capital,TUCUMÁN,321,291,574,506,1080
90,90084,900841810,Capital,TUCUMÁN,217,191,408,363,771
90,90084,900841808,Capital,TUCUMÁN,424,468,643,544,1187
90,90084,900841601,Capital,TUCUMÁN,297,337,540,506,1046
90,90084,900841505,Capital,TUCUMÁN,311,376,571,507,1078
90,90084,900840818,Capital,TUCUMÁN,179,197,359,303,662
90,90084,900842911,Capital,TUCUMÁN,378,358,789,818,1607
90,90084,900842814,Capital,TUCUMÁN,200,202,420,423,843
90,90084,900842519,Capital,TUCUMÁN,251,251,617,572,1189
90,90084,900842409,Capital,TUCUMÁN,350,339,711,631,1342
90,90084,900842221,Capital,TUCUMÁN,313,312,804,786,1590
90,90084,900842110,Capital,TUCUMÁN,323,293,583,504,1087
90,90084,900842109,Capital,TUCUMÁN,253,284,451,342,793
90,90084,900842001,Capital,TUCUMÁN,184,265,249,190,439
90,90084,900843007,Capital,TUCUMÁN,346,289,825,753,1578
90,90084,900843003,Capital,TUCUMÁN,357,362,720,741,1461
90,90084,900842713,Capital,TUCUMÁN,248,269,447,393,840
90,90084,900842708,Capital,TUCUMÁN,340,295,727,667,1394
90,90084,900842707,Capital,TUCUMÁN,364,353,870,848,1718
90,90084,900842508,Capital,TUCUMÁN,387,326,817,786,1603
90,90084,900842503,Capital,TUCUMÁN,333,319,683,550,1233
90,90084,900842311,Capital,TUCUMÁN,360,319,695,619,1314
90,90084,900842308,Capital,TUCUMÁN,242,268,454,359,813
90,90084,900842302,Capital,TUCUMÁN,220,203,372,297,669
90,90084,900842216,Capital,TUCUMÁN,329,332,685,713,1398
90,90084,900842205,Capital,TUCUMÁN,220,225,440,425,865
90,90084,900842117,Capital,TUCUMÁN,169,145,342,278,620
90,90084,900841711,Capital,TUCUMÁN,225,202,482,400,882
90,90084,900841709,Capital,TUCUMÁN,360,326,704,656,1360
90,90084,900841619,Capital,TUCUMÁN,276,249,521,496,1017
90,90084,900841616,Capital,TUCUMÁN,265,341,485,449,934
90,90084,900841412,Capital,TUCUMÁN,315,366,578,538,1116
90,90084,900841410,Capital,TUCUMÁN,234,250,449,382,831
90,90084,900841405,Capital,TUCUMÁN,348,359,611,518,1129
90,90084,900840610,Capital,TUCUMÁN,207,214,396,311,707
90,90084,900840603,Capital,TUCUMÁN,251,216,625,1277,1902
90,90084,900840307,Capital,TUCUMÁN,334,308,632,570,1202
90,90084,900840201,Capital,TUCUMÁN,165,155,345,346,691
90,90084,900840115,Capital,TUCUMÁN,276,275,601,552,1153
90,90084,900840102,Capital,TUCUMÁN,219,208,466,479,945
90,90084,900840509,Capital,TUCUMÁN,163,205,327,295,622
90,90084,900841112,Capital,TUCUMÁN,248,305,425,379,804
90,90084,900841105,Capital,TUCUMÁN,277,260,632,587,1219
90,90084,900841311,Capital,TUCUMÁN,146,222,223,151,374
90,90084,900841103,Capital,TUCUMÁN,212,316,351,309,660
90,90084,900841013,Capital,TUCUMÁN,276,225,577,547,1124
90,90084,900841010,Capital,TUCUMÁN,438,456,900,846,1746
90,90084,900841009,Capital,TUCUMÁN,285,267,690,638,1328
90,90084,900841001,Capital,TUCUMÁN,299,304,543,514,1057
90,90084,900840907,Capital,TUCUMÁN,201,169,438,392,830
90,90084,900840906,Capital,TUCUMÁN,178,181,381,327,708
90,90084,900840804,Capital,TUCUMÁN,241,237,539,534,1073
90,90084,900840713,Capital,TUCUMÁN,186,193,317,291,608
90,90084,900840712,Capital,TUCUMÁN,280,341,411,330,741
90,90084,900840702,Capital,TUCUMÁN,155,153,320,282,602
90,90084,900842013,Capital,TUCUMÁN,205,353,317,235,552
90,90084,900841216,Capital,TUCUMÁN,397,523,544,416,960
90,90084,900841214,Capital,TUCUMÁN,283,349,444,346,790
90,90084,900841213,Capital,TUCUMÁN,217,327,344,283,627
90,90084,900842007,Capital,TUCUMÁN,333,510,471,362,833
90,90084,900841205,Capital,TUCUMÁN,189,330,257,211,468
90,90084,900840505,Capital,TUCUMÁN,195,204,361,330,691
90,90084,900840504,Capital,TUCUMÁN,185,177,335,269,604
90,90084,900840503,Capital,TUCUMÁN,286,302,508,470,978
90,90084,900841316,Capital,TUCUMÁN,202,250,278,200,478
90,90084,900841809,Capital,TUCUMÁN,318,343,495,412,907
90,90084,900841509,Capital,TUCUMÁN,373,423,646,555,1201
90,90084,900841507,Capital,TUCUMÁN,133,166,374,265,639
90,90084,900841504,Capital,TUCUMÁN,360,399,659,594,1253
90,90084,900842606,Capital,TUCUMÁN,263,291,524,524,1048
90,90084,900842611,Capital,TUCUMÁN,282,239,596,501,1097
90,90084,900842419,Capital,TUCUMÁN,199,189,374,341,715
90,90119,901190508,Yerba Buena,TUCUMÁN,369,382,771,744,1515
90,90119,901190506,Yerba Buena,TUCUMÁN,176,206,343,320,663
90,90119,901190420,Yerba Buena,TUCUMÁN,270,282,587,541,1128
90,90119,901190417,Yerba Buena,TUCUMÁN,298,322,526,476,1002
90,90119,901190415,Yerba Buena,TUCUMÁN,135,145,268,258,526
90,90119,901190318,Yerba Buena,TUCUMÁN,186,192,384,409,793
90,90119,901190317,Yerba Buena,TUCUMÁN,443,427,812,797,1609
90,90119,901190316,Yerba Buena,TUCUMÁN,238,214,504,495,999
90,90119,901190204,Yerba Buena,TUCUMÁN,323,349,647,612,1259
90,90119,901190213,Yerba Buena,TUCUMÁN,241,245,498,442,940
90,90119,901190212,Yerba Buena,TUCUMÁN,157,162,306,289,595
90,90119,901190101,Yerba Buena,TUCUMÁN,15,14,25,28,53
90,90119,901190503,Yerba Buena,TUCUMÁN,266,233,529,545,1074
90,90119,901190419,Yerba Buena,TUCUMÁN,332,400,667,639,1306
90,90119,901190414,Yerba Buena,TUCUMÁN,211,234,423,361,784
90,90119,901190404,Yerba Buena,TUCUMÁN,353,339,703,756,1459
90,90119,901190402,Yerba Buena,TUCUMÁN,298,260,620,635,1255
90,90119,901190311,Yerba Buena,TUCUMÁN,179,172,366,379,745
90,90119,901190102,Yerba Buena,TUCUMÁN,4,30,8,16,24
90,90119,901190401,Yerba Buena,TUCUMÁN,206,209,461,479,940
90,90119,901190510,Yerba Buena,TUCUMÁN,252,308,471,458,929
90,90119,901190505,Yerba Buena,TUCUMÁN,214,242,409,400,809
90,90119,901190406,Yerba Buena,TUCUMÁN,366,383,719,687,1406
90,90119,901190405,Yerba Buena,TUCUMÁN,320,280,739,736,1475
90,90119,901190403,Yerba Buena,TUCUMÁN,333,276,733,713,1446
90,90119,901190208,Yerba Buena,TUCUMÁN,249,236,554,511,1065
90,90119,901190205,Yerba Buena,TUCUMÁN,223,226,471,417,888
90,90119,901190209,Yerba Buena,TUCUMÁN,269,236,616,579,1195
90,90119,901190516,Yerba Buena,TUCUMÁN,316,348,638,587,1225
90,90119,901190513,Yerba Buena,TUCUMÁN,402,463,864,769,1633
90,90119,901190504,Yerba Buena,TUCUMÁN,222,271,490,457,947
90,90119,901190421,Yerba Buena,TUCUMÁN,181,236,361,325,686
90,90119,901190418,Yerba Buena,TUCUMÁN,195,226,388,360,748
90,90119,901190413,Yerba Buena,TUCUMÁN,210,232,424,373,797
90,90119,901190411,Yerba Buena,TUCUMÁN,257,268,501,453,954
90,90119,901190408,Yerba Buena,TUCUMÁN,336,309,785,756,1541
90,90119,901190319,Yerba Buena,TUCUMÁN,271,309,512,473,985
90,90119,901190314,Yerba Buena,TUCUMÁN,254,335,511,507,1018
90,90119,901190305,Yerba Buena,TUCUMÁN,193,197,356,314,670
90,90119,901190207,Yerba Buena,TUCUMÁN,167,158,351,307,658
90,90119,901190202,Yerba Buena,TUCUMÁN,200,205,406,388,794
90,90119,901190215,Yerba Buena,TUCUMÁN,259,285,535,513,1048
90,90119,901190512,Yerba Buena,TUCUMÁN,375,470,740,741,1481
90,90119,901190304,Yerba Buena,TUCUMÁN,243,235,554,550,1104
90,90119,901190502,Yerba Buena,TUCUMÁN,235,233,485,462,947
90,90119,901190313,Yerba Buena,TUCUMÁN,355,399,698,640,1338
90,90119,901190310,Yerba Buena,TUCUMÁN,210,220,406,406,812
90,90119,901190216,Yerba Buena,TUCUMÁN,223,231,449,399,848
90,90119,901190211,Yerba Buena,TUCUMÁN,309,346,626,608,1234
90,90119,901190201,Yerba Buena,TUCUMÁN,292,287,640,597,1237
90,90119,901190412,Yerba Buena,TUCUMÁN,198,216,436,393,829
90,90119,901190409,Yerba Buena,TUCUMÁN,440,439,970,962,1932
90,90119,901190315,Yerba Buena,TUCUMÁN,239,273,532,497,1029
90,90119,901190309,Yerba Buena,TUCUMÁN,239,249,445,431,876
90,90119,901190307,Yerba Buena,TUCUMÁN,262,289,533,478,1011
90,90119,901190306,Yerba Buena,TUCUMÁN,280,257,663,707,1370
90,90119,901190511,Yerba Buena,TUCUMÁN,178,198,430,405,835
90,90119,901190501,Yerba Buena,TUCUMÁN,7,3,9,11,20
90,90119,901190302,Yerba Buena,TUCUMÁN,190,266,353,332,685
90,90119,901190514,Yerba Buena,TUCUMÁN,322,328,690,693,1383
90,90119,901190312,Yerba Buena,TUCUMÁN,173,206,345,316,661
90,90119,901190206,Yerba Buena,TUCUMÁN,369,400,812,740,1552
90,90119,901190214,Yerba Buena,TUCUMÁN,188,204,376,329,705
90,90119,901190210,Yerba Buena,TUCUMÁN,199,230,437,390,827
90,90119,901190217,Yerba Buena,TUCUMÁN,266,264,551,552,1103
90,90119,901190103,Yerba Buena,TUCUMÁN,46,80,97,108,205
90,90119,901190303,Yerba Buena,TUCUMÁN,149,186,341,294,635
90,90119,901190515,Yerba Buena,TUCUMÁN,281,325,591,536,1127
90,90119,901190507,Yerba Buena,TUCUMÁN,378,420,788,736,1524
90,90119,901190410,Yerba Buena,TUCUMÁN,259,276,488,395,883
90,90119,901190407,Yerba Buena,TUCUMÁN,423,393,1016,957,1973
90,90119,901190308,Yerba Buena,TUCUMÁN,194,213,386,350,736
90,90119,901190203,Yerba Buena,TUCUMÁN,211,229,445,400,845
90,90119,901190416,Yerba Buena,TUCUMÁN,119,129,245,219,464
90,90119,901190509,Yerba Buena,TUCUMÁN,318,350,635,633,1268
90,90119,901190301,Yerba Buena,TUCUMÁN,1,1,6,5,11
90,90112,901120216,Trancas,TUCUMÁN,257,280,549,548,1097
90,90112,901120211,Trancas,TUCUMÁN,5,12,3,9,12
90,90112,901120208,Trancas,TUCUMÁN,20,28,17,30,47
90,90112,901120207,Trancas,TUCUMÁN,34,50,49,71,120
90,90112,901120202,Trancas,TUCUMÁN,19,32,24,28,52
90,90112,901120307,Trancas,TUCUMÁN,147,191,210,265,475
90,90112,901120209,Trancas,TUCUMÁN,58,68,95,104,199
90,90112,901120107,Trancas,TUCUMÁN,16,35,17,25,42
90,90112,901120110,Trancas,TUCUMÁN,142,304,245,252,497
90,90112,901120403,Trancas,TUCUMÁN,88,95,184,215,399
90,90112,901120305,Trancas,TUCUMÁN,38,56,100,94,194
90,90112,901120212,Trancas,TUCUMÁN,23,38,35,47,82
90,90112,901120104,Trancas,TUCUMÁN,24,53,45,51,96
90,90112,901120102,Trancas,TUCUMÁN,41,73,44,69,113
90,90112,901120401,Trancas,TUCUMÁN,24,34,43,52,95
90,90112,901120214,Trancas,TUCUMÁN,299,322,618,555,1173
90,90112,901120115,Trancas,TUCUMÁN,143,288,285,295,580
90,90112,901120113,Trancas,TUCUMÁN,93,424,175,142,317
90,90112,901120112,Trancas,TUCUMÁN,82,353,204,159,363
90,90112,901120111,Trancas,TUCUMÁN,152,317,251,249,500
90,90112,901120402,Trancas,TUCUMÁN,45,44,105,109,214
90,90112,901120303,Trancas,TUCUMÁN,123,158,232,267,499
90,90112,901120206,Trancas,TUCUMÁN,57,98,77,90,167
90,90112,901120205,Trancas,TUCUMÁN,247,282,476,527,1003
90,90112,901120204,Trancas,TUCUMÁN,68,86,116,147,263
90,90112,901120301,Trancas,TUCUMÁN,62,69,111,118,229
90,90112,901120308,Trancas,TUCUMÁN,116,138,245,226,471
90,90112,901120404,Trancas,TUCUMÁN,195,228,396,461,857
90,90112,901120201,Trancas,TUCUMÁN,27,54,36,69,105
90,90112,901120215,Trancas,TUCUMÁN,162,167,306,294,600
90,90112,901120106,Trancas,TUCUMÁN,21,36,28,50,78
90,90112,901120103,Trancas,TUCUMÁN,41,54,77,90,167
90,90112,901120213,Trancas,TUCUMÁN,416,431,820,739,1559
90,90112,901120116,Trancas,TUCUMÁN,85,258,178,188,366
90,90112,901120304,Trancas,TUCUMÁN,28,37,46,61,107
90,90112,901120302,Trancas,TUCUMÁN,228,291,487,499,986
90,90112,901120210,Trancas,TUCUMÁN,326,476,716,737,1453
90,90112,901120203,Trancas,TUCUMÁN,92,131,156,181,337
90,90112,901120105,Trancas,TUCUMÁN,59,64,71,105,176
90,90112,901120101,Trancas,TUCUMÁN,11,23,15,25,40
90,90112,901120109,Trancas,TUCUMÁN,124,224,242,259,501
90,90112,901120114,Trancas,TUCUMÁN,112,375,185,202,387
90,90112,901120306,Trancas,TUCUMÁN,36,40,86,94,180
90,90112,901120108,Trancas,TUCUMÁN,55,72,78,95,173
90,90098,900980412,Tafí del Valle,TUCUMÁN,151,587,274,269,543
90,90098,900980413,Tafí del Valle,TUCUMÁN,95,240,182,191,373
90,90098,900980102,Tafí del Valle,TUCUMÁN,57,83,107,140,247
90,90098,900980103,Tafí del Valle,TUCUMÁN,23,37,31,25,56
90,90098,900980303,Tafí del Valle,TUCUMÁN,12,43,24,30,54
90,90098,900980409,Tafí del Valle,TUCUMÁN,112,190,182,225,407
90,90098,900980420,Tafí del Valle,TUCUMÁN,137,358,255,266,521
90,90098,900980201,Tafí del Valle,TUCUMÁN,12,16,19,21,40
90,90098,900980307,Tafí del Valle,TUCUMÁN,5,7,2,10,12
90,90098,900980407,Tafí del Valle,TUCUMÁN,80,164,129,145,274
90,90098,900980309,Tafí del Valle,TUCUMÁN,109,183,196,184,380
90,90098,900980304,Tafí del Valle,TUCUMÁN,90,141,179,175,354
90,90098,900980104,Tafí del Valle,TUCUMÁN,76,138,105,107,212
90,90098,900980101,Tafí del Valle,TUCUMÁN,131,159,226,254,480
90,90098,900980106,Tafí del Valle,TUCUMÁN,178,253,303,329,632
90,90098,900980419,Tafí del Valle,TUCUMÁN,24,291,53,44,97
90,90098,900980403,Tafí del Valle,TUCUMÁN,10,19,16,21,37
90,90098,900980202,Tafí del Valle,TUCUMÁN,4,10,2,3,5
90,90098,900980415,Tafí del Valle,TUCUMÁN,265,492,566,560,1126
90,90098,900980406,Tafí del Valle,TUCUMÁN,171,319,297,305,602
90,90098,900980405,Tafí del Valle,TUCUMÁN,142,281,275,306,581
90,90098,900980402,Tafí del Valle,TUCUMÁN,245,517,455,512,967
90,90098,900980108,Tafí del Valle,TUCUMÁN,0,5,0,0,0
90,90098,900980203,Tafí del Valle,TUCUMÁN,14,24,34,35,69
90,90098,900980311,Tafí del Valle,TUCUMÁN,179,336,314,317,631
90,90098,900980305,Tafí del Valle,TUCUMÁN,30,53,58,70,128
90,90098,900980410,Tafí del Valle,TUCUMÁN,91,415,148,172,320
90,90098,900980414,Tafí del Valle,TUCUMÁN,155,500,315,304,619
90,90098,900980411,Tafí del Valle,TUCUMÁN,74,297,139,133,272
90,90098,900980404,Tafí del Valle,TUCUMÁN,5,8,4,4,8
90,90098,900980306,Tafí del Valle,TUCUMÁN,0,1,0,0,0
90,90098,900980302,Tafí del Valle,TUCUMÁN,7,33,9,17,26
90,90098,900980301,Tafí del Valle,TUCUMÁN,11,21,10,21,31
90,90098,900980105,Tafí del Valle,TUCUMÁN,68,91,79,127,206
90,90098,900980401,Tafí del Valle,TUCUMÁN,181,284,320,360,680
90,90098,900980418,Tafí del Valle,TUCUMÁN,109,299,202,217,419
90,90098,900980417,Tafí del Valle,TUCUMÁN,94,207,183,185,368
90,90098,900980416,Tafí del Valle,TUCUMÁN,203,354,392,377,769
90,90098,900980310,Tafí del Valle,TUCUMÁN,187,373,362,334,696
90,90098,900980107,Tafí del Valle,TUCUMÁN,12,36,13,21,34
90,90098,900980308,Tafí del Valle,TUCUMÁN,225,374,424,434,858
90,90098,900980408,Tafí del Valle,TUCUMÁN,198,278,385,414,799
90,90070,900701410,Monteros,TUCUMÁN,312,326,594,553,1147
90,90070,900700306,Monteros,TUCUMÁN,201,237,388,383,771
90,90070,900701415,Monteros,TUCUMÁN,357,393,718,610,1328
90,90070,900701406,Monteros,TUCUMÁN,340,333,693,624,1317
90,90070,900701303,Monteros,TUCUMÁN,217,230,473,463,936
90,90070,900701202,Monteros,TUCUMÁN,66,80,99,116,215
90,90070,900701203,Monteros,TUCUMÁN,114,131,214,232,446
90,90070,900700901,Monteros,TUCUMÁN,0,5,0,0,0
90,90070,900700404,Monteros,TUCUMÁN,182,210,353,366,719
90,90070,900700401,Monteros,TUCUMÁN,66,93,123,123,246
90,90070,900700304,Monteros,TUCUMÁN,31,34,64,72,136
90,90070,900700302,Monteros,TUCUMÁN,35,37,71,101,172
90,90070,900701419,Monteros,TUCUMÁN,346,325,653,565,1218
90,90070,900701417,Monteros,TUCUMÁN,413,425,833,757,1590
90,90070,900701404,Monteros,TUCUMÁN,222,227,406,367,773
90,90070,900701401,Monteros,TUCUMÁN,186,193,355,313,668
90,90070,900701414,Monteros,TUCUMÁN,226,248,437,390,827
90,90070,900701412,Monteros,TUCUMÁN,232,243,469,443,912
90,90070,900700807,Monteros,TUCUMÁN,440,474,985,937,1922
90,90070,900700206,Monteros,TUCUMÁN,316,355,624,623,1247
90,90070,900700605,Monteros,TUCUMÁN,197,213,386,373,759
90,90070,900701003,Monteros,TUCUMÁN,82,71,172,161,333
90,90070,900701302,Monteros,TUCUMÁN,127,161,237,261,498
90,90070,900700902,Monteros,TUCUMÁN,64,74,115,160,275
90,90070,900700703,Monteros,TUCUMÁN,3,3,0,3,3
90,90070,900700501,Monteros,TUCUMÁN,142,151,280,306,586
90,90070,900700407,Monteros,TUCUMÁN,67,71,129,134,263
90,90070,900700201,Monteros,TUCUMÁN,22,34,27,42,69
90,90070,900700702,Monteros,TUCUMÁN,46,59,94,114,208
90,90070,900701420,Monteros,TUCUMÁN,291,303,599,566,1165
90,90070,900701408,Monteros,TUCUMÁN,168,183,325,259,584
90,90070,900701413,Monteros,TUCUMÁN,157,176,276,201,477
90,90070,900701101,Monteros,TUCUMÁN,76,78,178,180,358
90,90070,900701411,Monteros,TUCUMÁN,219,249,417,324,741
90,90070,900700604,Monteros,TUCUMÁN,264,247,533,541,1074
90,90070,900700603,Monteros,TUCUMÁN,212,257,380,413,793
90,90070,900700207,Monteros,TUCUMÁN,183,196,402,406,808
90,90070,900700204,Monteros,TUCUMÁN,225,237,450,430,880
90,90070,900701001,Monteros,TUCUMÁN,3,26,0,4,4
90,90070,900700903,Monteros,TUCUMÁN,298,322,602,645,1247
90,90070,900700403,Monteros,TUCUMÁN,305,418,557,560,1117
90,90070,900700303,Monteros,TUCUMÁN,33,41,61,68,129
90,90070,900700806,Monteros,TUCUMÁN,223,235,452,418,870
90,90070,900700412,Monteros,TUCUMÁN,270,327,554,537,1091
90,90070,900701403,Monteros,TUCUMÁN,174,199,307,286,593
90,90070,900700601,Monteros,TUCUMÁN,3,3,5,4,9
90,90070,900700408,Monteros,TUCUMÁN,48,57,81,94,175
90,90070,900700301,Monteros,TUCUMÁN,375,330,801,800,1601
90,90070,900701421,Monteros,TUCUMÁN,206,194,418,376,794
90,90070,900701402,Monteros,TUCUMÁN,230,225,497,478,975
90,90070,900700208,Monteros,TUCUMÁN,239,235,500,524,1024
90,90070,900700607,Monteros,TUCUMÁN,254,258,569,553,1122
90,90070,900701201,Monteros,TUCUMÁN,3,6,2,3,5
90,90070,900700803,Monteros,TUCUMÁN,87,74,174,193,367
90,90070,900700409,Monteros,TUCUMÁN,211,235,408,374,782
90,90070,900700405,Monteros,TUCUMÁN,121,134,224,245,469
90,90070,900700305,Monteros,TUCUMÁN,48,50,103,99,202
90,90070,900700802,Monteros,TUCUMÁN,11,10,23,25,48
90,90070,900701002,Monteros,TUCUMÁN,86,104,179,188,367
90,90070,900700602,Monteros,TUCUMÁN,285,301,667,658,1325
90,90070,900700203,Monteros,TUCUMÁN,111,134,221,215,436
90,90070,900701304,Monteros,TUCUMÁN,336,378,684,636,1320
90,90070,900701407,Monteros,TUCUMÁN,187,218,338,301,639
90,90070,900700101,Monteros,TUCUMÁN,109,114,222,234,456
90,90070,900700606,Monteros,TUCUMÁN,240,267,474,436,910
90,90070,900700414,Monteros,TUCUMÁN,226,228,498,488,986
90,90070,900700801,Monteros,TUCUMÁN,37,59,99,104,203
90,90070,900700502,Monteros,TUCUMÁN,161,179,267,275,542
90,90070,900700410,Monteros,TUCUMÁN,46,54,85,98,183
90,90070,900700904,Monteros,TUCUMÁN,70,66,152,132,284
90,90070,900701416,Monteros,TUCUMÁN,252,287,479,422,901
90,90070,900700205,Monteros,TUCUMÁN,352,388,736,802,1538
90,90070,900700808,Monteros,TUCUMÁN,173,169,363,351,714
90,90070,900700413,Monteros,TUCUMÁN,329,341,703,750,1453
90,90070,900700307,Monteros,TUCUMÁN,256,278,524,505,1029
90,90070,900701204,Monteros,TUCUMÁN,183,204,344,386,730
90,90070,900700406,Monteros,TUCUMÁN,173,191,346,384,730
90,90070,900700804,Monteros,TUCUMÁN,152,194,299,336,635
90,90070,900701301,Monteros,TUCUMÁN,359,369,777,745,1522
90,90070,900701102,Monteros,TUCUMÁN,108,120,247,248,495
90,90070,900700102,Monteros,TUCUMÁN,109,124,221,254,475
90,90070,900701418,Monteros,TUCUMÁN,362,369,762,775,1537
90,90070,900701405,Monteros,TUCUMÁN,333,324,686,642,1328
90,90070,900701409,Monteros,TUCUMÁN,424,429,874,805,1679
90,90070,900700805,Monteros,TUCUMÁN,174,195,370,364,734
90,90070,900700701,Monteros,TUCUMÁN,92,98,205,179,384
90,90070,900700402,Monteros,TUCUMÁN,84,94,203,194,397
90,90070,900700202,Monteros,TUCUMÁN,70,74,160,166,326
90,90070,900700411,Monteros,TUCUMÁN,76,77,142,153,295
90,90056,900560308,Leales,TUCUMÁN,318,325,565,520,1085
90,90056,900561401,Leales,TUCUMÁN,72,79,141,142,283
90,90056,900561202,Leales,TUCUMÁN,95,103,166,183,349
90,90056,900561103,Leales,TUCUMÁN,33,53,66,66,132
90,90056,900560603,Leales,TUCUMÁN,193,210,374,424,798
90,90056,900560801,Leales,TUCUMÁN,59,68,120,125,245
90,90056,900560607,Leales,TUCUMÁN,64,90,123,149,272
90,90056,900560605,Leales,TUCUMÁN,45,54,86,96,182
90,90056,900561403,Leales,TUCUMÁN,154,181,325,343,668
90,90056,900561108,Leales,TUCUMÁN,293,327,616,621,1237
90,90056,900560307,Leales,TUCUMÁN,215,222,394,386,780
90,90056,900560306,Leales,TUCUMÁN,355,360,762,714,1476
90,90056,900560305,Leales,TUCUMÁN,367,377,824,847,1671
90,90056,900561303,Leales,TUCUMÁN,41,54,70,69,139
90,90056,900561301,Leales,TUCUMÁN,140,156,296,316,612
90,90056,900560907,Leales,TUCUMÁN,110,135,201,198,399
90,90056,900560706,Leales,TUCUMÁN,103,124,229,229,458
90,90056,900560406,Leales,TUCUMÁN,83,98,143,186,329
90,90056,900561102,Leales,TUCUMÁN,9,22,8,21,29
90,90056,900560903,Leales,TUCUMÁN,132,170,257,245,502
90,90056,900560103,Leales,TUCUMÁN,274,277,548,513,1061
90,90056,900561209,Leales,TUCUMÁN,89,92,187,174,361
90,90056,900561201,Leales,TUCUMÁN,86,99,189,191,380
90,90056,900561001,Leales,TUCUMÁN,145,157,303,325,628
90,90056,900560906,Leales,TUCUMÁN,63,60,136,149,285
90,90056,900560606,Leales,TUCUMÁN,100,116,198,217,415
90,90056,900560503,Leales,TUCUMÁN,118,121,233,250,483
90,90056,900560703,Leales,TUCUMÁN,36,49,58,58,116
90,90056,900560402,Leales,TUCUMÁN,227,304,414,454,868
90,90056,900560401,Leales,TUCUMÁN,99,115,184,198,382
90,90056,900561203,Leales,TUCUMÁN,185,214,359,349,708
90,90056,900560303,Leales,TUCUMÁN,223,228,473,463,936
90,90056,900560309,Leales,TUCUMÁN,288,315,569,530,1099
90,90056,900561205,Leales,TUCUMÁN,125,139,236,278,514
90,90056,900561107,Leales,TUCUMÁN,211,226,393,437,830
90,90056,900561005,Leales,TUCUMÁN,109,128,202,212,414
90,90056,900560910,Leales,TUCUMÁN,35,30,62,68,130
90,90056,900560904,Leales,TUCUMÁN,149,155,322,282,604
90,90056,900560901,Leales,TUCUMÁN,71,91,124,146,270
90,90056,900560604,Leales,TUCUMÁN,35,81,83,92,175
90,90056,900560405,Leales,TUCUMÁN,27,50,36,45,81
90,90056,900560704,Leales,TUCUMÁN,141,153,292,318,610
90,90056,900560101,Leales,TUCUMÁN,29,39,42,52,94
90,90056,900560505,Leales,TUCUMÁN,80,92,153,148,301
90,90056,900561305,Leales,TUCUMÁN,289,304,545,532,1077
90,90056,900560310,Leales,TUCUMÁN,305,320,629,540,1169
90,90056,900561302,Leales,TUCUMÁN,89,102,205,195,400
90,90056,900561210,Leales,TUCUMÁN,33,46,57,65,122
90,90056,900561002,Leales,TUCUMÁN,16,23,25,29,54
90,90056,900560909,Leales,TUCUMÁN,48,55,80,114,194
90,90056,900560908,Leales,TUCUMÁN,107,107,215,260,475
90,90056,900560701,Leales,TUCUMÁN,102,107,194,241,435
90,90056,900560705,Leales,TUCUMÁN,87,99,177,192,369
90,90056,900560403,Leales,TUCUMÁN,115,121,274,278,552
90,90056,900560805,Leales,TUCUMÁN,221,228,442,466,908
90,90056,900560102,Leales,TUCUMÁN,34,42,67,86,153
90,90056,900561213,Leales,TUCUMÁN,285,306,613,613,1226
90,90056,900560311,Leales,TUCUMÁN,429,446,841,820,1661
90,90056,900561306,Leales,TUCUMÁN,36,35,68,82,150
90,90056,900561304,Leales,TUCUMÁN,202,221,392,440,832
90,90056,900561212,Leales,TUCUMÁN,96,108,176,195,371
90,90056,900561211,Leales,TUCUMÁN,117,144,203,244,447
90,90056,900561207,Leales,TUCUMÁN,153,178,295,301,596
90,90056,900561206,Leales,TUCUMÁN,126,137,237,242,479
90,90056,900561003,Leales,TUCUMÁN,182,220,372,410,782
90,90056,900561106,Leales,TUCUMÁN,67,73,114,144,258
90,90056,900560501,Leales,TUCUMÁN,74,101,135,144,279
90,90056,900560803,Leales,TUCUMÁN,117,138,228,254,482
90,90056,900560404,Leales,TUCUMÁN,35,46,69,86,155
90,90056,900560202,Leales,TUCUMÁN,1,3,0,3,3
90,90056,900560201,Leales,TUCUMÁN,50,60,94,109,203
90,90056,900560804,Leales,TUCUMÁN,101,116,222,235,457
90,90056,900561402,Leales,TUCUMÁN,85,95,150,151,301
90,90056,900561404,Leales,TUCUMÁN,351,396,797,736,1533
90,90056,900561407,Leales,TUCUMÁN,301,308,596,575,1171
90,90056,900560408,Leales,TUCUMÁN,153,168,292,277,569
90,90056,900560302,Leales,TUCUMÁN,308,324,604,565,1169
90,90056,900560301,Leales,TUCUMÁN,248,259,524,490,1014
90,90056,900561101,Leales,TUCUMÁN,5,19,13,13,26
90,90056,900560911,Leales,TUCUMÁN,42,50,66,75,141
90,90056,900560602,Leales,TUCUMÁN,142,173,301,285,586
90,90056,900560601,Leales,TUCUMÁN,43,51,60,80,140
90,90056,900560802,Leales,TUCUMÁN,33,39,59,70,129
90,90056,900560407,Leales,TUCUMÁN,25,33,51,42,93
90,90056,900561408,Leales,TUCUMÁN,256,254,550,546,1096
90,90056,900560702,Leales,TUCUMÁN,322,354,653,662,1315
90,90056,900560312,Leales,TUCUMÁN,368,396,780,750,1530
90,90056,900560304,Leales,TUCUMÁN,162,166,326,306,632
90,90056,900561406,Leales,TUCUMÁN,227,239,452,462,914
90,90056,900561405,Leales,TUCUMÁN,109,115,227,247,474
90,90056,900561208,Leales,TUCUMÁN,33,37,71,77,148
90,90056,900561204,Leales,TUCUMÁN,165,197,308,311,619
90,90056,900561105,Leales,TUCUMÁN,88,110,177,178,355
90,90056,900561104,Leales,TUCUMÁN,96,101,164,184,348
90,90056,900561004,Leales,TUCUMÁN,117,134,225,223,448
90,90056,900560502,Leales,TUCUMÁN,241,282,458,457,915
90,90056,900560504,Leales,TUCUMÁN,195,218,406,391,797
90,90056,900560203,Leales,TUCUMÁN,178,231,343,358,701
90,90056,900560905,Leales,TUCUMÁN,23,26,43,43,86
90,90056,900560902,Leales,TUCUMÁN,4,9,7,12,19
90,90014,900141610,Cruz Alta,TUCUMÁN,202,216,411,386,797
90,90014,900141607,Cruz Alta,TUCUMÁN,253,269,511,460,971
90,90014,900141405,Cruz Alta,TUCUMÁN,285,310,601,566,1167
90,90014,900141206,Cruz Alta,TUCUMÁN,251,206,588,533,1121
90,90014,900141205,Cruz Alta,TUCUMÁN,338,337,710,745,1455
90,90014,900140711,Cruz Alta,TUCUMÁN,293,279,656,690,1346
90,90014,900140612,Cruz Alta,TUCUMÁN,302,285,698,724,1422
90,90014,900140124,Cruz Alta,TUCUMÁN,287,296,596,555,1151
90,90014,900140122,Cruz Alta,TUCUMÁN,442,485,1011,933,1944
90,90014,900140110,Cruz Alta,TUCUMÁN,376,371,796,787,1583
90,90014,900140115,Cruz Alta,TUCUMÁN,432,443,898,908,1806
90,90014,900140114,Cruz Alta,TUCUMÁN,477,447,1085,1002,2087
90,90014,900141309,Cruz Alta,TUCUMÁN,249,226,470,479,949
90,90014,900140128,Cruz Alta,TUCUMÁN,262,260,550,573,1123
90,90014,900140119,Cruz Alta,TUCUMÁN,262,276,622,570,1192
90,90014,900141615,Cruz Alta,TUCUMÁN,352,315,742,728,1470
90,90014,900140121,Cruz Alta,TUCUMÁN,415,374,872,786,1658
90,90014,900140712,Cruz Alta,TUCUMÁN,278,267,554,567,1121
90,90014,900141505,Cruz Alta,TUCUMÁN,79,72,160,162,322
90,90014,900141401,Cruz Alta,TUCUMÁN,7,6,15,22,37
90,90014,900141002,Cruz Alta,TUCUMÁN,114,133,190,211,401
90,90014,900140904,Cruz Alta,TUCUMÁN,75,82,154,165,319
90,90014,900140903,Cruz Alta,TUCUMÁN,152,193,313,332,645
90,90014,900140709,Cruz Alta,TUCUMÁN,64,67,149,120,269
90,90014,900140707,Cruz Alta,TUCUMÁN,35,35,70,86,156
90,90014,900140706,Cruz Alta,TUCUMÁN,151,157,335,330,665
90,90014,900140603,Cruz Alta,TUCUMÁN,6,10,8,17,25
90,90014,900140402,Cruz Alta,TUCUMÁN,57,72,80,115,195
90,90014,900140205,Cruz Alta,TUCUMÁN,184,162,406,439,845
90,90014,900140304,Cruz Alta,TUCUMÁN,66,72,142,149,291
90,90014,900141201,Cruz Alta,TUCUMÁN,262,278,584,538,1122
90,90014,900141612,Cruz Alta,TUCUMÁN,213,199,415,406,821
90,90014,900141506,Cruz Alta,TUCUMÁN,386,381,847,795,1642
90,90014,900141410,Cruz Alta,TUCUMÁN,267,244,604,586,1190
90,90014,900141617,Cruz Alta,TUCUMÁN,258,246,513,495,1008
90,90014,900141224,Cruz Alta,TUCUMÁN,202,213,445,415,860
90,90014,900141219,Cruz Alta,TUCUMÁN,328,336,674,619,1293
90,90014,900141207,Cruz Alta,TUCUMÁN,313,321,750,685,1435
90,90014,900141216,Cruz Alta,TUCUMÁN,232,232,506,458,964
90,90014,900141221,Cruz Alta,TUCUMÁN,159,160,327,344,671
90,90014,900141217,Cruz Alta,TUCUMÁN,354,317,788,730,1518
90,90014,900140611,Cruz Alta,TUCUMÁN,267,294,567,588,1155
90,90014,900140207,Cruz Alta,TUCUMÁN,353,338,734,733,1467
90,90014,900140113,Cruz Alta,TUCUMÁN,420,431,904,825,1729
90,90014,900140120,Cruz Alta,TUCUMÁN,237,237,513,496,1009
90,90014,900140117,Cruz Alta,TUCUMÁN,212,231,444,418,862
90,90014,900141614,Cruz Alta,TUCUMÁN,301,272,730,676,1406
90,90014,900140211,Cruz Alta,TUCUMÁN,254,236,574,546,1120
90,90014,900141105,Cruz Alta,TUCUMÁN,357,360,785,768,1553
90,90014,900140905,Cruz Alta,TUCUMÁN,143,169,295,318,613
90,90014,900141311,Cruz Alta,TUCUMÁN,377,342,887,853,1740
90,90014,900141218,Cruz Alta,TUCUMÁN,273,252,570,534,1104
90,90014,900141503,Cruz Alta,TUCUMÁN,29,41,63,64,127
90,90014,900141104,Cruz Alta,TUCUMÁN,168,202,323,335,658
90,90014,900140901,Cruz Alta,TUCUMÁN,231,312,449,474,923
90,90014,900140804,Cruz Alta,TUCUMÁN,53,71,79,77,156
90,90014,900140705,Cruz Alta,TUCUMÁN,56,48,118,135,253
90,90014,900140605,Cruz Alta,TUCUMÁN,6,6,10,12,22
90,90014,900140201,Cruz Alta,TUCUMÁN,61,72,122,134,256
90,90014,900140102,Cruz Alta,TUCUMÁN,273,272,562,611,1173
90,90014,900141504,Cruz Alta,TUCUMÁN,445,435,1010,1081,2091
90,90014,900141213,Cruz Alta,TUCUMÁN,333,315,732,669,1401
90,90014,900140404,Cruz Alta,TUCUMÁN,247,284,484,475,959
90,90014,900140209,Cruz Alta,TUCUMÁN,228,221,471,491,962
90,90014,900140129,Cruz Alta,TUCUMÁN,314,302,738,716,1454
90,90014,900140126,Cruz Alta,TUCUMÁN,549,562,1151,1118,2269
90,90014,900140111,Cruz Alta,TUCUMÁN,169,201,330,310,640
90,90014,900141605,Cruz Alta,TUCUMÁN,291,280,593,554,1147
90,90014,900141314,Cruz Alta,TUCUMÁN,203,168,418,466,884
90,90014,900141313,Cruz Alta,TUCUMÁN,259,249,612,541,1153
90,90014,900141502,Cruz Alta,TUCUMÁN,247,244,565,563,1128
90,90014,900141102,Cruz Alta,TUCUMÁN,286,308,566,540,1106
90,90014,900140906,Cruz Alta,TUCUMÁN,130,165,262,248,510
90,90014,900140902,Cruz Alta,TUCUMÁN,135,153,275,279,554
90,90014,900140708,Cruz Alta,TUCUMÁN,223,253,445,473,918
90,90014,900140701,Cruz Alta,TUCUMÁN,118,124,267,262,529
90,90014,900140504,Cruz Alta,TUCUMÁN,73,81,106,137,243
90,90014,900140502,Cruz Alta,TUCUMÁN,101,103,182,221,403
90,90014,900140204,Cruz Alta,TUCUMÁN,147,160,298,319,617
90,90014,900140103,Cruz Alta,TUCUMÁN,419,416,938,960,1898
90,90014,900140301,Cruz Alta,TUCUMÁN,229,254,454,521,975
90,90014,900141611,Cruz Alta,TUCUMÁN,236,246,461,460,921
90,90014,900141409,Cruz Alta,TUCUMÁN,393,354,832,834,1666
90,90014,900141407,Cruz Alta,TUCUMÁN,328,330,729,691,1420
90,90014,900141301,Cruz Alta,TUCUMÁN,346,340,791,763,1554
90,90014,900141223,Cruz Alta,TUCUMÁN,322,356,609,594,1203
90,90014,900141209,Cruz Alta,TUCUMÁN,337,320,780,702,1482
90,90014,900141106,Cruz Alta,TUCUMÁN,391,396,839,761,1600
90,90014,900140208,Cruz Alta,TUCUMÁN,363,368,731,713,1444
90,90014,900140127,Cruz Alta,TUCUMÁN,434,451,967,893,1860
90,90014,900140123,Cruz Alta,TUCUMÁN,332,326,692,671,1363
90,90014,900140116,Cruz Alta,TUCUMÁN,466,508,1014,1026,2040
90,90014,900141616,Cruz Alta,TUCUMÁN,524,527,1182,1136,2318
90,90014,900141604,Cruz Alta,TUCUMÁN,206,194,403,373,776
90,90014,900140118,Cruz Alta,TUCUMÁN,296,318,618,607,1225
90,90014,900141202,Cruz Alta,TUCUMÁN,184,150,359,385,744
90,90014,900141001,Cruz Alta,TUCUMÁN,158,172,308,305,613
90,90014,900140802,Cruz Alta,TUCUMÁN,62,82,143,151,294
90,90014,900140505,Cruz Alta,TUCUMÁN,70,79,127,186,313
90,90014,900140606,Cruz Alta,TUCUMÁN,135,153,277,262,539
90,90014,900141613,Cruz Alta,TUCUMÁN,390,385,835,780,1615
90,90014,900141303,Cruz Alta,TUCUMÁN,400,330,888,775,1663
90,90014,900141308,Cruz Alta,TUCUMÁN,243,236,519,458,977
90,90014,900141215,Cruz Alta,TUCUMÁN,212,200,408,412,820
90,90014,900140710,Cruz Alta,TUCUMÁN,356,390,725,690,1415
90,90014,900140609,Cruz Alta,TUCUMÁN,289,274,616,556,1172
90,90014,900140403,Cruz Alta,TUCUMÁN,214,245,424,443,867
90,90014,900141601,Cruz Alta,TUCUMÁN,183,147,375,359,734
90,90014,900140801,Cruz Alta,TUCUMÁN,77,87,171,175,346
90,90014,900140604,Cruz Alta,TUCUMÁN,22,22,39,52,91
90,90014,900140503,Cruz Alta,TUCUMÁN,134,190,251,291,542
90,90014,900140501,Cruz Alta,TUCUMÁN,32,38,50,65,115
90,90014,900140206,Cruz Alta,TUCUMÁN,41,44,80,94,174
90,90014,900140202,Cruz Alta,TUCUMÁN,132,119,295,336,631
90,90014,900140101,Cruz Alta,TUCUMÁN,122,127,217,251,468
90,90014,900140506,Cruz Alta,TUCUMÁN,91,104,189,201,390
90,90014,900140401,Cruz Alta,TUCUMÁN,36,50,74,90,164
90,90014,900141501,Cruz Alta,TUCUMÁN,263,291,627,582,1209
90,90014,900141608,Cruz Alta,TUCUMÁN,272,253,530,514,1044
90,90014,900141603,Cruz Alta,TUCUMÁN,241,241,521,470,991
90,90014,900141602,Cruz Alta,TUCUMÁN,395,367,791,661,1452
90,90014,900141305,Cruz Alta,TUCUMÁN,239,233,593,547,1140
90,90014,900141225,Cruz Alta,TUCUMÁN,205,409,441,445,886
90,90014,900141211,Cruz Alta,TUCUMÁN,299,295,622,631,1253
90,90014,900141210,Cruz Alta,TUCUMÁN,437,420,889,884,1773
90,90014,900140131,Cruz Alta,TUCUMÁN,434,431,973,963,1936
90,90014,900140112,Cruz Alta,TUCUMÁN,625,668,1344,1318,2662
90,90014,900140108,Cruz Alta,TUCUMÁN,219,196,446,455,901
90,90014,900140107,Cruz Alta,TUCUMÁN,273,292,592,623,1215
90,90014,900140106,Cruz Alta,TUCUMÁN,161,172,362,339,701
90,90014,900140105,Cruz Alta,TUCUMÁN,202,187,480,448,928
90,90014,900141404,Cruz Alta,TUCUMÁN,47,49,95,110,205
90,90014,900141101,Cruz Alta,TUCUMÁN,68,80,131,133,264
90,90014,900140805,Cruz Alta,TUCUMÁN,169,185,344,328,672
90,90014,900140803,Cruz Alta,TUCUMÁN,98,116,199,224,423
90,90014,900140303,Cruz Alta,TUCUMÁN,29,32,41,74,115
90,90014,900140602,Cruz Alta,TUCUMÁN,14,16,25,31,56
90,90014,900141103,Cruz Alta,TUCUMÁN,46,74,105,111,216
90,90014,900140601,Cruz Alta,TUCUMÁN,131,129,266,284,550
90,90014,900140104,Cruz Alta,TUCUMÁN,180,173,386,383,769
90,90014,900141609,Cruz Alta,TUCUMÁN,261,240,554,487,1041
90,90014,900141618,Cruz Alta,TUCUMÁN,330,341,689,659,1348
90,90014,900141307,Cruz Alta,TUCUMÁN,297,298,677,634,1311
90,90014,900141306,Cruz Alta,TUCUMÁN,459,437,987,971,1958
90,90014,900141304,Cruz Alta,TUCUMÁN,181,185,415,388,803
90,90014,900141212,Cruz Alta,TUCUMÁN,265,244,515,481,996
90,90014,900141208,Cruz Alta,TUCUMÁN,251,258,572,542,1114
90,90014,900140713,Cruz Alta,TUCUMÁN,439,465,928,859,1787
90,90014,900140610,Cruz Alta,TUCUMÁN,367,363,847,757,1604
90,90014,900140608,Cruz Alta,TUCUMÁN,174,174,376,352,728
90,90014,900140125,Cruz Alta,TUCUMÁN,274,275,587,613,1200
90,90014,900141312,Cruz Alta,TUCUMÁN,408,377,806,787,1593
90,90014,900141310,Cruz Alta,TUCUMÁN,483,456,1085,1065,2150
90,90014,900141220,Cruz Alta,TUCUMÁN,27,27,53,52,105
90,90014,900141203,Cruz Alta,TUCUMÁN,67,70,148,169,317
90,90014,900141003,Cruz Alta,TUCUMÁN,174,214,323,346,669
90,90014,900140806,Cruz Alta,TUCUMÁN,67,94,114,148,262
90,90014,900140704,Cruz Alta,TUCUMÁN,209,230,463,467,930
90,90014,900140703,Cruz Alta,TUCUMÁN,214,222,452,452,904
90,90014,900140203,Cruz Alta,TUCUMÁN,33,34,61,74,135
90,90014,900140302,Cruz Alta,TUCUMÁN,53,51,113,115,228
90,90014,900140613,Cruz Alta,TUCUMÁN,326,301,740,691,1431
90,90014,900141507,Cruz Alta,TUCUMÁN,464,453,949,946,1895
90,90014,900141408,Cruz Alta,TUCUMÁN,506,481,1161,1084,2245
90,90014,900141406,Cruz Alta,TUCUMÁN,267,245,544,596,1140
90,90014,900141302,Cruz Alta,TUCUMÁN,280,229,622,569,1191
90,90014,900141222,Cruz Alta,TUCUMÁN,432,421,944,901,1845
90,90014,900141214,Cruz Alta,TUCUMÁN,338,337,798,782,1580
90,90014,900140714,Cruz Alta,TUCUMÁN,295,270,612,611,1223
90,90014,900140614,Cruz Alta,TUCUMÁN,246,237,503,532,1035
90,90014,900140130,Cruz Alta,TUCUMÁN,514,444,1143,1179,2322
90,90014,900140109,Cruz Alta,TUCUMÁN,487,495,1054,1001,2055
90,90014,900140210,Cruz Alta,TUCUMÁN,249,234,499,467,966
90,90014,900141606,Cruz Alta,TUCUMÁN,229,199,465,466,931
90,90014,900141403,Cruz Alta,TUCUMÁN,31,39,58,47,105
90,90014,900141402,Cruz Alta,TUCUMÁN,8,8,9,12,21
90,90014,900141204,Cruz Alta,TUCUMÁN,452,360,975,936,1911
90,90014,900140702,Cruz Alta,TUCUMÁN,10,9,30,24,54
90,90014,900140607,Cruz Alta,TUCUMÁN,49,53,112,110,222
90,90042,900420112,Juan B. Alberdi,TUCUMÁN,217,236,442,383,825
90,90042,900420114,Juan B. Alberdi,TUCUMÁN,302,304,587,510,1097
90,90042,900420103,Juan B. Alberdi,TUCUMÁN,184,179,358,350,708
90,90042,900420109,Juan B. Alberdi,TUCUMÁN,155,160,244,236,480
90,90042,900420108,Juan B. Alberdi,TUCUMÁN,350,355,640,606,1246
90,90042,900420304,Juan B. Alberdi,TUCUMÁN,69,73,158,167,325
90,90042,900420205,Juan B. Alberdi,TUCUMÁN,61,68,138,155,293
90,90042,900420115,Juan B. Alberdi,TUCUMÁN,282,276,679,619,1298
90,90042,900420107,Juan B. Alberdi,TUCUMÁN,331,363,675,618,1293
90,90042,900420105,Juan B. Alberdi,TUCUMÁN,242,248,505,456,961
90,90042,900420213,Juan B. Alberdi,TUCUMÁN,108,130,212,229,441
90,90042,900420201,Juan B. Alberdi,TUCUMÁN,142,159,261,290,551
90,90042,900420302,Juan B. Alberdi,TUCUMÁN,199,227,437,447,884
90,90042,900420214,Juan B. Alberdi,TUCUMÁN,239,266,479,427,906
90,90042,900420110,Juan B. Alberdi,TUCUMÁN,192,197,347,330,677
90,90042,900420106,Juan B. Alberdi,TUCUMÁN,253,251,504,466,970
90,90042,900420301,Juan B. Alberdi,TUCUMÁN,49,56,123,150,273
90,90042,900420203,Juan B. Alberdi,TUCUMÁN,47,46,84,108,192
90,90042,900420217,Juan B. Alberdi,TUCUMÁN,154,152,356,363,719
90,90042,900420402,Juan B. Alberdi,TUCUMÁN,99,166,129,184,313
90,90042,900420207,Juan B. Alberdi,TUCUMÁN,57,64,94,122,216
90,90042,900420206,Juan B. Alberdi,TUCUMÁN,47,53,107,128,235
90,90042,900420305,Juan B. Alberdi,TUCUMÁN,96,105,216,229,445
90,90042,900420116,Juan B. Alberdi,TUCUMÁN,225,237,511,491,1002
90,90042,900420216,Juan B. Alberdi,TUCUMÁN,148,157,274,283,557
90,90042,900420401,Juan B. Alberdi,TUCUMÁN,21,32,41,50,91
90,90042,900420208,Juan B. Alberdi,TUCUMÁN,170,212,302,345,647
90,90042,900420306,Juan B. Alberdi,TUCUMÁN,291,309,609,596,1205
90,90042,900420113,Juan B. Alberdi,TUCUMÁN,280,299,552,492,1044
90,90042,900420212,Juan B. Alberdi,TUCUMÁN,506,592,1019,1042,2061
90,90042,900420101,Juan B. Alberdi,TUCUMÁN,317,335,641,589,1230
90,90042,900420215,Juan B. Alberdi,TUCUMÁN,140,206,270,262,532
90,90042,900420102,Juan B. Alberdi,TUCUMÁN,352,368,693,649,1342
90,90042,900420104,Juan B. Alberdi,TUCUMÁN,182,227,332,274,606
90,90042,900420111,Juan B. Alberdi,TUCUMÁN,154,160,320,289,609
90,90042,900420303,Juan B. Alberdi,TUCUMÁN,73,98,161,166,327
90,90042,900420211,Juan B. Alberdi,TUCUMÁN,302,335,645,619,1264
90,90042,900420210,Juan B. Alberdi,TUCUMÁN,134,141,334,301,635
90,90042,900420209,Juan B. Alberdi,TUCUMÁN,276,300,603,642,1245
90,90042,900420204,Juan B. Alberdi,TUCUMÁN,48,55,124,122,246
90,90042,900420202,Juan B. Alberdi,TUCUMÁN,60,64,121,125,246
90,90035,900350213,Graneros,TUCUMÁN,359,429,642,640,1282
90,90035,900350307,Graneros,TUCUMÁN,50,60,98,136,234
90,90035,900350114,Graneros,TUCUMÁN,285,391,558,543,1101
90,90035,900350201,Graneros,TUCUMÁN,24,24,37,50,87
90,90035,900350110,Graneros,TUCUMÁN,64,67,137,149,286
90,90035,900350102,Graneros,TUCUMÁN,33,37,50,71,121
90,90035,900350311,Graneros,TUCUMÁN,47,56,98,110,208
90,90035,900350310,Graneros,TUCUMÁN,97,124,194,233,427
90,90035,900350303,Graneros,TUCUMÁN,31,42,48,56,104
90,90035,900350208,Graneros,TUCUMÁN,49,53,76,99,175
90,90035,900350312,Graneros,TUCUMÁN,358,475,618,623,1241
90,90035,900350107,Graneros,TUCUMÁN,23,30,37,50,87
90,90035,900350211,Graneros,TUCUMÁN,6,11,4,10,14
90,90035,900350209,Graneros,TUCUMÁN,37,49,73,70,143
90,90035,900350308,Graneros,TUCUMÁN,12,18,20,28,48
90,90035,900350206,Graneros,TUCUMÁN,97,95,186,205,391
90,90035,900350113,Graneros,TUCUMÁN,324,382,634,640,1274
90,90035,900350108,Graneros,TUCUMÁN,11,13,14,32,46
90,90035,900350106,Graneros,TUCUMÁN,39,43,68,100,168
90,90035,900350103,Graneros,TUCUMÁN,32,37,52,68,120
90,90035,900350301,Graneros,TUCUMÁN,80,91,143,189,332
90,90035,900350202,Graneros,TUCUMÁN,20,22,25,38,63
90,90035,900350112,Graneros,TUCUMÁN,154,176,324,362,686
90,90035,900350101,Graneros,TUCUMÁN,230,247,476,496,972
90,90035,900350304,Graneros,TUCUMÁN,40,49,46,67,113
90,90035,900350203,Graneros,TUCUMÁN,10,13,16,25,41
90,90035,900350306,Graneros,TUCUMÁN,12,15,18,27,45
90,90035,900350111,Graneros,TUCUMÁN,154,153,334,377,711
90,90035,900350214,Graneros,TUCUMÁN,187,223,371,329,700
90,90035,900350212,Graneros,TUCUMÁN,233,273,425,434,859
90,90035,900350104,Graneros,TUCUMÁN,8,18,12,16,28
90,90035,900350305,Graneros,TUCUMÁN,52,55,86,109,195
90,90035,900350302,Graneros,TUCUMÁN,39,41,58,64,122
90,90035,900350210,Graneros,TUCUMÁN,5,5,12,12,24
90,90035,900350207,Graneros,TUCUMÁN,71,77,147,151,298
90,90035,900350105,Graneros,TUCUMÁN,21,31,36,40,76
90,90035,900350309,Graneros,TUCUMÁN,23,26,43,42,85
90,90035,900350204,Graneros,TUCUMÁN,40,41,90,101,191
90,90035,900350205,Graneros,TUCUMÁN,81,101,150,162,312
90,90035,900350109,Graneros,TUCUMÁN,43,50,60,81,141
90,90028,900280102,Famaillá,TUCUMÁN,350,352,801,775,1576
90,90028,900280205,Famaillá,TUCUMÁN,114,121,268,233,501
90,90028,900280108,Famaillá,TUCUMÁN,334,335,689,657,1346
90,90028,900280106,Famaillá,TUCUMÁN,231,265,489,410,899
90,90028,900280101,Famaillá,TUCUMÁN,375,360,835,836,1671
90,90028,900280310,Famaillá,TUCUMÁN,95,113,205,213,418
90,90028,900280308,Famaillá,TUCUMÁN,8,24,7,12,19
90,90028,900280320,Famaillá,TUCUMÁN,196,202,458,438,896
90,90028,900280103,Famaillá,TUCUMÁN,382,381,808,755,1563
90,90028,900280318,Famaillá,TUCUMÁN,370,368,760,773,1533
90,90028,900280111,Famaillá,TUCUMÁN,341,346,709,644,1353
90,90028,900280307,Famaillá,TUCUMÁN,270,263,597,643,1240
90,90028,900280305,Famaillá,TUCUMÁN,243,246,592,542,1134
90,90028,900280304,Famaillá,TUCUMÁN,113,115,225,266,491
90,90028,900280319,Famaillá,TUCUMÁN,316,308,754,764,1518
90,90028,900280208,Famaillá,TUCUMÁN,206,199,437,453,890
90,90028,900280107,Famaillá,TUCUMÁN,266,258,527,532,1059
90,90028,900280306,Famaillá,TUCUMÁN,212,168,473,521,994
90,90028,900280302,Famaillá,TUCUMÁN,76,122,106,156,262
90,90028,900280207,Famaillá,TUCUMÁN,251,242,555,651,1206
90,90028,900280206,Famaillá,TUCUMÁN,524,540,1153,1114,2267
90,90028,900280204,Famaillá,TUCUMÁN,43,64,106,116,222
90,90028,900280312,Famaillá,TUCUMÁN,106,113,238,288,526
90,90028,900280303,Famaillá,TUCUMÁN,33,32,65,74,139
90,90028,900280301,Famaillá,TUCUMÁN,5,5,6,14,20
90,90028,900280201,Famaillá,TUCUMÁN,10,10,12,20,32
90,90028,900280317,Famaillá,TUCUMÁN,287,282,655,670,1325
90,90028,900280316,Famaillá,TUCUMÁN,239,231,599,542,1141
90,90028,900280113,Famaillá,TUCUMÁN,265,275,578,539,1117
90,90028,900280112,Famaillá,TUCUMÁN,435,400,1017,986,2003
90,90028,900280105,Famaillá,TUCUMÁN,310,298,643,616,1259
90,90028,900280315,Famaillá,TUCUMÁN,3,43,6,7,13
90,90028,900280313,Famaillá,TUCUMÁN,2,5,11,11,22
90,90028,900280309,Famaillá,TUCUMÁN,72,88,130,131,261
90,90028,900280202,Famaillá,TUCUMÁN,44,52,58,96,154
90,90028,900280203,Famaillá,TUCUMÁN,59,66,103,118,221
90,90028,900280311,Famaillá,TUCUMÁN,61,55,111,126,237
90,90028,900280104,Famaillá,TUCUMÁN,317,315,662,599,1261
90,90028,900280110,Famaillá,TUCUMÁN,214,214,447,423,870
90,90028,900280109,Famaillá,TUCUMÁN,221,225,424,411,835
90,90028,900280314,Famaillá,TUCUMÁN,20,23,7,41,48
90,90021,900210619,Chicligasta,TUCUMÁN,208,211,417,371,788
90,90021,900210606,Chicligasta,TUCUMÁN,335,289,729,677,1406
90,90021,900210507,Chicligasta,TUCUMÁN,349,352,751,760,1511
90,90021,900210506,Chicligasta,TUCUMÁN,210,220,408,422,830
90,90021,900210708,Chicligasta,TUCUMÁN,185,220,329,271,600
90,90021,900210407,Chicligasta,TUCUMÁN,283,297,584,617,1201
90,90021,900210404,Chicligasta,TUCUMÁN,67,74,160,140,300
90,90021,900210402,Chicligasta,TUCUMÁN,51,51,120,121,241
90,90021,900210207,Chicligasta,TUCUMÁN,172,194,326,355,681
90,90021,900210208,Chicligasta,TUCUMÁN,130,151,273,294,567
90,90021,900210101,Chicligasta,TUCUMÁN,2,10,0,2,2
90,90021,900210106,Chicligasta,TUCUMÁN,130,131,302,318,620
90,90021,900210410,Chicligasta,TUCUMÁN,238,260,458,444,902
90,90021,900210613,Chicligasta,TUCUMÁN,218,229,404,363,767
90,90021,900210608,Chicligasta,TUCUMÁN,394,411,705,698,1403
90,90021,900210605,Chicligasta,TUCUMÁN,351,333,722,591,1313
90,90021,900210205,Chicligasta,TUCUMÁN,489,532,1060,1012,2072
90,90021,900210405,Chicligasta,TUCUMÁN,24,28,50,54,104
90,90021,900210304,Chicligasta,TUCUMÁN,121,136,251,269,520
90,90021,900210303,Chicligasta,TUCUMÁN,146,157,299,309,608
90,90021,900210209,Chicligasta,TUCUMÁN,148,154,346,324,670
90,90021,900210720,Chicligasta,TUCUMÁN,288,296,653,625,1278
90,90021,900210716,Chicligasta,TUCUMÁN,272,263,523,485,1008
90,90021,900210604,Chicligasta,TUCUMÁN,378,392,774,696,1470
90,90021,900210411,Chicligasta,TUCUMÁN,272,298,575,583,1158
90,90021,900210409,Chicligasta,TUCUMÁN,328,343,711,691,1402
90,90021,900210408,Chicligasta,TUCUMÁN,210,244,441,371,812
90,90021,900210110,Chicligasta,TUCUMÁN,169,203,363,383,746
90,90021,900210111,Chicligasta,TUCUMÁN,118,118,219,247,466
90,90021,900210206,Chicligasta,TUCUMÁN,188,215,376,431,807
90,90021,900210502,Chicligasta,TUCUMÁN,293,318,659,674,1333
90,90021,900210724,Chicligasta,TUCUMÁN,284,336,516,512,1028
90,90021,900210612,Chicligasta,TUCUMÁN,298,315,612,529,1141
90,90021,900210611,Chicligasta,TUCUMÁN,317,372,746,600,1346
90,90021,900210610,Chicligasta,TUCUMÁN,400,388,792,717,1509
90,90021,900210603,Chicligasta,TUCUMÁN,369,316,784,752,1536
90,90021,900210707,Chicligasta,TUCUMÁN,301,326,568,467,1035
90,90021,900210705,Chicligasta,TUCUMÁN,212,200,436,409,845
90,90021,900210706,Chicligasta,TUCUMÁN,381,406,727,611,1338
90,90021,900210718,Chicligasta,TUCUMÁN,226,239,479,508,987
90,90021,900210302,Chicligasta,TUCUMÁN,132,137,277,299,576
90,90021,900210102,Chicligasta,TUCUMÁN,104,129,205,235,440
90,90021,900210109,Chicligasta,TUCUMÁN,234,237,474,479,953
90,90021,900210406,Chicligasta,TUCUMÁN,180,186,376,385,761
90,90021,900210726,Chicligasta,TUCUMÁN,280,279,660,604,1264
90,90021,900210725,Chicligasta,TUCUMÁN,417,445,882,824,1706
90,90021,900210722,Chicligasta,TUCUMÁN,286,296,651,617,1268
90,90021,900210717,Chicligasta,TUCUMÁN,306,286,697,670,1367
90,90021,900210710,Chicligasta,TUCUMÁN,346,362,658,584,1242
90,90021,900210704,Chicligasta,TUCUMÁN,191,191,364,334,698
90,90021,900210618,Chicligasta,TUCUMÁN,268,266,597,559,1156
90,90021,900210602,Chicligasta,TUCUMÁN,510,451,1129,1062,2191
90,90021,900210505,Chicligasta,TUCUMÁN,21,28,40,46,86
90,90021,900210504,Chicligasta,TUCUMÁN,146,162,330,355,685
90,90021,900210104,Chicligasta,TUCUMÁN,311,322,673,702,1375
90,90021,900210723,Chicligasta,TUCUMÁN,225,229,453,452,905
90,90021,900210702,Chicligasta,TUCUMÁN,361,348,782,730,1512
90,90021,900210620,Chicligasta,TUCUMÁN,166,216,347,294,641
90,90021,900210709,Chicligasta,TUCUMÁN,298,262,611,599,1210
90,90021,900210617,Chicligasta,TUCUMÁN,183,176,411,357,768
90,90021,900210711,Chicligasta,TUCUMÁN,158,178,255,222,477
90,90021,900210715,Chicligasta,TUCUMÁN,273,268,543,504,1047
90,90021,900210714,Chicligasta,TUCUMÁN,267,244,559,490,1049
90,90021,900210501,Chicligasta,TUCUMÁN,149,145,311,299,610
90,90021,900210301,Chicligasta,TUCUMÁN,118,135,230,261,491
90,90021,900210202,Chicligasta,TUCUMÁN,80,88,141,177,318
90,90021,900210103,Chicligasta,TUCUMÁN,0,2,0,0,0
90,90021,900210701,Chicligasta,TUCUMÁN,429,472,909,841,1750
90,90021,900210712,Chicligasta,TUCUMÁN,237,253,472,363,835
90,90021,900210703,Chicligasta,TUCUMÁN,228,210,458,644,1102
90,90021,900210615,Chicligasta,TUCUMÁN,247,251,522,444,966
90,90021,900210601,Chicligasta,TUCUMÁN,26,27,70,56,126
90,90021,900210403,Chicligasta,TUCUMÁN,136,140,293,283,576
90,90021,900210204,Chicligasta,TUCUMÁN,192,208,370,403,773
90,90021,900210107,Chicligasta,TUCUMÁN,62,63,127,147,274
90,90021,900210105,Chicligasta,TUCUMÁN,146,161,286,266,552
90,90021,900210721,Chicligasta,TUCUMÁN,222,222,494,522,1016
90,90021,900210719,Chicligasta,TUCUMÁN,439,419,986,1023,2009
90,90021,900210614,Chicligasta,TUCUMÁN,360,376,731,631,1362
90,90021,900210609,Chicligasta,TUCUMÁN,171,172,344,290,634
90,90021,900210607,Chicligasta,TUCUMÁN,308,299,653,589,1242
90,90021,900210616,Chicligasta,TUCUMÁN,266,283,515,548,1063
90,90021,900210713,Chicligasta,TUCUMÁN,184,197,350,288,638
90,90021,900210503,Chicligasta,TUCUMÁN,189,233,320,376,696
90,90021,900210401,Chicligasta,TUCUMÁN,110,124,236,218,454
90,90021,900210203,Chicligasta,TUCUMÁN,108,125,237,245,482
90,90021,900210201,Chicligasta,TUCUMÁN,62,89,127,127,254
90,90021,900210108,Chicligasta,TUCUMÁN,177,185,375,409,784
90,90091,900911202,Simoca,TUCUMÁN,55,61,101,109,210
90,90091,900911201,Simoca,TUCUMÁN,102,130,197,233,430
90,90091,900911103,Simoca,TUCUMÁN,54,59,106,110,216
90,90091,900910605,Simoca,TUCUMÁN,25,25,47,52,99
90,90091,900910307,Simoca,TUCUMÁN,106,113,188,224,412
90,90091,900910208,Simoca,TUCUMÁN,152,190,268,321,589
90,90091,900910902,Simoca,TUCUMÁN,76,83,166,169,335
90,90091,900910804,Simoca,TUCUMÁN,95,113,149,156,305
90,90091,900910901,Simoca,TUCUMÁN,60,69,124,127,251
90,90091,900911203,Simoca,TUCUMÁN,13,16,16,30,46
90,90091,900911102,Simoca,TUCUMÁN,26,42,43,43,86
90,90091,900911101,Simoca,TUCUMÁN,56,62,81,112,193
90,90091,900910801,Simoca,TUCUMÁN,34,39,58,77,135
90,90091,900910701,Simoca,TUCUMÁN,195,208,395,441,836
90,90091,900910602,Simoca,TUCUMÁN,132,153,219,263,482
90,90091,900910205,Simoca,TUCUMÁN,112,138,188,225,413
90,90091,900910104,Simoca,TUCUMÁN,385,416,740,707,1447
90,90091,900910103,Simoca,TUCUMÁN,377,392,740,733,1473
90,90091,900910106,Simoca,TUCUMÁN,249,271,531,457,988
90,90091,900911004,Simoca,TUCUMÁN,37,44,65,88,153
90,90091,900911001,Simoca,TUCUMÁN,67,70,102,121,223
90,90091,900910503,Simoca,TUCUMÁN,122,140,211,231,442
90,90091,900910502,Simoca,TUCUMÁN,112,137,220,243,463
90,90091,900910404,Simoca,TUCUMÁN,87,94,185,185,370
90,90091,900910403,Simoca,TUCUMÁN,118,85,240,260,500
90,90091,900910305,Simoca,TUCUMÁN,152,153,306,331,637
90,90091,900910809,Simoca,TUCUMÁN,224,264,439,441,880
90,90091,900910808,Simoca,TUCUMÁN,132,151,276,269,545
90,90091,900910807,Simoca,TUCUMÁN,17,22,16,31,47
90,90091,900910805,Simoca,TUCUMÁN,56,67,86,118,204
90,90091,900910702,Simoca,TUCUMÁN,186,200,344,376,720
90,90091,900910606,Simoca,TUCUMÁN,30,42,54,64,118
90,90091,900910604,Simoca,TUCUMÁN,42,50,61,96,157
90,90091,900910601,Simoca,TUCUMÁN,26,29,53,59,112
90,90091,900910402,Simoca,TUCUMÁN,97,110,166,206,372
90,90091,900910301,Simoca,TUCUMÁN,76,84,148,165,313
90,90091,900910207,Simoca,TUCUMÁN,168,195,315,326,641
90,90091,900910202,Simoca,TUCUMÁN,87,94,144,172,316
90,90091,900910201,Simoca,TUCUMÁN,161,175,348,341,689
90,90091,900910105,Simoca,TUCUMÁN,293,327,591,534,1125
90,90091,900910603,Simoca,TUCUMÁN,75,77,119,121,240
90,90091,900910401,Simoca,TUCUMÁN,40,42,96,115,211
90,90091,900910306,Simoca,TUCUMÁN,159,174,298,300,598
90,90091,900910501,Simoca,TUCUMÁN,154,174,294,347,641
90,90091,900910203,Simoca,TUCUMÁN,144,161,309,324,633
90,90091,900910504,Simoca,TUCUMÁN,37,43,56,72,128
90,90091,900910101,Simoca,TUCUMÁN,447,460,941,915,1856
90,90091,900910704,Simoca,TUCUMÁN,80,78,138,153,291
90,90091,900910803,Simoca,TUCUMÁN,71,49,112,132,244
90,90091,900910302,Simoca,TUCUMÁN,170,179,304,347,651
90,90091,900910209,Simoca,TUCUMÁN,126,155,209,249,458
90,90091,900910607,Simoca,TUCUMÁN,117,145,210,189,399
90,90091,900911104,Simoca,TUCUMÁN,55,61,104,110,214
90,90091,900911003,Simoca,TUCUMÁN,116,137,210,236,446
90,90091,900910802,Simoca,TUCUMÁN,23,34,43,44,87
90,90091,900910102,Simoca,TUCUMÁN,386,370,769,693,1462
90,90091,900910406,Simoca,TUCUMÁN,48,61,97,90,187
90,90091,900910904,Simoca,TUCUMÁN,26,27,37,46,83
90,90091,900910903,Simoca,TUCUMÁN,76,85,131,155,286
90,90091,900911002,Simoca,TUCUMÁN,45,48,97,110,207
90,90091,900910806,Simoca,TUCUMÁN,49,55,65,82,147
90,90091,900910703,Simoca,TUCUMÁN,58,59,127,142,269
90,90091,900910405,Simoca,TUCUMÁN,120,141,217,215,432
90,90091,900910308,Simoca,TUCUMÁN,46,52,80,96,176
90,90091,900910304,Simoca,TUCUMÁN,167,169,349,371,720
90,90091,900910303,Simoca,TUCUMÁN,142,165,297,318,615
90,90091,900910206,Simoca,TUCUMÁN,88,106,171,209,380
90,90091,900910204,Simoca,TUCUMÁN,216,240,391,451,842
90,90049,900490401,La Cocha,TUCUMÁN,121,167,218,240,458
90,90049,900490302,La Cocha,TUCUMÁN,79,99,155,164,319
90,90049,900490404,La Cocha,TUCUMÁN,29,33,63,60,123
90,90049,900490203,La Cocha,TUCUMÁN,303,312,604,651,1255
90,90049,900490102,La Cocha,TUCUMÁN,229,193,470,490,960
90,90049,900490502,La Cocha,TUCUMÁN,124,127,259,251,510
90,90049,900490512,La Cocha,TUCUMÁN,207,238,471,440,911
90,90049,900490510,La Cocha,TUCUMÁN,310,348,621,616,1237
90,90049,900490601,La Cocha,TUCUMÁN,2,5,4,6,10
90,90049,900490403,La Cocha,TUCUMÁN,141,163,295,282,577
90,90049,900490505,La Cocha,TUCUMÁN,8,10,20,23,43
90,90049,900490205,La Cocha,TUCUMÁN,70,96,162,170,332
90,90049,900490501,La Cocha,TUCUMÁN,284,258,621,557,1178
90,90049,900490508,La Cocha,TUCUMÁN,232,214,515,456,971
90,90049,900490701,La Cocha,TUCUMÁN,1,1,3,2,5
90,90049,900490402,La Cocha,TUCUMÁN,166,188,348,322,670
90,90049,900490602,La Cocha,TUCUMÁN,149,181,260,277,537
90,90049,900490504,La Cocha,TUCUMÁN,30,37,50,77,127
90,90049,900490503,La Cocha,TUCUMÁN,12,26,15,26,41
90,90049,900490202,La Cocha,TUCUMÁN,17,18,25,43,68
90,90049,900490509,La Cocha,TUCUMÁN,390,407,767,724,1491
90,90049,900490511,La Cocha,TUCUMÁN,357,366,706,711,1417
90,90049,900490507,La Cocha,TUCUMÁN,41,45,87,108,195
90,90049,900490703,La Cocha,TUCUMÁN,162,198,311,344,655
90,90049,900490702,La Cocha,TUCUMÁN,130,178,276,273,549
90,90049,900490603,La Cocha,TUCUMÁN,54,59,102,98,200
90,90049,900490506,La Cocha,TUCUMÁN,85,84,163,207,370
90,90049,900490301,La Cocha,TUCUMÁN,217,253,419,477,896
90,90049,900490201,La Cocha,TUCUMÁN,149,167,299,325,624
90,90049,900490101,La Cocha,TUCUMÁN,140,168,259,260,519
90,90049,900490204,La Cocha,TUCUMÁN,368,404,856,898,1754
86,86049,860491916,Capital,SANTIAGO DEL ESTERO,307,518,624,602,1226
86,86049,860490501,Capital,SANTIAGO DEL ESTERO,661,792,1559,1490,3049
86,86049,860491605,Capital,SANTIAGO DEL ESTERO,343,374,751,764,1515
86,86049,860491702,Capital,SANTIAGO DEL ESTERO,213,242,446,422,868
86,86049,860491804,Capital,SANTIAGO DEL ESTERO,342,384,724,729,1453
86,86049,860490201,Capital,SANTIAGO DEL ESTERO,346,300,636,751,1387
86,86049,860490309,Capital,SANTIAGO DEL ESTERO,271,287,660,631,1291
86,86049,860490512,Capital,SANTIAGO DEL ESTERO,287,253,671,665,1336
86,86049,860490310,Capital,SANTIAGO DEL ESTERO,234,268,461,458,919
86,86049,860490508,Capital,SANTIAGO DEL ESTERO,314,369,657,574,1231
86,86049,860490514,Capital,SANTIAGO DEL ESTERO,406,416,927,828,1755
86,86049,860490909,Capital,SANTIAGO DEL ESTERO,279,430,408,300,708
86,86049,860490913,Capital,SANTIAGO DEL ESTERO,209,283,356,241,597
86,86049,860491115,Capital,SANTIAGO DEL ESTERO,322,383,628,543,1171
86,86049,860491202,Capital,SANTIAGO DEL ESTERO,244,290,409,357,766
86,86049,860491206,Capital,SANTIAGO DEL ESTERO,294,330,542,467,1009
86,86049,860491502,Capital,SANTIAGO DEL ESTERO,229,233,513,487,1000
86,86049,860491707,Capital,SANTIAGO DEL ESTERO,303,303,731,710,1441
86,86049,860491504,Capital,SANTIAGO DEL ESTERO,266,297,558,445,1003
86,86049,860491616,Capital,SANTIAGO DEL ESTERO,238,261,594,542,1136
86,86049,860491703,Capital,SANTIAGO DEL ESTERO,259,259,566,473,1039
86,86049,860491709,Capital,SANTIAGO DEL ESTERO,354,361,792,760,1552
86,86049,860491717,Capital,SANTIAGO DEL ESTERO,299,373,600,581,1181
86,86049,860491902,Capital,SANTIAGO DEL ESTERO,427,468,794,787,1581
86,86049,860491904,Capital,SANTIAGO DEL ESTERO,362,506,724,632,1356
86,86049,860491005,Capital,SANTIAGO DEL ESTERO,286,297,602,512,1114
86,86049,860491908,Capital,SANTIAGO DEL ESTERO,379,435,727,648,1375
86,86049,860490521,Capital,SANTIAGO DEL ESTERO,187,222,383,331,714
86,86049,860490103,Capital,SANTIAGO DEL ESTERO,66,71,139,151,290
86,86049,860490302,Capital,SANTIAGO DEL ESTERO,12,13,27,22,49
86,86049,860490601,Capital,SANTIAGO DEL ESTERO,95,110,168,221,389
86,86049,860490402,Capital,SANTIAGO DEL ESTERO,135,146,247,324,571
86,86049,860491403,Capital,SANTIAGO DEL ESTERO,336,391,649,566,1215
86,86049,860491408,Capital,SANTIAGO DEL ESTERO,194,204,445,359,804
86,86049,860491215,Capital,SANTIAGO DEL ESTERO,258,282,519,478,997
86,86049,860491711,Capital,SANTIAGO DEL ESTERO,304,328,662,580,1242
86,86049,860490819,Capital,SANTIAGO DEL ESTERO,233,264,476,444,920
86,86049,860491515,Capital,SANTIAGO DEL ESTERO,208,230,444,474,918
86,86049,860490511,Capital,SANTIAGO DEL ESTERO,230,238,575,540,1115
86,86049,860490305,Capital,SANTIAGO DEL ESTERO,348,352,725,658,1383
86,86049,860490313,Capital,SANTIAGO DEL ESTERO,148,358,260,251,511
86,86049,860490504,Capital,SANTIAGO DEL ESTERO,315,343,691,630,1321
86,86049,860490506,Capital,SANTIAGO DEL ESTERO,316,397,696,723,1419
86,86049,860490510,Capital,SANTIAGO DEL ESTERO,117,118,277,282,559
86,86049,860490519,Capital,SANTIAGO DEL ESTERO,372,440,689,630,1319
86,86049,860490922,Capital,SANTIAGO DEL ESTERO,169,236,267,195,462
86,86049,860491015,Capital,SANTIAGO DEL ESTERO,268,303,481,392,873
86,86049,860490911,Capital,SANTIAGO DEL ESTERO,141,202,245,157,402
86,86049,860490918,Capital,SANTIAGO DEL ESTERO,302,362,539,474,1013
86,86049,860491020,Capital,SANTIAGO DEL ESTERO,276,268,610,546,1156
86,86049,860491503,Capital,SANTIAGO DEL ESTERO,349,364,652,542,1194
86,86049,860491708,Capital,SANTIAGO DEL ESTERO,228,247,495,497,992
86,86049,860491802,Capital,SANTIAGO DEL ESTERO,369,399,812,751,1563
86,86049,860491803,Capital,SANTIAGO DEL ESTERO,295,336,683,690,1373
86,86049,860491815,Capital,SANTIAGO DEL ESTERO,301,325,697,631,1328
86,86049,860490513,Capital,SANTIAGO DEL ESTERO,249,229,594,596,1190
86,86049,860490522,Capital,SANTIAGO DEL ESTERO,322,309,741,680,1421
86,86049,860490811,Capital,SANTIAGO DEL ESTERO,189,221,359,311,670
86,86049,860491218,Capital,SANTIAGO DEL ESTERO,220,233,476,418,894
86,86049,860491301,Capital,SANTIAGO DEL ESTERO,288,384,557,397,954
86,86049,860491310,Capital,SANTIAGO DEL ESTERO,288,310,509,454,963
86,86049,860491312,Capital,SANTIAGO DEL ESTERO,212,289,342,268,610
86,86049,860491401,Capital,SANTIAGO DEL ESTERO,187,213,329,300,629
86,86049,860491217,Capital,SANTIAGO DEL ESTERO,265,264,620,556,1176
86,86049,860491308,Capital,SANTIAGO DEL ESTERO,227,239,431,685,1116
86,86049,860491407,Capital,SANTIAGO DEL ESTERO,212,203,492,442,934
86,86049,860491511,Capital,SANTIAGO DEL ESTERO,246,267,519,494,1013
86,86049,860491912,Capital,SANTIAGO DEL ESTERO,327,370,623,587,1210
86,86049,860491012,Capital,SANTIAGO DEL ESTERO,304,377,484,429,913
86,86049,860490308,Capital,SANTIAGO DEL ESTERO,252,304,532,586,1118
86,86049,860490303,Capital,SANTIAGO DEL ESTERO,397,403,770,726,1496
86,86049,860490306,Capital,SANTIAGO DEL ESTERO,352,338,764,726,1490
86,86049,860490312,Capital,SANTIAGO DEL ESTERO,209,463,445,418,863
86,86049,860490505,Capital,SANTIAGO DEL ESTERO,195,245,393,404,797
86,86049,860491002,Capital,SANTIAGO DEL ESTERO,256,257,505,575,1080
86,86049,860490517,Capital,SANTIAGO DEL ESTERO,223,257,469,402,871
86,86049,860490518,Capital,SANTIAGO DEL ESTERO,310,393,615,539,1154
86,86049,860490802,Capital,SANTIAGO DEL ESTERO,235,247,497,476,973
86,86049,860490807,Capital,SANTIAGO DEL ESTERO,197,226,372,304,676
86,86049,860490903,Capital,SANTIAGO DEL ESTERO,233,272,396,354,750
86,86049,860491011,Capital,SANTIAGO DEL ESTERO,218,245,342,292,634
86,86049,860491016,Capital,SANTIAGO DEL ESTERO,291,304,517,434,951
86,86049,860491106,Capital,SANTIAGO DEL ESTERO,354,377,782,722,1504
86,86049,860491205,Capital,SANTIAGO DEL ESTERO,212,237,412,390,802
86,86049,860491210,Capital,SANTIAGO DEL ESTERO,319,330,684,656,1340
86,86049,860491211,Capital,SANTIAGO DEL ESTERO,179,181,346,332,678
86,86049,860491411,Capital,SANTIAGO DEL ESTERO,257,266,489,441,930
86,86049,860491514,Capital,SANTIAGO DEL ESTERO,390,417,865,791,1656
86,86049,860491601,Capital,SANTIAGO DEL ESTERO,369,366,794,776,1570
86,86049,860491606,Capital,SANTIAGO DEL ESTERO,269,288,540,524,1064
86,86049,860491610,Capital,SANTIAGO DEL ESTERO,308,322,774,672,1446
86,86049,860491715,Capital,SANTIAGO DEL ESTERO,313,313,690,591,1281
86,86049,860491812,Capital,SANTIAGO DEL ESTERO,83,243,183,179,362
86,86049,860491814,Capital,SANTIAGO DEL ESTERO,214,250,433,419,852
86,86049,860491214,Capital,SANTIAGO DEL ESTERO,241,254,453,379,832
86,86049,860490813,Capital,SANTIAGO DEL ESTERO,270,252,517,465,982
86,86049,860490602,Capital,SANTIAGO DEL ESTERO,64,67,114,127,241
86,86049,860491307,Capital,SANTIAGO DEL ESTERO,253,256,502,451,953
86,86049,860491811,Capital,SANTIAGO DEL ESTERO,212,267,473,440,913
86,86049,860491313,Capital,SANTIAGO DEL ESTERO,135,174,228,173,401
86,86049,860491006,Capital,SANTIAGO DEL ESTERO,389,395,951,876,1827
86,86049,860491007,Capital,SANTIAGO DEL ESTERO,340,350,814,797,1611
86,86049,860491614,Capital,SANTIAGO DEL ESTERO,227,251,483,468,951
86,86049,860491909,Capital,SANTIAGO DEL ESTERO,292,499,580,482,1062
86,86049,860491914,Capital,SANTIAGO DEL ESTERO,335,451,625,585,1210
86,86049,860491915,Capital,SANTIAGO DEL ESTERO,196,377,380,350,730
86,86049,860490503,Capital,SANTIAGO DEL ESTERO,281,309,611,599,1210
86,86049,860490515,Capital,SANTIAGO DEL ESTERO,303,330,571,498,1069
86,86049,860490523,Capital,SANTIAGO DEL ESTERO,120,253,180,199,379
86,86049,860490804,Capital,SANTIAGO DEL ESTERO,181,185,483,394,877
86,86049,860490905,Capital,SANTIAGO DEL ESTERO,227,296,428,368,796
86,86049,860490906,Capital,SANTIAGO DEL ESTERO,236,315,338,276,614
86,86049,860490916,Capital,SANTIAGO DEL ESTERO,240,284,422,343,765
86,86049,860490917,Capital,SANTIAGO DEL ESTERO,265,305,508,446,954
86,86049,860491008,Capital,SANTIAGO DEL ESTERO,283,319,662,683,1345
86,86049,860491009,Capital,SANTIAGO DEL ESTERO,291,348,495,412,907
86,86049,860491018,Capital,SANTIAGO DEL ESTERO,312,310,682,676,1358
86,86049,860491019,Capital,SANTIAGO DEL ESTERO,314,313,774,721,1495
86,86049,860491108,Capital,SANTIAGO DEL ESTERO,317,328,528,480,1008
86,86049,860491112,Capital,SANTIAGO DEL ESTERO,377,480,745,638,1383
86,86049,860491203,Capital,SANTIAGO DEL ESTERO,262,270,499,452,951
86,86049,860491207,Capital,SANTIAGO DEL ESTERO,232,264,433,396,829
86,86049,860491608,Capital,SANTIAGO DEL ESTERO,280,294,515,402,917
86,86049,860491716,Capital,SANTIAGO DEL ESTERO,274,331,618,566,1184
86,86049,860491801,Capital,SANTIAGO DEL ESTERO,293,253,632,635,1267
86,86049,860491805,Capital,SANTIAGO DEL ESTERO,348,356,704,670,1374
86,86049,860491816,Capital,SANTIAGO DEL ESTERO,298,301,611,536,1147
86,86049,860490502,Capital,SANTIAGO DEL ESTERO,537,640,1163,1192,2355
86,86049,860490301,Capital,SANTIAGO DEL ESTERO,11,12,24,30,54
86,86049,860490814,Capital,SANTIAGO DEL ESTERO,206,201,449,398,847
86,86049,860490816,Capital,SANTIAGO DEL ESTERO,213,211,458,478,936
86,86049,860490101,Capital,SANTIAGO DEL ESTERO,198,206,365,413,778
86,86049,860490404,Capital,SANTIAGO DEL ESTERO,36,41,72,81,153
86,86049,860491305,Capital,SANTIAGO DEL ESTERO,318,355,552,429,981
86,86049,860491314,Capital,SANTIAGO DEL ESTERO,186,207,315,236,551
86,86049,860491907,Capital,SANTIAGO DEL ESTERO,300,636,530,486,1016
86,86049,860491219,Capital,SANTIAGO DEL ESTERO,227,244,502,357,859
86,86049,860491309,Capital,SANTIAGO DEL ESTERO,383,441,664,522,1186
86,86049,860491508,Capital,SANTIAGO DEL ESTERO,457,493,932,909,1841
86,86049,860491612,Capital,SANTIAGO DEL ESTERO,295,316,560,465,1025
86,86049,860491613,Capital,SANTIAGO DEL ESTERO,336,347,694,584,1278
86,86049,860491910,Capital,SANTIAGO DEL ESTERO,75,379,122,105,227
86,86049,860491303,Capital,SANTIAGO DEL ESTERO,248,308,402,328,730
86,86049,860490307,Capital,SANTIAGO DEL ESTERO,296,319,660,619,1279
86,86049,860490304,Capital,SANTIAGO DEL ESTERO,283,280,531,478,1009
86,86049,860490507,Capital,SANTIAGO DEL ESTERO,227,292,560,572,1132
86,86049,860490806,Capital,SANTIAGO DEL ESTERO,151,223,281,201,482
86,86049,860490904,Capital,SANTIAGO DEL ESTERO,272,299,527,430,957
86,86049,860490915,Capital,SANTIAGO DEL ESTERO,262,329,450,362,812
86,86049,860491010,Capital,SANTIAGO DEL ESTERO,214,236,339,285,624
86,86049,860491105,Capital,SANTIAGO DEL ESTERO,241,248,492,472,964
86,86049,860491113,Capital,SANTIAGO DEL ESTERO,372,402,792,761,1553
86,86049,860491208,Capital,SANTIAGO DEL ESTERO,303,309,629,562,1191
86,86049,860491209,Capital,SANTIAGO DEL ESTERO,232,257,460,411,871
86,86049,860491213,Capital,SANTIAGO DEL ESTERO,258,271,550,452,1002
86,86049,860491413,Capital,SANTIAGO DEL ESTERO,266,301,491,415,906
86,86049,860491415,Capital,SANTIAGO DEL ESTERO,293,297,653,592,1245
86,86049,860491505,Capital,SANTIAGO DEL ESTERO,199,225,403,358,761
86,86049,860491607,Capital,SANTIAGO DEL ESTERO,328,342,799,747,1546
86,86049,860491705,Capital,SANTIAGO DEL ESTERO,279,309,594,563,1157
86,86049,860491808,Capital,SANTIAGO DEL ESTERO,277,304,569,496,1065
86,86049,860491817,Capital,SANTIAGO DEL ESTERO,289,317,683,639,1322
86,86049,860490202,Capital,SANTIAGO DEL ESTERO,509,354,1060,1106,2166
86,86049,860491004,Capital,SANTIAGO DEL ESTERO,280,287,692,689,1381
86,86049,860491003,Capital,SANTIAGO DEL ESTERO,511,517,1172,1227,2399
86,86049,860491114,Capital,SANTIAGO DEL ESTERO,351,396,689,633,1322
86,86049,860490102,Capital,SANTIAGO DEL ESTERO,165,144,309,360,669
86,86049,860491311,Capital,SANTIAGO DEL ESTERO,274,369,469,371,840
86,86049,860491405,Capital,SANTIAGO DEL ESTERO,275,293,516,451,967
86,86049,860491409,Capital,SANTIAGO DEL ESTERO,168,181,322,294,616
86,86049,860491507,Capital,SANTIAGO DEL ESTERO,231,263,525,514,1039
86,86049,860491512,Capital,SANTIAGO DEL ESTERO,304,306,671,684,1355
86,86049,860491710,Capital,SANTIAGO DEL ESTERO,327,332,737,729,1466
86,86049,860491905,Capital,SANTIAGO DEL ESTERO,366,500,700,583,1283
86,86049,860491906,Capital,SANTIAGO DEL ESTERO,415,463,780,716,1496
86,86049,860490311,Capital,SANTIAGO DEL ESTERO,300,339,606,548,1154
86,86049,860490314,Capital,SANTIAGO DEL ESTERO,402,463,744,692,1436
86,86049,860490815,Capital,SANTIAGO DEL ESTERO,238,249,537,506,1043
86,86049,860490516,Capital,SANTIAGO DEL ESTERO,374,394,802,722,1524
86,86049,860490520,Capital,SANTIAGO DEL ESTERO,273,394,532,532,1064
86,86049,860490803,Capital,SANTIAGO DEL ESTERO,182,171,360,315,675
86,86049,860490901,Capital,SANTIAGO DEL ESTERO,285,295,609,605,1214
86,86049,860490919,Capital,SANTIAGO DEL ESTERO,259,275,429,356,785
86,86049,860491013,Capital,SANTIAGO DEL ESTERO,176,214,281,246,527
86,86049,860491111,Capital,SANTIAGO DEL ESTERO,337,335,597,520,1117
86,86049,860491412,Capital,SANTIAGO DEL ESTERO,339,369,670,605,1275
86,86049,860490817,Capital,SANTIAGO DEL ESTERO,389,477,792,729,1521
86,86049,860491911,Capital,SANTIAGO DEL ESTERO,303,342,601,561,1162
86,86049,860490401,Capital,SANTIAGO DEL ESTERO,83,87,126,181,307
86,86049,860491302,Capital,SANTIAGO DEL ESTERO,213,329,403,309,712
86,86049,860491404,Capital,SANTIAGO DEL ESTERO,248,260,496,441,937
86,86049,860491713,Capital,SANTIAGO DEL ESTERO,294,296,705,623,1328
86,86049,860491809,Capital,SANTIAGO DEL ESTERO,334,381,638,620,1258
86,86049,860491014,Capital,SANTIAGO DEL ESTERO,204,259,327,245,572
86,86049,860491102,Capital,SANTIAGO DEL ESTERO,291,351,617,576,1193
86,86049,860490509,Capital,SANTIAGO DEL ESTERO,349,380,861,814,1675
86,86049,860490809,Capital,SANTIAGO DEL ESTERO,256,259,480,386,866
86,86049,860491001,Capital,SANTIAGO DEL ESTERO,386,371,735,704,1439
86,86049,860490920,Capital,SANTIAGO DEL ESTERO,145,224,203,144,347
86,86049,860490908,Capital,SANTIAGO DEL ESTERO,205,308,259,199,458
86,86049,860491101,Capital,SANTIAGO DEL ESTERO,366,367,754,737,1491
86,86049,860491107,Capital,SANTIAGO DEL ESTERO,245,274,445,478,923
86,86049,860491109,Capital,SANTIAGO DEL ESTERO,363,432,678,645,1323
86,86049,860491212,Capital,SANTIAGO DEL ESTERO,177,201,372,328,700
86,86049,860491410,Capital,SANTIAGO DEL ESTERO,281,345,557,446,1003
86,86049,860491602,Capital,SANTIAGO DEL ESTERO,363,383,809,739,1548
86,86049,860491609,Capital,SANTIAGO DEL ESTERO,268,288,490,412,902
86,86049,860491714,Capital,SANTIAGO DEL ESTERO,302,301,662,653,1315
86,86049,860491704,Capital,SANTIAGO DEL ESTERO,306,306,626,607,1233
86,86049,860491718,Capital,SANTIAGO DEL ESTERO,284,298,667,610,1277
86,86049,860491807,Capital,SANTIAGO DEL ESTERO,302,340,592,607,1199
86,86049,860491901,Capital,SANTIAGO DEL ESTERO,254,418,465,426,891
86,86049,860491220,Capital,SANTIAGO DEL ESTERO,216,225,460,416,876
86,86049,860490403,Capital,SANTIAGO DEL ESTERO,40,50,91,94,185
86,86049,860491306,Capital,SANTIAGO DEL ESTERO,313,348,528,396,924
86,86049,860491406,Capital,SANTIAGO DEL ESTERO,281,288,586,484,1070
86,86049,860491216,Capital,SANTIAGO DEL ESTERO,286,285,592,524,1116
86,86049,860491402,Capital,SANTIAGO DEL ESTERO,285,275,526,461,987
86,86049,860491513,Capital,SANTIAGO DEL ESTERO,186,211,330,312,642
86,86049,860491810,Capital,SANTIAGO DEL ESTERO,294,335,626,581,1207
86,86049,860491913,Capital,SANTIAGO DEL ESTERO,186,419,357,289,646
86,86049,860490805,Capital,SANTIAGO DEL ESTERO,203,260,355,283,638
86,86049,860490818,Capital,SANTIAGO DEL ESTERO,205,221,492,413,905
86,86049,860491201,Capital,SANTIAGO DEL ESTERO,220,275,566,388,954
86,86049,860491603,Capital,SANTIAGO DEL ESTERO,297,310,645,600,1245
86,86049,860490801,Capital,SANTIAGO DEL ESTERO,321,312,637,621,1258
86,86049,860490808,Capital,SANTIAGO DEL ESTERO,183,197,314,261,575
86,86049,860490902,Capital,SANTIAGO DEL ESTERO,218,236,469,399,868
86,86049,860490921,Capital,SANTIAGO DEL ESTERO,189,236,350,254,604
86,86049,860490907,Capital,SANTIAGO DEL ESTERO,172,182,277,203,480
86,86049,860490910,Capital,SANTIAGO DEL ESTERO,117,192,201,132,333
86,86049,860490912,Capital,SANTIAGO DEL ESTERO,165,218,262,192,454
86,86049,860490914,Capital,SANTIAGO DEL ESTERO,210,294,336,263,599
86,86049,860491017,Capital,SANTIAGO DEL ESTERO,385,367,885,845,1730
86,86049,860491103,Capital,SANTIAGO DEL ESTERO,367,385,783,696,1479
86,86049,860491104,Capital,SANTIAGO DEL ESTERO,218,250,455,415,870
86,86049,860491110,Capital,SANTIAGO DEL ESTERO,271,276,501,407,908
86,86049,860491204,Capital,SANTIAGO DEL ESTERO,256,322,468,446,914
86,86049,860491706,Capital,SANTIAGO DEL ESTERO,282,272,654,600,1254
86,86049,860491414,Capital,SANTIAGO DEL ESTERO,198,209,453,411,864
86,86049,860491501,Capital,SANTIAGO DEL ESTERO,287,315,573,538,1111
86,86049,860491506,Capital,SANTIAGO DEL ESTERO,348,376,778,728,1506
86,86049,860491604,Capital,SANTIAGO DEL ESTERO,349,394,702,620,1322
86,86049,860491615,Capital,SANTIAGO DEL ESTERO,330,348,741,710,1451
86,86049,860491701,Capital,SANTIAGO DEL ESTERO,177,173,358,372,730
86,86049,860491813,Capital,SANTIAGO DEL ESTERO,233,252,426,386,812
86,86049,860491903,Capital,SANTIAGO DEL ESTERO,433,486,824,787,1611
86,86049,860490810,Capital,SANTIAGO DEL ESTERO,322,355,545,429,974
86,86049,860490812,Capital,SANTIAGO DEL ESTERO,405,489,802,653,1455
86,86049,860491806,Capital,SANTIAGO DEL ESTERO,238,269,456,393,849
86,86049,860491509,Capital,SANTIAGO DEL ESTERO,307,328,606,559,1165
86,86049,860491304,Capital,SANTIAGO DEL ESTERO,309,363,537,435,972
86,86049,860491510,Capital,SANTIAGO DEL ESTERO,272,280,567,546,1113
86,86049,860491611,Capital,SANTIAGO DEL ESTERO,245,313,391,301,692
86,86049,860491712,Capital,SANTIAGO DEL ESTERO,449,478,1024,941,1965
86,86056,860560309,Copo,SANTIAGO DEL ESTERO,230,290,533,524,1057
86,86056,860560402,Copo,SANTIAGO DEL ESTERO,121,132,184,284,468
86,86056,860560502,Copo,SANTIAGO DEL ESTERO,260,348,527,533,1060
86,86056,860560203,Copo,SANTIAGO DEL ESTERO,179,136,374,407,781
86,86056,860560401,Copo,SANTIAGO DEL ESTERO,65,68,126,151,277
86,86056,860560201,Copo,SANTIAGO DEL ESTERO,53,52,95,121,216
86,86056,860560305,Copo,SANTIAGO DEL ESTERO,72,104,136,189,325
86,86056,860560501,Copo,SANTIAGO DEL ESTERO,406,424,789,1253,2042
86,86056,860560403,Copo,SANTIAGO DEL ESTERO,84,98,124,152,276
86,86056,860560205,Copo,SANTIAGO DEL ESTERO,113,112,229,258,487
86,86056,860560206,Copo,SANTIAGO DEL ESTERO,60,65,114,135,249
86,86056,860560404,Copo,SANTIAGO DEL ESTERO,160,178,351,386,737
86,86056,860560103,Copo,SANTIAGO DEL ESTERO,235,168,525,549,1074
86,86056,860560306,Copo,SANTIAGO DEL ESTERO,393,495,902,847,1749
86,86056,860560307,Copo,SANTIAGO DEL ESTERO,365,449,757,766,1523
86,86056,860560503,Copo,SANTIAGO DEL ESTERO,255,328,492,551,1043
86,86056,860560102,Copo,SANTIAGO DEL ESTERO,403,226,729,801,1530
86,86056,860560311,Copo,SANTIAGO DEL ESTERO,254,297,515,528,1043
86,86056,860560312,Copo,SANTIAGO DEL ESTERO,491,645,1036,958,1994
86,86056,860560505,Copo,SANTIAGO DEL ESTERO,282,367,552,565,1117
86,86056,860560303,Copo,SANTIAGO DEL ESTERO,141,143,272,342,614
86,86056,860560302,Copo,SANTIAGO DEL ESTERO,64,65,121,136,257
86,86056,860560101,Copo,SANTIAGO DEL ESTERO,183,189,363,442,805
86,86056,860560304,Copo,SANTIAGO DEL ESTERO,117,145,174,228,402
86,86056,860560104,Copo,SANTIAGO DEL ESTERO,402,303,673,726,1399
86,86056,860560202,Copo,SANTIAGO DEL ESTERO,147,191,309,378,687
86,86056,860560301,Copo,SANTIAGO DEL ESTERO,70,26,92,110,202
86,86056,860560310,Copo,SANTIAGO DEL ESTERO,213,271,458,431,889
86,86056,860560313,Copo,SANTIAGO DEL ESTERO,199,237,337,325,662
86,86056,860560315,Copo,SANTIAGO DEL ESTERO,272,364,604,571,1175
86,86056,860560314,Copo,SANTIAGO DEL ESTERO,217,268,458,449,907
86,86056,860560308,Copo,SANTIAGO DEL ESTERO,305,400,654,647,1301
86,86056,860560504,Copo,SANTIAGO DEL ESTERO,267,342,576,579,1155
86,86056,860560204,Copo,SANTIAGO DEL ESTERO,97,93,166,218,384
86,86056,860560405,Copo,SANTIAGO DEL ESTERO,347,416,744,773,1517
86,86063,860630403,Choya,SANTIAGO DEL ESTERO,162,189,337,354,691
86,86063,860630809,Choya,SANTIAGO DEL ESTERO,157,185,239,203,442
86,86063,860630303,Choya,SANTIAGO DEL ESTERO,273,365,526,516,1042
86,86063,860630811,Choya,SANTIAGO DEL ESTERO,285,326,539,467,1006
86,86063,860630806,Choya,SANTIAGO DEL ESTERO,261,290,454,437,891
86,86063,860630813,Choya,SANTIAGO DEL ESTERO,304,347,538,558,1096
86,86063,860630201,Choya,SANTIAGO DEL ESTERO,123,115,248,257,505
86,86063,860630301,Choya,SANTIAGO DEL ESTERO,103,124,169,185,354
86,86063,860630502,Choya,SANTIAGO DEL ESTERO,34,37,61,91,152
86,86063,860630611,Choya,SANTIAGO DEL ESTERO,270,313,510,484,994
86,86063,860630106,Choya,SANTIAGO DEL ESTERO,202,309,392,395,787
86,86063,860630802,Choya,SANTIAGO DEL ESTERO,253,296,429,406,835
86,86063,860630810,Choya,SANTIAGO DEL ESTERO,313,363,536,434,970
86,86063,860630815,Choya,SANTIAGO DEL ESTERO,331,372,636,647,1283
86,86063,860630202,Choya,SANTIAGO DEL ESTERO,62,61,112,150,262
86,86063,860630402,Choya,SANTIAGO DEL ESTERO,43,65,57,88,145
86,86063,860630602,Choya,SANTIAGO DEL ESTERO,288,328,584,521,1105
86,86063,860630608,Choya,SANTIAGO DEL ESTERO,237,256,396,389,785
86,86063,860630610,Choya,SANTIAGO DEL ESTERO,306,369,492,471,963
86,86063,860630104,Choya,SANTIAGO DEL ESTERO,104,114,172,233,405
86,86063,860630203,Choya,SANTIAGO DEL ESTERO,76,64,134,187,321
86,86063,860630204,Choya,SANTIAGO DEL ESTERO,27,31,54,61,115
86,86063,860630702,Choya,SANTIAGO DEL ESTERO,0,1,0,0,0
86,86063,860630601,Choya,SANTIAGO DEL ESTERO,192,227,406,399,805
86,86063,860630205,Choya,SANTIAGO DEL ESTERO,295,366,610,587,1197
86,86063,860630615,Choya,SANTIAGO DEL ESTERO,225,281,336,323,659
86,86063,860630803,Choya,SANTIAGO DEL ESTERO,175,220,251,220,471
86,86063,860630805,Choya,SANTIAGO DEL ESTERO,207,227,374,327,701
86,86063,860630808,Choya,SANTIAGO DEL ESTERO,216,255,402,423,825
86,86063,860630401,Choya,SANTIAGO DEL ESTERO,29,34,56,58,114
86,86063,860630603,Choya,SANTIAGO DEL ESTERO,155,343,291,280,571
86,86063,860630604,Choya,SANTIAGO DEL ESTERO,203,231,419,416,835
86,86063,860630606,Choya,SANTIAGO DEL ESTERO,231,262,511,484,995
86,86063,860630804,Choya,SANTIAGO DEL ESTERO,225,266,375,310,685
86,86063,860630613,Choya,SANTIAGO DEL ESTERO,252,267,471,516,987
86,86063,860630614,Choya,SANTIAGO DEL ESTERO,279,309,476,430,906
86,86063,860630102,Choya,SANTIAGO DEL ESTERO,150,196,263,301,564
86,86063,860630103,Choya,SANTIAGO DEL ESTERO,182,166,353,386,739
86,86063,860630501,Choya,SANTIAGO DEL ESTERO,70,79,122,163,285
86,86063,860630703,Choya,SANTIAGO DEL ESTERO,0,1,0,0,0
86,86063,860630605,Choya,SANTIAGO DEL ESTERO,335,368,614,567,1181
86,86063,860630609,Choya,SANTIAGO DEL ESTERO,280,319,487,451,938
86,86063,860630612,Choya,SANTIAGO DEL ESTERO,264,277,494,448,942
86,86063,860630814,Choya,SANTIAGO DEL ESTERO,197,232,376,369,745
86,86063,860630701,Choya,SANTIAGO DEL ESTERO,0,1,0,0,0
86,86063,860630607,Choya,SANTIAGO DEL ESTERO,209,227,434,398,832
86,86063,860630807,Choya,SANTIAGO DEL ESTERO,273,300,545,481,1026
86,86063,860630812,Choya,SANTIAGO DEL ESTERO,178,188,392,383,775
86,86063,860630801,Choya,SANTIAGO DEL ESTERO,337,350,675,725,1400
86,86063,860630105,Choya,SANTIAGO DEL ESTERO,40,47,69,80,149
86,86063,860630101,Choya,SANTIAGO DEL ESTERO,12,14,26,22,48
86,86063,860630302,Choya,SANTIAGO DEL ESTERO,40,61,68,75,143
86,86070,860700603,Figueroa,SANTIAGO DEL ESTERO,406,413,828,868,1696
86,86070,860700403,Figueroa,SANTIAGO DEL ESTERO,191,204,396,438,834
86,86070,860700401,Figueroa,SANTIAGO DEL ESTERO,656,658,1326,1589,2915
86,86070,860700501,Figueroa,SANTIAGO DEL ESTERO,128,138,304,326,630
86,86070,860700103,Figueroa,SANTIAGO DEL ESTERO,160,176,312,378,690
86,86070,860700102,Figueroa,SANTIAGO DEL ESTERO,137,110,287,329,616
86,86070,860700602,Figueroa,SANTIAGO DEL ESTERO,86,102,163,197,360
86,86070,860700601,Figueroa,SANTIAGO DEL ESTERO,89,104,169,197,366
86,86070,860700201,Figueroa,SANTIAGO DEL ESTERO,269,316,593,635,1228
86,86070,860700104,Figueroa,SANTIAGO DEL ESTERO,162,185,346,384,730
86,86070,860700503,Figueroa,SANTIAGO DEL ESTERO,236,182,456,546,1002
86,86070,860700505,Figueroa,SANTIAGO DEL ESTERO,141,112,267,296,563
86,86070,860700504,Figueroa,SANTIAGO DEL ESTERO,39,48,67,115,182
86,86070,860700402,Figueroa,SANTIAGO DEL ESTERO,291,324,576,668,1244
86,86070,860700202,Figueroa,SANTIAGO DEL ESTERO,447,484,960,1006,1966
86,86070,860700302,Figueroa,SANTIAGO DEL ESTERO,152,161,286,320,606
86,86070,860700203,Figueroa,SANTIAGO DEL ESTERO,194,240,422,394,816
86,86070,860700101,Figueroa,SANTIAGO DEL ESTERO,118,137,252,361,613
86,86070,860700301,Figueroa,SANTIAGO DEL ESTERO,43,44,57,104,161
86,86070,860700502,Figueroa,SANTIAGO DEL ESTERO,139,152,267,335,602
86,86084,860840408,Guasayán,SANTIAGO DEL ESTERO,223,271,432,419,851
86,86084,860840404,Guasayán,SANTIAGO DEL ESTERO,23,38,41,45,86
86,86084,860840304,Guasayán,SANTIAGO DEL ESTERO,82,90,183,196,379
86,86084,860840302,Guasayán,SANTIAGO DEL ESTERO,50,63,116,119,235
86,86084,860840303,Guasayán,SANTIAGO DEL ESTERO,87,96,198,210,408
86,86084,860840407,Guasayán,SANTIAGO DEL ESTERO,254,321,486,435,921
86,86084,860840305,Guasayán,SANTIAGO DEL ESTERO,89,106,160,158,318
86,86084,860840402,Guasayán,SANTIAGO DEL ESTERO,22,30,24,35,59
86,86084,860840403,Guasayán,SANTIAGO DEL ESTERO,27,42,26,68,94
86,86084,860840101,Guasayán,SANTIAGO DEL ESTERO,26,37,54,99,153
86,86084,860840102,Guasayán,SANTIAGO DEL ESTERO,128,165,226,257,483
86,86084,860840401,Guasayán,SANTIAGO DEL ESTERO,56,52,101,134,235
86,86084,860840103,Guasayán,SANTIAGO DEL ESTERO,26,32,37,59,96
86,86084,860840301,Guasayán,SANTIAGO DEL ESTERO,200,172,466,456,922
86,86084,860840406,Guasayán,SANTIAGO DEL ESTERO,198,287,340,329,669
86,86084,860840201,Guasayán,SANTIAGO DEL ESTERO,120,108,196,280,476
86,86084,860840409,Guasayán,SANTIAGO DEL ESTERO,203,269,350,341,691
86,86084,860840405,Guasayán,SANTIAGO DEL ESTERO,89,101,128,168,296
86,86084,860840202,Guasayán,SANTIAGO DEL ESTERO,47,58,103,127,230
86,86091,860910109,Jiménez,SANTIAGO DEL ESTERO,351,370,721,654,1375
86,86091,860910401,Jiménez,SANTIAGO DEL ESTERO,40,50,82,83,165
86,86091,860910406,Jiménez,SANTIAGO DEL ESTERO,400,279,735,733,1468
86,86091,860910409,Jiménez,SANTIAGO DEL ESTERO,32,41,77,60,137
86,86091,860910410,Jiménez,SANTIAGO DEL ESTERO,336,351,675,717,1392
86,86091,860910106,Jiménez,SANTIAGO DEL ESTERO,192,119,347,412,759
86,86091,860910408,Jiménez,SANTIAGO DEL ESTERO,46,37,86,95,181
86,86091,860910301,Jiménez,SANTIAGO DEL ESTERO,43,31,108,127,235
86,86091,860910405,Jiménez,SANTIAGO DEL ESTERO,202,131,320,352,672
86,86091,860910101,Jiménez,SANTIAGO DEL ESTERO,131,141,237,288,525
86,86091,860910202,Jiménez,SANTIAGO DEL ESTERO,20,16,23,40,63
86,86091,860910204,Jiménez,SANTIAGO DEL ESTERO,7,11,13,12,25
86,86091,860910108,Jiménez,SANTIAGO DEL ESTERO,13,19,29,25,54
86,86091,860910103,Jiménez,SANTIAGO DEL ESTERO,131,46,318,309,627
86,86091,860910102,Jiménez,SANTIAGO DEL ESTERO,42,35,59,79,138
86,86091,860910411,Jiménez,SANTIAGO DEL ESTERO,315,346,657,658,1315
86,86091,860910201,Jiménez,SANTIAGO DEL ESTERO,64,64,105,116,221
86,86091,860910302,Jiménez,SANTIAGO DEL ESTERO,27,27,39,55,94
86,86091,860910407,Jiménez,SANTIAGO DEL ESTERO,184,148,381,382,763
86,86091,860910403,Jiménez,SANTIAGO DEL ESTERO,146,132,284,284,568
86,86091,860910203,Jiménez,SANTIAGO DEL ESTERO,77,23,201,199,400
86,86091,860910107,Jiménez,SANTIAGO DEL ESTERO,109,68,188,222,410
86,86091,860910105,Jiménez,SANTIAGO DEL ESTERO,345,124,780,769,1549
86,86091,860910404,Jiménez,SANTIAGO DEL ESTERO,180,140,296,333,629
86,86091,860910402,Jiménez,SANTIAGO DEL ESTERO,69,80,93,133,226
86,86091,860910104,Jiménez,SANTIAGO DEL ESTERO,84,57,137,224,361
86,86098,860980205,Juan F. Ibarra,SANTIAGO DEL ESTERO,252,289,608,564,1172
86,86098,860980401,Juan F. Ibarra,SANTIAGO DEL ESTERO,221,256,452,532,984
86,86098,860980111,Juan F. Ibarra,SANTIAGO DEL ESTERO,267,364,649,630,1279
86,86098,860980201,Juan F. Ibarra,SANTIAGO DEL ESTERO,126,140,294,291,585
86,86098,860980110,Juan F. Ibarra,SANTIAGO DEL ESTERO,326,391,669,673,1342
86,86098,860980109,Juan F. Ibarra,SANTIAGO DEL ESTERO,476,493,1037,969,2006
86,86098,860980701,Juan F. Ibarra,SANTIAGO DEL ESTERO,33,33,77,71,148
86,86098,860980502,Juan F. Ibarra,SANTIAGO DEL ESTERO,202,128,446,474,920
86,86098,860980108,Juan F. Ibarra,SANTIAGO DEL ESTERO,373,436,893,791,1684
86,86098,860980105,Juan F. Ibarra,SANTIAGO DEL ESTERO,33,39,63,85,148
86,86098,860980204,Juan F. Ibarra,SANTIAGO DEL ESTERO,40,50,79,90,169
86,86098,860980106,Juan F. Ibarra,SANTIAGO DEL ESTERO,30,40,56,60,116
86,86098,860980402,Juan F. Ibarra,SANTIAGO DEL ESTERO,144,173,290,343,633
86,86098,860980702,Juan F. Ibarra,SANTIAGO DEL ESTERO,18,21,33,35,68
86,86098,860980112,Juan F. Ibarra,SANTIAGO DEL ESTERO,188,224,454,436,890
86,86098,860980301,Juan F. Ibarra,SANTIAGO DEL ESTERO,67,71,127,143,270
86,86098,860980602,Juan F. Ibarra,SANTIAGO DEL ESTERO,53,52,117,141,258
86,86098,860980305,Juan F. Ibarra,SANTIAGO DEL ESTERO,392,442,843,880,1723
86,86098,860980503,Juan F. Ibarra,SANTIAGO DEL ESTERO,278,152,514,596,1110
86,86098,860980107,Juan F. Ibarra,SANTIAGO DEL ESTERO,11,13,14,21,35
86,86098,860980703,Juan F. Ibarra,SANTIAGO DEL ESTERO,8,8,14,16,30
86,86098,860980501,Juan F. Ibarra,SANTIAGO DEL ESTERO,63,28,130,139,269
86,86098,860980403,Juan F. Ibarra,SANTIAGO DEL ESTERO,165,171,227,354,581
86,86098,860980601,Juan F. Ibarra,SANTIAGO DEL ESTERO,28,30,41,47,88
86,86098,860980202,Juan F. Ibarra,SANTIAGO DEL ESTERO,12,16,6,28,34
86,86098,860980101,Juan F. Ibarra,SANTIAGO DEL ESTERO,71,90,161,140,301
86,86098,860980104,Juan F. Ibarra,SANTIAGO DEL ESTERO,34,38,54,74,128
86,86098,860980302,Juan F. Ibarra,SANTIAGO DEL ESTERO,44,35,66,102,168
86,86098,860980603,Juan F. Ibarra,SANTIAGO DEL ESTERO,15,14,36,36,72
86,86098,860980102,Juan F. Ibarra,SANTIAGO DEL ESTERO,17,21,18,34,52
86,86098,860980103,Juan F. Ibarra,SANTIAGO DEL ESTERO,122,99,254,288,542
86,86098,860980303,Juan F. Ibarra,SANTIAGO DEL ESTERO,12,16,10,21,31
86,86098,860980304,Juan F. Ibarra,SANTIAGO DEL ESTERO,19,20,14,38,52
86,86098,860980203,Juan F. Ibarra,SANTIAGO DEL ESTERO,40,51,65,98,163
86,86119,861190104,Moreno,SANTIAGO DEL ESTERO,450,496,1024,1012,2036
86,86119,861190301,Moreno,SANTIAGO DEL ESTERO,141,112,267,330,597
86,86119,861190408,Moreno,SANTIAGO DEL ESTERO,398,463,910,782,1692
86,86119,861190409,Moreno,SANTIAGO DEL ESTERO,406,422,747,729,1476
86,86119,861190414,Moreno,SANTIAGO DEL ESTERO,379,432,692,686,1378
86,86119,861190415,Moreno,SANTIAGO DEL ESTERO,229,235,565,645,1210
86,86119,861190201,Moreno,SANTIAGO DEL ESTERO,108,70,228,271,499
86,86119,861190502,Moreno,SANTIAGO DEL ESTERO,380,189,819,1000,1819
86,86119,861190302,Moreno,SANTIAGO DEL ESTERO,75,85,123,165,288
86,86119,861190403,Moreno,SANTIAGO DEL ESTERO,43,44,72,101,173
86,86119,861190103,Moreno,SANTIAGO DEL ESTERO,340,383,729,765,1494
86,86119,861190413,Moreno,SANTIAGO DEL ESTERO,496,557,1143,1111,2254
86,86119,861190102,Moreno,SANTIAGO DEL ESTERO,459,436,1058,1134,2192
86,86119,861190304,Moreno,SANTIAGO DEL ESTERO,36,32,80,75,155
86,86119,861190405,Moreno,SANTIAGO DEL ESTERO,130,150,314,318,632
86,86119,861190202,Moreno,SANTIAGO DEL ESTERO,33,37,24,90,114
86,86119,861190406,Moreno,SANTIAGO DEL ESTERO,489,374,996,984,1980
86,86119,861190411,Moreno,SANTIAGO DEL ESTERO,261,164,551,585,1136
86,86119,861190401,Moreno,SANTIAGO DEL ESTERO,129,148,208,264,472
86,86119,861190101,Moreno,SANTIAGO DEL ESTERO,395,422,863,1015,1878
86,86119,861190203,Moreno,SANTIAGO DEL ESTERO,80,31,106,146,252
86,86119,861190410,Moreno,SANTIAGO DEL ESTERO,413,297,843,791,1634
86,86119,861190412,Moreno,SANTIAGO DEL ESTERO,360,394,804,796,1600
86,86119,861190501,Moreno,SANTIAGO DEL ESTERO,316,194,667,710,1377
86,86119,861190503,Moreno,SANTIAGO DEL ESTERO,159,160,261,310,571
86,86119,861190407,Moreno,SANTIAGO DEL ESTERO,296,441,618,593,1211
86,86119,861190303,Moreno,SANTIAGO DEL ESTERO,115,113,208,247,455
86,86119,861190404,Moreno,SANTIAGO DEL ESTERO,329,267,684,778,1462
86,86119,861190402,Moreno,SANTIAGO DEL ESTERO,22,26,39,54,93
86,86126,861260313,Ojo de Agua,SANTIAGO DEL ESTERO,284,308,590,547,1137
86,86126,861260201,Ojo de Agua,SANTIAGO DEL ESTERO,183,192,332,381,713
86,86126,861260102,Ojo de Agua,SANTIAGO DEL ESTERO,7,13,9,10,19
86,86126,861260304,Ojo de Agua,SANTIAGO DEL ESTERO,32,45,42,50,92
86,86126,861260306,Ojo de Agua,SANTIAGO DEL ESTERO,30,33,38,61,99
86,86126,861260401,Ojo de Agua,SANTIAGO DEL ESTERO,87,105,123,158,281
86,86126,861260303,Ojo de Agua,SANTIAGO DEL ESTERO,93,112,140,145,285
86,86126,861260403,Ojo de Agua,SANTIAGO DEL ESTERO,126,159,225,265,490
86,86126,861260402,Ojo de Agua,SANTIAGO DEL ESTERO,82,95,142,157,299
86,86126,861260307,Ojo de Agua,SANTIAGO DEL ESTERO,307,353,585,570,1155
86,86126,861260202,Ojo de Agua,SANTIAGO DEL ESTERO,39,53,67,65,132
86,86126,861260203,Ojo de Agua,SANTIAGO DEL ESTERO,121,148,205,255,460
86,86126,861260301,Ojo de Agua,SANTIAGO DEL ESTERO,209,254,371,405,776
86,86126,861260305,Ojo de Agua,SANTIAGO DEL ESTERO,58,77,88,132,220
86,86126,861260404,Ojo de Agua,SANTIAGO DEL ESTERO,29,35,35,48,83
86,86126,861260308,Ojo de Agua,SANTIAGO DEL ESTERO,327,365,668,614,1282
86,86126,861260309,Ojo de Agua,SANTIAGO DEL ESTERO,419,358,843,830,1673
86,86126,861260101,Ojo de Agua,SANTIAGO DEL ESTERO,46,55,63,65,128
86,86126,861260311,Ojo de Agua,SANTIAGO DEL ESTERO,304,355,537,455,992
86,86126,861260312,Ojo de Agua,SANTIAGO DEL ESTERO,327,408,653,566,1219
86,86126,861260302,Ojo de Agua,SANTIAGO DEL ESTERO,89,133,159,172,331
86,86126,861260310,Ojo de Agua,SANTIAGO DEL ESTERO,494,598,920,835,1755
86,86126,861260204,Ojo de Agua,SANTIAGO DEL ESTERO,91,117,184,203,387
86,86147,861470806,Río Hondo,SANTIAGO DEL ESTERO,267,302,588,480,1068
86,86147,861470917,Río Hondo,SANTIAGO DEL ESTERO,212,272,393,359,752
86,86147,861470808,Río Hondo,SANTIAGO DEL ESTERO,338,369,627,595,1222
86,86147,861470809,Río Hondo,SANTIAGO DEL ESTERO,253,273,528,524,1052
86,86147,861470814,Río Hondo,SANTIAGO DEL ESTERO,311,339,585,544,1129
86,86147,861470906,Río Hondo,SANTIAGO DEL ESTERO,190,256,374,317,691
86,86147,861470911,Río Hondo,SANTIAGO DEL ESTERO,82,248,140,108,248
86,86147,861470913,Río Hondo,SANTIAGO DEL ESTERO,172,187,375,354,729
86,86147,861470810,Río Hondo,SANTIAGO DEL ESTERO,191,248,405,398,803
86,86147,861470905,Río Hondo,SANTIAGO DEL ESTERO,259,301,545,544,1089
86,86147,861470916,Río Hondo,SANTIAGO DEL ESTERO,234,254,481,504,985
86,86147,861470504,Río Hondo,SANTIAGO DEL ESTERO,126,155,273,256,529
86,86147,861470915,Río Hondo,SANTIAGO DEL ESTERO,199,260,451,365,816
86,86147,861470706,Río Hondo,SANTIAGO DEL ESTERO,164,260,269,304,573
86,86147,861470815,Río Hondo,SANTIAGO DEL ESTERO,121,197,240,182,422
86,86147,861470912,Río Hondo,SANTIAGO DEL ESTERO,209,266,577,486,1063
86,86147,861470702,Río Hondo,SANTIAGO DEL ESTERO,78,99,158,143,301
86,86147,861470705,Río Hondo,SANTIAGO DEL ESTERO,111,136,184,198,382
86,86147,861470101,Río Hondo,SANTIAGO DEL ESTERO,143,152,232,266,498
86,86147,861470501,Río Hondo,SANTIAGO DEL ESTERO,184,219,357,414,771
86,86147,861470403,Río Hondo,SANTIAGO DEL ESTERO,177,156,418,420,838
86,86147,861470104,Río Hondo,SANTIAGO DEL ESTERO,159,168,329,360,689
86,86147,861470803,Río Hondo,SANTIAGO DEL ESTERO,297,338,587,542,1129
86,86147,861470909,Río Hondo,SANTIAGO DEL ESTERO,236,233,445,410,855
86,86147,861470910,Río Hondo,SANTIAGO DEL ESTERO,155,171,275,251,526
86,86147,861470601,Río Hondo,SANTIAGO DEL ESTERO,148,200,314,325,639
86,86147,861470401,Río Hondo,SANTIAGO DEL ESTERO,567,324,1283,1409,2692
86,86147,861470807,Río Hondo,SANTIAGO DEL ESTERO,360,375,749,685,1434
86,86147,861470801,Río Hondo,SANTIAGO DEL ESTERO,343,365,699,643,1342
86,86147,861470802,Río Hondo,SANTIAGO DEL ESTERO,313,350,615,596,1211
86,86147,861470901,Río Hondo,SANTIAGO DEL ESTERO,230,293,432,456,888
86,86147,861470103,Río Hondo,SANTIAGO DEL ESTERO,365,353,667,728,1395
86,86147,861470502,Río Hondo,SANTIAGO DEL ESTERO,281,326,575,595,1170
86,86147,861470903,Río Hondo,SANTIAGO DEL ESTERO,237,289,486,455,941
86,86147,861470301,Río Hondo,SANTIAGO DEL ESTERO,851,530,1948,1985,3933
86,86147,861470302,Río Hondo,SANTIAGO DEL ESTERO,164,240,301,322,623
86,86147,861470811,Río Hondo,SANTIAGO DEL ESTERO,306,355,618,509,1127
86,86147,861470817,Río Hondo,SANTIAGO DEL ESTERO,168,211,376,322,698
86,86147,861470914,Río Hondo,SANTIAGO DEL ESTERO,228,256,534,531,1065
86,86147,861470918,Río Hondo,SANTIAGO DEL ESTERO,159,185,324,325,649
86,86147,861470703,Río Hondo,SANTIAGO DEL ESTERO,232,275,410,379,789
86,86147,861470602,Río Hondo,SANTIAGO DEL ESTERO,127,113,245,265,510
86,86147,861470603,Río Hondo,SANTIAGO DEL ESTERO,134,102,302,302,604
86,86147,861470805,Río Hondo,SANTIAGO DEL ESTERO,203,259,377,321,698
86,86147,861470202,Río Hondo,SANTIAGO DEL ESTERO,383,336,867,889,1756
86,86147,861470902,Río Hondo,SANTIAGO DEL ESTERO,359,391,773,744,1517
86,86147,861470813,Río Hondo,SANTIAGO DEL ESTERO,229,275,476,473,949
86,86147,861470908,Río Hondo,SANTIAGO DEL ESTERO,154,240,269,254,523
86,86147,861470919,Río Hondo,SANTIAGO DEL ESTERO,202,223,479,448,927
86,86147,861470201,Río Hondo,SANTIAGO DEL ESTERO,194,160,387,413,800
86,86147,861470904,Río Hondo,SANTIAGO DEL ESTERO,209,260,437,432,869
86,86147,861470503,Río Hondo,SANTIAGO DEL ESTERO,120,128,248,277,525
86,86147,861470804,Río Hondo,SANTIAGO DEL ESTERO,194,230,336,313,649
86,86147,861470812,Río Hondo,SANTIAGO DEL ESTERO,260,284,536,479,1015
86,86147,861470816,Río Hondo,SANTIAGO DEL ESTERO,206,258,397,344,741
86,86147,861470907,Río Hondo,SANTIAGO DEL ESTERO,64,105,179,165,344
86,86147,861470102,Río Hondo,SANTIAGO DEL ESTERO,307,292,536,605,1141
86,86147,861470402,Río Hondo,SANTIAGO DEL ESTERO,123,398,239,271,510
86,86147,861470701,Río Hondo,SANTIAGO DEL ESTERO,42,62,78,91,169
86,86147,861470704,Río Hondo,SANTIAGO DEL ESTERO,237,279,414,450,864
86,86140,861400208,Quebrachos,SANTIAGO DEL ESTERO,206,252,397,352,749
86,86140,861400103,Quebrachos,SANTIAGO DEL ESTERO,194,249,410,426,836
86,86140,861400209,Quebrachos,SANTIAGO DEL ESTERO,277,333,589,577,1166
86,86140,861400104,Quebrachos,SANTIAGO DEL ESTERO,69,68,148,138,286
86,86140,861400301,Quebrachos,SANTIAGO DEL ESTERO,148,128,258,300,558
86,86140,861400205,Quebrachos,SANTIAGO DEL ESTERO,200,229,323,285,608
86,86140,861400105,Quebrachos,SANTIAGO DEL ESTERO,144,174,202,259,461
86,86140,861400102,Quebrachos,SANTIAGO DEL ESTERO,47,57,96,92,188
86,86140,861400206,Quebrachos,SANTIAGO DEL ESTERO,339,385,725,615,1340
86,86140,861400207,Quebrachos,SANTIAGO DEL ESTERO,234,313,447,401,848
86,86140,861400202,Quebrachos,SANTIAGO DEL ESTERO,78,82,116,146,262
86,86140,861400302,Quebrachos,SANTIAGO DEL ESTERO,71,72,122,157,279
86,86140,861400203,Quebrachos,SANTIAGO DEL ESTERO,67,59,111,135,246
86,86140,861400201,Quebrachos,SANTIAGO DEL ESTERO,113,134,208,210,418
86,86140,861400101,Quebrachos,SANTIAGO DEL ESTERO,109,108,190,187,377
86,86140,861400303,Quebrachos,SANTIAGO DEL ESTERO,143,139,260,307,567
86,86140,861400210,Quebrachos,SANTIAGO DEL ESTERO,241,291,440,408,848
86,86140,861400204,Quebrachos,SANTIAGO DEL ESTERO,127,133,242,289,531
86,86014,860140702,Alberdi,SANTIAGO DEL ESTERO,290,279,575,699,1274
86,86014,860140502,Alberdi,SANTIAGO DEL ESTERO,306,333,531,609,1140
86,86014,860140202,Alberdi,SANTIAGO DEL ESTERO,161,105,284,427,711
86,86014,860140302,Alberdi,SANTIAGO DEL ESTERO,10,10,10,21,31
86,86014,860140101,Alberdi,SANTIAGO DEL ESTERO,252,267,603,628,1231
86,86014,860140701,Alberdi,SANTIAGO DEL ESTERO,3,4,2,4,6
86,86014,860140504,Alberdi,SANTIAGO DEL ESTERO,249,300,551,568,1119
86,86014,860140706,Alberdi,SANTIAGO DEL ESTERO,350,363,793,782,1575
86,86014,860140602,Alberdi,SANTIAGO DEL ESTERO,59,54,149,150,299
86,86014,860140902,Alberdi,SANTIAGO DEL ESTERO,89,54,148,156,304
86,86014,860140503,Alberdi,SANTIAGO DEL ESTERO,246,314,499,462,961
86,86014,860140705,Alberdi,SANTIAGO DEL ESTERO,308,344,673,672,1345
86,86014,860140103,Alberdi,SANTIAGO DEL ESTERO,104,78,207,285,492
86,86014,860140901,Alberdi,SANTIAGO DEL ESTERO,168,117,361,398,759
86,86014,860140201,Alberdi,SANTIAGO DEL ESTERO,63,48,118,129,247
86,86014,860140903,Alberdi,SANTIAGO DEL ESTERO,64,34,115,149,264
86,86014,860140601,Alberdi,SANTIAGO DEL ESTERO,22,22,44,50,94
86,86014,860140402,Alberdi,SANTIAGO DEL ESTERO,57,43,102,165,267
86,86014,860140102,Alberdi,SANTIAGO DEL ESTERO,74,44,150,166,316
86,86014,860140603,Alberdi,SANTIAGO DEL ESTERO,129,176,276,283,559
86,86014,860140704,Alberdi,SANTIAGO DEL ESTERO,372,394,839,858,1697
86,86014,860140801,Alberdi,SANTIAGO DEL ESTERO,65,69,129,153,282
86,86014,860140203,Alberdi,SANTIAGO DEL ESTERO,43,44,91,111,202
86,86014,860140401,Alberdi,SANTIAGO DEL ESTERO,20,23,20,55,75
86,86014,860140703,Alberdi,SANTIAGO DEL ESTERO,335,367,753,737,1490
86,86014,860140802,Alberdi,SANTIAGO DEL ESTERO,43,43,65,100,165
86,86014,860140301,Alberdi,SANTIAGO DEL ESTERO,59,71,81,131,212
86,86014,860140501,Alberdi,SANTIAGO DEL ESTERO,39,48,48,87,135
86,86007,860070303,Aguirre,SANTIAGO DEL ESTERO,33,38,31,39,70
86,86007,860070103,Aguirre,SANTIAGO DEL ESTERO,146,188,231,284,515
86,86007,860070107,Aguirre,SANTIAGO DEL ESTERO,361,449,703,695,1398
86,86007,860070102,Aguirre,SANTIAGO DEL ESTERO,85,104,155,174,329
86,86007,860070206,Aguirre,SANTIAGO DEL ESTERO,307,353,516,514,1030
86,86007,860070203,Aguirre,SANTIAGO DEL ESTERO,45,65,64,80,144
86,86007,860070104,Aguirre,SANTIAGO DEL ESTERO,107,113,219,291,510
86,86007,860070205,Aguirre,SANTIAGO DEL ESTERO,7,18,9,14,23
86,86007,860070302,Aguirre,SANTIAGO DEL ESTERO,23,27,20,42,62
86,86007,860070304,Aguirre,SANTIAGO DEL ESTERO,36,35,41,63,104
86,86007,860070301,Aguirre,SANTIAGO DEL ESTERO,8,16,8,18,26
86,86007,860070106,Aguirre,SANTIAGO DEL ESTERO,371,503,660,679,1339
86,86007,860070201,Aguirre,SANTIAGO DEL ESTERO,9,11,10,18,28
86,86007,860070105,Aguirre,SANTIAGO DEL ESTERO,196,258,373,327,700
86,86007,860070108,Aguirre,SANTIAGO DEL ESTERO,281,396,529,529,1058
86,86007,860070202,Aguirre,SANTIAGO DEL ESTERO,28,33,38,65,103
86,86007,860070101,Aguirre,SANTIAGO DEL ESTERO,38,38,84,73,157
86,86007,860070204,Aguirre,SANTIAGO DEL ESTERO,6,10,6,8,14
86,86035,860351203,Banda,SANTIAGO DEL ESTERO,204,176,484,476,960
86,86035,860350102,Banda,SANTIAGO DEL ESTERO,78,88,152,165,317
86,86035,860350201,Banda,SANTIAGO DEL ESTERO,53,49,108,118,226
86,86035,860350701,Banda,SANTIAGO DEL ESTERO,99,111,212,204,416
86,86035,860351512,Banda,SANTIAGO DEL ESTERO,216,165,470,446,916
86,86035,860351208,Banda,SANTIAGO DEL ESTERO,276,279,634,618,1252
86,86035,860351313,Banda,SANTIAGO DEL ESTERO,299,325,674,608,1282
86,86035,860351218,Banda,SANTIAGO DEL ESTERO,181,191,427,420,847
86,86035,860351307,Banda,SANTIAGO DEL ESTERO,425,433,889,861,1750
86,86035,860351312,Banda,SANTIAGO DEL ESTERO,293,294,610,532,1142
86,86035,860351302,Banda,SANTIAGO DEL ESTERO,339,355,722,706,1428
86,86035,860351303,Banda,SANTIAGO DEL ESTERO,442,462,908,845,1753
86,86035,860351403,Banda,SANTIAGO DEL ESTERO,441,453,999,948,1947
86,86035,860351517,Banda,SANTIAGO DEL ESTERO,255,269,569,557,1126
86,86035,860351604,Banda,SANTIAGO DEL ESTERO,401,455,707,604,1311
86,86035,860350601,Banda,SANTIAGO DEL ESTERO,304,336,637,598,1235
86,86035,860350705,Banda,SANTIAGO DEL ESTERO,72,82,142,173,315
86,86035,860350802,Banda,SANTIAGO DEL ESTERO,73,102,135,134,269
86,86035,860351103,Banda,SANTIAGO DEL ESTERO,59,67,120,146,266
86,86035,860350902,Banda,SANTIAGO DEL ESTERO,91,93,215,237,452
86,86035,860351314,Banda,SANTIAGO DEL ESTERO,305,330,631,620,1251
86,86035,860350808,Banda,SANTIAGO DEL ESTERO,269,291,481,492,973
86,86035,860351502,Banda,SANTIAGO DEL ESTERO,285,315,599,460,1059
86,86035,860351505,Banda,SANTIAGO DEL ESTERO,257,286,552,496,1048
86,86035,860351507,Banda,SANTIAGO DEL ESTERO,287,314,581,468,1049
86,86035,860351111,Banda,SANTIAGO DEL ESTERO,96,510,178,170,348
86,86035,860351514,Banda,SANTIAGO DEL ESTERO,284,316,664,624,1288
86,86035,860351515,Banda,SANTIAGO DEL ESTERO,320,357,596,591,1187
86,86035,860351612,Banda,SANTIAGO DEL ESTERO,435,459,984,901,1885
86,86035,860351607,Banda,SANTIAGO DEL ESTERO,335,367,629,565,1194
86,86035,860350805,Banda,SANTIAGO DEL ESTERO,389,433,800,760,1560
86,86035,860351202,Banda,SANTIAGO DEL ESTERO,167,192,361,341,702
86,86035,860350901,Banda,SANTIAGO DEL ESTERO,154,164,342,385,727
86,86035,860350702,Banda,SANTIAGO DEL ESTERO,121,132,270,315,585
86,86035,860351211,Banda,SANTIAGO DEL ESTERO,274,295,564,494,1058
86,86035,860351404,Banda,SANTIAGO DEL ESTERO,312,321,667,661,1328
86,86035,860350806,Banda,SANTIAGO DEL ESTERO,272,295,497,467,964
86,86035,860351504,Banda,SANTIAGO DEL ESTERO,389,419,761,724,1485
86,86035,860351108,Banda,SANTIAGO DEL ESTERO,476,517,941,830,1771
86,86035,860351509,Banda,SANTIAGO DEL ESTERO,262,292,460,379,839
86,86035,860351220,Banda,SANTIAGO DEL ESTERO,277,307,590,485,1075
86,86035,860351603,Banda,SANTIAGO DEL ESTERO,291,313,517,465,982
86,86035,860351605,Banda,SANTIAGO DEL ESTERO,265,275,490,420,910
86,86035,860351609,Banda,SANTIAGO DEL ESTERO,422,414,760,713,1473
86,86035,860350803,Banda,SANTIAGO DEL ESTERO,215,189,461,517,978
86,86035,860350602,Banda,SANTIAGO DEL ESTERO,198,226,463,376,839
86,86035,860350303,Banda,SANTIAGO DEL ESTERO,49,55,88,108,196
86,86035,860351102,Banda,SANTIAGO DEL ESTERO,198,199,398,447,845
86,86035,860351005,Banda,SANTIAGO DEL ESTERO,119,127,241,266,507
86,86035,860351210,Banda,SANTIAGO DEL ESTERO,279,327,471,399,870
86,86035,860350809,Banda,SANTIAGO DEL ESTERO,297,328,605,568,1173
86,86035,860351410,Banda,SANTIAGO DEL ESTERO,259,306,522,417,939
86,86035,860351513,Banda,SANTIAGO DEL ESTERO,300,312,666,719,1385
86,86035,860351508,Banda,SANTIAGO DEL ESTERO,160,230,258,195,453
86,86035,860351216,Banda,SANTIAGO DEL ESTERO,216,246,434,376,810
86,86035,860351217,Banda,SANTIAGO DEL ESTERO,259,282,495,481,976
86,86035,860351219,Banda,SANTIAGO DEL ESTERO,473,513,1019,997,2016
86,86035,860351204,Banda,SANTIAGO DEL ESTERO,137,146,337,329,666
86,86035,860351114,Banda,SANTIAGO DEL ESTERO,324,352,616,586,1202
86,86035,860350804,Banda,SANTIAGO DEL ESTERO,296,322,582,517,1099
86,86035,860351613,Banda,SANTIAGO DEL ESTERO,280,314,560,559,1119
86,86035,860350402,Banda,SANTIAGO DEL ESTERO,128,135,272,304,576
86,86035,860351104,Banda,SANTIAGO DEL ESTERO,70,75,167,178,345
86,86035,860351105,Banda,SANTIAGO DEL ESTERO,39,52,89,96,185
86,86035,860351201,Banda,SANTIAGO DEL ESTERO,96,117,198,197,395
86,86035,860351209,Banda,SANTIAGO DEL ESTERO,278,325,491,427,918
86,86035,860351506,Banda,SANTIAGO DEL ESTERO,370,367,854,778,1632
86,86035,860350810,Banda,SANTIAGO DEL ESTERO,453,549,1041,932,1973
86,86035,860351411,Banda,SANTIAGO DEL ESTERO,242,293,414,316,730
86,86035,860351511,Banda,SANTIAGO DEL ESTERO,350,355,831,830,1661
86,86035,860351109,Banda,SANTIAGO DEL ESTERO,484,536,1022,927,1949
86,86035,860350203,Banda,SANTIAGO DEL ESTERO,152,155,346,390,736
86,86035,860351106,Banda,SANTIAGO DEL ESTERO,176,518,347,287,634
86,86035,860351206,Banda,SANTIAGO DEL ESTERO,232,277,475,442,917
86,86035,860351301,Banda,SANTIAGO DEL ESTERO,377,414,804,704,1508
86,86035,860351304,Banda,SANTIAGO DEL ESTERO,225,236,450,379,829
86,86035,860351306,Banda,SANTIAGO DEL ESTERO,239,252,461,424,885
86,86035,860351310,Banda,SANTIAGO DEL ESTERO,258,168,635,589,1224
86,86035,860351317,Banda,SANTIAGO DEL ESTERO,240,274,488,439,927
86,86035,860351606,Banda,SANTIAGO DEL ESTERO,191,198,368,365,733
86,86035,860351101,Banda,SANTIAGO DEL ESTERO,328,319,661,634,1295
86,86035,860350703,Banda,SANTIAGO DEL ESTERO,106,109,224,236,460
86,86035,860350101,Banda,SANTIAGO DEL ESTERO,67,63,138,164,302
86,86035,860350501,Banda,SANTIAGO DEL ESTERO,156,169,296,249,545
86,86035,860351107,Banda,SANTIAGO DEL ESTERO,518,585,1145,1199,2344
86,86035,860350807,Banda,SANTIAGO DEL ESTERO,454,517,1002,917,1919
86,86035,860351412,Banda,SANTIAGO DEL ESTERO,322,350,588,534,1122
86,86035,860351414,Banda,SANTIAGO DEL ESTERO,420,412,945,946,1891
86,86035,860351110,Banda,SANTIAGO DEL ESTERO,1,526,0,1,1
86,86035,860351315,Banda,SANTIAGO DEL ESTERO,337,368,795,793,1588
86,86035,860351316,Banda,SANTIAGO DEL ESTERO,349,344,769,833,1602
86,86035,860351318,Banda,SANTIAGO DEL ESTERO,296,284,660,635,1295
86,86035,860351319,Banda,SANTIAGO DEL ESTERO,386,426,808,748,1556
86,86035,860351402,Banda,SANTIAGO DEL ESTERO,284,264,667,646,1313
86,86035,860351601,Banda,SANTIAGO DEL ESTERO,189,214,316,272,588
86,86035,860351608,Banda,SANTIAGO DEL ESTERO,259,275,491,448,939
86,86035,860350704,Banda,SANTIAGO DEL ESTERO,297,339,650,639,1289
86,86035,860350301,Banda,SANTIAGO DEL ESTERO,40,48,77,88,165
86,86035,860351001,Banda,SANTIAGO DEL ESTERO,401,458,838,923,1761
86,86035,860351213,Banda,SANTIAGO DEL ESTERO,315,318,679,636,1315
86,86035,860351214,Banda,SANTIAGO DEL ESTERO,382,397,820,779,1599
86,86035,860351215,Banda,SANTIAGO DEL ESTERO,273,323,592,571,1163
86,86035,860351611,Banda,SANTIAGO DEL ESTERO,265,277,560,545,1105
86,86035,860351407,Banda,SANTIAGO DEL ESTERO,232,205,564,525,1089
86,86035,860351415,Banda,SANTIAGO DEL ESTERO,265,254,591,557,1148
86,86035,860351510,Banda,SANTIAGO DEL ESTERO,364,393,736,702,1438
86,86035,860351112,Banda,SANTIAGO DEL ESTERO,320,360,628,542,1170
86,86035,860351113,Banda,SANTIAGO DEL ESTERO,401,423,813,736,1549
86,86035,860351221,Banda,SANTIAGO DEL ESTERO,36,95,57,52,109
86,86035,860351309,Banda,SANTIAGO DEL ESTERO,257,262,536,503,1039
86,86035,860351311,Banda,SANTIAGO DEL ESTERO,282,312,581,481,1062
86,86035,860351401,Banda,SANTIAGO DEL ESTERO,494,510,1083,1084,2167
86,86035,860351516,Banda,SANTIAGO DEL ESTERO,331,394,653,696,1349
86,86035,860350502,Banda,SANTIAGO DEL ESTERO,123,151,205,249,454
86,86035,860350801,Banda,SANTIAGO DEL ESTERO,95,109,149,202,351
86,86035,860350302,Banda,SANTIAGO DEL ESTERO,23,25,25,35,60
86,86035,860350401,Banda,SANTIAGO DEL ESTERO,144,144,273,298,571
86,86035,860351002,Banda,SANTIAGO DEL ESTERO,194,207,420,483,903
86,86035,860351406,Banda,SANTIAGO DEL ESTERO,273,280,556,525,1081
86,86035,860351503,Banda,SANTIAGO DEL ESTERO,250,241,501,468,969
86,86035,860350707,Banda,SANTIAGO DEL ESTERO,255,272,534,531,1065
86,86035,860351205,Banda,SANTIAGO DEL ESTERO,416,436,809,831,1640
86,86035,860351207,Banda,SANTIAGO DEL ESTERO,424,437,939,916,1855
86,86035,860351305,Banda,SANTIAGO DEL ESTERO,184,213,333,303,636
86,86035,860351308,Banda,SANTIAGO DEL ESTERO,453,441,1020,959,1979
86,86035,860351602,Banda,SANTIAGO DEL ESTERO,232,273,365,290,655
86,86035,860351610,Banda,SANTIAGO DEL ESTERO,400,422,789,646,1435
86,86035,860351004,Banda,SANTIAGO DEL ESTERO,189,166,380,408,788
86,86035,860350202,Banda,SANTIAGO DEL ESTERO,28,28,71,79,150
86,86035,860350503,Banda,SANTIAGO DEL ESTERO,67,84,144,151,295
86,86035,860351003,Banda,SANTIAGO DEL ESTERO,52,63,90,121,211
86,86035,860350706,Banda,SANTIAGO DEL ESTERO,96,108,221,209,430
86,86035,860351405,Banda,SANTIAGO DEL ESTERO,366,364,839,849,1688
86,86035,860351408,Banda,SANTIAGO DEL ESTERO,305,323,632,609,1241
86,86035,860351409,Banda,SANTIAGO DEL ESTERO,289,326,570,459,1029
86,86035,860351413,Banda,SANTIAGO DEL ESTERO,260,269,464,436,900
86,86035,860351501,Banda,SANTIAGO DEL ESTERO,258,292,460,364,824
86,86035,860351416,Banda,SANTIAGO DEL ESTERO,237,246,509,502,1011
86,86077,860770606,General Taboada,SANTIAGO DEL ESTERO,175,191,377,307,684
86,86077,860770501,General Taboada,SANTIAGO DEL ESTERO,218,214,515,534,1049
86,86077,860770603,General Taboada,SANTIAGO DEL ESTERO,217,243,364,317,681
86,86077,860770605,General Taboada,SANTIAGO DEL ESTERO,215,222,405,357,762
86,86077,860770502,General Taboada,SANTIAGO DEL ESTERO,327,344,677,668,1345
86,86077,860770504,General Taboada,SANTIAGO DEL ESTERO,194,222,505,451,956
86,86077,860770506,General Taboada,SANTIAGO DEL ESTERO,233,282,478,495,973
86,86077,860770404,General Taboada,SANTIAGO DEL ESTERO,46,52,74,108,182
86,86077,860770601,General Taboada,SANTIAGO DEL ESTERO,177,225,407,383,790
86,86077,860770611,General Taboada,SANTIAGO DEL ESTERO,233,265,516,474,990
86,86077,860770609,General Taboada,SANTIAGO DEL ESTERO,214,235,429,393,822
86,86077,860770303,General Taboada,SANTIAGO DEL ESTERO,59,78,100,129,229
86,86077,860770512,General Taboada,SANTIAGO DEL ESTERO,218,234,459,417,876
86,86077,860770402,General Taboada,SANTIAGO DEL ESTERO,150,166,280,382,662
86,86077,860770509,General Taboada,SANTIAGO DEL ESTERO,187,233,368,342,710
86,86077,860770405,General Taboada,SANTIAGO DEL ESTERO,224,233,549,511,1060
86,86077,860770604,General Taboada,SANTIAGO DEL ESTERO,214,288,340,326,666
86,86077,860770205,General Taboada,SANTIAGO DEL ESTERO,374,453,718,680,1398
86,86077,860770207,General Taboada,SANTIAGO DEL ESTERO,227,269,474,428,902
86,86077,860770507,General Taboada,SANTIAGO DEL ESTERO,182,200,445,415,860
86,86077,860770612,General Taboada,SANTIAGO DEL ESTERO,235,271,516,498,1014
86,86077,860770103,General Taboada,SANTIAGO DEL ESTERO,247,211,594,619,1213
86,86077,860770202,General Taboada,SANTIAGO DEL ESTERO,490,477,1105,1132,2237
86,86077,860770610,General Taboada,SANTIAGO DEL ESTERO,246,277,573,515,1088
86,86077,860770101,General Taboada,SANTIAGO DEL ESTERO,318,308,687,762,1449
86,86077,860770301,General Taboada,SANTIAGO DEL ESTERO,238,249,441,522,963
86,86077,860770403,General Taboada,SANTIAGO DEL ESTERO,152,67,269,370,639
86,86077,860770401,General Taboada,SANTIAGO DEL ESTERO,42,41,93,132,225
86,86077,860770203,General Taboada,SANTIAGO DEL ESTERO,211,145,442,510,952
86,86077,860770204,General Taboada,SANTIAGO DEL ESTERO,102,90,202,225,427
86,86077,860770602,General Taboada,SANTIAGO DEL ESTERO,210,237,372,327,699
86,86077,860770206,General Taboada,SANTIAGO DEL ESTERO,248,271,536,533,1069
86,86077,860770503,General Taboada,SANTIAGO DEL ESTERO,193,221,427,428,855
86,86077,860770102,General Taboada,SANTIAGO DEL ESTERO,206,210,444,523,967
86,86077,860770201,General Taboada,SANTIAGO DEL ESTERO,115,123,203,313,516
86,86077,860770607,General Taboada,SANTIAGO DEL ESTERO,162,194,365,354,719
86,86077,860770510,General Taboada,SANTIAGO DEL ESTERO,173,213,359,288,647
86,86077,860770511,General Taboada,SANTIAGO DEL ESTERO,205,243,386,379,765
86,86077,860770505,General Taboada,SANTIAGO DEL ESTERO,317,431,792,733,1525
86,86077,860770508,General Taboada,SANTIAGO DEL ESTERO,323,376,630,546,1176
86,86077,860770302,General Taboada,SANTIAGO DEL ESTERO,205,244,406,424,830
86,86077,860770608,General Taboada,SANTIAGO DEL ESTERO,351,409,784,749,1533
86,86105,861050208,Loreto,SANTIAGO DEL ESTERO,294,338,625,538,1163
86,86105,861050207,Loreto,SANTIAGO DEL ESTERO,342,400,682,670,1352
86,86105,861050301,Loreto,SANTIAGO DEL ESTERO,335,211,699,644,1343
86,86105,861050210,Loreto,SANTIAGO DEL ESTERO,347,398,825,660,1485
86,86105,861050211,Loreto,SANTIAGO DEL ESTERO,265,333,617,565,1182
86,86105,861050205,Loreto,SANTIAGO DEL ESTERO,296,347,577,514,1091
86,86105,861050202,Loreto,SANTIAGO DEL ESTERO,44,52,103,104,207
86,86105,861050209,Loreto,SANTIAGO DEL ESTERO,339,370,732,665,1397
86,86105,861050303,Loreto,SANTIAGO DEL ESTERO,94,84,190,232,422
86,86105,861050206,Loreto,SANTIAGO DEL ESTERO,283,328,617,542,1159
86,86105,861050201,Loreto,SANTIAGO DEL ESTERO,324,359,690,609,1299
86,86105,861050203,Loreto,SANTIAGO DEL ESTERO,389,413,821,778,1599
86,86105,861050102,Loreto,SANTIAGO DEL ESTERO,58,65,120,162,282
86,86105,861050101,Loreto,SANTIAGO DEL ESTERO,521,569,1148,1231,2379
86,86105,861050212,Loreto,SANTIAGO DEL ESTERO,282,346,621,614,1235
86,86105,861050302,Loreto,SANTIAGO DEL ESTERO,162,175,339,301,640
86,86105,861050204,Loreto,SANTIAGO DEL ESTERO,407,460,934,867,1801
86,86133,861330408,Pellegrini,SANTIAGO DEL ESTERO,215,272,387,391,778
86,86133,861330504,Pellegrini,SANTIAGO DEL ESTERO,114,137,200,260,460
86,86133,861330402,Pellegrini,SANTIAGO DEL ESTERO,44,61,82,106,188
86,86133,861330406,Pellegrini,SANTIAGO DEL ESTERO,157,171,263,366,629
86,86133,861330101,Pellegrini,SANTIAGO DEL ESTERO,68,82,86,126,212
86,86133,861330410,Pellegrini,SANTIAGO DEL ESTERO,513,697,985,962,1947
86,86133,861330103,Pellegrini,SANTIAGO DEL ESTERO,163,151,255,288,543
86,86133,861330203,Pellegrini,SANTIAGO DEL ESTERO,248,353,436,503,939
86,86133,861330102,Pellegrini,SANTIAGO DEL ESTERO,93,95,157,207,364
86,86133,861330501,Pellegrini,SANTIAGO DEL ESTERO,16,18,23,28,51
86,86133,861330502,Pellegrini,SANTIAGO DEL ESTERO,23,28,23,44,67
86,86133,861330503,Pellegrini,SANTIAGO DEL ESTERO,41,29,70,77,147
86,86133,861330603,Pellegrini,SANTIAGO DEL ESTERO,73,87,142,155,297
86,86133,861330407,Pellegrini,SANTIAGO DEL ESTERO,195,254,338,342,680
86,86133,861330201,Pellegrini,SANTIAGO DEL ESTERO,150,123,282,301,583
86,86133,861330802,Pellegrini,SANTIAGO DEL ESTERO,239,295,461,535,996
86,86133,861330301,Pellegrini,SANTIAGO DEL ESTERO,154,184,222,334,556
86,86133,861330602,Pellegrini,SANTIAGO DEL ESTERO,56,66,100,133,233
86,86133,861330505,Pellegrini,SANTIAGO DEL ESTERO,318,415,662,641,1303
86,86133,861330403,Pellegrini,SANTIAGO DEL ESTERO,348,301,621,676,1297
86,86133,861330205,Pellegrini,SANTIAGO DEL ESTERO,355,417,679,684,1363
86,86133,861330404,Pellegrini,SANTIAGO DEL ESTERO,319,379,697,687,1384
86,86133,861330601,Pellegrini,SANTIAGO DEL ESTERO,76,95,147,120,267
86,86133,861330409,Pellegrini,SANTIAGO DEL ESTERO,208,231,455,393,848
86,86133,861330202,Pellegrini,SANTIAGO DEL ESTERO,68,80,130,156,286
86,86133,861330701,Pellegrini,SANTIAGO DEL ESTERO,231,281,464,483,947
86,86133,861330204,Pellegrini,SANTIAGO DEL ESTERO,192,231,331,346,677
86,86133,861330302,Pellegrini,SANTIAGO DEL ESTERO,85,103,185,181,366
86,86133,861330702,Pellegrini,SANTIAGO DEL ESTERO,139,187,258,264,522
86,86133,861330303,Pellegrini,SANTIAGO DEL ESTERO,138,185,262,304,566
86,86133,861330401,Pellegrini,SANTIAGO DEL ESTERO,58,61,113,159,272
86,86133,861330304,Pellegrini,SANTIAGO DEL ESTERO,30,45,43,55,98
86,86133,861330305,Pellegrini,SANTIAGO DEL ESTERO,46,75,93,83,176
86,86133,861330405,Pellegrini,SANTIAGO DEL ESTERO,53,62,72,99,171
86,86133,861330801,Pellegrini,SANTIAGO DEL ESTERO,70,35,140,161,301
86,86161,861610108,Robles,SANTIAGO DEL ESTERO,277,365,554,551,1105
86,86161,861610205,Robles,SANTIAGO DEL ESTERO,163,184,388,393,781
86,86161,861610319,Robles,SANTIAGO DEL ESTERO,235,246,456,448,904
86,86161,861610410,Robles,SANTIAGO DEL ESTERO,320,357,646,632,1278
86,86161,861610107,Robles,SANTIAGO DEL ESTERO,234,304,467,465,932
86,86161,861610409,Robles,SANTIAGO DEL ESTERO,303,334,601,638,1239
86,86161,861610408,Robles,SANTIAGO DEL ESTERO,48,27,119,126,245
86,86161,861610303,Robles,SANTIAGO DEL ESTERO,45,55,74,95,169
86,86161,861610404,Robles,SANTIAGO DEL ESTERO,204,231,396,422,818
86,86161,861610109,Robles,SANTIAGO DEL ESTERO,334,454,670,622,1292
86,86161,861610411,Robles,SANTIAGO DEL ESTERO,201,219,431,429,860
86,86161,861610204,Robles,SANTIAGO DEL ESTERO,218,235,456,504,960
86,86161,861610413,Robles,SANTIAGO DEL ESTERO,188,218,400,387,787
86,86161,861610312,Robles,SANTIAGO DEL ESTERO,264,307,500,420,920
86,86161,861610306,Robles,SANTIAGO DEL ESTERO,152,85,335,350,685
86,86161,861610103,Robles,SANTIAGO DEL ESTERO,144,124,287,363,650
86,86161,861610401,Robles,SANTIAGO DEL ESTERO,73,63,130,164,294
86,86161,861610314,Robles,SANTIAGO DEL ESTERO,229,272,473,432,905
86,86161,861610313,Robles,SANTIAGO DEL ESTERO,193,235,362,311,673
86,86161,861610104,Robles,SANTIAGO DEL ESTERO,119,133,239,286,525
86,86161,861610106,Robles,SANTIAGO DEL ESTERO,222,230,440,484,924
86,86161,861610201,Robles,SANTIAGO DEL ESTERO,87,112,129,175,304
86,86161,861610304,Robles,SANTIAGO DEL ESTERO,82,76,169,197,366
86,86161,861610406,Robles,SANTIAGO DEL ESTERO,127,146,235,242,477
86,86161,861610310,Robles,SANTIAGO DEL ESTERO,243,248,468,465,933
86,86161,861610317,Robles,SANTIAGO DEL ESTERO,222,265,436,430,866
86,86161,861610102,Robles,SANTIAGO DEL ESTERO,230,130,441,515,956
86,86161,861610307,Robles,SANTIAGO DEL ESTERO,42,44,81,107,188
86,86161,861610402,Robles,SANTIAGO DEL ESTERO,97,85,175,212,387
86,86161,861610206,Robles,SANTIAGO DEL ESTERO,222,238,466,533,999
86,86161,861610305,Robles,SANTIAGO DEL ESTERO,262,129,620,647,1267
86,86161,861610301,Robles,SANTIAGO DEL ESTERO,371,286,824,868,1692
86,86161,861610407,Robles,SANTIAGO DEL ESTERO,54,52,135,130,265
86,86161,861610412,Robles,SANTIAGO DEL ESTERO,308,335,653,646,1299
86,86161,861610112,Robles,SANTIAGO DEL ESTERO,284,321,650,638,1288
86,86161,861610315,Robles,SANTIAGO DEL ESTERO,242,260,573,577,1150
86,86161,861610110,Robles,SANTIAGO DEL ESTERO,345,389,783,688,1471
86,86161,861610111,Robles,SANTIAGO DEL ESTERO,283,323,598,598,1196
86,86161,861610318,Robles,SANTIAGO DEL ESTERO,323,331,674,581,1255
86,86161,861610309,Robles,SANTIAGO DEL ESTERO,255,285,594,590,1184
86,86161,861610308,Robles,SANTIAGO DEL ESTERO,469,513,950,923,1873
86,86161,861610101,Robles,SANTIAGO DEL ESTERO,154,171,342,375,717
86,86161,861610105,Robles,SANTIAGO DEL ESTERO,314,378,649,723,1372
86,86161,861610403,Robles,SANTIAGO DEL ESTERO,119,143,236,260,496
86,86161,861610405,Robles,SANTIAGO DEL ESTERO,120,138,213,214,427
86,86161,861610316,Robles,SANTIAGO DEL ESTERO,329,317,743,717,1460
86,86161,861610203,Robles,SANTIAGO DEL ESTERO,304,209,698,714,1412
86,86161,861610202,Robles,SANTIAGO DEL ESTERO,42,45,46,58,104
86,86161,861610311,Robles,SANTIAGO DEL ESTERO,206,250,398,365,763
86,86161,861610302,Robles,SANTIAGO DEL ESTERO,307,215,621,681,1302
86,86168,861680205,Salavina,SANTIAGO DEL ESTERO,195,272,397,432,829
86,86168,861680204,Salavina,SANTIAGO DEL ESTERO,133,141,273,295,568
86,86168,861680102,Salavina,SANTIAGO DEL ESTERO,109,118,228,291,519
86,86168,861680203,Salavina,SANTIAGO DEL ESTERO,142,141,312,294,606
86,86168,861680104,Salavina,SANTIAGO DEL ESTERO,87,98,149,174,323
86,86168,861680201,Salavina,SANTIAGO DEL ESTERO,165,198,348,397,745
86,86168,861680105,Salavina,SANTIAGO DEL ESTERO,149,191,283,256,539
86,86168,861680101,Salavina,SANTIAGO DEL ESTERO,112,150,199,232,431
86,86168,861680103,Salavina,SANTIAGO DEL ESTERO,152,193,302,324,626
86,86168,861680302,Salavina,SANTIAGO DEL ESTERO,180,193,384,430,814
86,86168,861680207,Salavina,SANTIAGO DEL ESTERO,305,399,566,568,1134
86,86168,861680206,Salavina,SANTIAGO DEL ESTERO,376,506,684,724,1408
86,86168,861680303,Salavina,SANTIAGO DEL ESTERO,65,68,134,161,295
86,86168,861680301,Salavina,SANTIAGO DEL ESTERO,224,252,473,516,989
86,86168,861680304,Salavina,SANTIAGO DEL ESTERO,119,137,256,289,545
86,86168,861680202,Salavina,SANTIAGO DEL ESTERO,205,250,384,462,846
82,82063,820630617,La Capital,SANTA FE,304,344,475,389,864
82,82063,820630608,La Capital,SANTA FE,212,224,359,297,656
82,82063,820631003,La Capital,SANTA FE,258,242,413,362,775
82,82063,820630507,La Capital,SANTA FE,360,240,716,726,1442
82,82063,820630505,La Capital,SANTA FE,290,279,573,541,1114
82,82063,820630501,La Capital,SANTA FE,535,510,1107,1162,2269
82,82063,820630232,La Capital,SANTA FE,392,411,656,638,1294
82,82063,820633507,La Capital,SANTA FE,318,432,405,320,725
82,82063,820633502,La Capital,SANTA FE,268,291,433,422,855
82,82063,820630303,La Capital,SANTA FE,167,499,273,244,517
82,82063,820630213,La Capital,SANTA FE,459,479,760,791,1551
82,82063,820630118,La Capital,SANTA FE,270,313,464,505,969
82,82063,820630406,La Capital,SANTA FE,5,13,3,7,10
82,82063,820630307,La Capital,SANTA FE,365,535,636,608,1244
82,82063,820632909,La Capital,SANTA FE,348,364,658,612,1270
82,82063,820632705,La Capital,SANTA FE,283,355,429,357,786
82,82063,820632114,La Capital,SANTA FE,340,450,408,321,729
82,82063,820633504,La Capital,SANTA FE,230,251,338,327,665
82,82063,820632614,La Capital,SANTA FE,309,328,546,501,1047
82,82063,820630323,La Capital,SANTA FE,246,295,400,405,805
82,82063,820630102,La Capital,SANTA FE,23,24,29,25,54
82,82063,820631204,La Capital,SANTA FE,398,339,723,713,1436
82,82063,820631114,La Capital,SANTA FE,276,260,588,515,1103
82,82063,820631306,La Capital,SANTA FE,234,265,375,335,710
82,82063,820631112,La Capital,SANTA FE,234,231,466,429,895
82,82063,820631203,La Capital,SANTA FE,170,164,288,286,574
82,82063,820631201,La Capital,SANTA FE,356,370,559,541,1100
82,82063,820631012,La Capital,SANTA FE,210,214,360,306,666
82,82063,820631005,La Capital,SANTA FE,234,248,386,363,749
82,82063,820630903,La Capital,SANTA FE,385,403,613,515,1128
82,82063,820630809,La Capital,SANTA FE,266,288,402,317,719
82,82063,820630802,La Capital,SANTA FE,325,352,500,385,885
82,82063,820630702,La Capital,SANTA FE,248,265,398,328,726
82,82063,820630603,La Capital,SANTA FE,419,443,682,567,1249
82,82063,820630601,La Capital,SANTA FE,405,413,808,754,1562
82,82063,820631004,La Capital,SANTA FE,222,210,401,339,740
82,82063,820630231,La Capital,SANTA FE,306,325,555,494,1049
82,82063,820630410,La Capital,SANTA FE,1221,870,2048,1792,3840
82,82063,820633412,La Capital,SANTA FE,445,415,807,800,1607
82,82063,820633405,La Capital,SANTA FE,1517,1444,2954,2810,5764
82,82063,820633402,La Capital,SANTA FE,383,384,744,740,1484
82,82063,820633303,La Capital,SANTA FE,324,315,615,609,1224
82,82063,820633205,La Capital,SANTA FE,335,333,677,702,1379
82,82063,820633114,La Capital,SANTA FE,371,358,722,613,1335
82,82063,820630204,La Capital,SANTA FE,333,359,599,538,1137
82,82063,820633004,La Capital,SANTA FE,198,225,296,261,557
82,82063,820633003,La Capital,SANTA FE,219,262,324,273,597
82,82063,820632813,La Capital,SANTA FE,7,10,23,127,150
82,82063,820632812,La Capital,SANTA FE,4,8,7,9,16
82,82063,820632510,La Capital,SANTA FE,295,335,425,361,786
82,82063,820632507,La Capital,SANTA FE,183,202,293,225,518
82,82063,820632413,La Capital,SANTA FE,179,233,230,185,415
82,82063,820632313,La Capital,SANTA FE,147,205,196,129,325
82,82063,820632312,La Capital,SANTA FE,283,323,420,337,757
82,82063,820632307,La Capital,SANTA FE,156,196,208,168,376
82,82063,820632205,La Capital,SANTA FE,152,236,158,119,277
82,82063,820632109,La Capital,SANTA FE,354,422,476,368,844
82,82063,820632012,La Capital,SANTA FE,306,325,467,414,881
82,82063,820631905,La Capital,SANTA FE,238,271,340,313,653
82,82063,820631903,La Capital,SANTA FE,374,400,642,534,1176
82,82063,820631808,La Capital,SANTA FE,347,539,445,337,782
82,82063,820631807,La Capital,SANTA FE,474,662,573,456,1029
82,82063,820631711,La Capital,SANTA FE,311,366,451,400,851
82,82063,820631506,La Capital,SANTA FE,189,216,268,240,508
82,82063,820631702,La Capital,SANTA FE,457,519,712,629,1341
82,82063,820631701,La Capital,SANTA FE,355,415,524,403,927
82,82063,820631610,La Capital,SANTA FE,378,417,744,667,1411
82,82063,820631401,La Capital,SANTA FE,301,363,430,349,779
82,82063,820631317,La Capital,SANTA FE,371,402,560,490,1050
82,82063,820631409,La Capital,SANTA FE,359,430,479,383,862
82,82063,820631301,La Capital,SANTA FE,272,301,425,400,825
82,82063,820631215,La Capital,SANTA FE,251,167,511,493,1004
82,82063,820630125,La Capital,SANTA FE,317,329,587,540,1127
82,82063,820630309,La Capital,SANTA FE,325,454,503,492,995
82,82063,820630106,La Capital,SANTA FE,102,167,162,193,355
82,82063,820630322,La Capital,SANTA FE,333,631,585,580,1165
82,82063,820630214,La Capital,SANTA FE,76,109,123,139,262
82,82063,820632825,La Capital,SANTA FE,163,339,240,262,502
82,82063,820632616,La Capital,SANTA FE,292,171,634,649,1283
82,82063,820630405,La Capital,SANTA FE,99,64,181,217,398
82,82063,820630403,La Capital,SANTA FE,135,123,237,194,431
82,82063,820630612,La Capital,SANTA FE,250,253,439,425,864
82,82063,820630611,La Capital,SANTA FE,263,236,477,421,898
82,82063,820630407,La Capital,SANTA FE,331,267,671,658,1329
82,82063,820633112,La Capital,SANTA FE,358,362,727,712,1439
82,82063,820632110,La Capital,SANTA FE,101,130,124,128,252
82,82063,820632908,La Capital,SANTA FE,295,300,521,559,1080
82,82063,820633508,La Capital,SANTA FE,318,413,408,328,736
82,82063,820633503,La Capital,SANTA FE,236,240,429,427,856
82,82063,820630319,La Capital,SANTA FE,474,474,842,780,1622
82,82063,820630215,La Capital,SANTA FE,78,109,140,128,268
82,82063,820631307,La Capital,SANTA FE,261,276,446,381,827
82,82063,820631101,La Capital,SANTA FE,397,385,816,764,1580
82,82063,820631011,La Capital,SANTA FE,381,401,649,597,1246
82,82063,820631006,La Capital,SANTA FE,257,274,429,348,777
82,82063,820630908,La Capital,SANTA FE,366,383,552,455,1007
82,82063,820630814,La Capital,SANTA FE,225,241,372,315,687
82,82063,820630813,La Capital,SANTA FE,219,227,303,240,543
82,82063,820631009,La Capital,SANTA FE,347,320,607,642,1249
82,82063,820630807,La Capital,SANTA FE,229,256,345,290,635
82,82063,820630713,La Capital,SANTA FE,324,343,532,532,1064
82,82063,820630710,La Capital,SANTA FE,275,283,381,379,760
82,82063,820630709,La Capital,SANTA FE,249,260,366,310,676
82,82063,820630706,La Capital,SANTA FE,470,519,697,615,1312
82,82063,820630704,La Capital,SANTA FE,427,486,644,540,1184
82,82063,820630602,La Capital,SANTA FE,319,313,565,565,1130
82,82063,820630509,La Capital,SANTA FE,581,579,1117,1129,2246
82,82063,820630504,La Capital,SANTA FE,321,298,560,606,1166
82,82063,820630412,La Capital,SANTA FE,560,542,1015,881,1896
82,82063,820630221,La Capital,SANTA FE,491,512,797,768,1565
82,82063,820633410,La Capital,SANTA FE,250,254,424,406,830
82,82063,820633215,La Capital,SANTA FE,225,282,332,280,612
82,82063,820633214,La Capital,SANTA FE,287,324,508,415,923
82,82063,820633211,La Capital,SANTA FE,396,395,734,710,1444
82,82063,820630212,La Capital,SANTA FE,394,427,658,562,1220
82,82063,820633011,La Capital,SANTA FE,357,381,558,487,1045
82,82063,820633008,La Capital,SANTA FE,468,506,781,694,1475
82,82063,820630126,La Capital,SANTA FE,515,582,863,788,1651
82,82063,820632818,La Capital,SANTA FE,263,250,512,503,1015
82,82063,820632815,La Capital,SANTA FE,164,198,308,286,594
82,82063,820632710,La Capital,SANTA FE,469,528,790,704,1494
82,82063,820632601,La Capital,SANTA FE,572,550,1139,1130,2269
82,82063,820632508,La Capital,SANTA FE,199,218,295,219,514
82,82063,820632506,La Capital,SANTA FE,278,209,454,455,909
82,82063,820632505,La Capital,SANTA FE,177,210,298,263,561
82,82063,820632501,La Capital,SANTA FE,206,195,391,356,747
82,82063,820632414,La Capital,SANTA FE,231,349,324,251,575
82,82063,820632513,La Capital,SANTA FE,228,262,338,308,646
82,82063,820632403,La Capital,SANTA FE,299,441,400,238,638
82,82063,820632314,La Capital,SANTA FE,305,392,405,348,753
82,82063,820632305,La Capital,SANTA FE,251,341,344,276,620
82,82063,820632213,La Capital,SANTA FE,240,339,282,238,520
82,82063,820632202,La Capital,SANTA FE,241,417,283,291,574
82,82063,820632104,La Capital,SANTA FE,462,595,619,467,1086
82,82063,820632103,La Capital,SANTA FE,289,439,400,280,680
82,82063,820630615,La Capital,SANTA FE,282,312,469,395,864
82,82063,820631912,La Capital,SANTA FE,282,330,373,337,710
82,82063,820631910,La Capital,SANTA FE,420,420,775,752,1527
82,82063,820631901,La Capital,SANTA FE,330,315,555,540,1095
82,82063,820631811,La Capital,SANTA FE,369,496,417,274,691
82,82063,820631806,La Capital,SANTA FE,261,354,322,246,568
82,82063,820631804,La Capital,SANTA FE,283,377,405,287,692
82,82063,820631803,La Capital,SANTA FE,324,431,398,310,708
82,82063,820631710,La Capital,SANTA FE,291,311,404,365,769
82,82063,820631709,La Capital,SANTA FE,281,320,385,334,719
82,82063,820631813,La Capital,SANTA FE,178,261,211,159,370
82,82063,820631513,La Capital,SANTA FE,252,210,362,292,654
82,82063,820631508,La Capital,SANTA FE,257,297,375,317,692
82,82063,820631503,La Capital,SANTA FE,297,354,471,374,845
82,82063,820631501,La Capital,SANTA FE,357,430,542,493,1035
82,82063,820631608,La Capital,SANTA FE,373,374,619,603,1222
82,82063,820631316,La Capital,SANTA FE,398,440,575,523,1098
82,82063,820631315,La Capital,SANTA FE,362,389,533,473,1006
82,82063,820631302,La Capital,SANTA FE,356,374,531,483,1014
82,82063,820631311,La Capital,SANTA FE,266,291,383,310,693
82,82063,820631211,La Capital,SANTA FE,316,240,475,428,903
82,82063,820630105,La Capital,SANTA FE,386,396,561,496,1057
82,82063,820630318,La Capital,SANTA FE,10,10,17,22,39
82,82063,820630308,La Capital,SANTA FE,275,347,467,471,938
82,82063,820630224,La Capital,SANTA FE,98,111,233,210,443
82,82063,820630114,La Capital,SANTA FE,100,164,162,162,324
82,82063,820630301,La Capital,SANTA FE,177,365,292,297,589
82,82063,820630313,La Capital,SANTA FE,227,309,375,379,754
82,82063,820630226,La Capital,SANTA FE,74,160,136,143,279
82,82063,820632701,La Capital,SANTA FE,232,248,431,417,848
82,82063,820630327,La Capital,SANTA FE,217,470,299,323,622
82,82063,820632807,La Capital,SANTA FE,425,439,746,737,1483
82,82063,820630124,La Capital,SANTA FE,271,258,450,438,888
82,82063,820632905,La Capital,SANTA FE,436,357,849,845,1694
82,82063,820632804,La Capital,SANTA FE,16,27,26,30,56
82,82063,820633505,La Capital,SANTA FE,223,237,338,271,609
82,82063,820633006,La Capital,SANTA FE,290,318,433,374,807
82,82063,820630711,La Capital,SANTA FE,285,292,402,342,744
82,82063,820631205,La Capital,SANTA FE,229,212,427,392,819
82,82063,820631116,La Capital,SANTA FE,294,316,501,514,1015
82,82063,820631115,La Capital,SANTA FE,371,355,822,815,1637
82,82063,820631013,La Capital,SANTA FE,433,428,745,737,1482
82,82063,820631010,La Capital,SANTA FE,358,397,695,518,1213
82,82063,820630910,La Capital,SANTA FE,348,371,521,452,973
82,82063,820630904,La Capital,SANTA FE,227,259,345,276,621
82,82063,820630901,La Capital,SANTA FE,416,429,651,605,1256
82,82063,820630804,La Capital,SANTA FE,268,321,407,384,791
82,82063,820630712,La Capital,SANTA FE,292,341,378,338,716
82,82063,820630705,La Capital,SANTA FE,423,489,621,571,1192
82,82063,820630610,La Capital,SANTA FE,218,232,361,323,684
82,82063,820630513,La Capital,SANTA FE,366,298,650,619,1269
82,82063,820631002,La Capital,SANTA FE,390,386,593,528,1121
82,82063,820630506,La Capital,SANTA FE,572,544,1269,1207,2476
82,82063,820630907,La Capital,SANTA FE,243,259,405,310,715
82,82063,820633413,La Capital,SANTA FE,881,874,1643,1622,3265
82,82063,820633306,La Capital,SANTA FE,346,370,531,478,1009
82,82063,820633302,La Capital,SANTA FE,276,267,520,542,1062
82,82063,820633301,La Capital,SANTA FE,369,212,748,736,1484
82,82063,820633207,La Capital,SANTA FE,476,491,946,883,1829
82,82063,820633203,La Capital,SANTA FE,435,411,845,823,1668
82,82063,820633103,La Capital,SANTA FE,345,367,593,580,1173
82,82063,820633102,La Capital,SANTA FE,188,201,330,336,666
82,82063,820630207,La Capital,SANTA FE,390,426,610,534,1144
82,82063,820630906,La Capital,SANTA FE,340,373,529,486,1015
82,82063,820633012,La Capital,SANTA FE,263,280,430,375,805
82,82063,820633002,La Capital,SANTA FE,381,435,568,468,1036
82,82063,820632823,La Capital,SANTA FE,211,277,398,417,815
82,82063,820632816,La Capital,SANTA FE,162,289,227,252,479
82,82063,820632712,La Capital,SANTA FE,401,385,790,760,1550
82,82063,820632611,La Capital,SANTA FE,252,269,399,369,768
82,82063,820632418,La Capital,SANTA FE,120,185,158,149,307
82,82063,820632417,La Capital,SANTA FE,221,331,269,176,445
82,82063,820632410,La Capital,SANTA FE,232,312,314,273,587
82,82063,820632301,La Capital,SANTA FE,283,347,399,316,715
82,82063,820632009,La Capital,SANTA FE,237,266,406,380,786
82,82063,820632001,La Capital,SANTA FE,310,354,419,366,785
82,82063,820630110,La Capital,SANTA FE,369,390,730,701,1431
82,82063,820631712,La Capital,SANTA FE,285,349,335,315,650
82,82063,820631605,La Capital,SANTA FE,229,263,352,288,640
82,82063,820631602,La Capital,SANTA FE,330,355,498,414,912
82,82063,820631510,La Capital,SANTA FE,348,381,531,435,966
82,82063,820631609,La Capital,SANTA FE,231,229,364,309,673
82,82063,820631402,La Capital,SANTA FE,382,415,589,523,1112
82,82063,820631303,La Capital,SANTA FE,177,191,249,241,490
82,82063,820631213,La Capital,SANTA FE,373,264,638,560,1198
82,82063,820631313,La Capital,SANTA FE,365,431,532,485,1017
82,82063,820631312,La Capital,SANTA FE,300,312,464,407,871
82,82063,820631310,La Capital,SANTA FE,233,230,382,379,761
82,82063,820631207,La Capital,SANTA FE,365,393,653,599,1252
82,82063,820631210,La Capital,SANTA FE,282,249,567,552,1119
82,82063,820632716,La Capital,SANTA FE,132,148,217,232,449
82,82063,820632822,La Capital,SANTA FE,56,65,93,91,184
82,82063,820630108,La Capital,SANTA FE,79,93,149,154,303
82,82063,820630317,La Capital,SANTA FE,314,522,486,532,1018
82,82063,820630314,La Capital,SANTA FE,380,440,635,667,1302
82,82063,820630613,La Capital,SANTA FE,266,282,427,387,814
82,82063,820632906,La Capital,SANTA FE,353,365,703,745,1448
82,82063,820632902,La Capital,SANTA FE,236,236,464,455,919
82,82063,820632805,La Capital,SANTA FE,526,561,943,900,1843
82,82063,820632704,La Capital,SANTA FE,344,396,499,405,904
82,82063,820633007,La Capital,SANTA FE,448,515,698,529,1227
82,82063,820631117,La Capital,SANTA FE,260,251,489,433,922
82,82063,820631111,La Capital,SANTA FE,426,361,763,753,1516
82,82063,820631107,La Capital,SANTA FE,708,620,1318,1444,2762
82,82063,820631105,La Capital,SANTA FE,359,409,691,610,1301
82,82063,820631103,La Capital,SANTA FE,391,355,757,755,1512
82,82063,820631102,La Capital,SANTA FE,304,282,543,1185,1728
82,82063,820630812,La Capital,SANTA FE,328,380,498,418,916
82,82063,820630808,La Capital,SANTA FE,292,328,429,372,801
82,82063,820630806,La Capital,SANTA FE,258,273,427,355,782
82,82063,820630607,La Capital,SANTA FE,225,230,362,303,665
82,82063,820630604,La Capital,SANTA FE,382,383,671,611,1282
82,82063,820630510,La Capital,SANTA FE,461,207,853,768,1621
82,82063,820630411,La Capital,SANTA FE,301,335,561,582,1143
82,82063,820630408,La Capital,SANTA FE,297,222,569,503,1072
82,82063,820630222,La Capital,SANTA FE,420,444,765,743,1508
82,82063,820633216,La Capital,SANTA FE,298,308,500,492,992
82,82063,820633212,La Capital,SANTA FE,597,609,1079,1069,2148
82,82063,820633209,La Capital,SANTA FE,490,479,792,706,1498
82,82063,820633206,La Capital,SANTA FE,253,267,452,474,926
82,82063,820633404,La Capital,SANTA FE,255,265,514,491,1005
82,82063,820633013,La Capital,SANTA FE,394,422,704,656,1360
82,82063,820630211,La Capital,SANTA FE,263,290,418,382,800
82,82063,820633110,La Capital,SANTA FE,376,368,783,731,1514
82,82063,820633109,La Capital,SANTA FE,667,708,1194,1169,2363
82,82063,820633108,La Capital,SANTA FE,241,221,442,413,855
82,82063,820630128,La Capital,SANTA FE,378,348,816,868,1684
82,82063,820630120,La Capital,SANTA FE,285,308,521,470,991
82,82063,820632914,La Capital,SANTA FE,215,237,336,278,614
82,82063,820632913,La Capital,SANTA FE,332,406,484,382,866
82,82063,820632827,La Capital,SANTA FE,79,187,93,99,192
82,82063,820632826,La Capital,SANTA FE,198,455,278,296,574
82,82063,820632819,La Capital,SANTA FE,359,500,589,552,1141
82,82063,820632811,La Capital,SANTA FE,671,695,1374,1339,2713
82,82063,820632714,La Capital,SANTA FE,476,513,853,813,1666
82,82063,820632711,La Capital,SANTA FE,376,428,682,636,1318
82,82063,820632608,La Capital,SANTA FE,332,359,531,460,991
82,82063,820632409,La Capital,SANTA FE,249,338,342,241,583
82,82063,820632407,La Capital,SANTA FE,136,213,213,134,347
82,82063,820632810,La Capital,SANTA FE,467,496,844,780,1624
82,82063,820632311,La Capital,SANTA FE,157,210,243,209,452
82,82063,820632310,La Capital,SANTA FE,353,438,525,400,925
82,82063,820632206,La Capital,SANTA FE,110,261,145,128,273
82,82063,820632204,La Capital,SANTA FE,134,212,159,121,280
82,82063,820632107,La Capital,SANTA FE,319,422,463,380,843
82,82063,820632105,La Capital,SANTA FE,343,430,451,362,813
82,82063,820631913,La Capital,SANTA FE,636,694,1249,1311,2560
82,82063,820630109,La Capital,SANTA FE,297,312,533,480,1013
82,82063,820631906,La Capital,SANTA FE,167,214,221,192,413
82,82063,820631809,La Capital,SANTA FE,227,356,239,179,418
82,82063,820631802,La Capital,SANTA FE,392,593,530,415,945
82,82063,820631801,La Capital,SANTA FE,332,449,444,317,761
82,82063,820631707,La Capital,SANTA FE,242,300,327,258,585
82,82063,820631706,La Capital,SANTA FE,311,363,429,428,857
82,82063,820631703,La Capital,SANTA FE,224,214,421,423,844
82,82063,820631511,La Capital,SANTA FE,357,331,578,477,1055
82,82063,820631411,La Capital,SANTA FE,326,381,442,352,794
82,82063,820631406,La Capital,SANTA FE,277,326,380,363,743
82,82063,820631607,La Capital,SANTA FE,177,202,305,253,558
82,82063,820631404,La Capital,SANTA FE,358,388,528,445,973
82,82063,820631319,La Capital,SANTA FE,222,226,334,306,640
82,82063,820631318,La Capital,SANTA FE,267,291,421,327,748
82,82063,820630101,La Capital,SANTA FE,221,261,354,337,691
82,82063,820630320,La Capital,SANTA FE,2,2,0,2,2
82,82063,820630321,La Capital,SANTA FE,0,1,0,0,0
82,82063,820630230,La Capital,SANTA FE,28,58,33,43,76
82,82063,820632820,La Capital,SANTA FE,5,10,7,7,14
82,82063,820630116,La Capital,SANTA FE,30,42,36,44,80
82,82063,820632617,La Capital,SANTA FE,446,398,808,789,1597
82,82063,820632615,La Capital,SANTA FE,272,215,488,447,935
82,82063,820630905,La Capital,SANTA FE,237,258,377,313,690
82,82063,820632702,La Capital,SANTA FE,272,288,433,462,895
82,82063,820632111,La Capital,SANTA FE,312,411,618,391,1009
82,82063,820633509,La Capital,SANTA FE,307,378,394,335,729
82,82063,820631110,La Capital,SANTA FE,554,396,1015,923,1938
82,82063,820631108,La Capital,SANTA FE,203,211,430,410,840
82,82063,820631119,La Capital,SANTA FE,242,213,410,361,771
82,82063,820631008,La Capital,SANTA FE,529,485,866,861,1727
82,82063,820630811,La Capital,SANTA FE,273,292,434,379,813
82,82063,820630810,La Capital,SANTA FE,303,338,441,383,824
82,82063,820630708,La Capital,SANTA FE,248,275,356,341,697
82,82063,820630508,La Capital,SANTA FE,400,396,795,838,1633
82,82063,820631001,La Capital,SANTA FE,288,300,485,513,998
82,82063,820633307,La Capital,SANTA FE,308,347,504,449,953
82,82063,820633204,La Capital,SANTA FE,253,241,440,426,866
82,82063,820633201,La Capital,SANTA FE,370,373,680,629,1309
82,82063,820633104,La Capital,SANTA FE,677,712,1283,1188,2471
82,82063,820633009,La Capital,SANTA FE,457,498,748,708,1456
82,82063,820632915,La Capital,SANTA FE,346,369,571,454,1025
82,82063,820632911,La Capital,SANTA FE,235,243,396,340,736
82,82063,820632910,La Capital,SANTA FE,291,275,494,454,948
82,82063,820633113,La Capital,SANTA FE,373,380,661,577,1238
82,82063,820632609,La Capital,SANTA FE,392,390,632,577,1209
82,82063,820632606,La Capital,SANTA FE,277,294,492,491,983
82,82063,820632605,La Capital,SANTA FE,372,360,738,732,1470
82,82063,820632602,La Capital,SANTA FE,340,253,635,589,1224
82,82063,820632511,La Capital,SANTA FE,252,285,397,334,731
82,82063,820632412,La Capital,SANTA FE,259,350,404,293,697
82,82063,820632411,La Capital,SANTA FE,244,337,321,279,600
82,82063,820632309,La Capital,SANTA FE,298,380,348,283,631
82,82063,820632304,La Capital,SANTA FE,329,412,421,387,808
82,82063,820632212,La Capital,SANTA FE,249,378,286,236,522
82,82063,820632211,La Capital,SANTA FE,168,244,217,143,360
82,82063,820632203,La Capital,SANTA FE,194,320,226,187,413
82,82063,820632102,La Capital,SANTA FE,347,409,461,369,830
82,82063,820632011,La Capital,SANTA FE,274,297,394,367,761
82,82063,820630122,La Capital,SANTA FE,349,395,618,553,1171
82,82063,820631904,La Capital,SANTA FE,188,202,289,250,539
82,82063,820631810,La Capital,SANTA FE,265,423,298,208,506
82,82063,820631705,La Capital,SANTA FE,351,399,484,430,914
82,82063,820631601,La Capital,SANTA FE,304,343,431,393,824
82,82063,820631502,La Capital,SANTA FE,285,321,437,381,818
82,82063,820631611,La Capital,SANTA FE,243,243,420,370,790
82,82063,820631403,La Capital,SANTA FE,374,415,565,443,1008
82,82063,820631309,La Capital,SANTA FE,484,411,900,901,1801
82,82063,820630304,La Capital,SANTA FE,1,4,1,1,2
82,82063,820630229,La Capital,SANTA FE,25,33,42,35,77
82,82063,820630228,La Capital,SANTA FE,93,100,138,157,295
82,82063,820630315,La Capital,SANTA FE,254,240,463,492,955
82,82063,820630312,La Capital,SANTA FE,470,572,797,816,1613
82,82063,820630220,La Capital,SANTA FE,307,364,604,600,1204
82,82063,820630117,La Capital,SANTA FE,33,49,45,66,111
82,82063,820632613,La Capital,SANTA FE,617,473,1233,1195,2428
82,82063,820630402,La Capital,SANTA FE,378,372,669,620,1289
82,82063,820630401,La Capital,SANTA FE,19,32,34,38,72
82,82063,820632415,La Capital,SANTA FE,222,307,324,232,556
82,82063,820632907,La Capital,SANTA FE,255,256,486,471,957
82,82063,820632904,La Capital,SANTA FE,431,457,679,619,1298
82,82063,820632901,La Capital,SANTA FE,519,716,899,1006,1905
82,82063,820632806,La Capital,SANTA FE,567,593,1092,1046,2138
82,82063,820632802,La Capital,SANTA FE,374,417,640,591,1231
82,82063,820633506,La Capital,SANTA FE,324,372,499,393,892
82,82063,820632004,La Capital,SANTA FE,0,0,146,71,217
82,82063,820630404,La Capital,SANTA FE,372,383,691,543,1234
82,82063,820630225,La Capital,SANTA FE,195,177,456,400,856
82,82063,820631308,La Capital,SANTA FE,245,224,420,423,843
82,82063,820631109,La Capital,SANTA FE,255,127,432,466,898
82,82063,820631202,La Capital,SANTA FE,229,210,378,304,682
82,82063,820631118,La Capital,SANTA FE,301,293,570,637,1207
82,82063,820630902,La Capital,SANTA FE,251,255,395,343,738
82,82063,820630703,La Capital,SANTA FE,200,280,316,265,581
82,82063,820630609,La Capital,SANTA FE,442,485,770,664,1434
82,82063,820630606,La Capital,SANTA FE,257,254,432,386,818
82,82063,820630605,La Capital,SANTA FE,226,211,449,423,872
82,82063,820630614,La Capital,SANTA FE,331,342,546,463,1009
82,82063,820630503,La Capital,SANTA FE,400,274,792,765,1557
82,82063,820630310,La Capital,SANTA FE,417,408,778,715,1493
82,82063,820630409,La Capital,SANTA FE,874,798,1740,1677,3417
82,82063,820630311,La Capital,SANTA FE,417,479,774,801,1575
82,82063,820630216,La Capital,SANTA FE,227,251,390,361,751
82,82063,820633409,La Capital,SANTA FE,263,273,499,467,966
82,82063,820633403,La Capital,SANTA FE,459,467,823,833,1656
82,82063,820633308,La Capital,SANTA FE,300,310,761,582,1343
82,82063,820633304,La Capital,SANTA FE,295,285,575,542,1117
82,82063,820633208,La Capital,SANTA FE,379,380,642,593,1235
82,82063,820633115,La Capital,SANTA FE,442,381,925,867,1792
82,82063,820633101,La Capital,SANTA FE,574,733,1023,1007,2030
82,82063,820630210,La Capital,SANTA FE,272,326,393,359,752
82,82063,820630208,La Capital,SANTA FE,493,496,929,915,1844
82,82063,820630205,La Capital,SANTA FE,308,321,461,442,903
82,82063,820633001,La Capital,SANTA FE,330,371,509,392,901
82,82063,820630127,La Capital,SANTA FE,305,336,456,445,901
82,82063,820632817,La Capital,SANTA FE,240,575,340,356,696
82,82063,820632828,La Capital,SANTA FE,259,676,326,372,698
82,82063,820632809,La Capital,SANTA FE,418,448,768,765,1533
82,82063,820632808,La Capital,SANTA FE,313,335,594,556,1150
82,82063,820632713,La Capital,SANTA FE,478,480,991,994,1985
82,82063,820632709,La Capital,SANTA FE,508,521,939,845,1784
82,82063,820632607,La Capital,SANTA FE,416,438,700,592,1292
82,82063,820632603,La Capital,SANTA FE,303,316,556,551,1107
82,82063,820632509,La Capital,SANTA FE,339,385,474,404,878
82,82063,820632416,La Capital,SANTA FE,231,297,335,299,634
82,82063,820632408,La Capital,SANTA FE,230,316,273,219,492
82,82063,820632406,La Capital,SANTA FE,175,242,208,141,349
82,82063,820632405,La Capital,SANTA FE,186,305,224,178,402
82,82063,820632401,La Capital,SANTA FE,301,455,360,263,623
82,82063,820632303,La Capital,SANTA FE,262,341,377,310,687
82,82063,820632214,La Capital,SANTA FE,252,330,325,201,526
82,82063,820632208,La Capital,SANTA FE,326,475,418,332,750
82,82063,820632207,La Capital,SANTA FE,327,459,400,285,685
82,82063,820632008,La Capital,SANTA FE,312,354,492,394,886
82,82063,820632006,La Capital,SANTA FE,236,286,320,265,585
82,82063,820632003,La Capital,SANTA FE,206,242,301,254,555
82,82063,820631911,La Capital,SANTA FE,247,247,426,459,885
82,82063,820631909,La Capital,SANTA FE,396,449,653,621,1274
82,82063,820631805,La Capital,SANTA FE,97,162,122,86,208
82,82063,820631713,La Capital,SANTA FE,326,377,426,379,805
82,82063,820631708,La Capital,SANTA FE,291,341,462,374,836
82,82063,820631603,La Capital,SANTA FE,395,445,572,517,1089
82,82063,820631512,La Capital,SANTA FE,317,340,505,422,927
82,82063,820631505,La Capital,SANTA FE,310,360,436,394,830
82,82063,820631504,La Capital,SANTA FE,239,287,341,280,621
82,82063,820631407,La Capital,SANTA FE,280,336,352,314,666
82,82063,820631612,La Capital,SANTA FE,256,288,399,349,748
82,82063,820631606,La Capital,SANTA FE,241,289,367,266,633
82,82063,820631410,La Capital,SANTA FE,360,393,510,448,958
82,82063,820631214,La Capital,SANTA FE,269,248,506,500,1006
82,82063,820631304,La Capital,SANTA FE,296,331,450,353,803
82,82063,820631208,La Capital,SANTA FE,377,389,710,626,1336
82,82063,820630104,La Capital,SANTA FE,286,318,493,480,973
82,82063,820630103,La Capital,SANTA FE,332,382,563,526,1089
82,82063,820630223,La Capital,SANTA FE,140,121,276,276,552
82,82063,820630217,La Capital,SANTA FE,28,101,28,50,78
82,82063,820630302,La Capital,SANTA FE,222,372,356,385,741
82,82063,820630219,La Capital,SANTA FE,53,197,50,72,122
82,82063,820632821,La Capital,SANTA FE,56,73,90,116,206
82,82063,820630325,La Capital,SANTA FE,368,453,555,597,1152
82,82063,820630324,La Capital,SANTA FE,422,643,662,655,1317
82,82063,820632707,La Capital,SANTA FE,310,354,447,375,822
82,82063,820630306,La Capital,SANTA FE,194,232,301,265,566
82,82063,820632903,La Capital,SANTA FE,258,292,447,377,824
82,82063,820632803,La Capital,SANTA FE,418,447,781,719,1500
82,82063,820632706,La Capital,SANTA FE,411,476,574,486,1060
82,82063,820632113,La Capital,SANTA FE,209,303,279,215,494
82,82063,820632112,La Capital,SANTA FE,346,450,431,317,748
82,82063,820633105,La Capital,SANTA FE,30,38,56,54,110
82,82063,820632612,La Capital,SANTA FE,356,372,623,500,1123
82,82063,820632402,La Capital,SANTA FE,261,402,319,213,532
82,82063,820630206,La Capital,SANTA FE,332,359,539,399,938
82,82063,820631113,La Capital,SANTA FE,397,310,750,728,1478
82,82063,820631104,La Capital,SANTA FE,251,250,447,385,832
82,82063,820631305,La Capital,SANTA FE,259,283,404,367,771
82,82063,820630909,La Capital,SANTA FE,285,325,441,342,783
82,82063,820631007,La Capital,SANTA FE,433,415,781,755,1536
82,82063,820630714,La Capital,SANTA FE,216,235,337,278,615
82,82063,820630707,La Capital,SANTA FE,299,339,434,370,804
82,82063,820630618,La Capital,SANTA FE,234,261,393,297,690
82,82063,820633501,La Capital,SANTA FE,237,214,453,454,907
82,82063,820633213,La Capital,SANTA FE,530,580,841,771,1612
82,82063,820633210,La Capital,SANTA FE,301,302,511,473,984
82,82063,820633106,La Capital,SANTA FE,329,333,662,588,1250
82,82063,820633111,La Capital,SANTA FE,311,292,622,627,1249
82,82063,820633005,La Capital,SANTA FE,246,236,368,324,692
82,82063,820630121,La Capital,SANTA FE,220,253,367,332,699
82,82063,820630119,La Capital,SANTA FE,407,446,637,615,1252
82,82063,820632604,La Capital,SANTA FE,307,289,572,537,1109
82,82063,820632502,La Capital,SANTA FE,370,412,609,519,1128
82,82063,820632912,La Capital,SANTA FE,238,253,375,304,679
82,82063,820632512,La Capital,SANTA FE,123,126,197,162,359
82,82063,820632306,La Capital,SANTA FE,440,573,589,543,1132
82,82063,820632210,La Capital,SANTA FE,208,298,277,198,475
82,82063,820632115,La Capital,SANTA FE,167,222,329,346,675
82,82063,820632106,La Capital,SANTA FE,254,308,420,288,708
82,82063,820632010,La Capital,SANTA FE,313,334,518,451,969
82,82063,820632007,La Capital,SANTA FE,168,201,259,222,481
82,82063,820632005,La Capital,SANTA FE,159,192,233,183,416
82,82063,820630123,La Capital,SANTA FE,255,293,413,386,799
82,82063,820631908,La Capital,SANTA FE,187,173,336,364,700
82,82063,820631907,La Capital,SANTA FE,368,428,577,460,1037
82,82063,820631812,La Capital,SANTA FE,197,288,258,170,428
82,82063,820631604,La Capital,SANTA FE,251,280,343,301,644
82,82063,820631405,La Capital,SANTA FE,286,304,446,339,785
82,82063,820631320,La Capital,SANTA FE,217,241,364,305,669
82,82063,820631209,La Capital,SANTA FE,396,435,632,569,1201
82,82063,820632824,La Capital,SANTA FE,2,8,1,1,2
82,82063,820630218,La Capital,SANTA FE,53,81,81,85,166
82,82063,820630202,La Capital,SANTA FE,37,62,51,62,113
82,82063,820630203,La Capital,SANTA FE,22,39,33,34,67
82,82063,820632708,La Capital,SANTA FE,258,283,398,338,736
82,82063,820630326,La Capital,SANTA FE,311,355,517,487,1004
82,82063,820630305,La Capital,SANTA FE,208,313,318,303,621
82,82063,820632610,La Capital,SANTA FE,244,264,439,401,840
82,82063,820632801,La Capital,SANTA FE,314,332,506,457,963
82,82063,820632703,La Capital,SANTA FE,271,285,408,404,812
82,82063,820631106,La Capital,SANTA FE,634,412,1022,1041,2063
82,82063,820630805,La Capital,SANTA FE,241,260,382,282,664
82,82063,820630803,La Capital,SANTA FE,257,283,396,307,703
82,82063,820630801,La Capital,SANTA FE,241,277,377,290,667
82,82063,820630701,La Capital,SANTA FE,302,307,555,562,1117
82,82063,820630512,La Capital,SANTA FE,233,269,405,376,781
82,82063,820630511,La Capital,SANTA FE,347,335,699,739,1438
82,82063,820630502,La Capital,SANTA FE,442,389,915,849,1764
82,82063,820630616,La Capital,SANTA FE,291,326,466,424,890
82,82063,820630316,La Capital,SANTA FE,384,399,692,673,1365
82,82063,820633411,La Capital,SANTA FE,289,315,516,457,973
82,82063,820633408,La Capital,SANTA FE,218,233,382,375,757
82,82063,820633407,La Capital,SANTA FE,264,277,452,419,871
82,82063,820633406,La Capital,SANTA FE,545,567,1106,1027,2133
82,82063,820633401,La Capital,SANTA FE,725,751,1496,1423,2919
82,82063,820633310,La Capital,SANTA FE,276,275,513,499,1012
82,82063,820633309,La Capital,SANTA FE,226,230,435,417,852
82,82063,820633305,La Capital,SANTA FE,260,274,439,406,845
82,82063,820633202,La Capital,SANTA FE,315,314,565,534,1099
82,82063,820630209,La Capital,SANTA FE,275,306,422,354,776
82,82063,820633107,La Capital,SANTA FE,402,444,712,684,1396
82,82063,820633010,La Capital,SANTA FE,413,432,714,612,1326
82,82063,820630201,La Capital,SANTA FE,95,112,156,157,313
82,82063,820630129,La Capital,SANTA FE,562,626,1050,1021,2071
82,82063,820632829,La Capital,SANTA FE,292,535,497,514,1011
82,82063,820632814,La Capital,SANTA FE,468,573,877,847,1724
82,82063,820632715,La Capital,SANTA FE,373,380,675,678,1353
82,82063,820632504,La Capital,SANTA FE,197,253,276,235,511
82,82063,820632503,La Capital,SANTA FE,403,522,577,457,1034
82,82063,820632404,La Capital,SANTA FE,236,315,315,201,516
82,82063,820632308,La Capital,SANTA FE,372,501,519,378,897
82,82063,820632302,La Capital,SANTA FE,314,399,434,340,774
82,82063,820632209,La Capital,SANTA FE,273,377,308,216,524
82,82063,820632201,La Capital,SANTA FE,221,310,287,221,508
82,82063,820632108,La Capital,SANTA FE,258,331,375,290,665
82,82063,820632101,La Capital,SANTA FE,328,403,410,289,699
82,82063,820632002,La Capital,SANTA FE,121,147,179,162,341
82,82063,820630107,La Capital,SANTA FE,299,329,436,452,888
82,82063,820631902,La Capital,SANTA FE,253,283,401,312,713
82,82063,820631714,La Capital,SANTA FE,340,364,460,336,796
82,82063,820631704,La Capital,SANTA FE,173,211,236,229,465
82,82063,820631509,La Capital,SANTA FE,266,324,400,329,729
82,82063,820631507,La Capital,SANTA FE,285,330,436,398,834
82,82063,820631408,La Capital,SANTA FE,312,340,451,369,820
82,82063,820631314,La Capital,SANTA FE,282,294,416,361,777
82,82063,820631206,La Capital,SANTA FE,161,115,276,283,559
82,82063,820631212,La Capital,SANTA FE,302,338,481,361,842
82,82063,820630227,La Capital,SANTA FE,84,121,163,141,304
82,82063,820630115,La Capital,SANTA FE,51,59,80,71,151
82,82063,820630113,La Capital,SANTA FE,41,72,76,81,157
82,82063,820630112,La Capital,SANTA FE,89,180,119,144,263
82,82063,820630111,La Capital,SANTA FE,164,188,249,317,566
82,82084,820848408,Rosario,SANTA FE,317,316,548,476,1024
82,82084,820840508,Rosario,SANTA FE,312,361,458,406,864
82,82084,820842807,Rosario,SANTA FE,365,547,443,345,788
82,82084,820840410,Rosario,SANTA FE,246,275,359,332,691
82,82084,820840407,Rosario,SANTA FE,214,242,317,308,625
82,82084,820840309,Rosario,SANTA FE,297,312,554,539,1093
82,82084,820840306,Rosario,SANTA FE,480,432,857,773,1630
82,82084,820840304,Rosario,SANTA FE,346,295,619,606,1225
82,82084,820841811,Rosario,SANTA FE,341,482,475,346,821
82,82084,820840214,Rosario,SANTA FE,435,445,726,754,1480
82,82084,820840420,Rosario,SANTA FE,355,379,634,541,1175
82,82084,820843107,Rosario,SANTA FE,192,214,292,260,552
82,82084,820843012,Rosario,SANTA FE,277,275,486,488,974
82,82084,820843010,Rosario,SANTA FE,368,352,658,580,1238
82,82084,820843009,Rosario,SANTA FE,367,360,600,606,1206
82,82084,820843005,Rosario,SANTA FE,319,317,504,454,958
82,82084,820843003,Rosario,SANTA FE,613,622,944,946,1890
82,82084,820840414,Rosario,SANTA FE,279,289,416,338,754
82,82084,820840413,Rosario,SANTA FE,333,362,640,578,1218
82,82084,820845921,Rosario,SANTA FE,494,364,872,904,1776
82,82084,820843119,Rosario,SANTA FE,267,281,419,341,760
82,82084,820845410,Rosario,SANTA FE,165,153,258,267,525
82,82084,820843118,Rosario,SANTA FE,271,306,415,348,763
82,82084,820843116,Rosario,SANTA FE,328,352,495,414,909
82,82084,820845103,Rosario,SANTA FE,310,366,461,399,860
82,82084,820842712,Rosario,SANTA FE,353,609,455,333,788
82,82084,820842711,Rosario,SANTA FE,226,382,249,211,460
82,82084,820842710,Rosario,SANTA FE,265,393,332,260,592
82,82084,820842922,Rosario,SANTA FE,151,216,208,170,378
82,82084,820842921,Rosario,SANTA FE,160,255,181,153,334
82,82084,820842915,Rosario,SANTA FE,315,438,339,348,687
82,82084,820842706,Rosario,SANTA FE,151,218,235,144,379
82,82084,820842701,Rosario,SANTA FE,311,509,486,423,909
82,82084,820842604,Rosario,SANTA FE,334,468,418,312,730
82,82084,820842514,Rosario,SANTA FE,86,190,85,69,154
82,82084,820842508,Rosario,SANTA FE,337,486,374,303,677
82,82084,820842501,Rosario,SANTA FE,244,348,325,238,563
82,82084,820842902,Rosario,SANTA FE,359,532,393,298,691
82,82084,820846801,Rosario,SANTA FE,202,250,308,362,670
82,82084,820840301,Rosario,SANTA FE,136,104,212,272,484
82,82084,820846109,Rosario,SANTA FE,474,442,922,854,1776
82,82084,820846107,Rosario,SANTA FE,420,361,748,752,1500
82,82084,820846105,Rosario,SANTA FE,247,266,377,363,740
82,82084,820848908,Rosario,SANTA FE,155,157,266,327,593
82,82084,820848508,Rosario,SANTA FE,274,294,420,381,801
82,82084,820848501,Rosario,SANTA FE,551,507,1092,1173,2265
82,82084,820848415,Rosario,SANTA FE,260,293,435,463,898
82,82084,820848209,Rosario,SANTA FE,579,479,1103,1073,2176
82,82084,820848208,Rosario,SANTA FE,468,454,835,822,1657
82,82084,820848204,Rosario,SANTA FE,371,367,817,717,1534
82,82084,820848011,Rosario,SANTA FE,176,225,260,219,479
82,82084,820847504,Rosario,SANTA FE,154,162,238,226,464
82,82084,820846404,Rosario,SANTA FE,390,412,613,582,1195
82,82084,820845309,Rosario,SANTA FE,358,358,634,628,1262
82,82084,820845308,Rosario,SANTA FE,444,451,745,694,1439
82,82084,820845301,Rosario,SANTA FE,256,282,365,311,676
82,82084,820845214,Rosario,SANTA FE,451,406,778,738,1516
82,82084,820843307,Rosario,SANTA FE,314,260,522,484,1006
82,82084,820840421,Rosario,SANTA FE,542,436,874,926,1800
82,82084,820845312,Rosario,SANTA FE,314,327,479,399,878
82,82084,820848015,Rosario,SANTA FE,250,310,344,282,626
82,82084,820844711,Rosario,SANTA FE,223,164,376,346,722
82,82084,820842311,Rosario,SANTA FE,405,601,431,344,775
82,82084,820844524,Rosario,SANTA FE,293,325,468,367,835
82,82084,820844523,Rosario,SANTA FE,360,403,577,494,1071
82,82084,820844520,Rosario,SANTA FE,276,283,488,478,966
82,82084,820844518,Rosario,SANTA FE,371,388,597,568,1165
82,82084,820844509,Rosario,SANTA FE,353,364,533,509,1042
82,82084,820844505,Rosario,SANTA FE,209,207,330,277,607
82,82084,820844703,Rosario,SANTA FE,288,251,499,566,1065
82,82084,820844701,Rosario,SANTA FE,295,208,529,533,1062
82,82084,820841909,Rosario,SANTA FE,354,595,480,368,848
82,82084,820844610,Rosario,SANTA FE,314,317,516,531,1047
82,82084,820844415,Rosario,SANTA FE,263,302,398,350,748
82,82084,820844413,Rosario,SANTA FE,316,370,443,366,809
82,82084,820846215,Rosario,SANTA FE,253,273,399,354,753
82,82084,820844406,Rosario,SANTA FE,228,307,437,309,746
82,82084,820844404,Rosario,SANTA FE,268,281,513,504,1017
82,82084,820844208,Rosario,SANTA FE,297,195,557,546,1103
82,82084,820844109,Rosario,SANTA FE,342,333,588,538,1126
82,82084,820844108,Rosario,SANTA FE,336,385,550,478,1028
82,82084,820844105,Rosario,SANTA FE,0,1,0,0,0
82,82084,820843804,Rosario,SANTA FE,358,499,462,390,852
82,82084,820843704,Rosario,SANTA FE,195,330,314,263,577
82,82084,820843701,Rosario,SANTA FE,364,455,476,373,849
82,82084,820842310,Rosario,SANTA FE,222,377,244,175,419
82,82084,820847602,Rosario,SANTA FE,81,131,132,121,253
82,82084,820846307,Rosario,SANTA FE,346,334,659,544,1203
82,82084,820842810,Rosario,SANTA FE,386,530,491,390,881
82,82084,820843916,Rosario,SANTA FE,162,220,183,167,350
82,82084,820843910,Rosario,SANTA FE,177,242,230,194,424
82,82084,820843905,Rosario,SANTA FE,410,563,494,430,924
82,82084,820843902,Rosario,SANTA FE,213,268,292,232,524
82,82084,820843006,Rosario,SANTA FE,248,226,452,413,865
82,82084,820843120,Rosario,SANTA FE,233,255,369,352,721
82,82084,820845516,Rosario,SANTA FE,272,260,480,479,959
82,82084,820845515,Rosario,SANTA FE,227,206,478,458,936
82,82084,820842104,Rosario,SANTA FE,367,504,454,360,814
82,82084,820842919,Rosario,SANTA FE,240,344,325,306,631
82,82084,820842917,Rosario,SANTA FE,251,345,331,515,846
82,82084,820842013,Rosario,SANTA FE,307,403,333,302,635
82,82084,820842012,Rosario,SANTA FE,217,345,326,246,572
82,82084,820842511,Rosario,SANTA FE,258,293,322,245,567
82,82084,820842509,Rosario,SANTA FE,266,305,403,307,710
82,82084,820842507,Rosario,SANTA FE,263,318,324,244,568
82,82084,820842505,Rosario,SANTA FE,244,474,300,222,522
82,82084,820842502,Rosario,SANTA FE,230,356,295,178,473
82,82084,820842806,Rosario,SANTA FE,29,42,37,23,60
82,82084,820842804,Rosario,SANTA FE,251,390,311,224,535
82,82084,820842716,Rosario,SANTA FE,257,399,332,256,588
82,82084,820842201,Rosario,SANTA FE,249,396,295,225,520
82,82084,820841809,Rosario,SANTA FE,264,310,330,241,571
82,82084,820841807,Rosario,SANTA FE,437,675,500,399,899
82,82084,820841411,Rosario,SANTA FE,165,177,261,233,494
82,82084,820842009,Rosario,SANTA FE,295,445,358,263,621
82,82084,820841603,Rosario,SANTA FE,377,480,503,409,912
82,82084,820841508,Rosario,SANTA FE,245,263,411,326,737
82,82084,820842003,Rosario,SANTA FE,350,501,449,307,756
82,82084,820841715,Rosario,SANTA FE,375,575,423,352,775
82,82084,820841301,Rosario,SANTA FE,315,354,491,436,927
82,82084,820841221,Rosario,SANTA FE,342,348,642,603,1245
82,82084,820843508,Rosario,SANTA FE,244,149,390,402,792
82,82084,820843504,Rosario,SANTA FE,329,373,532,445,977
82,82084,820841118,Rosario,SANTA FE,325,367,499,440,939
82,82084,820843417,Rosario,SANTA FE,255,299,386,335,721
82,82084,820843416,Rosario,SANTA FE,418,408,761,720,1481
82,82084,820843410,Rosario,SANTA FE,304,371,432,406,838
82,82084,820843408,Rosario,SANTA FE,392,413,587,484,1071
82,82084,820843407,Rosario,SANTA FE,330,387,452,403,855
82,82084,820841110,Rosario,SANTA FE,495,531,854,840,1694
82,82084,820845202,Rosario,SANTA FE,310,299,582,526,1108
82,82084,820845112,Rosario,SANTA FE,262,301,414,365,779
82,82084,820845110,Rosario,SANTA FE,274,304,405,352,757
82,82084,820845001,Rosario,SANTA FE,311,351,484,448,932
82,82084,820844911,Rosario,SANTA FE,746,480,1276,1453,2729
82,82084,820844908,Rosario,SANTA FE,579,558,1140,1110,2250
82,82084,820843404,Rosario,SANTA FE,384,281,747,704,1451
82,82084,820845104,Rosario,SANTA FE,309,332,481,388,869
82,82084,820845111,Rosario,SANTA FE,356,357,522,437,959
82,82084,820844815,Rosario,SANTA FE,264,267,423,386,809
82,82084,820844810,Rosario,SANTA FE,315,321,578,542,1120
82,82084,820848816,Rosario,SANTA FE,388,389,666,642,1308
82,82084,820842407,Rosario,SANTA FE,273,395,298,293,591
82,82084,820848806,Rosario,SANTA FE,409,278,742,771,1513
82,82084,820845912,Rosario,SANTA FE,394,444,609,510,1119
82,82084,820845805,Rosario,SANTA FE,476,549,731,756,1487
82,82084,820845803,Rosario,SANTA FE,380,450,568,541,1109
82,82084,820842617,Rosario,SANTA FE,194,274,240,183,423
82,82084,820842615,Rosario,SANTA FE,299,404,303,264,567
82,82084,820848608,Rosario,SANTA FE,309,280,579,493,1072
82,82084,820848602,Rosario,SANTA FE,461,484,722,652,1374
82,82084,820840602,Rosario,SANTA FE,347,368,507,398,905
82,82084,820842410,Rosario,SANTA FE,189,232,234,199,433
82,82084,820842402,Rosario,SANTA FE,275,365,337,261,598
82,82084,820842401,Rosario,SANTA FE,195,320,218,185,403
82,82084,820842323,Rosario,SANTA FE,225,314,289,242,531
82,82084,820840412,Rosario,SANTA FE,309,318,543,456,999
82,82084,820840308,Rosario,SANTA FE,479,482,810,852,1662
82,82084,820840505,Rosario,SANTA FE,662,531,985,796,1781
82,82084,820841705,Rosario,SANTA FE,226,283,312,290,602
82,82084,820841916,Rosario,SANTA FE,197,318,272,185,457
82,82084,820848301,Rosario,SANTA FE,352,393,531,505,1036
82,82084,820848305,Rosario,SANTA FE,320,370,470,398,868
82,82084,820840903,Rosario,SANTA FE,226,259,332,278,610
82,82084,820840807,Rosario,SANTA FE,359,370,513,535,1048
82,82084,820840724,Rosario,SANTA FE,266,251,500,463,963
82,82084,820848211,Rosario,SANTA FE,411,403,761,727,1488
82,82084,820840710,Rosario,SANTA FE,215,243,329,285,614
82,82084,820840702,Rosario,SANTA FE,330,322,567,576,1143
82,82084,820840623,Rosario,SANTA FE,322,282,651,609,1260
82,82084,820840612,Rosario,SANTA FE,372,411,549,497,1046
82,82084,820848112,Rosario,SANTA FE,301,339,436,362,798
82,82084,820848107,Rosario,SANTA FE,260,294,367,356,723
82,82084,820848102,Rosario,SANTA FE,249,293,357,307,664
82,82084,820848019,Rosario,SANTA FE,267,323,362,312,674
82,82084,820847803,Rosario,SANTA FE,284,307,449,425,874
82,82084,820845710,Rosario,SANTA FE,408,698,649,615,1264
82,82084,820845701,Rosario,SANTA FE,64,93,88,98,186
82,82084,820845509,Rosario,SANTA FE,279,299,457,411,868
82,82084,820845408,Rosario,SANTA FE,300,313,479,486,965
82,82084,820845407,Rosario,SANTA FE,192,204,330,322,652
82,82084,820845319,Rosario,SANTA FE,292,227,443,407,850
82,82084,820845313,Rosario,SANTA FE,174,184,284,238,522
82,82084,820845213,Rosario,SANTA FE,337,314,602,568,1170
82,82084,820841107,Rosario,SANTA FE,475,497,844,785,1629
82,82084,820841016,Rosario,SANTA FE,160,174,229,235,464
82,82084,820847719,Rosario,SANTA FE,328,349,548,469,1017
82,82084,820846302,Rosario,SANTA FE,416,405,822,774,1596
82,82084,820849010,Rosario,SANTA FE,313,452,506,487,993
82,82084,820846208,Rosario,SANTA FE,399,373,663,583,1246
82,82084,820846206,Rosario,SANTA FE,422,385,757,798,1555
82,82084,820846218,Rosario,SANTA FE,499,461,905,859,1764
82,82084,820847707,Rosario,SANTA FE,4,24,4,8,12
82,82084,820847502,Rosario,SANTA FE,12,21,15,22,37
82,82084,820845804,Rosario,SANTA FE,31,27,45,49,94
82,82084,820840213,Rosario,SANTA FE,14,22,21,25,46
82,82084,820849501,Rosario,SANTA FE,3,7,4,5,9
82,82084,820847201,Rosario,SANTA FE,48,62,85,89,174
82,82084,820846901,Rosario,SANTA FE,64,86,99,102,201
82,82084,820846504,Rosario,SANTA FE,244,552,367,366,733
82,82084,820840201,Rosario,SANTA FE,223,150,377,429,806
82,82084,820849002,Rosario,SANTA FE,523,556,964,985,1949
82,82084,820848909,Rosario,SANTA FE,432,390,825,760,1585
82,82084,820848503,Rosario,SANTA FE,317,267,568,595,1163
82,82084,820848416,Rosario,SANTA FE,78,78,135,180,315
82,82084,820848006,Rosario,SANTA FE,214,272,310,270,580
82,82084,820848002,Rosario,SANTA FE,361,504,473,453,926
82,82084,820848014,Rosario,SANTA FE,249,341,362,305,667
82,82084,820847714,Rosario,SANTA FE,234,246,328,303,631
82,82084,820847503,Rosario,SANTA FE,135,152,203,189,392
82,82084,820847204,Rosario,SANTA FE,199,226,306,270,576
82,82084,820846503,Rosario,SANTA FE,576,581,1002,934,1936
82,82084,820848013,Rosario,SANTA FE,315,387,425,361,786
82,82084,820846904,Rosario,SANTA FE,585,638,1076,1059,2135
82,82084,820845311,Rosario,SANTA FE,223,245,327,284,611
82,82084,820843605,Rosario,SANTA FE,164,209,243,211,454
82,82084,820840208,Rosario,SANTA FE,454,535,786,706,1492
82,82084,820840501,Rosario,SANTA FE,420,311,666,538,1204
82,82084,820840205,Rosario,SANTA FE,265,296,446,441,887
82,82084,820842702,Rosario,SANTA FE,277,429,340,231,571
82,82084,820845207,Rosario,SANTA FE,444,456,834,830,1664
82,82084,820845206,Rosario,SANTA FE,371,368,725,728,1453
82,82084,820844805,Rosario,SANTA FE,280,193,509,473,982
82,82084,820844802,Rosario,SANTA FE,392,292,737,619,1356
82,82084,820844801,Rosario,SANTA FE,539,558,954,906,1860
82,82084,820844715,Rosario,SANTA FE,255,225,441,452,893
82,82084,820844710,Rosario,SANTA FE,428,292,777,710,1487
82,82084,820844521,Rosario,SANTA FE,191,204,302,284,586
82,82084,820844508,Rosario,SANTA FE,241,245,368,324,692
82,82084,820841818,Rosario,SANTA FE,280,421,456,339,795
82,82084,820844501,Rosario,SANTA FE,263,260,442,345,787
82,82084,820844306,Rosario,SANTA FE,256,278,352,308,660
82,82084,820844207,Rosario,SANTA FE,374,254,687,654,1341
82,82084,820844112,Rosario,SANTA FE,295,310,534,493,1027
82,82084,820844103,Rosario,SANTA FE,263,202,410,373,783
82,82084,820844101,Rosario,SANTA FE,295,354,432,386,818
82,82084,820844010,Rosario,SANTA FE,301,378,403,367,770
82,82084,820844005,Rosario,SANTA FE,381,290,733,703,1436
82,82084,820844002,Rosario,SANTA FE,323,459,383,313,696
82,82084,820843806,Rosario,SANTA FE,298,397,393,336,729
82,82084,820843711,Rosario,SANTA FE,242,320,289,229,518
82,82084,820843706,Rosario,SANTA FE,352,497,440,318,758
82,82084,820843204,Rosario,SANTA FE,327,367,517,443,960
82,82084,820847402,Rosario,SANTA FE,267,285,396,400,796
82,82084,820846704,Rosario,SANTA FE,273,319,428,407,835
82,82084,820842307,Rosario,SANTA FE,319,442,381,286,667
82,82084,820844803,Rosario,SANTA FE,363,373,580,511,1091
82,82084,820843115,Rosario,SANTA FE,257,289,388,326,714
82,82084,820842102,Rosario,SANTA FE,303,425,420,363,783
82,82084,820844015,Rosario,SANTA FE,224,282,338,257,595
82,82084,820843913,Rosario,SANTA FE,310,382,428,363,791
82,82084,820842814,Rosario,SANTA FE,160,238,193,142,335
82,82084,820843912,Rosario,SANTA FE,357,482,480,410,890
82,82084,820843812,Rosario,SANTA FE,243,208,371,389,760
82,82084,820842920,Rosario,SANTA FE,222,309,295,246,541
82,82084,820843007,Rosario,SANTA FE,438,441,790,767,1557
82,82084,820841307,Rosario,SANTA FE,196,164,360,334,694
82,82084,820840601,Rosario,SANTA FE,245,242,370,300,670
82,82084,820842017,Rosario,SANTA FE,118,194,144,122,266
82,82084,820840211,Rosario,SANTA FE,309,285,601,562,1163
82,82084,820842912,Rosario,SANTA FE,269,424,429,292,721
82,82084,820842908,Rosario,SANTA FE,305,429,403,329,732
82,82084,820842907,Rosario,SANTA FE,303,452,372,310,682
82,82084,820842609,Rosario,SANTA FE,146,222,170,119,289
82,82084,820842602,Rosario,SANTA FE,220,296,372,257,629
82,82084,820842516,Rosario,SANTA FE,78,110,135,94,229
82,82084,820842506,Rosario,SANTA FE,343,420,409,289,698
82,82084,820842504,Rosario,SANTA FE,172,259,265,242,507
82,82084,820842008,Rosario,SANTA FE,227,339,236,148,384
82,82084,820842015,Rosario,SANTA FE,128,176,168,118,286
82,82084,820842905,Rosario,SANTA FE,379,510,455,348,803
82,82084,820842821,Rosario,SANTA FE,206,345,254,184,438
82,82084,820842803,Rosario,SANTA FE,187,324,211,141,352
82,82084,820842714,Rosario,SANTA FE,231,347,308,271,579
82,82084,820842202,Rosario,SANTA FE,260,399,285,197,482
82,82084,820842115,Rosario,SANTA FE,197,296,231,164,395
82,82084,820842112,Rosario,SANTA FE,149,225,166,127,293
82,82084,820842207,Rosario,SANTA FE,334,429,416,311,727
82,82084,820841408,Rosario,SANTA FE,306,328,479,410,889
82,82084,820841205,Rosario,SANTA FE,308,323,520,499,1019
82,82084,820841114,Rosario,SANTA FE,339,238,565,588,1153
82,82084,820843612,Rosario,SANTA FE,626,663,1007,825,1832
82,82084,820843502,Rosario,SANTA FE,151,136,229,205,434
82,82084,820841204,Rosario,SANTA FE,381,339,746,739,1485
82,82084,820841201,Rosario,SANTA FE,433,386,713,697,1410
82,82084,820843415,Rosario,SANTA FE,316,247,515,490,1005
82,82084,820843413,Rosario,SANTA FE,174,217,260,247,507
82,82084,820843401,Rosario,SANTA FE,306,121,533,483,1016
82,82084,820841923,Rosario,SANTA FE,157,217,176,140,316
82,82084,820843606,Rosario,SANTA FE,163,229,217,174,391
82,82084,820843317,Rosario,SANTA FE,423,367,736,747,1483
82,82084,820845004,Rosario,SANTA FE,388,400,660,602,1262
82,82084,820844915,Rosario,SANTA FE,306,280,548,568,1116
82,82084,820843402,Rosario,SANTA FE,381,367,722,689,1411
82,82084,820844906,Rosario,SANTA FE,204,180,354,321,675
82,82084,820845108,Rosario,SANTA FE,380,355,580,517,1097
82,82084,820845101,Rosario,SANTA FE,380,403,571,545,1116
82,82084,820844806,Rosario,SANTA FE,269,243,560,806,1366
82,82084,820848815,Rosario,SANTA FE,262,268,506,469,975
82,82084,820848814,Rosario,SANTA FE,269,326,381,416,797
82,82084,820848804,Rosario,SANTA FE,304,358,468,405,873
82,82084,820842313,Rosario,SANTA FE,322,468,390,312,702
82,82084,820848801,Rosario,SANTA FE,394,231,739,739,1478
82,82084,820848712,Rosario,SANTA FE,246,254,412,394,806
82,82084,820845911,Rosario,SANTA FE,410,354,677,757,1434
82,82084,820845802,Rosario,SANTA FE,453,553,655,649,1304
82,82084,820848704,Rosario,SANTA FE,395,472,587,447,1034
82,82084,820848811,Rosario,SANTA FE,467,510,717,681,1398
82,82084,820848606,Rosario,SANTA FE,484,504,862,803,1665
82,82084,820848603,Rosario,SANTA FE,335,358,561,535,1096
82,82084,820842404,Rosario,SANTA FE,320,447,428,276,704
82,82084,820842612,Rosario,SANTA FE,173,313,181,133,314
82,82084,820842409,Rosario,SANTA FE,330,525,364,326,690
82,82084,820848510,Rosario,SANTA FE,421,456,749,753,1502
82,82084,820848410,Rosario,SANTA FE,557,524,976,914,1890
82,82084,820840517,Rosario,SANTA FE,355,400,537,437,974
82,82084,820840512,Rosario,SANTA FE,181,213,276,237,513
82,82084,820840418,Rosario,SANTA FE,136,155,220,197,417
82,82084,820841812,Rosario,SANTA FE,226,309,262,213,475
82,82084,820840502,Rosario,SANTA FE,876,787,1368,1146,2514
82,82084,820848306,Rosario,SANTA FE,294,331,456,382,838
82,82084,820848307,Rosario,SANTA FE,290,317,420,380,800
82,82084,820840906,Rosario,SANTA FE,284,316,427,360,787
82,82084,820840905,Rosario,SANTA FE,327,398,457,395,852
82,82084,820840911,Rosario,SANTA FE,207,233,270,272,542
82,82084,820842318,Rosario,SANTA FE,234,308,278,206,484
82,82084,820840723,Rosario,SANTA FE,289,295,491,453,944
82,82084,820840718,Rosario,SANTA FE,382,406,599,599,1198
82,82084,820840709,Rosario,SANTA FE,525,538,847,760,1607
82,82084,820848109,Rosario,SANTA FE,329,363,505,412,917
82,82084,820848022,Rosario,SANTA FE,340,518,347,302,649
82,82084,820845702,Rosario,SANTA FE,273,449,418,405,823
82,82084,820845706,Rosario,SANTA FE,112,181,171,177,348
82,82084,820845705,Rosario,SANTA FE,334,409,547,442,989
82,82084,820845505,Rosario,SANTA FE,420,449,620,537,1157
82,82084,820845413,Rosario,SANTA FE,197,220,332,266,598
82,82084,820845412,Rosario,SANTA FE,329,380,498,486,984
82,82084,820845411,Rosario,SANTA FE,356,384,592,487,1079
82,82084,820845320,Rosario,SANTA FE,209,223,344,314,658
82,82084,820841102,Rosario,SANTA FE,195,223,313,274,587
82,82084,820841017,Rosario,SANTA FE,425,379,695,632,1327
82,82084,820841816,Rosario,SANTA FE,153,228,181,154,335
82,82084,820841011,Rosario,SANTA FE,572,393,1041,1028,2069
82,82084,820841010,Rosario,SANTA FE,470,390,892,827,1719
82,82084,820841008,Rosario,SANTA FE,479,425,764,750,1514
82,82084,820847720,Rosario,SANTA FE,377,384,599,512,1111
82,82084,820849012,Rosario,SANTA FE,325,468,503,485,988
82,82084,820846311,Rosario,SANTA FE,565,508,1134,1089,2223
82,82084,820846212,Rosario,SANTA FE,323,271,608,564,1172
82,82084,820846204,Rosario,SANTA FE,280,243,491,458,949
82,82084,820846203,Rosario,SANTA FE,192,186,350,328,678
82,82084,820847001,Rosario,SANTA FE,16,66,15,19,34
82,82084,820846702,Rosario,SANTA FE,17,23,28,29,57
82,82084,820840101,Rosario,SANTA FE,186,284,292,345,637
82,82084,820847601,Rosario,SANTA FE,29,46,31,40,71
82,82084,820847902,Rosario,SANTA FE,43,59,107,97,204
82,82084,820846402,Rosario,SANTA FE,307,377,461,522,983
82,82084,820846401,Rosario,SANTA FE,142,207,226,221,447
82,82084,820847302,Rosario,SANTA FE,108,149,156,202,358
82,82084,820842315,Rosario,SANTA FE,238,302,306,229,535
82,82084,820846114,Rosario,SANTA FE,354,253,705,716,1421
82,82084,820846111,Rosario,SANTA FE,425,444,708,609,1317
82,82084,820846110,Rosario,SANTA FE,420,424,695,633,1328
82,82084,820847704,Rosario,SANTA FE,228,338,405,445,850
82,82084,820848005,Rosario,SANTA FE,277,320,381,338,719
82,82084,820848003,Rosario,SANTA FE,352,483,478,360,838
82,82084,820848001,Rosario,SANTA FE,382,445,510,420,930
82,82084,820847102,Rosario,SANTA FE,94,118,150,138,288
82,82084,820846505,Rosario,SANTA FE,638,1093,1012,945,1957
82,82084,820846906,Rosario,SANTA FE,357,378,561,534,1095
82,82084,820846313,Rosario,SANTA FE,412,429,862,878,1740
82,82084,820845907,Rosario,SANTA FE,571,529,1092,1207,2299
82,82084,820845603,Rosario,SANTA FE,23,9,21,46,67
82,82084,820845518,Rosario,SANTA FE,303,266,574,613,1187
82,82084,820845513,Rosario,SANTA FE,445,426,835,815,1650
82,82084,820845306,Rosario,SANTA FE,386,406,620,504,1124
82,82084,820843306,Rosario,SANTA FE,359,361,586,579,1165
82,82084,820841922,Rosario,SANTA FE,93,123,117,90,207
82,82084,820847715,Rosario,SANTA FE,196,204,293,258,551
82,82084,820841911,Rosario,SANTA FE,264,363,296,242,538
82,82084,820841904,Rosario,SANTA FE,189,276,248,179,427
82,82084,820844504,Rosario,SANTA FE,294,316,434,392,826
82,82084,820841902,Rosario,SANTA FE,249,331,303,248,551
82,82084,820841901,Rosario,SANTA FE,285,399,338,282,620
82,82084,820844418,Rosario,SANTA FE,280,329,454,381,835
82,82084,820844607,Rosario,SANTA FE,438,431,705,640,1345
82,82084,820844603,Rosario,SANTA FE,323,337,489,497,986
82,82084,820844410,Rosario,SANTA FE,273,314,401,340,741
82,82084,820844409,Rosario,SANTA FE,282,341,437,385,822
82,82084,820844310,Rosario,SANTA FE,236,307,348,304,652
82,82084,820842816,Rosario,SANTA FE,300,532,367,287,654
82,82084,820844304,Rosario,SANTA FE,276,344,379,345,724
82,82084,820844408,Rosario,SANTA FE,221,227,407,353,760
82,82084,820844106,Rosario,SANTA FE,299,299,467,376,843
82,82084,820844102,Rosario,SANTA FE,269,287,448,383,831
82,82084,820842815,Rosario,SANTA FE,295,465,370,280,650
82,82084,820844011,Rosario,SANTA FE,119,129,184,176,360
82,82084,820844008,Rosario,SANTA FE,192,241,238,224,462
82,82084,820843808,Rosario,SANTA FE,193,200,255,229,484
82,82084,820843213,Rosario,SANTA FE,425,403,721,674,1395
82,82084,820843208,Rosario,SANTA FE,519,458,936,903,1839
82,82084,820843801,Rosario,SANTA FE,431,610,496,405,901
82,82084,820843714,Rosario,SANTA FE,312,410,432,381,813
82,82084,820848509,Rosario,SANTA FE,268,271,530,512,1042
82,82084,820843703,Rosario,SANTA FE,283,336,368,295,663
82,82084,820843203,Rosario,SANTA FE,341,364,487,477,964
82,82084,820842309,Rosario,SANTA FE,244,341,391,304,695
82,82084,820846902,Rosario,SANTA FE,346,368,549,501,1050
82,82084,820844522,Rosario,SANTA FE,244,266,367,346,713
82,82084,820844506,Rosario,SANTA FE,180,203,254,221,475
82,82084,820843901,Rosario,SANTA FE,175,228,267,199,466
82,82084,820843102,Rosario,SANTA FE,303,329,456,395,851
82,82084,820843011,Rosario,SANTA FE,250,261,430,353,783
82,82084,820843004,Rosario,SANTA FE,423,436,641,619,1260
82,82084,820840609,Rosario,SANTA FE,270,288,399,347,746
82,82084,820840415,Rosario,SANTA FE,236,268,363,292,655
82,82084,820842911,Rosario,SANTA FE,368,522,466,384,850
82,82084,820842910,Rosario,SANTA FE,372,531,423,378,801
82,82084,820842909,Rosario,SANTA FE,221,334,275,230,505
82,82084,820843117,Rosario,SANTA FE,283,324,396,340,736
82,82084,820842014,Rosario,SANTA FE,246,330,303,225,528
82,82084,820842918,Rosario,SANTA FE,298,368,402,323,725
82,82084,820842704,Rosario,SANTA FE,184,268,214,151,365
82,82084,820842703,Rosario,SANTA FE,176,259,255,170,425
82,82084,820842608,Rosario,SANTA FE,293,412,327,228,555
82,82084,820842605,Rosario,SANTA FE,200,347,218,166,384
82,82084,820842512,Rosario,SANTA FE,557,593,641,484,1125
82,82084,820842503,Rosario,SANTA FE,191,377,215,185,400
82,82084,820842822,Rosario,SANTA FE,205,322,218,187,405
82,82084,820842722,Rosario,SANTA FE,186,279,236,167,403
82,82084,820842719,Rosario,SANTA FE,202,281,243,188,431
82,82084,820842117,Rosario,SANTA FE,201,327,208,121,329
82,82084,820842004,Rosario,SANTA FE,212,295,229,182,411
82,82084,820841806,Rosario,SANTA FE,232,301,301,227,528
82,82084,820841805,Rosario,SANTA FE,295,406,335,241,576
82,82084,820841802,Rosario,SANTA FE,161,237,186,159,345
82,82084,820841914,Rosario,SANTA FE,174,292,220,142,362
82,82084,820842419,Rosario,SANTA FE,217,315,260,196,456
82,82084,820842418,Rosario,SANTA FE,249,363,262,225,487
82,82084,820841701,Rosario,SANTA FE,165,224,227,209,436
82,82084,820841605,Rosario,SANTA FE,353,423,489,411,900
82,82084,820841509,Rosario,SANTA FE,236,315,389,424,813
82,82084,820841506,Rosario,SANTA FE,261,341,403,337,740
82,82084,820841504,Rosario,SANTA FE,268,306,411,375,786
82,82084,820841312,Rosario,SANTA FE,246,280,342,300,642
82,82084,820841406,Rosario,SANTA FE,342,373,513,446,959
82,82084,820841211,Rosario,SANTA FE,315,279,694,707,1401
82,82084,820841304,Rosario,SANTA FE,589,575,989,1000,1989
82,82084,820841209,Rosario,SANTA FE,313,288,631,656,1287
82,82084,820841208,Rosario,SANTA FE,232,246,378,356,734
82,82084,820841303,Rosario,SANTA FE,420,338,794,731,1525
82,82084,820841220,Rosario,SANTA FE,261,219,485,513,998
82,82084,820841202,Rosario,SANTA FE,305,263,578,600,1178
82,82084,820843412,Rosario,SANTA FE,219,238,353,306,659
82,82084,820843411,Rosario,SANTA FE,188,216,287,242,529
82,82084,820843318,Rosario,SANTA FE,346,351,597,604,1201
82,82084,820841113,Rosario,SANTA FE,181,172,339,298,637
82,82084,820841913,Rosario,SANTA FE,162,243,177,143,320
82,82084,820843516,Rosario,SANTA FE,316,277,549,578,1127
82,82084,820843514,Rosario,SANTA FE,382,318,668,613,1281
82,82084,820845114,Rosario,SANTA FE,230,140,437,419,856
82,82084,820844904,Rosario,SANTA FE,340,345,598,553,1151
82,82084,820844822,Rosario,SANTA FE,408,405,758,789,1547
82,82084,820844820,Rosario,SANTA FE,333,325,643,586,1229
82,82084,820845107,Rosario,SANTA FE,361,293,634,585,1219
82,82084,820841817,Rosario,SANTA FE,198,273,231,155,386
82,82084,820845211,Rosario,SANTA FE,441,377,815,793,1608
82,82084,820845917,Rosario,SANTA FE,535,575,951,892,1843
82,82084,820848715,Rosario,SANTA FE,208,214,347,316,663
82,82084,820848714,Rosario,SANTA FE,238,244,396,351,747
82,82084,820845915,Rosario,SANTA FE,179,208,276,241,517
82,82084,820848607,Rosario,SANTA FE,538,457,1007,951,1958
82,82084,820848512,Rosario,SANTA FE,423,425,709,739,1448
82,82084,820848809,Rosario,SANTA FE,266,297,433,413,846
82,82084,820848511,Rosario,SANTA FE,276,302,454,447,901
82,82084,820848411,Rosario,SANTA FE,477,512,890,807,1697
82,82084,820840518,Rosario,SANTA FE,413,445,605,560,1165
82,82084,820840515,Rosario,SANTA FE,214,260,328,299,627
82,82084,820848405,Rosario,SANTA FE,270,284,429,373,802
82,82084,820840509,Rosario,SANTA FE,307,353,484,422,906
82,82084,820840409,Rosario,SANTA FE,404,451,630,525,1155
82,82084,820840408,Rosario,SANTA FE,279,311,433,401,834
82,82084,820840310,Rosario,SANTA FE,299,207,521,489,1010
82,82084,820840303,Rosario,SANTA FE,332,305,581,557,1138
82,82084,820840503,Rosario,SANTA FE,397,386,575,523,1098
82,82084,820848315,Rosario,SANTA FE,297,321,466,399,865
82,82084,820848214,Rosario,SANTA FE,387,442,662,639,1301
82,82084,820840901,Rosario,SANTA FE,282,332,418,355,773
82,82084,820840910,Rosario,SANTA FE,206,224,285,240,525
82,82084,820841815,Rosario,SANTA FE,223,328,268,229,497
82,82084,820840801,Rosario,SANTA FE,255,317,364,326,690
82,82084,820840722,Rosario,SANTA FE,206,209,329,349,678
82,82084,820841919,Rosario,SANTA FE,161,220,189,143,332
82,82084,820840716,Rosario,SANTA FE,217,239,340,296,636
82,82084,820840711,Rosario,SANTA FE,261,258,367,340,707
82,82084,820840621,Rosario,SANTA FE,287,293,487,416,903
82,82084,820840617,Rosario,SANTA FE,297,281,492,486,978
82,82084,820848116,Rosario,SANTA FE,350,384,501,458,959
82,82084,820848108,Rosario,SANTA FE,233,264,365,284,649
82,82084,820848017,Rosario,SANTA FE,305,372,403,351,754
82,82084,820847804,Rosario,SANTA FE,344,368,536,514,1050
82,82084,820845712,Rosario,SANTA FE,263,387,394,381,775
82,82084,820845416,Rosario,SANTA FE,286,316,439,372,811
82,82084,820845402,Rosario,SANTA FE,242,261,369,332,701
82,82084,820845322,Rosario,SANTA FE,59,62,90,71,161
82,82084,820845315,Rosario,SANTA FE,300,337,506,462,968
82,82084,820841101,Rosario,SANTA FE,238,271,397,389,786
82,82084,820841019,Rosario,SANTA FE,1329,1396,2377,2286,4663
82,82084,820847717,Rosario,SANTA FE,243,260,389,362,751
82,82084,820846219,Rosario,SANTA FE,287,319,431,378,809
82,82084,820847805,Rosario,SANTA FE,164,207,284,323,607
82,82084,820846405,Rosario,SANTA FE,82,115,129,169,298
82,82084,820846002,Rosario,SANTA FE,147,198,230,278,508
82,82084,820845902,Rosario,SANTA FE,28,41,45,41,86
82,82084,820845714,Rosario,SANTA FE,27,40,49,41,90
82,82084,820847705,Rosario,SANTA FE,320,382,542,557,1099
82,82084,820846403,Rosario,SANTA FE,223,215,408,431,839
82,82084,820849001,Rosario,SANTA FE,188,230,322,292,614
82,82084,820846113,Rosario,SANTA FE,287,320,477,407,884
82,82084,820845924,Rosario,SANTA FE,311,349,584,530,1114
82,82084,820845923,Rosario,SANTA FE,499,418,979,986,1965
82,82084,820847702,Rosario,SANTA FE,70,105,118,128,246
82,82084,820849005,Rosario,SANTA FE,199,224,318,288,606
82,82084,820848910,Rosario,SANTA FE,555,512,1061,1035,2096
82,82084,820848905,Rosario,SANTA FE,413,398,708,703,1411
82,82084,820848502,Rosario,SANTA FE,418,397,846,833,1679
82,82084,820848414,Rosario,SANTA FE,318,316,676,706,1382
82,82084,820848203,Rosario,SANTA FE,380,376,674,720,1394
82,82084,820848202,Rosario,SANTA FE,379,390,739,685,1424
82,82084,820848010,Rosario,SANTA FE,262,254,332,268,600
82,82084,820847807,Rosario,SANTA FE,335,343,549,497,1046
82,82084,820847301,Rosario,SANTA FE,145,175,257,274,531
82,82084,820846903,Rosario,SANTA FE,358,379,571,471,1042
82,82084,820847203,Rosario,SANTA FE,359,437,597,593,1190
82,82084,820847202,Rosario,SANTA FE,470,427,695,602,1297
82,82084,820847713,Rosario,SANTA FE,390,390,618,603,1221
82,82084,820846103,Rosario,SANTA FE,260,258,472,431,903
82,82084,820846102,Rosario,SANTA FE,248,273,386,365,751
82,82084,820846004,Rosario,SANTA FE,389,459,636,602,1238
82,82084,820845522,Rosario,SANTA FE,439,408,820,800,1620
82,82084,820845521,Rosario,SANTA FE,272,258,486,440,926
82,82084,820845305,Rosario,SANTA FE,187,168,345,338,683
82,82084,820843303,Rosario,SANTA FE,487,390,869,832,1701
82,82084,820840203,Rosario,SANTA FE,368,365,688,587,1275
82,82084,820841921,Rosario,SANTA FE,155,226,175,138,313
82,82084,820841910,Rosario,SANTA FE,357,491,447,322,769
82,82084,820844705,Rosario,SANTA FE,380,337,641,608,1249
82,82084,820841907,Rosario,SANTA FE,201,268,243,185,428
82,82084,820844601,Rosario,SANTA FE,324,353,495,468,963
82,82084,820844909,Rosario,SANTA FE,376,386,660,605,1265
82,82084,820844511,Rosario,SANTA FE,367,389,553,541,1094
82,82084,820844507,Rosario,SANTA FE,261,260,394,366,760
82,82084,820844614,Rosario,SANTA FE,397,405,718,706,1424
82,82084,820844613,Rosario,SANTA FE,387,406,731,672,1403
82,82084,820844611,Rosario,SANTA FE,377,362,727,756,1483
82,82084,820844606,Rosario,SANTA FE,356,393,546,550,1096
82,82084,820844605,Rosario,SANTA FE,148,161,234,219,453
82,82084,820844411,Rosario,SANTA FE,237,275,340,263,603
82,82084,820844407,Rosario,SANTA FE,289,314,423,379,802
82,82084,820844405,Rosario,SANTA FE,200,233,288,244,532
82,82084,820844313,Rosario,SANTA FE,328,325,538,464,1002
82,82084,820844312,Rosario,SANTA FE,361,398,576,519,1095
82,82084,820844307,Rosario,SANTA FE,335,422,471,422,893
82,82084,820844214,Rosario,SANTA FE,163,91,301,242,543
82,82084,820844111,Rosario,SANTA FE,241,251,493,456,949
82,82084,820844014,Rosario,SANTA FE,341,428,463,437,900
82,82084,820844013,Rosario,SANTA FE,209,246,321,300,621
82,82084,820843918,Rosario,SANTA FE,438,420,664,594,1258
82,82084,820843209,Rosario,SANTA FE,252,251,419,393,812
82,82084,820848313,Rosario,SANTA FE,248,260,405,385,790
82,82084,820846802,Rosario,SANTA FE,185,216,329,817,1146
82,82084,820842103,Rosario,SANTA FE,296,421,334,262,596
82,82084,820843113,Rosario,SANTA FE,295,315,474,411,885
82,82084,820843112,Rosario,SANTA FE,312,340,503,388,891
82,82084,820843313,Rosario,SANTA FE,288,320,474,490,964
82,82084,820843215,Rosario,SANTA FE,305,285,535,570,1105
82,82084,820843106,Rosario,SANTA FE,305,327,457,420,877
82,82084,820843103,Rosario,SANTA FE,290,303,436,389,825
82,82084,820843101,Rosario,SANTA FE,385,410,635,513,1148
82,82084,820841006,Rosario,SANTA FE,496,235,871,924,1795
82,82084,820843002,Rosario,SANTA FE,289,297,474,430,904
82,82084,820842105,Rosario,SANTA FE,166,259,201,152,353
82,82084,820842709,Rosario,SANTA FE,116,167,181,121,302
82,82084,820842606,Rosario,SANTA FE,170,267,229,192,421
82,82084,820842603,Rosario,SANTA FE,305,474,383,250,633
82,82084,820842515,Rosario,SANTA FE,188,480,196,156,352
82,82084,820842510,Rosario,SANTA FE,159,194,197,141,338
82,82084,820842904,Rosario,SANTA FE,327,481,380,313,693
82,82084,820842901,Rosario,SANTA FE,487,720,604,466,1070
82,82084,820842817,Rosario,SANTA FE,318,575,350,275,625
82,82084,820842802,Rosario,SANTA FE,386,597,480,354,834
82,82084,820842114,Rosario,SANTA FE,317,403,416,311,727
82,82084,820841810,Rosario,SANTA FE,262,301,330,258,588
82,82084,820841501,Rosario,SANTA FE,252,274,386,339,725
82,82084,820841924,Rosario,SANTA FE,246,357,311,282,593
82,82084,820842302,Rosario,SANTA FE,224,307,266,217,483
82,82084,820842209,Rosario,SANTA FE,256,424,283,214,497
82,82084,820841718,Rosario,SANTA FE,284,449,304,230,534
82,82084,820841610,Rosario,SANTA FE,253,316,293,273,566
82,82084,820841601,Rosario,SANTA FE,319,440,400,361,761
82,82084,820841503,Rosario,SANTA FE,240,284,386,313,699
82,82084,820841502,Rosario,SANTA FE,263,304,434,379,813
82,82084,820841401,Rosario,SANTA FE,284,314,440,394,834
82,82084,820841716,Rosario,SANTA FE,174,243,231,178,409
82,82084,820841712,Rosario,SANTA FE,262,330,350,290,640
82,82084,820841210,Rosario,SANTA FE,263,244,441,502,943
82,82084,820841218,Rosario,SANTA FE,400,244,697,678,1375
82,82084,820843610,Rosario,SANTA FE,330,412,486,430,916
82,82084,820841203,Rosario,SANTA FE,332,337,552,521,1073
82,82084,820841117,Rosario,SANTA FE,349,395,524,468,992
82,82084,820843414,Rosario,SANTA FE,294,343,429,389,818
82,82084,820843406,Rosario,SANTA FE,353,401,527,399,926
82,82084,820843319,Rosario,SANTA FE,293,276,514,489,1003
82,82084,820843609,Rosario,SANTA FE,311,364,482,438,920
82,82084,820843604,Rosario,SANTA FE,287,318,429,393,822
82,82084,820843603,Rosario,SANTA FE,227,255,388,325,713
82,82084,820843315,Rosario,SANTA FE,500,472,992,982,1974
82,82084,820845002,Rosario,SANTA FE,361,359,572,536,1108
82,82084,820844905,Rosario,SANTA FE,271,261,470,483,953
82,82084,820844903,Rosario,SANTA FE,281,265,570,561,1131
82,82084,820845109,Rosario,SANTA FE,317,312,489,461,950
82,82084,820845102,Rosario,SANTA FE,313,339,479,444,923
82,82084,820845013,Rosario,SANTA FE,336,374,537,492,1029
82,82084,820844817,Rosario,SANTA FE,430,421,765,748,1513
82,82084,820846101,Rosario,SANTA FE,206,221,369,359,728
82,82084,820848901,Rosario,SANTA FE,262,278,418,393,811
82,82084,820848802,Rosario,SANTA FE,342,252,637,604,1241
82,82084,820848713,Rosario,SANTA FE,297,296,495,443,938
82,82084,820845916,Rosario,SANTA FE,186,228,301,209,510
82,82084,820848610,Rosario,SANTA FE,670,428,1268,1203,2471
82,82084,820848605,Rosario,SANTA FE,403,424,675,665,1340
82,82084,820848514,Rosario,SANTA FE,409,361,795,825,1620
82,82084,820848513,Rosario,SANTA FE,355,251,669,653,1322
82,82084,820842412,Rosario,SANTA FE,303,413,373,286,659
82,82084,820840607,Rosario,SANTA FE,265,293,402,321,723
82,82084,820842413,Rosario,SANTA FE,318,434,427,328,755
82,82084,820840606,Rosario,SANTA FE,374,362,658,620,1278
82,82084,820840519,Rosario,SANTA FE,382,432,564,480,1044
82,82084,820840514,Rosario,SANTA FE,354,394,534,453,987
82,82084,820840419,Rosario,SANTA FE,72,80,100,94,194
82,82084,820840417,Rosario,SANTA FE,94,109,137,132,269
82,82084,820840411,Rosario,SANTA FE,307,334,457,396,853
82,82084,820840212,Rosario,SANTA FE,315,306,609,598,1207
82,82084,820841917,Rosario,SANTA FE,296,393,396,326,722
82,82084,820848312,Rosario,SANTA FE,247,263,376,321,697
82,82084,820848302,Rosario,SANTA FE,377,392,623,541,1164
82,82084,820848216,Rosario,SANTA FE,357,421,667,625,1292
82,82084,820842408,Rosario,SANTA FE,219,305,261,227,488
82,82084,820840904,Rosario,SANTA FE,269,314,415,302,717
82,82084,820840805,Rosario,SANTA FE,332,376,485,399,884
82,82084,820842809,Rosario,SANTA FE,340,575,396,304,700
82,82084,820840708,Rosario,SANTA FE,272,280,448,419,867
82,82084,820840704,Rosario,SANTA FE,450,405,779,745,1524
82,82084,820840703,Rosario,SANTA FE,453,474,785,763,1548
82,82084,820840622,Rosario,SANTA FE,344,370,597,498,1095
82,82084,820840614,Rosario,SANTA FE,475,488,797,723,1520
82,82084,820840611,Rosario,SANTA FE,347,367,541,513,1054
82,82084,820840705,Rosario,SANTA FE,619,516,1000,912,1912
82,82084,820848021,Rosario,SANTA FE,235,276,334,295,629
82,82084,820845704,Rosario,SANTA FE,249,303,382,354,736
82,82084,820845508,Rosario,SANTA FE,459,418,842,843,1685
82,82084,820845708,Rosario,SANTA FE,415,687,599,620,1219
82,82084,820845404,Rosario,SANTA FE,307,343,471,418,889
82,82084,820845321,Rosario,SANTA FE,201,210,314,289,603
82,82084,820845318,Rosario,SANTA FE,537,557,859,735,1594
82,82084,820841105,Rosario,SANTA FE,310,331,528,517,1045
82,82084,820841103,Rosario,SANTA FE,300,347,474,457,931
82,82084,820841014,Rosario,SANTA FE,398,298,683,639,1322
82,82084,820841009,Rosario,SANTA FE,490,420,840,831,1671
82,82084,820846309,Rosario,SANTA FE,333,274,626,652,1278
82,82084,820846301,Rosario,SANTA FE,409,288,794,825,1619
82,82084,820846209,Rosario,SANTA FE,392,391,753,779,1532
82,82084,820846221,Rosario,SANTA FE,309,293,543,525,1068
82,82084,820846213,Rosario,SANTA FE,426,426,776,729,1505
82,82084,820842416,Rosario,SANTA FE,241,328,279,273,552
82,82084,820847706,Rosario,SANTA FE,18,32,20,33,53
82,82084,820847205,Rosario,SANTA FE,76,102,128,147,275
82,82084,820845903,Rosario,SANTA FE,20,23,27,34,61
82,82084,820845901,Rosario,SANTA FE,18,24,18,28,46
82,82084,820844901,Rosario,SANTA FE,158,135,245,247,492
82,82084,820844821,Rosario,SANTA FE,553,460,866,901,1767
82,82084,820842314,Rosario,SANTA FE,285,439,304,242,546
82,82084,820846214,Rosario,SANTA FE,238,242,394,358,752
82,82084,820846201,Rosario,SANTA FE,232,219,425,400,825
82,82084,820848912,Rosario,SANTA FE,715,682,1362,1404,2766
82,82084,820848911,Rosario,SANTA FE,802,749,1620,1639,3259
82,82084,820848505,Rosario,SANTA FE,242,267,407,340,747
82,82084,820848413,Rosario,SANTA FE,483,389,899,897,1796
82,82084,820848201,Rosario,SANTA FE,472,523,845,887,1732
82,82084,820847905,Rosario,SANTA FE,313,356,450,422,872
82,82084,820847710,Rosario,SANTA FE,338,369,546,505,1051
82,82084,820847708,Rosario,SANTA FE,356,364,565,531,1096
82,82084,820847206,Rosario,SANTA FE,252,275,411,401,812
82,82084,820846104,Rosario,SANTA FE,325,308,615,626,1241
82,82084,820845909,Rosario,SANTA FE,380,390,677,741,1418
82,82084,820845905,Rosario,SANTA FE,444,407,908,922,1830
82,82084,820843304,Rosario,SANTA FE,344,316,604,590,1194
82,82084,820843302,Rosario,SANTA FE,339,330,613,607,1220
82,82084,820843301,Rosario,SANTA FE,309,308,493,502,995
82,82084,820840102,Rosario,SANTA FE,447,536,758,796,1554
82,82084,820840204,Rosario,SANTA FE,445,447,767,757,1524
82,82084,820842622,Rosario,SANTA FE,169,263,196,113,309
82,82084,820842621,Rosario,SANTA FE,331,513,417,318,735
82,82084,820846220,Rosario,SANTA FE,252,233,429,429,858
82,82084,820842818,Rosario,SANTA FE,209,356,261,190,451
82,82084,820841918,Rosario,SANTA FE,330,490,383,315,698
82,82084,820844716,Rosario,SANTA FE,511,360,948,917,1865
82,82084,820844714,Rosario,SANTA FE,233,145,453,412,865
82,82084,820842312,Rosario,SANTA FE,320,482,379,270,649
82,82084,820844707,Rosario,SANTA FE,241,231,389,363,752
82,82084,820844706,Rosario,SANTA FE,283,283,509,470,979
82,82084,820841908,Rosario,SANTA FE,309,469,346,269,615
82,82084,820844602,Rosario,SANTA FE,320,324,502,412,914
82,82084,820844712,Rosario,SANTA FE,236,216,442,414,856
82,82084,820844516,Rosario,SANTA FE,316,240,600,594,1194
82,82084,820844512,Rosario,SANTA FE,327,361,503,442,945
82,82084,820844502,Rosario,SANTA FE,176,181,263,240,503
82,82084,820844702,Rosario,SANTA FE,241,234,427,418,845
82,82084,820844612,Rosario,SANTA FE,210,221,383,335,718
82,82084,820844412,Rosario,SANTA FE,264,326,399,322,721
82,82084,820844308,Rosario,SANTA FE,165,208,237,192,429
82,82084,820844305,Rosario,SANTA FE,234,293,370,309,679
82,82084,820844302,Rosario,SANTA FE,206,227,332,285,617
82,82084,820844210,Rosario,SANTA FE,361,391,569,497,1066
82,82084,820844009,Rosario,SANTA FE,282,306,409,367,776
82,82084,820844007,Rosario,SANTA FE,268,373,338,293,631
82,82084,820843920,Rosario,SANTA FE,216,260,287,283,570
82,82084,820843807,Rosario,SANTA FE,243,306,345,314,659
82,82084,820843210,Rosario,SANTA FE,338,217,613,602,1215
82,82084,820844212,Rosario,SANTA FE,281,265,525,480,1005
82,82084,820843716,Rosario,SANTA FE,253,373,295,239,534
82,82084,820843206,Rosario,SANTA FE,360,344,663,612,1275
82,82084,820843710,Rosario,SANTA FE,339,453,422,347,769
82,82084,820848810,Rosario,SANTA FE,364,397,517,488,1005
82,82084,820843707,Rosario,SANTA FE,279,403,344,263,607
82,82084,820843202,Rosario,SANTA FE,333,351,573,478,1051
82,82084,820843702,Rosario,SANTA FE,403,494,592,467,1059
82,82084,820843211,Rosario,SANTA FE,318,332,527,500,1027
82,82084,820842308,Rosario,SANTA FE,359,487,385,287,672
82,82084,820847002,Rosario,SANTA FE,188,238,253,244,497
82,82084,820846502,Rosario,SANTA FE,305,362,531,497,1028
82,82084,820842101,Rosario,SANTA FE,272,359,349,293,642
82,82084,820843903,Rosario,SANTA FE,273,371,379,317,696
82,82084,820842813,Rosario,SANTA FE,234,296,285,214,499
82,82084,820843310,Rosario,SANTA FE,438,428,808,721,1529
82,82084,820843813,Rosario,SANTA FE,348,391,561,483,1044
82,82084,820842812,Rosario,SANTA FE,189,265,254,170,424
82,82084,820843214,Rosario,SANTA FE,242,241,423,370,793
82,82084,820843105,Rosario,SANTA FE,172,171,263,229,492
82,82084,820843104,Rosario,SANTA FE,292,358,445,387,832
82,82084,820841109,Rosario,SANTA FE,19,24,36,21,57
82,82084,820840619,Rosario,SANTA FE,223,225,401,368,769
82,82084,820842913,Rosario,SANTA FE,259,348,327,235,562
82,82084,820843201,Rosario,SANTA FE,421,418,693,615,1308
82,82084,820843121,Rosario,SANTA FE,291,312,480,410,890
82,82084,820842924,Rosario,SANTA FE,281,409,366,320,686
82,82084,820842203,Rosario,SANTA FE,237,319,278,245,523
82,82084,820842903,Rosario,SANTA FE,323,455,401,336,737
82,82084,820842824,Rosario,SANTA FE,285,484,322,264,586
82,82084,820842820,Rosario,SANTA FE,282,387,383,269,652
82,82084,820842111,Rosario,SANTA FE,248,333,302,252,554
82,82084,820842108,Rosario,SANTA FE,258,429,282,257,539
82,82084,820842011,Rosario,SANTA FE,228,355,279,209,488
82,82084,820842301,Rosario,SANTA FE,289,396,336,294,630
82,82084,820842211,Rosario,SANTA FE,325,473,430,351,781
82,82084,820842205,Rosario,SANTA FE,292,373,410,318,728
82,82084,820841409,Rosario,SANTA FE,241,245,351,292,643
82,82084,820841719,Rosario,SANTA FE,260,356,324,254,578
82,82084,820841612,Rosario,SANTA FE,222,327,281,235,516
82,82084,820841609,Rosario,SANTA FE,372,510,459,419,878
82,82084,820841606,Rosario,SANTA FE,297,378,398,331,729
82,82084,820842002,Rosario,SANTA FE,249,367,311,235,546
82,82084,820841915,Rosario,SANTA FE,245,317,280,209,489
82,82084,820841403,Rosario,SANTA FE,283,343,403,348,751
82,82084,820841311,Rosario,SANTA FE,276,315,447,383,830
82,82084,820841310,Rosario,SANTA FE,345,353,531,443,974
82,82084,820841216,Rosario,SANTA FE,275,168,382,362,744
82,82084,820841713,Rosario,SANTA FE,282,374,375,291,666
82,82084,820841708,Rosario,SANTA FE,147,220,188,158,346
82,82084,820841706,Rosario,SANTA FE,292,333,411,345,756
82,82084,820841703,Rosario,SANTA FE,211,307,307,254,561
82,82084,820843614,Rosario,SANTA FE,231,249,331,322,653
82,82084,820843611,Rosario,SANTA FE,321,356,466,369,835
82,82084,820843509,Rosario,SANTA FE,397,427,650,569,1219
82,82084,820843507,Rosario,SANTA FE,188,213,303,240,543
82,82084,820843503,Rosario,SANTA FE,245,291,366,338,704
82,82084,820843501,Rosario,SANTA FE,330,344,577,589,1166
82,82084,820843419,Rosario,SANTA FE,162,134,310,310,620
82,82084,820841108,Rosario,SANTA FE,267,300,418,413,831
82,82084,820845201,Rosario,SANTA FE,499,472,840,873,1713
82,82084,820845003,Rosario,SANTA FE,321,347,485,452,937
82,82084,820844913,Rosario,SANTA FE,384,362,707,732,1439
82,82084,820843403,Rosario,SANTA FE,139,135,229,193,422
82,82084,820845010,Rosario,SANTA FE,206,207,334,302,636
82,82084,820844818,Rosario,SANTA FE,272,257,522,540,1062
82,82084,820844910,Rosario,SANTA FE,332,198,610,601,1211
82,82084,820844816,Rosario,SANTA FE,407,329,665,617,1282
82,82084,820844814,Rosario,SANTA FE,309,302,594,601,1195
82,82084,820844812,Rosario,SANTA FE,302,337,466,447,913
82,82084,820848813,Rosario,SANTA FE,305,315,617,613,1230
82,82084,820848805,Rosario,SANTA FE,302,310,538,463,1001
82,82084,820842405,Rosario,SANTA FE,238,340,428,287,715
82,82084,820848711,Rosario,SANTA FE,228,229,382,367,749
82,82084,820845914,Rosario,SANTA FE,304,353,475,443,918
82,82084,820845910,Rosario,SANTA FE,611,620,1041,1016,2057
82,82084,820848702,Rosario,SANTA FE,274,306,415,361,776
82,82084,820842618,Rosario,SANTA FE,209,360,215,177,392
82,82084,820842614,Rosario,SANTA FE,300,477,364,269,633
82,82084,820842403,Rosario,SANTA FE,174,230,231,174,405
82,82084,820842411,Rosario,SANTA FE,178,239,224,188,412
82,82084,820840507,Rosario,SANTA FE,336,423,484,448,932
82,82084,820840406,Rosario,SANTA FE,348,403,497,472,969
82,82084,820840307,Rosario,SANTA FE,620,769,1160,1134,2294
82,82084,820840302,Rosario,SANTA FE,395,278,765,776,1541
82,82084,820840210,Rosario,SANTA FE,507,556,917,896,1813
82,82084,820848304,Rosario,SANTA FE,356,398,580,470,1050
82,82084,820840808,Rosario,SANTA FE,337,354,499,417,916
82,82084,820840802,Rosario,SANTA FE,314,378,432,395,827
82,82084,820840720,Rosario,SANTA FE,329,385,482,425,907
82,82084,820840719,Rosario,SANTA FE,269,312,376,327,703
82,82084,820840717,Rosario,SANTA FE,348,339,540,576,1116
82,82084,820840714,Rosario,SANTA FE,279,293,420,358,778
82,82084,820840613,Rosario,SANTA FE,386,420,615,562,1177
82,82084,820848113,Rosario,SANTA FE,235,260,313,261,574
82,82084,820848121,Rosario,SANTA FE,218,244,317,273,590
82,82084,820848018,Rosario,SANTA FE,223,292,331,296,627
82,82084,820848020,Rosario,SANTA FE,317,379,480,381,861
82,82084,820845709,Rosario,SANTA FE,135,257,222,206,428
82,82084,820845602,Rosario,SANTA FE,8,8,2,10,12
82,82084,820845504,Rosario,SANTA FE,323,339,530,482,1012
82,82084,820846216,Rosario,SANTA FE,357,358,626,653,1279
82,82084,820845405,Rosario,SANTA FE,228,246,371,340,711
82,82084,820841106,Rosario,SANTA FE,319,312,535,549,1084
82,82084,820841104,Rosario,SANTA FE,233,263,353,300,653
82,82084,820841018,Rosario,SANTA FE,538,387,975,888,1863
82,82084,820841002,Rosario,SANTA FE,513,439,902,872,1774
82,82084,820849013,Rosario,SANTA FE,243,296,336,397,733
82,82084,820847722,Rosario,SANTA FE,295,365,485,364,849
82,82084,820846305,Rosario,SANTA FE,235,231,425,395,820
82,82084,820842611,Rosario,SANTA FE,187,297,227,177,404
82,82084,820849006,Rosario,SANTA FE,99,144,172,149,321
82,82084,820848902,Rosario,SANTA FE,434,349,769,799,1568
82,82084,820846210,Rosario,SANTA FE,378,357,739,692,1431
82,82084,820845715,Rosario,SANTA FE,16,21,23,35,58
82,82084,820847903,Rosario,SANTA FE,31,53,64,60,124
82,82084,820846601,Rosario,SANTA FE,298,410,591,641,1232
82,82084,820842316,Rosario,SANTA FE,242,338,282,228,510
82,82084,820848907,Rosario,SANTA FE,271,270,433,416,849
82,82084,820848506,Rosario,SANTA FE,221,236,324,315,639
82,82084,820848207,Rosario,SANTA FE,370,364,622,593,1215
82,82084,820848206,Rosario,SANTA FE,324,320,517,508,1025
82,82084,820848205,Rosario,SANTA FE,326,319,565,495,1060
82,82084,820848004,Rosario,SANTA FE,349,539,406,324,730
82,82084,820848009,Rosario,SANTA FE,367,489,462,397,859
82,82084,820847712,Rosario,SANTA FE,354,338,590,538,1128
82,82084,820847709,Rosario,SANTA FE,326,355,505,479,984
82,82084,820847207,Rosario,SANTA FE,345,404,538,515,1053
82,82084,820846312,Rosario,SANTA FE,264,205,496,531,1027
82,82084,820845908,Rosario,SANTA FE,267,281,465,458,923
82,82084,820845904,Rosario,SANTA FE,549,475,986,1045,2031
82,82084,820845517,Rosario,SANTA FE,252,238,445,443,888
82,82084,820845304,Rosario,SANTA FE,376,405,601,636,1237
82,82084,820845303,Rosario,SANTA FE,336,352,547,539,1086
82,82084,820848012,Rosario,SANTA FE,188,231,251,190,441
82,82084,820843308,Rosario,SANTA FE,256,259,435,383,818
82,82084,820840403,Rosario,SANTA FE,345,394,502,493,995
82,82084,820840402,Rosario,SANTA FE,253,277,381,359,740
82,82084,820845406,Rosario,SANTA FE,128,79,213,225,438
82,82084,820845205,Rosario,SANTA FE,363,281,700,679,1379
82,82084,820844519,Rosario,SANTA FE,320,365,487,442,929
82,82084,820844515,Rosario,SANTA FE,258,260,391,362,753
82,82084,820841903,Rosario,SANTA FE,359,482,413,322,735
82,82084,820844503,Rosario,SANTA FE,367,376,588,530,1118
82,82084,820844604,Rosario,SANTA FE,319,359,484,419,903
82,82084,820844417,Rosario,SANTA FE,279,336,408,368,776
82,82084,820841704,Rosario,SANTA FE,278,393,321,324,645
82,82084,820844303,Rosario,SANTA FE,247,298,365,293,658
82,82084,820844301,Rosario,SANTA FE,255,304,356,333,689
82,82084,820844203,Rosario,SANTA FE,124,98,143,191,334
82,82084,820844201,Rosario,SANTA FE,183,204,246,196,442
82,82084,820844110,Rosario,SANTA FE,408,401,781,742,1523
82,82084,820844104,Rosario,SANTA FE,288,222,521,429,950
82,82084,820844004,Rosario,SANTA FE,328,372,540,515,1055
82,82084,820843917,Rosario,SANTA FE,187,230,226,182,408
82,82084,820843212,Rosario,SANTA FE,393,386,815,792,1607
82,82084,820843805,Rosario,SANTA FE,284,378,383,358,741
82,82084,820843802,Rosario,SANTA FE,309,406,430,344,774
82,82084,820848906,Rosario,SANTA FE,236,249,381,309,690
82,82084,820843709,Rosario,SANTA FE,220,317,252,229,481
82,82084,820843705,Rosario,SANTA FE,264,334,327,258,585
82,82084,820843114,Rosario,SANTA FE,270,299,495,427,922
82,82084,820843907,Rosario,SANTA FE,346,448,490,377,867
82,82084,820843906,Rosario,SANTA FE,307,391,413,357,770
82,82084,820843314,Rosario,SANTA FE,290,269,501,500,1001
82,82084,820842415,Rosario,SANTA FE,226,368,247,180,427
82,82084,820843013,Rosario,SANTA FE,242,249,420,361,781
82,82084,820840416,Rosario,SANTA FE,116,126,178,142,320
82,82084,820840404,Rosario,SANTA FE,321,352,517,577,1094
82,82084,820843001,Rosario,SANTA FE,259,237,430,381,811
82,82084,820842914,Rosario,SANTA FE,300,412,373,374,747
82,82084,820842106,Rosario,SANTA FE,43,68,49,42,91
82,82084,820845511,Rosario,SANTA FE,293,266,532,509,1041
82,82084,820842916,Rosario,SANTA FE,186,238,239,216,455
82,82084,820842708,Rosario,SANTA FE,296,491,352,224,576
82,82084,820842601,Rosario,SANTA FE,282,478,331,270,601
82,82084,820842513,Rosario,SANTA FE,334,368,425,319,744
82,82084,820842823,Rosario,SANTA FE,157,250,180,152,332
82,82084,820842819,Rosario,SANTA FE,223,295,292,215,507
82,82084,820842805,Rosario,SANTA FE,107,165,153,117,270
82,82084,820842718,Rosario,SANTA FE,157,205,222,168,390
82,82084,820842006,Rosario,SANTA FE,240,356,244,186,430
82,82084,820842110,Rosario,SANTA FE,249,339,310,214,524
82,82084,820842109,Rosario,SANTA FE,247,403,282,200,482
82,82084,820841804,Rosario,SANTA FE,444,587,561,466,1027
82,82084,820841803,Rosario,SANTA FE,173,263,181,130,311
82,82084,820841801,Rosario,SANTA FE,417,542,552,460,1012
82,82084,820842417,Rosario,SANTA FE,114,174,135,146,281
82,82084,820842303,Rosario,SANTA FE,300,412,409,322,731
82,82084,820842210,Rosario,SANTA FE,385,539,459,381,840
82,82084,820841717,Rosario,SANTA FE,177,252,266,210,476
82,82084,820841604,Rosario,SANTA FE,299,343,405,381,786
82,82084,820841507,Rosario,SANTA FE,204,220,285,259,544
82,82084,820841314,Rosario,SANTA FE,281,250,477,471,948
82,82084,820841308,Rosario,SANTA FE,308,334,491,454,945
82,82084,820841707,Rosario,SANTA FE,250,330,315,277,592
82,82084,820841407,Rosario,SANTA FE,291,338,439,373,812
82,82084,820841212,Rosario,SANTA FE,267,271,444,443,887
82,82084,820841206,Rosario,SANTA FE,461,228,824,819,1643
82,82084,820843618,Rosario,SANTA FE,202,212,310,272,582
82,82084,820841302,Rosario,SANTA FE,574,456,970,945,1915
82,82084,820841217,Rosario,SANTA FE,281,180,460,407,867
82,82084,820841115,Rosario,SANTA FE,214,228,355,306,661
82,82084,820843616,Rosario,SANTA FE,382,390,675,631,1306
82,82084,820843613,Rosario,SANTA FE,292,366,417,408,825
82,82084,820843409,Rosario,SANTA FE,368,353,674,616,1290
82,82084,820841112,Rosario,SANTA FE,300,361,488,424,912
82,82084,820841111,Rosario,SANTA FE,371,429,587,569,1156
82,82084,820843517,Rosario,SANTA FE,721,648,1346,1426,2772
82,82084,820843511,Rosario,SANTA FE,395,257,715,685,1400
82,82084,820844902,Rosario,SANTA FE,293,306,574,489,1063
82,82084,820845105,Rosario,SANTA FE,302,340,447,392,839
82,82084,820845011,Rosario,SANTA FE,366,348,571,572,1143
82,82084,820844811,Rosario,SANTA FE,473,484,849,753,1602
82,82084,820848817,Rosario,SANTA FE,295,150,473,557,1030
82,82084,820848803,Rosario,SANTA FE,272,291,401,386,787
82,82084,820848709,Rosario,SANTA FE,328,362,582,532,1114
82,82084,820845913,Rosario,SANTA FE,267,323,415,316,731
82,82084,820848707,Rosario,SANTA FE,452,495,737,640,1377
82,82084,820848604,Rosario,SANTA FE,336,356,525,498,1023
82,82084,820842414,Rosario,SANTA FE,182,243,204,178,382
82,82084,820848515,Rosario,SANTA FE,278,266,500,521,1021
82,82084,820841813,Rosario,SANTA FE,393,562,406,360,766
82,82084,820840604,Rosario,SANTA FE,468,373,836,870,1706
82,82084,820842324,Rosario,SANTA FE,190,232,228,186,414
82,82084,820842808,Rosario,SANTA FE,214,307,243,167,410
82,82084,820842613,Rosario,SANTA FE,357,527,423,360,783
82,82084,820840707,Rosario,SANTA FE,301,308,597,550,1147
82,82084,820840510,Rosario,SANTA FE,246,298,382,361,743
82,82084,820848403,Rosario,SANTA FE,491,521,865,808,1673
82,82084,820840305,Rosario,SANTA FE,472,458,777,715,1492
82,82084,820848402,Rosario,SANTA FE,342,350,601,558,1159
82,82084,820848309,Rosario,SANTA FE,203,226,294,257,551
82,82084,820848808,Rosario,SANTA FE,349,416,527,475,1002
82,82084,820848303,Rosario,SANTA FE,289,324,416,365,781
82,82084,820848215,Rosario,SANTA FE,310,268,546,560,1106
82,82084,820848213,Rosario,SANTA FE,517,449,953,958,1911
82,82084,820840909,Rosario,SANTA FE,199,270,299,239,538
82,82084,820840908,Rosario,SANTA FE,316,325,479,435,914
82,82084,820840811,Rosario,SANTA FE,438,347,896,947,1843
82,82084,820840810,Rosario,SANTA FE,277,326,427,361,788
82,82084,820840804,Rosario,SANTA FE,304,353,453,341,794
82,82084,820842317,Rosario,SANTA FE,172,245,257,160,417
82,82084,820840713,Rosario,SANTA FE,197,196,313,292,605
82,82084,820840618,Rosario,SANTA FE,301,279,448,415,863
82,82084,820840616,Rosario,SANTA FE,600,600,1091,1118,2209
82,82084,820848114,Rosario,SANTA FE,213,236,327,256,583
82,82084,820840610,Rosario,SANTA FE,367,402,564,544,1108
82,82084,820848106,Rosario,SANTA FE,251,294,345,296,641
82,82084,820848110,Rosario,SANTA FE,318,339,480,437,917
82,82084,820848103,Rosario,SANTA FE,231,273,306,290,596
82,82084,820842623,Rosario,SANTA FE,224,329,270,209,479
82,82084,820845703,Rosario,SANTA FE,297,456,479,465,944
82,82084,820845601,Rosario,SANTA FE,25,30,26,30,56
82,82084,820845506,Rosario,SANTA FE,246,274,367,341,708
82,82084,820845503,Rosario,SANTA FE,277,290,416,384,800
82,82084,820845501,Rosario,SANTA FE,388,355,576,559,1135
82,82084,820845418,Rosario,SANTA FE,283,328,429,369,798
82,82084,820845317,Rosario,SANTA FE,202,226,288,256,544
82,82084,820841015,Rosario,SANTA FE,247,158,414,359,773
82,82084,820848008,Rosario,SANTA FE,432,626,576,460,1036
82,82084,820847721,Rosario,SANTA FE,378,444,616,551,1167
82,82084,820849011,Rosario,SANTA FE,373,538,582,583,1165
82,82084,820846306,Rosario,SANTA FE,403,378,694,652,1346
82,82084,820849009,Rosario,SANTA FE,142,169,217,189,406
82,82084,820849007,Rosario,SANTA FE,526,622,932,905,1837
82,82084,820847901,Rosario,SANTA FE,8,16,12,10,22
82,82084,820847802,Rosario,SANTA FE,109,139,169,197,366
82,82084,820846905,Rosario,SANTA FE,209,388,332,320,652
82,82084,820846501,Rosario,SANTA FE,461,670,752,789,1541
82,82084,820844807,Rosario,SANTA FE,633,358,1120,1157,2277
82,82084,820845801,Rosario,SANTA FE,27,47,35,45,80
82,82084,820846112,Rosario,SANTA FE,341,316,677,595,1272
82,82084,820845922,Rosario,SANTA FE,430,364,810,856,1666
82,82084,820845920,Rosario,SANTA FE,290,302,455,444,899
82,82084,820847703,Rosario,SANTA FE,100,174,167,177,344
82,82084,820846202,Rosario,SANTA FE,181,151,320,306,626
82,82084,820849004,Rosario,SANTA FE,290,334,472,416,888
82,82084,820849003,Rosario,SANTA FE,467,504,821,787,1608
82,82084,820848507,Rosario,SANTA FE,275,281,436,428,864
82,82084,820848504,Rosario,SANTA FE,253,243,474,486,960
82,82084,820848210,Rosario,SANTA FE,496,480,951,988,1939
82,82084,820847906,Rosario,SANTA FE,336,387,552,484,1036
82,82084,820847806,Rosario,SANTA FE,321,345,543,521,1064
82,82084,820846005,Rosario,SANTA FE,366,401,622,617,1239
82,82084,820845807,Rosario,SANTA FE,397,495,508,527,1035
82,82084,820845523,Rosario,SANTA FE,247,257,414,380,794
82,82084,820845520,Rosario,SANTA FE,412,337,747,732,1479
82,82084,820845519,Rosario,SANTA FE,195,206,328,289,617
82,82084,820845514,Rosario,SANTA FE,414,426,697,694,1391
82,82084,820845512,Rosario,SANTA FE,325,278,604,610,1214
82,82084,820845310,Rosario,SANTA FE,403,430,625,547,1172
82,82084,820845307,Rosario,SANTA FE,390,414,625,550,1175
82,82084,820845302,Rosario,SANTA FE,318,368,486,398,884
82,82084,820843305,Rosario,SANTA FE,469,440,802,751,1553
82,82084,820840422,Rosario,SANTA FE,247,251,393,366,759
82,82084,820840202,Rosario,SANTA FE,324,191,606,627,1233
82,82084,820845314,Rosario,SANTA FE,232,256,341,281,622
82,82084,820845204,Rosario,SANTA FE,378,385,708,614,1322
82,82084,820844713,Rosario,SANTA FE,236,218,414,396,810
82,82084,820844517,Rosario,SANTA FE,328,331,536,519,1055
82,82084,820844513,Rosario,SANTA FE,130,134,201,181,382
82,82084,820844510,Rosario,SANTA FE,292,313,513,473,986
82,82084,820844704,Rosario,SANTA FE,513,305,950,956,1906
82,82084,820844609,Rosario,SANTA FE,541,378,1038,1038,2076
82,82084,820844403,Rosario,SANTA FE,361,370,597,533,1130
82,82084,820844402,Rosario,SANTA FE,179,195,226,184,410
82,82084,820844309,Rosario,SANTA FE,245,301,371,313,684
82,82084,820844213,Rosario,SANTA FE,414,322,754,751,1505
82,82084,820844206,Rosario,SANTA FE,114,105,191,176,367
82,82084,820844205,Rosario,SANTA FE,205,190,387,336,723
82,82084,820844202,Rosario,SANTA FE,172,118,324,351,675
82,82084,820842811,Rosario,SANTA FE,413,553,472,371,843
82,82084,820844211,Rosario,SANTA FE,275,197,477,448,925
82,82084,820843708,Rosario,SANTA FE,384,534,469,373,842
82,82084,820848406,Rosario,SANTA FE,282,306,481,422,903
82,82084,820843619,Rosario,SANTA FE,210,283,280,230,510
82,82084,820846310,Rosario,SANTA FE,412,392,798,746,1544
82,82084,820843915,Rosario,SANTA FE,219,322,271,205,476
82,82084,820843911,Rosario,SANTA FE,233,259,341,291,632
82,82084,820843908,Rosario,SANTA FE,420,598,525,396,921
82,82084,820843904,Rosario,SANTA FE,232,275,308,253,561
82,82084,820843815,Rosario,SANTA FE,233,255,332,289,621
82,82084,820843311,Rosario,SANTA FE,418,380,747,750,1497
82,82084,820843814,Rosario,SANTA FE,352,383,506,380,886
82,82084,820843811,Rosario,SANTA FE,327,374,599,450,1049
82,82084,820843810,Rosario,SANTA FE,307,350,453,387,840
82,82084,820843110,Rosario,SANTA FE,303,302,485,430,915
82,82084,820843014,Rosario,SANTA FE,367,389,583,586,1169
82,82084,820843008,Rosario,SANTA FE,286,293,484,464,948
82,82084,820842923,Rosario,SANTA FE,156,229,202,174,376
82,82084,820842016,Rosario,SANTA FE,151,197,209,181,390
82,82084,820842707,Rosario,SANTA FE,262,333,312,243,555
82,82084,820842705,Rosario,SANTA FE,180,308,218,151,369
82,82084,820842607,Rosario,SANTA FE,282,444,302,243,545
82,82084,820842906,Rosario,SANTA FE,175,245,216,173,389
82,82084,820842825,Rosario,SANTA FE,222,375,243,169,412
82,82084,820842801,Rosario,SANTA FE,164,252,228,168,396
82,82084,820842721,Rosario,SANTA FE,251,402,302,225,527
82,82084,820842720,Rosario,SANTA FE,199,366,269,148,417
82,82084,820842715,Rosario,SANTA FE,303,454,379,312,691
82,82084,820842713,Rosario,SANTA FE,232,369,278,217,495
82,82084,820842007,Rosario,SANTA FE,263,454,307,264,571
82,82084,820842005,Rosario,SANTA FE,160,217,209,165,374
82,82084,820841808,Rosario,SANTA FE,247,372,275,250,525
82,82084,820842304,Rosario,SANTA FE,189,264,248,195,443
82,82084,820842010,Rosario,SANTA FE,167,262,208,141,349
82,82084,820842212,Rosario,SANTA FE,355,525,432,322,754
82,82084,820841410,Rosario,SANTA FE,351,377,521,522,1043
82,82084,820841611,Rosario,SANTA FE,195,222,284,230,514
82,82084,820841607,Rosario,SANTA FE,447,682,472,395,867
82,82084,820841402,Rosario,SANTA FE,205,257,277,252,529
82,82084,820841215,Rosario,SANTA FE,305,334,504,445,949
82,82084,820841214,Rosario,SANTA FE,336,364,508,459,967
82,82084,820841213,Rosario,SANTA FE,293,279,530,488,1018
82,82084,820841714,Rosario,SANTA FE,225,342,391,307,698
82,82084,820841711,Rosario,SANTA FE,369,551,434,364,798
82,82084,820841702,Rosario,SANTA FE,239,363,287,279,566
82,82084,820841404,Rosario,SANTA FE,315,338,496,440,936
82,82084,820841207,Rosario,SANTA FE,241,246,387,373,760
82,82084,820841305,Rosario,SANTA FE,272,308,433,346,779
82,82084,820841116,Rosario,SANTA FE,275,300,445,389,834
82,82084,820843510,Rosario,SANTA FE,368,237,691,631,1322
82,82084,820843506,Rosario,SANTA FE,257,284,397,326,723
82,82084,820843418,Rosario,SANTA FE,154,179,224,202,426
82,82084,820841119,Rosario,SANTA FE,323,356,502,423,925
82,82084,820843405,Rosario,SANTA FE,361,433,481,450,931
82,82084,820843601,Rosario,SANTA FE,250,285,334,301,635
82,82084,820841912,Rosario,SANTA FE,266,464,349,231,580
82,82084,820843513,Rosario,SANTA FE,261,264,476,502,978
82,82084,820845009,Rosario,SANTA FE,195,208,316,291,607
82,82084,820845007,Rosario,SANTA FE,391,403,681,683,1364
82,82084,820845005,Rosario,SANTA FE,346,377,542,500,1042
82,82084,820844907,Rosario,SANTA FE,473,351,958,971,1929
82,82084,820845208,Rosario,SANTA FE,380,260,764,742,1506
82,82084,820845106,Rosario,SANTA FE,399,415,627,538,1165
82,82084,820845012,Rosario,SANTA FE,427,457,741,713,1454
82,82084,820844819,Rosario,SANTA FE,295,282,495,549,1044
82,82084,820845209,Rosario,SANTA FE,314,179,548,533,1081
82,82084,820844809,Rosario,SANTA FE,219,197,366,343,709
82,82084,820844808,Rosario,SANTA FE,231,238,439,383,822
82,82084,820845918,Rosario,SANTA FE,438,467,759,639,1398
82,82084,820848710,Rosario,SANTA FE,376,400,638,587,1225
82,82084,820848812,Rosario,SANTA FE,378,326,706,714,1420
82,82084,820848705,Rosario,SANTA FE,290,305,451,442,893
82,82084,820842406,Rosario,SANTA FE,226,319,282,223,505
82,82084,820842619,Rosario,SANTA FE,138,214,177,147,324
82,82084,820848703,Rosario,SANTA FE,260,271,416,371,787
82,82084,820840605,Rosario,SANTA FE,479,460,926,965,1891
82,82084,820840603,Rosario,SANTA FE,287,308,421,334,755
82,82084,820842322,Rosario,SANTA FE,214,275,238,215,453
82,82084,820848311,Rosario,SANTA FE,334,349,494,438,932
82,82084,820840721,Rosario,SANTA FE,420,193,925,904,1829
82,82084,820841920,Rosario,SANTA FE,198,289,215,159,374
82,82084,820848119,Rosario,SANTA FE,309,320,443,434,877
82,82084,820841003,Rosario,SANTA FE,225,230,399,369,768
82,82084,820840715,Rosario,SANTA FE,292,295,430,382,812
82,82084,820840712,Rosario,SANTA FE,273,332,383,349,732
82,82084,820848118,Rosario,SANTA FE,277,333,447,372,819
82,82084,820840620,Rosario,SANTA FE,299,332,488,430,918
82,82084,820840615,Rosario,SANTA FE,289,152,474,466,940
82,82084,820848117,Rosario,SANTA FE,271,309,389,341,730
82,82084,820840706,Rosario,SANTA FE,671,631,1275,1186,2461
82,82084,820848104,Rosario,SANTA FE,232,289,335,289,624
82,82084,820848111,Rosario,SANTA FE,228,250,305,260,565
82,82084,820848016,Rosario,SANTA FE,297,406,401,367,768
82,82084,820845713,Rosario,SANTA FE,280,304,438,422,860
82,82084,820845711,Rosario,SANTA FE,326,439,578,594,1172
82,82084,820845510,Rosario,SANTA FE,374,368,670,711,1381
82,82084,820845507,Rosario,SANTA FE,348,345,533,501,1034
82,82084,820845502,Rosario,SANTA FE,361,376,637,569,1206
82,82084,820845417,Rosario,SANTA FE,260,287,438,360,798
82,82084,820845415,Rosario,SANTA FE,346,369,565,483,1048
82,82084,820841020,Rosario,SANTA FE,300,329,574,577,1151
82,82084,820841001,Rosario,SANTA FE,420,143,775,791,1566
82,82084,820841004,Rosario,SANTA FE,498,323,926,922,1848
82,82084,820847725,Rosario,SANTA FE,284,306,454,387,841
82,82084,820847724,Rosario,SANTA FE,270,244,437,368,805
82,82084,820847723,Rosario,SANTA FE,455,500,784,665,1449
82,82084,820847718,Rosario,SANTA FE,478,302,975,1035,2010
82,82084,820846304,Rosario,SANTA FE,286,315,534,517,1051
82,82084,820846211,Rosario,SANTA FE,309,253,566,537,1103
82,82084,820849008,Rosario,SANTA FE,273,417,420,433,853
82,82084,820846207,Rosario,SANTA FE,449,397,822,795,1617
82,82084,820846217,Rosario,SANTA FE,485,409,944,894,1838
82,82084,820842610,Rosario,SANTA FE,323,540,376,293,669
82,82084,820846001,Rosario,SANTA FE,52,64,90,102,192
82,82084,820847101,Rosario,SANTA FE,7,29,11,11,22
82,82084,820847501,Rosario,SANTA FE,10,18,17,17,34
82,82084,820846703,Rosario,SANTA FE,19,25,31,30,61
82,82084,820847701,Rosario,SANTA FE,56,73,84,103,187
82,82084,820846701,Rosario,SANTA FE,134,263,180,209,389
82,82084,820846115,Rosario,SANTA FE,586,578,1127,1229,2356
82,82084,820846108,Rosario,SANTA FE,389,347,735,753,1488
82,82084,820846106,Rosario,SANTA FE,251,263,434,393,827
82,82084,820848904,Rosario,SANTA FE,350,346,637,643,1280
82,82084,820848007,Rosario,SANTA FE,250,330,308,285,593
82,82084,820847711,Rosario,SANTA FE,379,392,685,678,1363
82,82084,820843309,Rosario,SANTA FE,460,459,804,768,1572
82,82084,820847716,Rosario,SANTA FE,288,292,460,434,894
82,82084,820840405,Rosario,SANTA FE,381,424,602,501,1103
82,82084,820840401,Rosario,SANTA FE,162,171,271,263,534
82,82084,820840207,Rosario,SANTA FE,252,279,407,398,805
82,82084,820840103,Rosario,SANTA FE,641,993,1060,1084,2144
82,82084,820840206,Rosario,SANTA FE,598,633,1134,1134,2268
82,82084,820844804,Rosario,SANTA FE,282,220,501,468,969
82,82084,820844709,Rosario,SANTA FE,236,299,387,353,740
82,82084,820844708,Rosario,SANTA FE,270,242,429,433,862
82,82084,820841906,Rosario,SANTA FE,208,333,250,197,447
82,82084,820841905,Rosario,SANTA FE,197,260,264,191,455
82,82084,820844514,Rosario,SANTA FE,354,361,578,502,1080
82,82084,820844608,Rosario,SANTA FE,303,367,469,425,894
82,82084,820844416,Rosario,SANTA FE,327,353,501,445,946
82,82084,820844414,Rosario,SANTA FE,242,281,363,322,685
82,82084,820844401,Rosario,SANTA FE,373,418,534,494,1028
82,82084,820844314,Rosario,SANTA FE,375,429,593,539,1132
82,82084,820844311,Rosario,SANTA FE,299,311,458,401,859
82,82084,820844209,Rosario,SANTA FE,349,282,599,551,1150
82,82084,820844204,Rosario,SANTA FE,232,245,385,372,757
82,82084,820844107,Rosario,SANTA FE,351,414,537,517,1054
82,82084,820844012,Rosario,SANTA FE,74,89,117,105,222
82,82084,820844006,Rosario,SANTA FE,265,413,337,280,617
82,82084,820844003,Rosario,SANTA FE,372,504,434,390,824
82,82084,820844001,Rosario,SANTA FE,345,468,433,398,831
82,82084,820843919,Rosario,SANTA FE,201,260,238,226,464
82,82084,820843803,Rosario,SANTA FE,299,427,412,332,744
82,82084,820843715,Rosario,SANTA FE,252,377,329,288,617
82,82084,820843713,Rosario,SANTA FE,327,383,423,394,817
82,82084,820843712,Rosario,SANTA FE,340,397,485,420,905
82,82084,820843207,Rosario,SANTA FE,290,289,543,547,1090
82,82084,820848609,Rosario,SANTA FE,373,235,674,640,1314
82,82084,820848314,Rosario,SANTA FE,366,395,616,510,1126
82,82084,820843205,Rosario,SANTA FE,308,321,530,470,1000
82,82084,820846602,Rosario,SANTA FE,864,894,1463,1417,2880
82,82084,820846406,Rosario,SANTA FE,198,203,347,342,689
82,82084,820846308,Rosario,SANTA FE,379,374,692,732,1424
82,82084,820844615,Rosario,SANTA FE,223,230,398,362,760
82,82084,820843111,Rosario,SANTA FE,328,356,515,436,951
82,82084,820843914,Rosario,SANTA FE,149,234,187,166,353
82,82084,820843909,Rosario,SANTA FE,212,277,281,212,493
82,82084,820843312,Rosario,SANTA FE,396,387,659,596,1255
82,82084,820843809,Rosario,SANTA FE,209,243,289,270,559
82,82084,820843109,Rosario,SANTA FE,202,213,307,243,550
82,82084,820843108,Rosario,SANTA FE,269,256,446,389,835
82,82084,820842717,Rosario,SANTA FE,156,205,183,131,314
82,82084,820842116,Rosario,SANTA FE,266,401,336,276,612
82,82084,820842113,Rosario,SANTA FE,64,100,80,56,136
82,82084,820842107,Rosario,SANTA FE,294,485,333,255,588
82,82084,820842001,Rosario,SANTA FE,212,349,292,238,530
82,82084,820842306,Rosario,SANTA FE,258,368,330,270,600
82,82084,820842305,Rosario,SANTA FE,276,350,369,287,656
82,82084,820842213,Rosario,SANTA FE,190,276,221,174,395
82,82084,820842208,Rosario,SANTA FE,303,431,458,360,818
82,82084,820842206,Rosario,SANTA FE,304,426,351,322,673
82,82084,820842204,Rosario,SANTA FE,4,4,1,19,20
82,82084,820841608,Rosario,SANTA FE,215,292,260,211,471
82,82084,820841602,Rosario,SANTA FE,344,425,461,436,897
82,82084,820841505,Rosario,SANTA FE,244,276,366,333,699
82,82084,820841313,Rosario,SANTA FE,449,441,725,696,1421
82,82084,820841309,Rosario,SANTA FE,212,248,313,302,615
82,82084,820841306,Rosario,SANTA FE,328,361,546,534,1080
82,82084,820841710,Rosario,SANTA FE,287,378,344,287,631
82,82084,820841709,Rosario,SANTA FE,314,418,409,314,723
82,82084,820841405,Rosario,SANTA FE,270,302,415,354,769
82,82084,820841219,Rosario,SANTA FE,240,116,504,514,1018
82,82084,820843617,Rosario,SANTA FE,199,248,318,268,586
82,82084,820843615,Rosario,SANTA FE,203,210,320,311,631
82,82084,820843505,Rosario,SANTA FE,323,344,532,444,976
82,82084,820843608,Rosario,SANTA FE,333,410,483,423,906
82,82084,820843607,Rosario,SANTA FE,267,320,414,376,790
82,82084,820843602,Rosario,SANTA FE,240,280,367,353,720
82,82084,820843515,Rosario,SANTA FE,416,431,723,667,1390
82,82084,820843512,Rosario,SANTA FE,467,484,825,816,1641
82,82084,820845203,Rosario,SANTA FE,392,380,641,555,1196
82,82084,820845113,Rosario,SANTA FE,189,194,341,362,703
82,82084,820843316,Rosario,SANTA FE,368,372,653,631,1284
82,82084,820845008,Rosario,SANTA FE,373,354,645,621,1266
82,82084,820845006,Rosario,SANTA FE,379,350,632,599,1231
82,82084,820844914,Rosario,SANTA FE,391,157,806,863,1669
82,82084,820844912,Rosario,SANTA FE,344,215,718,683,1401
82,82084,820844813,Rosario,SANTA FE,414,322,782,745,1527
82,82084,820845210,Rosario,SANTA FE,278,228,569,560,1129
82,82084,820848807,Rosario,SANTA FE,475,444,942,973,1915
82,82084,820848706,Rosario,SANTA FE,551,580,878,851,1729
82,82084,820848708,Rosario,SANTA FE,434,442,735,650,1385
82,82084,820848701,Rosario,SANTA FE,107,119,162,141,303
82,82084,820842616,Rosario,SANTA FE,348,512,467,335,802
82,82084,820848611,Rosario,SANTA FE,332,187,632,631,1263
82,82084,820848601,Rosario,SANTA FE,275,255,488,441,929
82,82084,820848516,Rosario,SANTA FE,235,261,406,435,841
82,82084,820840608,Rosario,SANTA FE,294,333,422,351,773
82,82084,820848412,Rosario,SANTA FE,586,611,1101,1063,2164
82,82084,820840516,Rosario,SANTA FE,311,364,447,465,912
82,82084,820848409,Rosario,SANTA FE,562,569,972,880,1852
82,82084,820840513,Rosario,SANTA FE,225,256,339,301,640
82,82084,820840511,Rosario,SANTA FE,297,379,466,438,904
82,82084,820848407,Rosario,SANTA FE,165,154,312,303,615
82,82084,820840311,Rosario,SANTA FE,505,342,875,955,1830
82,82084,820842321,Rosario,SANTA FE,123,214,163,150,313
82,82084,820840506,Rosario,SANTA FE,334,385,528,439,967
82,82084,820840504,Rosario,SANTA FE,131,159,220,177,397
82,82084,820848404,Rosario,SANTA FE,525,551,899,885,1784
82,82084,820840209,Rosario,SANTA FE,467,531,786,729,1515
82,82084,820848401,Rosario,SANTA FE,320,303,633,651,1284
82,82084,820842320,Rosario,SANTA FE,191,254,275,204,479
82,82084,820842620,Rosario,SANTA FE,198,287,232,178,410
82,82084,820848310,Rosario,SANTA FE,205,227,296,260,556
82,82084,820842319,Rosario,SANTA FE,218,287,257,206,463
82,82084,820848308,Rosario,SANTA FE,364,396,540,471,1011
82,82084,820848212,Rosario,SANTA FE,367,310,763,698,1461
82,82084,820840907,Rosario,SANTA FE,720,766,1235,1052,2287
82,82084,820840902,Rosario,SANTA FE,355,424,484,439,923
82,82084,820840809,Rosario,SANTA FE,312,366,444,365,809
82,82084,820840806,Rosario,SANTA FE,314,342,481,427,908
82,82084,820840803,Rosario,SANTA FE,303,357,504,419,923
82,82084,820848120,Rosario,SANTA FE,266,281,396,395,791
82,82084,820848115,Rosario,SANTA FE,103,128,173,152,325
82,82084,820840701,Rosario,SANTA FE,268,241,453,455,908
82,82084,820840624,Rosario,SANTA FE,154,172,267,218,485
82,82084,820841814,Rosario,SANTA FE,221,303,258,209,467
82,82084,820848105,Rosario,SANTA FE,224,251,358,286,644
82,82084,820848101,Rosario,SANTA FE,331,367,545,452,997
82,82084,820845707,Rosario,SANTA FE,220,423,341,320,661
82,82084,820845419,Rosario,SANTA FE,170,190,266,211,477
82,82084,820845414,Rosario,SANTA FE,350,381,558,493,1051
82,82084,820845409,Rosario,SANTA FE,276,297,466,413,879
82,82084,820845403,Rosario,SANTA FE,209,223,327,274,601
82,82084,820845401,Rosario,SANTA FE,134,159,223,154,377
82,82084,820845323,Rosario,SANTA FE,562,495,992,987,1979
82,82084,820845316,Rosario,SANTA FE,259,292,452,454,906
82,82084,820845212,Rosario,SANTA FE,285,281,557,549,1106
82,82084,820841013,Rosario,SANTA FE,347,301,580,566,1146
82,82084,820841012,Rosario,SANTA FE,507,399,951,876,1827
82,82084,820841007,Rosario,SANTA FE,670,400,1260,1322,2582
82,82084,820841005,Rosario,SANTA FE,338,216,609,639,1248
82,82084,820846303,Rosario,SANTA FE,401,325,803,768,1571
82,82084,820848903,Rosario,SANTA FE,526,523,1019,1031,2050
82,82084,820846205,Rosario,SANTA FE,412,288,747,730,1477
82,82084,820847904,Rosario,SANTA FE,4,19,3,6,9
82,82084,820847401,Rosario,SANTA FE,96,105,145,150,295
82,82084,820846003,Rosario,SANTA FE,14,16,15,20,35
82,82084,820845906,Rosario,SANTA FE,203,221,398,379,777
82,82084,820845806,Rosario,SANTA FE,7,15,15,13,28
82,82084,820845919,Rosario,SANTA FE,4,6,13,8,21
82,82084,820847801,Rosario,SANTA FE,11,22,9,12,21
82,82049,820491016,General Obligado,SANTA FE,469,502,973,994,1967
82,82049,820491007,General Obligado,SANTA FE,775,753,1574,1586,3160
82,82049,820490810,General Obligado,SANTA FE,238,265,532,612,1144
82,82049,820490333,General Obligado,SANTA FE,338,268,607,610,1217
82,82049,820490121,General Obligado,SANTA FE,671,547,1270,1309,2579
82,82049,820490615,General Obligado,SANTA FE,243,275,344,296,640
82,82049,820490614,General Obligado,SANTA FE,192,226,295,226,521
82,82049,820490704,General Obligado,SANTA FE,265,282,392,378,770
82,82049,820490409,General Obligado,SANTA FE,80,86,165,154,319
82,82049,820491013,General Obligado,SANTA FE,271,292,487,487,974
82,82049,820491012,General Obligado,SANTA FE,325,356,621,615,1236
82,82049,820490817,General Obligado,SANTA FE,48,53,73,104,177
82,82049,820490708,General Obligado,SANTA FE,435,467,737,694,1431
82,82049,820490706,General Obligado,SANTA FE,430,433,703,620,1323
82,82049,820490608,General Obligado,SANTA FE,578,472,1272,1382,2654
82,82049,820490329,General Obligado,SANTA FE,348,371,553,532,1085
82,82049,820490301,General Obligado,SANTA FE,344,288,603,610,1213
82,82049,820490124,General Obligado,SANTA FE,394,396,624,579,1203
82,82049,820490108,General Obligado,SANTA FE,438,454,752,731,1483
82,82049,820490805,General Obligado,SANTA FE,10,18,13,16,29
82,82049,820490819,General Obligado,SANTA FE,80,90,134,156,290
82,82049,820490401,General Obligado,SANTA FE,42,45,72,89,161
82,82049,820490315,General Obligado,SANTA FE,107,73,190,222,412
82,82049,820490803,General Obligado,SANTA FE,126,135,244,228,472
82,82049,820490308,General Obligado,SANTA FE,750,391,1375,1459,2834
82,82049,820490120,General Obligado,SANTA FE,16,28,19,28,47
82,82049,820490328,General Obligado,SANTA FE,113,102,180,185,365
82,82049,820490914,General Obligado,SANTA FE,303,316,540,511,1051
82,82049,820491002,General Obligado,SANTA FE,260,290,441,417,858
82,82049,820490512,General Obligado,SANTA FE,309,312,586,596,1182
82,82049,820490515,General Obligado,SANTA FE,293,293,503,475,978
82,82049,820490611,General Obligado,SANTA FE,290,350,403,383,786
82,82049,820490201,General Obligado,SANTA FE,261,276,448,417,865
82,82049,820490907,General Obligado,SANTA FE,239,254,380,331,711
82,82049,820490713,General Obligado,SANTA FE,209,260,272,241,513
82,82049,820490709,General Obligado,SANTA FE,419,457,641,521,1162
82,82049,820490715,General Obligado,SANTA FE,486,526,836,737,1573
82,82049,820490714,General Obligado,SANTA FE,235,256,383,324,707
82,82049,820490331,General Obligado,SANTA FE,327,348,476,411,887
82,82049,820490302,General Obligado,SANTA FE,354,376,631,626,1257
82,82049,820490913,General Obligado,SANTA FE,222,240,441,454,895
82,82049,820490316,General Obligado,SANTA FE,12,18,22,20,42
82,82049,820490502,General Obligado,SANTA FE,76,89,168,167,335
82,82049,820490321,General Obligado,SANTA FE,31,35,51,42,93
82,82049,820490808,General Obligado,SANTA FE,88,136,148,164,312
82,82049,820490416,General Obligado,SANTA FE,196,213,416,412,828
82,82049,820490320,General Obligado,SANTA FE,23,36,9,35,44
82,82049,820490319,General Obligado,SANTA FE,51,57,88,109,197
82,82049,820490418,General Obligado,SANTA FE,108,117,187,218,405
82,82049,820490413,General Obligado,SANTA FE,80,99,157,157,314
82,82049,820490902,General Obligado,SANTA FE,28,48,54,59,113
82,82049,820490203,General Obligado,SANTA FE,34,44,45,60,105
82,82049,820490103,General Obligado,SANTA FE,157,169,278,307,585
82,82049,820490112,General Obligado,SANTA FE,430,304,834,832,1666
82,82049,820490607,General Obligado,SANTA FE,291,130,608,611,1219
82,82049,820490605,General Obligado,SANTA FE,389,415,630,573,1203
82,82049,820490521,General Obligado,SANTA FE,209,217,345,309,654
82,82049,820490612,General Obligado,SANTA FE,231,326,309,229,538
82,82049,820491018,General Obligado,SANTA FE,389,440,667,685,1352
82,82049,820490906,General Obligado,SANTA FE,508,535,977,946,1923
82,82049,820490702,General Obligado,SANTA FE,322,357,463,424,887
82,82049,820490517,General Obligado,SANTA FE,283,299,431,414,845
82,82049,820490202,General Obligado,SANTA FE,316,316,463,466,929
82,82049,820490123,General Obligado,SANTA FE,631,684,1247,1240,2487
82,82049,820490118,General Obligado,SANTA FE,391,402,691,645,1336
82,82049,820490109,General Obligado,SANTA FE,360,390,694,663,1357
82,82049,820490404,General Obligado,SANTA FE,113,138,186,216,402
82,82049,820490503,General Obligado,SANTA FE,47,56,70,82,152
82,82049,820490912,General Obligado,SANTA FE,75,95,118,151,269
82,82049,820490909,General Obligado,SANTA FE,77,98,131,129,260
82,82049,820490807,General Obligado,SANTA FE,76,102,134,154,288
82,82049,820490417,General Obligado,SANTA FE,8,9,11,14,25
82,82049,820490323,General Obligado,SANTA FE,92,105,157,160,317
82,82049,820490122,General Obligado,SANTA FE,67,56,117,141,258
82,82049,820490311,General Obligado,SANTA FE,208,216,369,398,767
82,82049,820490814,General Obligado,SANTA FE,79,78,150,156,306
82,82049,820490116,General Obligado,SANTA FE,750,713,1629,1570,3199
82,82049,820491006,General Obligado,SANTA FE,304,265,754,765,1519
82,82049,820490606,General Obligado,SANTA FE,324,367,488,389,877
82,82049,820490522,General Obligado,SANTA FE,368,365,603,547,1150
82,82049,820490514,General Obligado,SANTA FE,607,590,1214,1217,2431
82,82049,820490901,General Obligado,SANTA FE,112,119,154,158,312
82,82049,820490406,General Obligado,SANTA FE,232,249,369,335,704
82,82049,820490128,General Obligado,SANTA FE,375,367,716,690,1406
82,82049,820491014,General Obligado,SANTA FE,630,672,1228,1152,2380
82,82049,820490910,General Obligado,SANTA FE,123,127,187,177,364
82,82049,820490908,General Obligado,SANTA FE,281,298,466,468,934
82,82049,820490701,General Obligado,SANTA FE,307,316,570,542,1112
82,82049,820490718,General Obligado,SANTA FE,747,670,1477,1522,2999
82,82049,820490408,General Obligado,SANTA FE,310,340,561,562,1123
82,82049,820490305,General Obligado,SANTA FE,468,478,807,738,1545
82,82049,820490304,General Obligado,SANTA FE,311,355,472,423,895
82,82049,820490127,General Obligado,SANTA FE,204,194,391,364,755
82,82049,820490125,General Obligado,SANTA FE,315,333,566,563,1129
82,82049,820490519,General Obligado,SANTA FE,4,60,2,6,8
82,82049,820490210,General Obligado,SANTA FE,57,73,89,100,189
82,82049,820490318,General Obligado,SANTA FE,22,28,38,42,80
82,82049,820490804,General Obligado,SANTA FE,3,16,6,7,13
82,82049,820490801,General Obligado,SANTA FE,138,172,249,256,505
82,82049,820490813,General Obligado,SANTA FE,9,10,14,15,29
82,82049,820490812,General Obligado,SANTA FE,51,72,98,105,203
82,82049,820490325,General Obligado,SANTA FE,35,39,68,75,143
82,82049,820490324,General Obligado,SANTA FE,145,156,271,276,547
82,82049,820490205,General Obligado,SANTA FE,29,39,61,57,118
82,82049,820490115,General Obligado,SANTA FE,44,49,79,103,182
82,82049,820490104,General Obligado,SANTA FE,13,17,0,20,20
82,82049,820490314,General Obligado,SANTA FE,32,57,47,52,99
82,82049,820490114,General Obligado,SANTA FE,93,110,196,206,402
82,82049,820490113,General Obligado,SANTA FE,40,55,79,82,161
82,82049,820490403,General Obligado,SANTA FE,145,181,250,272,522
82,82049,820490806,General Obligado,SANTA FE,87,201,130,133,263
82,82049,820490911,General Obligado,SANTA FE,104,127,180,198,378
82,82049,820490101,General Obligado,SANTA FE,434,435,948,934,1882
82,82049,820490527,General Obligado,SANTA FE,512,516,940,903,1843
82,82049,820490524,General Obligado,SANTA FE,449,445,804,779,1583
82,82049,820490916,General Obligado,SANTA FE,295,318,455,396,851
82,82049,820491015,General Obligado,SANTA FE,449,470,929,894,1823
82,82049,820490334,General Obligado,SANTA FE,310,314,589,522,1111
82,82049,820490332,General Obligado,SANTA FE,335,367,510,495,1005
82,82049,820491019,General Obligado,SANTA FE,552,595,1175,1162,2337
82,82049,820491011,General Obligado,SANTA FE,436,438,881,834,1715
82,82049,820491009,General Obligado,SANTA FE,361,383,610,603,1213
82,82049,820491008,General Obligado,SANTA FE,387,396,708,712,1420
82,82049,820490707,General Obligado,SANTA FE,510,549,903,802,1705
82,82049,820490117,General Obligado,SANTA FE,378,365,678,584,1262
82,82049,820490520,General Obligado,SANTA FE,1,10,3,3,6
82,82049,820490415,General Obligado,SANTA FE,67,75,99,119,218
82,82049,820490816,General Obligado,SANTA FE,19,27,38,34,72
82,82049,820490815,General Obligado,SANTA FE,44,50,60,79,139
82,82049,820490212,General Obligado,SANTA FE,25,33,25,26,51
82,82049,820490501,General Obligado,SANTA FE,23,31,44,44,88
82,82049,820490322,General Obligado,SANTA FE,23,29,32,36,68
82,82049,820490207,General Obligado,SANTA FE,11,17,7,15,22
82,82049,820490204,General Obligado,SANTA FE,4,11,6,12,18
82,82049,820490126,General Obligado,SANTA FE,71,101,84,136,220
82,82049,820490106,General Obligado,SANTA FE,31,39,43,66,109
82,82049,820490313,General Obligado,SANTA FE,117,129,195,203,398
82,82049,820490510,General Obligado,SANTA FE,804,770,1763,1838,3601
82,82049,820490905,General Obligado,SANTA FE,104,124,154,208,362
82,82049,820490904,General Obligado,SANTA FE,93,129,149,186,335
82,82049,820490110,General Obligado,SANTA FE,216,158,452,451,903
82,82049,820490511,General Obligado,SANTA FE,340,318,535,565,1100
82,82049,820490604,General Obligado,SANTA FE,476,512,719,616,1335
82,82049,820490601,General Obligado,SANTA FE,256,261,384,337,721
82,82049,820490523,General Obligado,SANTA FE,607,173,1397,1399,2796
82,82049,820490613,General Obligado,SANTA FE,309,373,474,384,858
82,82049,820490610,General Obligado,SANTA FE,381,416,562,471,1033
82,82049,820490119,General Obligado,SANTA FE,296,302,488,505,993
82,82049,820490609,General Obligado,SANTA FE,128,163,214,169,383
82,82049,820490518,General Obligado,SANTA FE,309,319,528,500,1028
82,82049,820491017,General Obligado,SANTA FE,527,541,1032,1011,2043
82,82049,820490712,General Obligado,SANTA FE,471,560,645,532,1177
82,82049,820490710,General Obligado,SANTA FE,280,323,411,343,754
82,82049,820490705,General Obligado,SANTA FE,270,264,527,485,1012
82,82049,820490719,General Obligado,SANTA FE,532,473,1206,1201,2407
82,82049,820490410,General Obligado,SANTA FE,120,134,200,181,381
82,82049,820490303,General Obligado,SANTA FE,316,329,515,418,933
82,82049,820490411,General Obligado,SANTA FE,132,160,228,295,523
82,82049,820490809,General Obligado,SANTA FE,88,110,193,225,418
82,82049,820490310,General Obligado,SANTA FE,88,92,188,179,367
82,82049,820490307,General Obligado,SANTA FE,103,109,176,226,402
82,82049,820490507,General Obligado,SANTA FE,93,97,136,171,307
82,82049,820490504,General Obligado,SANTA FE,135,144,253,262,515
82,82049,820490414,General Obligado,SANTA FE,10,12,16,19,35
82,82049,820490402,General Obligado,SANTA FE,97,104,156,183,339
82,82049,820490327,General Obligado,SANTA FE,87,102,134,151,285
82,82049,820490312,General Obligado,SANTA FE,36,48,59,81,140
82,82049,820490105,General Obligado,SANTA FE,94,142,172,183,355
82,82049,820490509,General Obligado,SANTA FE,306,380,536,509,1045
82,82049,820490915,General Obligado,SANTA FE,335,362,591,581,1172
82,82049,820491005,General Obligado,SANTA FE,454,465,824,715,1539
82,82049,820491003,General Obligado,SANTA FE,293,294,595,494,1089
82,82049,820490602,General Obligado,SANTA FE,288,302,474,424,898
82,82049,820490526,General Obligado,SANTA FE,326,331,488,438,926
82,82049,820490525,General Obligado,SANTA FE,311,344,514,477,991
82,82049,820490616,General Obligado,SANTA FE,353,402,498,371,869
82,82049,820490603,General Obligado,SANTA FE,480,531,790,666,1456
82,82049,820490405,General Obligado,SANTA FE,63,68,104,99,203
82,82049,820490703,General Obligado,SANTA FE,226,262,333,305,638
82,82049,820490716,General Obligado,SANTA FE,424,421,875,851,1726
82,82049,820490326,General Obligado,SANTA FE,638,419,1222,1195,2417
82,82049,820490306,General Obligado,SANTA FE,334,335,548,520,1068
82,82049,820490107,General Obligado,SANTA FE,214,189,435,430,865
82,82049,820490102,General Obligado,SANTA FE,662,729,1275,1264,2539
82,82049,820490412,General Obligado,SANTA FE,134,153,251,259,510
82,82049,820490802,General Obligado,SANTA FE,64,59,159,148,307
82,82049,820490317,General Obligado,SANTA FE,23,31,46,42,88
82,82049,820490811,General Obligado,SANTA FE,0,0,4,35,39
82,82049,820490407,General Obligado,SANTA FE,33,45,59,74,133
82,82049,820490508,General Obligado,SANTA FE,60,79,98,102,200
82,82049,820490111,General Obligado,SANTA FE,68,75,110,120,230
82,82049,820491004,General Obligado,SANTA FE,349,355,692,620,1312
82,82049,820491001,General Obligado,SANTA FE,280,299,443,422,865
82,82049,820490513,General Obligado,SANTA FE,384,435,560,482,1042
82,82049,820491010,General Obligado,SANTA FE,377,410,594,610,1204
82,82049,820490711,General Obligado,SANTA FE,264,295,390,306,696
82,82049,820490516,General Obligado,SANTA FE,419,401,712,684,1396
82,82049,820490903,General Obligado,SANTA FE,123,138,215,227,442
82,82049,820490717,General Obligado,SANTA FE,484,512,874,833,1707
82,82049,820490330,General Obligado,SANTA FE,319,348,460,449,909
82,82049,820490213,General Obligado,SANTA FE,247,272,469,433,902
82,82049,820490208,General Obligado,SANTA FE,12,19,15,17,32
82,82049,820490818,General Obligado,SANTA FE,138,148,250,263,513
82,82049,820490309,General Obligado,SANTA FE,10,49,12,19,31
82,82049,820490506,General Obligado,SANTA FE,78,92,152,160,312
82,82049,820490505,General Obligado,SANTA FE,77,83,158,135,293
82,82049,820490419,General Obligado,SANTA FE,3,5,9,6,15
82,82049,820490209,General Obligado,SANTA FE,28,37,35,60,95
82,82049,820490206,General Obligado,SANTA FE,10,13,10,20,30
82,82049,820490211,General Obligado,SANTA FE,8,14,14,12,26
82,82028,820280515,Constitución,SANTA FE,387,381,791,744,1535
82,82028,820280509,Constitución,SANTA FE,366,366,654,625,1279
82,82028,820280505,Constitución,SANTA FE,476,497,762,762,1524
82,82028,820280501,Constitución,SANTA FE,297,175,599,560,1159
82,82028,820280403,Constitución,SANTA FE,363,393,594,566,1160
82,82028,820280327,Constitución,SANTA FE,105,137,149,161,310
82,82028,820280321,Constitución,SANTA FE,228,267,326,307,633
82,82028,820280308,Constitución,SANTA FE,327,389,494,437,931
82,82028,820280208,Constitución,SANTA FE,84,129,152,127,279
82,82028,820280212,Constitución,SANTA FE,266,305,391,417,808
82,82028,820280415,Constitución,SANTA FE,315,309,543,471,1014
82,82028,820280414,Constitución,SANTA FE,396,410,672,639,1311
82,82028,820280105,Constitución,SANTA FE,595,648,949,919,1868
82,82028,820280213,Constitución,SANTA FE,15,59,14,21,35
82,82028,820280115,Constitución,SANTA FE,13,92,16,15,31
82,82028,820280207,Constitución,SANTA FE,287,337,404,381,785
82,82028,820280316,Constitución,SANTA FE,229,276,328,304,632
82,82028,820280514,Constitución,SANTA FE,347,352,652,641,1293
82,82028,820280412,Constitución,SANTA FE,357,362,555,511,1066
82,82028,820280408,Constitución,SANTA FE,253,288,396,352,748
82,82028,820280407,Constitución,SANTA FE,343,365,493,411,904
82,82028,820280319,Constitución,SANTA FE,152,165,231,204,435
82,82028,820280301,Constitución,SANTA FE,601,252,1169,1248,2417
82,82028,820280203,Constitución,SANTA FE,140,181,189,196,385
82,82028,820280201,Constitución,SANTA FE,592,630,969,865,1834
82,82028,820280102,Constitución,SANTA FE,238,269,336,283,619
82,82028,820280116,Constitución,SANTA FE,21,105,10,31,41
82,82028,820280310,Constitución,SANTA FE,60,92,76,93,169
82,82028,820280324,Constitución,SANTA FE,264,331,481,523,1004
82,82028,820280209,Constitución,SANTA FE,114,144,173,176,349
82,82028,820280512,Constitución,SANTA FE,522,505,1023,970,1993
82,82028,820280508,Constitución,SANTA FE,425,444,729,721,1450
82,82028,820280413,Constitución,SANTA FE,382,412,623,586,1209
82,82028,820280204,Constitución,SANTA FE,323,371,447,401,848
82,82028,820280114,Constitución,SANTA FE,294,362,435,443,878
82,82028,820280103,Constitución,SANTA FE,220,253,314,279,593
82,82028,820280315,Constitución,SANTA FE,63,84,88,109,197
82,82028,820280219,Constitución,SANTA FE,14,18,14,21,35
82,82028,820280323,Constitución,SANTA FE,53,85,77,78,155
82,82028,820280107,Constitución,SANTA FE,148,291,217,232,449
82,82028,820280322,Constitución,SANTA FE,198,217,388,379,767
82,82028,820280312,Constitución,SANTA FE,111,139,217,204,421
82,82028,820280318,Constitución,SANTA FE,333,355,533,523,1056
82,82028,820280304,Constitución,SANTA FE,329,360,471,434,905
82,82028,820280214,Constitución,SANTA FE,222,258,329,312,641
82,82028,820280510,Constitución,SANTA FE,230,237,370,304,674
82,82028,820280504,Constitución,SANTA FE,306,317,462,435,897
82,82028,820280406,Constitución,SANTA FE,248,282,383,321,704
82,82028,820280326,Constitución,SANTA FE,528,537,880,871,1751
82,82028,820280314,Constitución,SANTA FE,173,215,247,231,478
82,82028,820280305,Constitución,SANTA FE,268,269,413,361,774
82,82028,820280205,Constitución,SANTA FE,490,506,731,731,1462
82,82028,820280124,Constitución,SANTA FE,231,253,355,351,706
82,82028,820280121,Constitución,SANTA FE,225,258,345,279,624
82,82028,820280122,Constitución,SANTA FE,263,301,408,371,779
82,82028,820280325,Constitución,SANTA FE,38,54,43,65,108
82,82028,820280306,Constitución,SANTA FE,418,484,715,760,1475
82,82028,820280110,Constitución,SANTA FE,81,151,134,145,279
82,82028,820280506,Constitución,SANTA FE,553,552,965,925,1890
82,82028,820280503,Constitución,SANTA FE,296,303,444,390,834
82,82028,820280405,Constitución,SANTA FE,368,372,609,601,1210
82,82028,820280404,Constitución,SANTA FE,379,391,585,569,1154
82,82028,820280401,Constitución,SANTA FE,363,399,578,588,1166
82,82028,820280313,Constitución,SANTA FE,158,175,235,236,471
82,82028,820280311,Constitución,SANTA FE,276,314,472,404,876
82,82028,820280309,Constitución,SANTA FE,729,740,1329,1359,2688
82,82028,820280220,Constitución,SANTA FE,267,310,368,325,693
82,82028,820280302,Constitución,SANTA FE,343,351,526,489,1015
82,82028,820280123,Constitución,SANTA FE,204,238,283,248,531
82,82028,820280113,Constitución,SANTA FE,360,438,539,459,998
82,82028,820280202,Constitución,SANTA FE,44,70,56,102,158
82,82028,820289201,Constitución,SANTA FE,50,97,76,84,160
82,82028,820280111,Constitución,SANTA FE,50,109,74,74,148
82,82028,820280211,Constitución,SANTA FE,342,380,523,493,1016
82,82028,820280502,Constitución,SANTA FE,238,262,357,322,679
82,82028,820280513,Constitución,SANTA FE,415,419,747,779,1526
82,82028,820280507,Constitución,SANTA FE,309,320,494,487,981
82,82028,820280320,Constitución,SANTA FE,226,271,344,367,711
82,82028,820280409,Constitución,SANTA FE,327,365,463,403,866
82,82028,820280108,Constitución,SANTA FE,258,247,418,427,845
82,82028,820280104,Constitución,SANTA FE,451,500,727,687,1414
82,82028,820280206,Constitución,SANTA FE,39,96,50,60,110
82,82028,820280215,Constitución,SANTA FE,22,54,29,41,70
82,82028,820280317,Constitución,SANTA FE,37,71,53,64,117
82,82028,820280217,Constitución,SANTA FE,28,63,43,49,92
82,82028,820280119,Constitución,SANTA FE,42,78,35,68,103
82,82028,820280210,Constitución,SANTA FE,23,37,33,21,54
82,82028,820280120,Constitución,SANTA FE,173,192,237,220,457
82,82028,820280117,Constitución,SANTA FE,334,395,476,465,941
82,82028,820280216,Constitución,SANTA FE,235,276,317,293,610
82,82028,820280221,Constitución,SANTA FE,285,329,391,338,729
82,82028,820280112,Constitución,SANTA FE,360,402,528,506,1034
82,82028,820280118,Constitución,SANTA FE,20,37,32,36,68
82,82028,820280106,Constitución,SANTA FE,20,106,19,35,54
82,82028,820280303,Constitución,SANTA FE,359,364,608,541,1149
82,82028,820280517,Constitución,SANTA FE,436,393,879,831,1710
82,82028,820280516,Constitución,SANTA FE,258,258,404,396,800
82,82028,820280511,Constitución,SANTA FE,457,491,730,686,1416
82,82028,820280402,Constitución,SANTA FE,283,302,441,396,837
82,82028,820280411,Constitución,SANTA FE,289,325,428,392,820
82,82028,820280410,Constitución,SANTA FE,491,507,807,724,1531
82,82028,820280307,Constitución,SANTA FE,364,405,593,538,1131
82,82028,820280109,Constitución,SANTA FE,217,239,329,290,619
82,82028,820280101,Constitución,SANTA FE,535,596,804,721,1525
82,82028,820280218,Constitución,SANTA FE,13,27,20,17,37
82,82133,821330204,Vera,SANTA FE,155,131,262,256,518
82,82133,821330608,Vera,SANTA FE,101,131,166,182,348
82,82133,821330312,Vera,SANTA FE,76,89,109,143,252
82,82133,821330631,Vera,SANTA FE,274,305,445,412,857
82,82133,821330629,Vera,SANTA FE,475,514,944,926,1870
82,82133,821330604,Vera,SANTA FE,538,608,817,702,1519
82,82133,821330212,Vera,SANTA FE,429,492,792,807,1599
82,82133,821330414,Vera,SANTA FE,265,303,478,443,921
82,82133,821330201,Vera,SANTA FE,289,366,517,535,1052
82,82133,821330416,Vera,SANTA FE,281,290,585,531,1116
82,82133,821330523,Vera,SANTA FE,26,37,47,57,104
82,82133,821330513,Vera,SANTA FE,8,12,2,17,19
82,82133,821330508,Vera,SANTA FE,7,12,10,11,21
82,82133,821330504,Vera,SANTA FE,109,131,188,221,409
82,82133,821330304,Vera,SANTA FE,13,17,17,28,45
82,82133,821330217,Vera,SANTA FE,18,34,17,28,45
82,82133,821330515,Vera,SANTA FE,22,28,31,34,65
82,82133,821330503,Vera,SANTA FE,9,12,15,16,31
82,82133,821330622,Vera,SANTA FE,20,25,33,50,83
82,82133,821330317,Vera,SANTA FE,20,34,31,34,65
82,82133,821330527,Vera,SANTA FE,19,31,20,41,61
82,82133,821330526,Vera,SANTA FE,13,14,6,21,27
82,82133,821330106,Vera,SANTA FE,3,5,1,6,7
82,82133,821330533,Vera,SANTA FE,341,401,604,592,1196
82,82133,821330619,Vera,SANTA FE,610,568,1037,954,1991
82,82133,821330620,Vera,SANTA FE,510,503,987,954,1941
82,82133,821330413,Vera,SANTA FE,307,336,552,614,1166
82,82133,821330219,Vera,SANTA FE,264,316,504,491,995
82,82133,821330613,Vera,SANTA FE,16,19,18,30,48
82,82133,821330520,Vera,SANTA FE,15,22,16,25,41
82,82133,821330316,Vera,SANTA FE,17,27,35,47,82
82,82133,821330315,Vera,SANTA FE,22,31,40,37,77
82,82133,821330305,Vera,SANTA FE,12,26,21,23,44
82,82133,821330214,Vera,SANTA FE,40,45,65,74,139
82,82133,821330308,Vera,SANTA FE,61,80,72,102,174
82,82133,821330210,Vera,SANTA FE,5,9,10,13,23
82,82133,821330207,Vera,SANTA FE,37,41,53,74,127
82,82133,821330607,Vera,SANTA FE,6,14,12,10,22
82,82133,821330511,Vera,SANTA FE,74,98,130,147,277
82,82133,821330403,Vera,SANTA FE,244,262,452,411,863
82,82133,821330213,Vera,SANTA FE,266,321,507,538,1045
82,82133,821330415,Vera,SANTA FE,529,526,1199,1086,2285
82,82133,821330624,Vera,SANTA FE,16,24,22,25,47
82,82133,821330615,Vera,SANTA FE,8,14,12,16,28
82,82133,821330506,Vera,SANTA FE,2,12,4,5,9
82,82133,821330205,Vera,SANTA FE,4,10,8,10,18
82,82133,821330530,Vera,SANTA FE,15,22,15,33,48
82,82133,821330502,Vera,SANTA FE,22,29,42,51,93
82,82133,821330603,Vera,SANTA FE,110,153,202,208,410
82,82133,821330528,Vera,SANTA FE,54,66,107,106,213
82,82133,821330311,Vera,SANTA FE,122,127,216,229,445
82,82133,821330412,Vera,SANTA FE,354,409,566,539,1105
82,82133,821330409,Vera,SANTA FE,292,318,469,435,904
82,82133,821330408,Vera,SANTA FE,165,230,245,210,455
82,82133,821330627,Vera,SANTA FE,14,34,19,34,53
82,82133,821330602,Vera,SANTA FE,74,98,161,161,322
82,82133,821330518,Vera,SANTA FE,54,88,88,85,173
82,82133,821330509,Vera,SANTA FE,59,76,98,100,198
82,82133,821330507,Vera,SANTA FE,4,20,4,7,11
82,82133,821330301,Vera,SANTA FE,8,13,10,12,22
82,82133,821330218,Vera,SANTA FE,29,40,49,64,113
82,82133,821330606,Vera,SANTA FE,10,11,13,20,33
82,82133,821330510,Vera,SANTA FE,16,41,18,86,104
82,82133,821330110,Vera,SANTA FE,0,1,0,0,0
82,82133,821330108,Vera,SANTA FE,24,27,41,50,91
82,82133,821330105,Vera,SANTA FE,18,19,8,63,71
82,82133,821330103,Vera,SANTA FE,11,16,7,17,24
82,82133,821330517,Vera,SANTA FE,121,154,218,215,433
82,82133,821330630,Vera,SANTA FE,266,308,425,408,833
82,82133,821330618,Vera,SANTA FE,305,318,561,560,1121
82,82133,821330411,Vera,SANTA FE,248,281,400,348,748
82,82133,821330410,Vera,SANTA FE,410,428,741,685,1426
82,82133,821330406,Vera,SANTA FE,297,327,556,476,1032
82,82133,821330402,Vera,SANTA FE,337,355,612,528,1140
82,82133,821330401,Vera,SANTA FE,383,398,837,763,1600
82,82133,821330626,Vera,SANTA FE,18,49,21,28,49
82,82133,821330625,Vera,SANTA FE,9,19,11,16,27
82,82133,821330611,Vera,SANTA FE,8,22,5,11,16
82,82133,821330532,Vera,SANTA FE,12,17,13,25,38
82,82133,821330525,Vera,SANTA FE,41,41,43,60,103
82,82133,821330531,Vera,SANTA FE,13,25,18,21,39
82,82133,821330519,Vera,SANTA FE,0,10,0,0,0
82,82133,821330514,Vera,SANTA FE,39,48,50,72,122
82,82133,821330306,Vera,SANTA FE,1,4,0,1,1
82,82133,821330216,Vera,SANTA FE,26,34,57,55,112
82,82133,821330309,Vera,SANTA FE,15,38,23,28,51
82,82133,821330208,Vera,SANTA FE,5,9,7,8,15
82,82133,821330529,Vera,SANTA FE,10,18,6,15,21
82,82133,821330521,Vera,SANTA FE,0,7,0,0,0
82,82133,821330109,Vera,SANTA FE,3,4,1,3,4
82,82133,821330101,Vera,SANTA FE,22,23,32,53,85
82,82133,821330303,Vera,SANTA FE,59,66,94,111,205
82,82133,821330621,Vera,SANTA FE,289,312,394,383,777
82,82133,821330605,Vera,SANTA FE,419,477,745,694,1439
82,82133,821330505,Vera,SANTA FE,65,71,115,151,266
82,82133,821330405,Vera,SANTA FE,349,425,527,459,986
82,82133,821330404,Vera,SANTA FE,375,427,659,599,1258
82,82133,821330417,Vera,SANTA FE,374,421,699,623,1322
82,82133,821330623,Vera,SANTA FE,23,41,30,41,71
82,82133,821330614,Vera,SANTA FE,40,55,53,76,129
82,82133,821330612,Vera,SANTA FE,11,21,16,21,37
82,82133,821330609,Vera,SANTA FE,10,19,13,20,33
82,82133,821330302,Vera,SANTA FE,0,3,0,0,0
82,82133,821330220,Vera,SANTA FE,3,12,5,7,12
82,82133,821330310,Vera,SANTA FE,43,62,70,83,153
82,82133,821330206,Vera,SANTA FE,85,113,160,171,331
82,82133,821330616,Vera,SANTA FE,6,10,7,10,17
82,82133,821330522,Vera,SANTA FE,41,61,46,73,119
82,82133,821330501,Vera,SANTA FE,41,48,87,93,180
82,82133,821330203,Vera,SANTA FE,6,12,12,10,22
82,82133,821330202,Vera,SANTA FE,26,28,27,48,75
82,82133,821330215,Vera,SANTA FE,51,55,97,96,193
82,82133,821330407,Vera,SANTA FE,237,267,343,311,654
82,82133,821330209,Vera,SANTA FE,95,110,158,166,324
82,82133,821330628,Vera,SANTA FE,9,11,8,20,28
82,82133,821330524,Vera,SANTA FE,34,52,31,54,85
82,82133,821330512,Vera,SANTA FE,21,33,29,33,62
82,82133,821330307,Vera,SANTA FE,39,80,26,59,85
82,82133,821330601,Vera,SANTA FE,12,11,17,19,36
82,82133,821330107,Vera,SANTA FE,65,69,94,124,218
82,82133,821330617,Vera,SANTA FE,294,357,524,575,1099
82,82133,821330534,Vera,SANTA FE,251,277,429,419,848
82,82133,821330313,Vera,SANTA FE,504,580,999,992,1991
82,82133,821330610,Vera,SANTA FE,21,31,40,44,84
82,82133,821330516,Vera,SANTA FE,12,18,11,23,34
82,82133,821330318,Vera,SANTA FE,44,60,67,78,145
82,82133,821330314,Vera,SANTA FE,66,88,124,117,241
82,82133,821330211,Vera,SANTA FE,51,86,87,103,190
82,82133,821330104,Vera,SANTA FE,24,34,16,36,52
82,82133,821330102,Vera,SANTA FE,41,65,41,76,117
82,82105,821050226,San Jerónimo,SANTA FE,210,246,315,263,578
82,82105,821050120,San Jerónimo,SANTA FE,340,368,565,547,1112
82,82105,821050305,San Jerónimo,SANTA FE,290,363,399,355,754
82,82105,821050303,San Jerónimo,SANTA FE,352,413,501,406,907
82,82105,821050302,San Jerónimo,SANTA FE,329,339,596,567,1163
82,82105,821050206,San Jerónimo,SANTA FE,58,158,97,126,223
82,82105,821050108,San Jerónimo,SANTA FE,255,321,464,470,934
82,82105,821050101,San Jerónimo,SANTA FE,113,150,210,228,438
82,82105,821050516,San Jerónimo,SANTA FE,228,255,365,349,714
82,82105,821050515,San Jerónimo,SANTA FE,224,238,325,301,626
82,82105,821050506,San Jerónimo,SANTA FE,338,383,518,472,990
82,82105,821050215,San Jerónimo,SANTA FE,78,67,115,110,225
82,82105,821050119,San Jerónimo,SANTA FE,288,325,452,421,873
82,82105,821050410,San Jerónimo,SANTA FE,397,433,625,674,1299
82,82105,821050411,San Jerónimo,SANTA FE,270,303,382,286,668
82,82105,821050311,San Jerónimo,SANTA FE,234,248,357,344,701
82,82105,821050308,San Jerónimo,SANTA FE,409,455,631,617,1248
82,82105,821050207,San Jerónimo,SANTA FE,20,58,33,39,72
82,82105,821050113,San Jerónimo,SANTA FE,38,79,44,63,107
82,82105,821050109,San Jerónimo,SANTA FE,199,250,333,386,719
82,82105,821050106,San Jerónimo,SANTA FE,24,59,36,40,76
82,82105,821050209,San Jerónimo,SANTA FE,73,149,109,141,250
82,82105,821050513,San Jerónimo,SANTA FE,417,455,630,606,1236
82,82105,821050508,San Jerónimo,SANTA FE,306,395,522,530,1052
82,82105,821050502,San Jerónimo,SANTA FE,356,407,539,532,1071
82,82105,821050229,San Jerónimo,SANTA FE,223,271,321,275,596
82,82105,821050222,San Jerónimo,SANTA FE,380,416,611,581,1192
82,82105,821050116,San Jerónimo,SANTA FE,278,289,470,437,907
82,82105,821050420,San Jerónimo,SANTA FE,272,285,414,368,782
82,82105,821050409,San Jerónimo,SANTA FE,351,433,476,421,897
82,82105,821050408,San Jerónimo,SANTA FE,250,310,350,259,609
82,82105,821050316,San Jerónimo,SANTA FE,322,334,585,519,1104
82,82105,821050313,San Jerónimo,SANTA FE,210,226,330,303,633
82,82105,821050309,San Jerónimo,SANTA FE,17,18,35,1032,1067
82,82105,821050504,San Jerónimo,SANTA FE,172,557,236,262,498
82,82105,821050211,San Jerónimo,SANTA FE,92,180,113,148,261
82,82105,821050228,San Jerónimo,SANTA FE,379,395,672,652,1324
82,82105,821050509,San Jerónimo,SANTA FE,218,271,331,364,695
82,82105,821050505,San Jerónimo,SANTA FE,302,345,430,418,848
82,82105,821050417,San Jerónimo,SANTA FE,249,261,388,378,766
82,82105,821050413,San Jerónimo,SANTA FE,355,383,602,599,1201
82,82105,821050405,San Jerónimo,SANTA FE,235,246,346,333,679
82,82105,821050403,San Jerónimo,SANTA FE,299,339,411,342,753
82,82105,821050231,San Jerónimo,SANTA FE,275,306,476,478,954
82,82105,821050307,San Jerónimo,SANTA FE,252,272,380,319,699
82,82105,821050501,San Jerónimo,SANTA FE,47,74,75,90,165
82,82105,821050121,San Jerónimo,SANTA FE,205,286,352,382,734
82,82105,821050103,San Jerónimo,SANTA FE,266,280,475,471,946
82,82105,821050224,San Jerónimo,SANTA FE,312,353,548,476,1024
82,82105,821050517,San Jerónimo,SANTA FE,198,326,385,382,767
82,82105,821050512,San Jerónimo,SANTA FE,247,290,398,371,769
82,82105,821050416,San Jerónimo,SANTA FE,326,329,576,563,1139
82,82105,821050314,San Jerónimo,SANTA FE,242,260,395,365,760
82,82105,821050312,San Jerónimo,SANTA FE,261,301,409,324,733
82,82105,821050301,San Jerónimo,SANTA FE,619,522,1177,1206,2383
82,82105,821050220,San Jerónimo,SANTA FE,225,250,345,304,649
82,82105,821050503,San Jerónimo,SANTA FE,183,210,315,335,650
82,82105,821050223,San Jerónimo,SANTA FE,213,243,343,318,661
82,82105,821050218,San Jerónimo,SANTA FE,293,344,489,461,950
82,82105,821050214,San Jerónimo,SANTA FE,421,473,694,640,1334
82,82105,821050111,San Jerónimo,SANTA FE,229,255,340,332,672
82,82105,821050105,San Jerónimo,SANTA FE,299,320,443,414,857
82,82105,821050418,San Jerónimo,SANTA FE,263,317,361,313,674
82,82105,821050230,San Jerónimo,SANTA FE,239,269,356,329,685
82,82105,821050507,San Jerónimo,SANTA FE,138,182,225,248,473
82,82105,821050112,San Jerónimo,SANTA FE,279,317,481,455,936
82,82105,821050102,San Jerónimo,SANTA FE,188,288,301,324,625
82,82105,821050118,San Jerónimo,SANTA FE,248,275,382,354,736
82,82105,821050310,San Jerónimo,SANTA FE,489,474,886,934,1820
82,82105,821050212,San Jerónimo,SANTA FE,295,322,448,407,855
82,82105,821050415,San Jerónimo,SANTA FE,284,283,455,484,939
82,82105,821050407,San Jerónimo,SANTA FE,389,433,599,565,1164
82,82105,821050315,San Jerónimo,SANTA FE,141,314,220,253,473
82,82105,821050225,San Jerónimo,SANTA FE,141,155,189,163,352
82,82105,821050306,San Jerónimo,SANTA FE,411,450,717,662,1379
82,82105,821050204,San Jerónimo,SANTA FE,78,176,113,135,248
82,82105,821050203,San Jerónimo,SANTA FE,32,57,38,48,86
82,82105,821050202,San Jerónimo,SANTA FE,27,63,41,45,86
82,82105,821050104,San Jerónimo,SANTA FE,51,89,72,71,143
82,82105,821050210,San Jerónimo,SANTA FE,72,130,105,122,227
82,82105,821050110,San Jerónimo,SANTA FE,223,367,366,436,802
82,82105,821050514,San Jerónimo,SANTA FE,366,413,657,587,1244
82,82105,821050511,San Jerónimo,SANTA FE,289,311,515,530,1045
82,82105,821050217,San Jerónimo,SANTA FE,297,328,429,395,824
82,82105,821050213,San Jerónimo,SANTA FE,488,539,732,664,1396
82,82105,821050221,San Jerónimo,SANTA FE,389,418,621,571,1192
82,82105,821050117,San Jerónimo,SANTA FE,304,342,403,351,754
82,82105,821050404,San Jerónimo,SANTA FE,256,294,384,291,675
82,82105,821050401,San Jerónimo,SANTA FE,355,369,632,626,1258
82,82105,821050510,San Jerónimo,SANTA FE,32,45,59,55,114
82,82105,821050208,San Jerónimo,SANTA FE,31,70,57,55,112
82,82105,821050201,San Jerónimo,SANTA FE,56,78,91,110,201
82,82105,821050115,San Jerónimo,SANTA FE,307,513,442,563,1005
82,82105,821050216,San Jerónimo,SANTA FE,28,35,35,44,79
82,82105,821050219,San Jerónimo,SANTA FE,56,79,80,78,158
82,82105,821050114,San Jerónimo,SANTA FE,262,299,419,401,820
82,82105,821050107,San Jerónimo,SANTA FE,145,108,243,244,487
82,82105,821050419,San Jerónimo,SANTA FE,489,541,776,720,1496
82,82105,821050414,San Jerónimo,SANTA FE,444,476,707,747,1454
82,82105,821050406,San Jerónimo,SANTA FE,266,342,381,288,669
82,82105,821050412,San Jerónimo,SANTA FE,409,444,579,564,1143
82,82105,821050402,San Jerónimo,SANTA FE,291,309,401,395,796
82,82105,821050227,San Jerónimo,SANTA FE,250,298,365,356,721
82,82105,821050304,San Jerónimo,SANTA FE,248,261,362,276,638
82,82105,821050205,San Jerónimo,SANTA FE,53,78,82,80,162
82,82126,821260514,San Martín,SANTA FE,290,293,486,527,1013
82,82126,821260302,San Martín,SANTA FE,366,411,522,466,988
82,82126,821260104,San Martín,SANTA FE,321,364,446,426,872
82,82126,821260515,San Martín,SANTA FE,312,322,563,504,1067
82,82126,821260504,San Martín,SANTA FE,320,355,447,344,791
82,82126,821260508,San Martín,SANTA FE,297,356,402,312,714
82,82126,821260201,San Martín,SANTA FE,392,432,578,575,1153
82,82126,821260215,San Martín,SANTA FE,99,151,171,213,384
82,82126,821260211,San Martín,SANTA FE,36,63,54,78,132
82,82126,821260111,San Martín,SANTA FE,53,126,63,96,159
82,82126,821260214,San Martín,SANTA FE,38,62,63,62,125
82,82126,821260113,San Martín,SANTA FE,64,97,129,144,273
82,82126,821260208,San Martín,SANTA FE,490,549,709,671,1380
82,82126,821260207,San Martín,SANTA FE,400,413,636,627,1263
82,82126,821260202,San Martín,SANTA FE,331,377,444,464,908
82,82126,821260206,San Martín,SANTA FE,225,237,367,362,729
82,82126,821260503,San Martín,SANTA FE,384,426,635,588,1223
82,82126,821260319,San Martín,SANTA FE,358,367,593,573,1166
82,82126,821260410,San Martín,SANTA FE,278,321,380,317,697
82,82126,821260305,San Martín,SANTA FE,131,187,220,217,437
82,82126,821260105,San Martín,SANTA FE,126,206,199,242,441
82,82126,821260404,San Martín,SANTA FE,425,493,606,536,1142
82,82126,821260303,San Martín,SANTA FE,349,414,523,484,1007
82,82126,821260209,San Martín,SANTA FE,362,392,468,441,909
82,82126,821260109,San Martín,SANTA FE,250,283,314,284,598
82,82126,821260108,San Martín,SANTA FE,394,435,572,514,1086
82,82126,821260316,San Martín,SANTA FE,194,208,266,228,494
82,82126,821260506,San Martín,SANTA FE,566,578,981,964,1945
82,82126,821260213,San Martín,SANTA FE,66,100,99,122,221
82,82126,821260301,San Martín,SANTA FE,84,188,128,163,291
82,82126,821260406,San Martín,SANTA FE,399,473,579,553,1132
82,82126,821260312,San Martín,SANTA FE,261,292,354,281,635
82,82126,821260311,San Martín,SANTA FE,384,425,534,456,990
82,82126,821260304,San Martín,SANTA FE,363,403,580,612,1192
82,82126,821260210,San Martín,SANTA FE,472,503,737,719,1456
82,82126,821260106,San Martín,SANTA FE,411,457,615,579,1194
82,82126,821260511,San Martín,SANTA FE,402,455,563,511,1074
82,82126,821260307,San Martín,SANTA FE,390,434,566,593,1159
82,82126,821260516,San Martín,SANTA FE,370,374,569,554,1123
82,82126,821260507,San Martín,SANTA FE,312,381,441,349,790
82,82126,821260505,San Martín,SANTA FE,322,363,456,385,841
82,82126,821260502,San Martín,SANTA FE,305,331,488,468,956
82,82126,821260315,San Martín,SANTA FE,280,314,400,350,750
82,82126,821260306,San Martín,SANTA FE,91,144,133,146,279
82,82126,821260103,San Martín,SANTA FE,123,204,198,223,421
82,82126,821260309,San Martín,SANTA FE,356,371,564,567,1131
82,82126,821260409,San Martín,SANTA FE,517,554,801,809,1610
82,82126,821260512,San Martín,SANTA FE,396,441,589,572,1161
82,82126,821260411,San Martín,SANTA FE,493,568,727,731,1458
82,82126,821260317,San Martín,SANTA FE,465,501,684,664,1348
82,82126,821260318,San Martín,SANTA FE,242,262,351,297,648
82,82126,821260403,San Martín,SANTA FE,64,121,83,114,197
82,82126,821260402,San Martín,SANTA FE,74,144,105,142,247
82,82126,821260204,San Martín,SANTA FE,80,98,181,177,358
82,82126,821260112,San Martín,SANTA FE,93,168,131,193,324
82,82126,821260407,San Martín,SANTA FE,205,319,357,382,739
82,82126,821260308,San Martín,SANTA FE,185,192,328,339,667
82,82126,821260110,San Martín,SANTA FE,280,292,358,344,702
82,82126,821260107,San Martín,SANTA FE,337,353,530,565,1095
82,82126,821260102,San Martín,SANTA FE,78,86,133,134,267
82,82126,821260101,San Martín,SANTA FE,210,237,304,310,614
82,82126,821260517,San Martín,SANTA FE,411,414,685,634,1319
82,82126,821260513,San Martín,SANTA FE,268,331,432,378,810
82,82126,821260509,San Martín,SANTA FE,335,323,575,589,1164
82,82126,821260314,San Martín,SANTA FE,344,402,556,519,1075
82,82126,821260405,San Martín,SANTA FE,345,389,532,530,1062
82,82126,821260310,San Martín,SANTA FE,259,293,360,313,673
82,82126,821260216,San Martín,SANTA FE,44,58,65,90,155
82,82126,821260401,San Martín,SANTA FE,447,507,640,638,1278
82,82126,821260203,San Martín,SANTA FE,23,32,32,33,65
82,82126,821260501,San Martín,SANTA FE,222,262,336,305,641
82,82126,821260313,San Martín,SANTA FE,458,506,765,744,1509
82,82126,821260114,San Martín,SANTA FE,231,258,329,292,621
82,82126,821260217,San Martín,SANTA FE,387,428,559,587,1146
82,82126,821260408,San Martín,SANTA FE,294,327,403,404,807
82,82126,821260205,San Martín,SANTA FE,50,62,80,92,172
82,82126,821260510,San Martín,SANTA FE,333,382,502,481,983
82,82126,821260212,San Martín,SANTA FE,61,101,83,113,196
82,82042,820421112,General López,SANTA FE,219,251,316,334,650
82,82042,820421114,General López,SANTA FE,283,343,372,317,689
82,82042,820421106,General López,SANTA FE,355,418,520,514,1034
82,82042,820421015,General López,SANTA FE,363,383,603,595,1198
82,82042,820421010,General López,SANTA FE,422,410,783,809,1592
82,82042,820420915,General López,SANTA FE,226,253,314,254,568
82,82042,820421007,General López,SANTA FE,339,356,519,468,987
82,82042,820420926,General López,SANTA FE,258,297,392,327,719
82,82042,820420921,General López,SANTA FE,481,527,743,766,1509
82,82042,820420904,General López,SANTA FE,229,254,334,323,657
82,82042,820420811,General López,SANTA FE,296,331,511,497,1008
82,82042,820420810,General López,SANTA FE,344,385,457,407,864
82,82042,820420808,General López,SANTA FE,302,435,383,316,699
82,82042,820420807,General López,SANTA FE,266,369,394,292,686
82,82042,820420714,General López,SANTA FE,376,423,537,446,983
82,82042,820420705,General López,SANTA FE,440,450,735,647,1382
82,82042,820420622,General López,SANTA FE,229,265,341,292,633
82,82042,820420620,General López,SANTA FE,352,434,520,501,1021
82,82042,820420619,General López,SANTA FE,314,392,508,552,1060
82,82042,820420617,General López,SANTA FE,233,238,392,377,769
82,82042,820420606,General López,SANTA FE,400,477,624,558,1182
82,82042,820420918,General López,SANTA FE,304,415,399,313,712
82,82042,820420411,General López,SANTA FE,159,182,257,217,474
82,82042,820420408,General López,SANTA FE,390,448,619,631,1250
82,82042,820420406,General López,SANTA FE,337,392,455,385,840
82,82042,820420323,General López,SANTA FE,287,306,421,429,850
82,82042,820420317,General López,SANTA FE,251,312,370,315,685
82,82042,820420108,General López,SANTA FE,439,442,664,654,1318
82,82042,820420222,General López,SANTA FE,310,339,500,464,964
82,82042,820421213,General López,SANTA FE,316,322,479,415,894
82,82042,820421211,General López,SANTA FE,342,409,479,433,912
82,82042,820421120,General López,SANTA FE,262,296,411,398,809
82,82042,820421115,General López,SANTA FE,317,365,474,391,865
82,82042,820421102,General López,SANTA FE,20,54,24,30,54
82,82042,820420321,General López,SANTA FE,29,44,58,53,111
82,82042,820429101,General López,SANTA FE,15,67,20,21,41
82,82042,820421103,General López,SANTA FE,115,143,168,205,373
82,82042,820421016,General López,SANTA FE,443,447,871,924,1795
82,82042,820421014,General López,SANTA FE,228,237,350,313,663
82,82042,820420910,General López,SANTA FE,194,261,239,193,432
82,82042,820420925,General López,SANTA FE,293,331,412,346,758
82,82042,820420907,General López,SANTA FE,400,438,566,494,1060
82,82042,820420806,General López,SANTA FE,364,402,505,398,903
82,82042,820420805,General López,SANTA FE,410,536,548,418,966
82,82042,820420803,General López,SANTA FE,241,399,294,218,512
82,82042,820420802,General López,SANTA FE,364,495,507,397,904
82,82042,820420801,General López,SANTA FE,297,388,440,385,825
82,82042,820420716,General López,SANTA FE,441,483,743,660,1403
82,82042,820420713,General López,SANTA FE,247,319,326,259,585
82,82042,820420706,General López,SANTA FE,387,435,573,481,1054
82,82042,820420416,General López,SANTA FE,200,233,279,257,536
82,82042,820420407,General López,SANTA FE,238,257,306,269,575
82,82042,820420403,General López,SANTA FE,473,490,838,870,1708
82,82042,820420314,General López,SANTA FE,315,353,499,506,1005
82,82042,820420313,General López,SANTA FE,552,567,818,787,1605
82,82042,820420309,General López,SANTA FE,157,189,195,224,419
82,82042,820420215,General López,SANTA FE,448,478,689,614,1303
82,82042,820420121,General López,SANTA FE,98,163,134,145,279
82,82042,820420112,General López,SANTA FE,309,363,463,400,863
82,82042,820420109,General López,SANTA FE,411,454,587,612,1199
82,82042,820420107,General López,SANTA FE,322,341,547,545,1092
82,82042,820420102,General López,SANTA FE,226,264,324,324,648
82,82042,820420206,General López,SANTA FE,338,377,576,606,1182
82,82042,820421208,General López,SANTA FE,415,461,611,567,1178
82,82042,820421113,General López,SANTA FE,265,271,383,326,709
82,82042,820420217,General López,SANTA FE,100,121,135,166,301
82,82042,820420120,General López,SANTA FE,52,116,56,81,137
82,82042,820420118,General López,SANTA FE,62,83,87,118,205
82,82042,820421215,General López,SANTA FE,31,77,32,51,83
82,82042,820421117,General López,SANTA FE,91,156,123,152,275
82,82042,820421216,General López,SANTA FE,345,394,464,464,928
82,82042,820420305,General López,SANTA FE,110,115,152,198,350
82,82042,820420202,General López,SANTA FE,158,179,258,241,499
82,82042,820421108,General López,SANTA FE,236,296,365,351,716
82,82042,820421009,General López,SANTA FE,227,248,415,384,799
82,82042,820420914,General López,SANTA FE,279,321,399,347,746
82,82042,820420912,General López,SANTA FE,257,324,325,320,645
82,82042,820421004,General López,SANTA FE,363,383,583,493,1076
82,82042,820421003,General López,SANTA FE,332,365,479,415,894
82,82042,820420903,General López,SANTA FE,520,594,806,751,1557
82,82042,820420711,General López,SANTA FE,294,317,503,500,1003
82,82042,820420709,General López,SANTA FE,269,321,358,307,665
82,82042,820420703,General López,SANTA FE,211,233,368,326,694
82,82042,820420418,General López,SANTA FE,298,356,444,444,888
82,82042,820420412,General López,SANTA FE,213,219,312,269,581
82,82042,820420409,General López,SANTA FE,286,315,388,335,723
82,82042,820420324,General López,SANTA FE,223,254,322,280,602
82,82042,820420212,General López,SANTA FE,282,309,423,409,832
82,82042,820420304,General López,SANTA FE,72,123,101,115,216
82,82042,820420301,General López,SANTA FE,67,94,82,103,185
82,82042,820420201,General López,SANTA FE,108,82,85,147,232
82,82042,820420113,General López,SANTA FE,54,67,80,88,168
82,82042,820420101,General López,SANTA FE,43,115,46,50,96
82,82042,820421202,General López,SANTA FE,74,115,100,114,214
82,82042,820420308,General López,SANTA FE,198,241,264,321,585
82,82042,820421209,General López,SANTA FE,120,223,145,179,324
82,82042,820421110,General López,SANTA FE,194,239,272,331,603
82,82042,820420911,General López,SANTA FE,251,306,374,304,678
82,82042,820421005,General López,SANTA FE,262,267,483,478,961
82,82042,820420804,General López,SANTA FE,271,412,333,258,591
82,82042,820420712,General López,SANTA FE,335,425,466,413,879
82,82042,820420704,General López,SANTA FE,411,426,705,677,1382
82,82042,820420701,General López,SANTA FE,283,394,477,489,966
82,82042,820420608,General López,SANTA FE,348,426,472,371,843
82,82042,820420607,General López,SANTA FE,329,370,475,422,897
82,82042,820420507,General López,SANTA FE,335,377,457,408,865
82,82042,820420421,General López,SANTA FE,405,444,603,548,1151
82,82042,820420420,General López,SANTA FE,37,37,67,55,122
82,82042,820420415,General López,SANTA FE,341,389,525,515,1040
82,82042,820420306,General López,SANTA FE,84,123,121,115,236
82,82042,820420221,General López,SANTA FE,425,453,623,608,1231
82,82042,820421121,General López,SANTA FE,220,243,346,334,680
82,82042,820421119,General López,SANTA FE,253,295,388,338,726
82,82042,820421206,General López,SANTA FE,276,309,374,316,690
82,82042,820421205,General López,SANTA FE,298,345,433,385,818
82,82042,820421204,General López,SANTA FE,325,367,498,488,986
82,82042,820421116,General López,SANTA FE,363,417,528,526,1054
82,82042,820421107,General López,SANTA FE,34,108,43,55,98
82,82042,820420322,General López,SANTA FE,26,61,27,46,73
82,82042,820420216,General López,SANTA FE,106,149,152,159,311
82,82042,820420116,General López,SANTA FE,96,149,142,176,318
82,82042,820420105,General López,SANTA FE,35,53,36,46,82
82,82042,820420302,General López,SANTA FE,169,282,215,266,481
82,82042,820420106,General López,SANTA FE,57,97,86,100,186
82,82042,820421111,General López,SANTA FE,204,336,296,312,608
82,82042,820421109,General López,SANTA FE,311,387,448,372,820
82,82042,820421012,General López,SANTA FE,313,334,517,525,1042
82,82042,820421008,General López,SANTA FE,418,451,727,777,1504
82,82042,820421001,General López,SANTA FE,269,286,409,372,781
82,82042,820420923,General López,SANTA FE,518,553,809,811,1620
82,82042,820420922,General López,SANTA FE,417,446,838,817,1655
82,82042,820420717,General López,SANTA FE,408,454,690,760,1450
82,82042,820420708,General López,SANTA FE,251,300,341,287,628
82,82042,820420707,General López,SANTA FE,391,464,515,459,974
82,82042,820420901,General López,SANTA FE,444,509,731,770,1501
82,82042,820420604,General López,SANTA FE,382,433,579,557,1136
82,82042,820420509,General López,SANTA FE,193,191,293,267,560
82,82042,820420506,General López,SANTA FE,339,390,514,491,1005
82,82042,820420401,General López,SANTA FE,418,494,555,572,1127
82,82042,820420315,General López,SANTA FE,304,348,460,446,906
82,82042,820420312,General López,SANTA FE,362,411,589,616,1205
82,82042,820420220,General López,SANTA FE,336,378,485,471,956
82,82042,820420123,General López,SANTA FE,251,298,378,391,769
82,82042,820420122,General López,SANTA FE,323,354,476,456,932
82,82042,820421214,General López,SANTA FE,394,426,611,557,1168
82,82042,820421210,General López,SANTA FE,477,489,785,753,1538
82,82042,820421104,General López,SANTA FE,20,43,33,33,66
82,82042,820420211,General López,SANTA FE,107,147,159,197,356
82,82042,820420204,General López,SANTA FE,83,140,95,121,216
82,82042,820420110,General López,SANTA FE,158,301,243,266,509
82,82042,820420924,General López,SANTA FE,232,269,337,279,616
82,82042,820420419,General López,SANTA FE,273,294,518,488,1006
82,82042,820420316,General López,SANTA FE,440,438,650,597,1247
82,82042,820421105,General López,SANTA FE,332,404,447,425,872
82,82042,820421011,General López,SANTA FE,684,701,1370,1316,2686
82,82042,820420909,General López,SANTA FE,408,483,610,446,1056
82,82042,820420908,General López,SANTA FE,253,285,337,303,640
82,82042,820420809,General López,SANTA FE,333,436,445,401,846
82,82042,820420720,General López,SANTA FE,235,244,376,361,737
82,82042,820420621,General López,SANTA FE,246,302,363,357,720
82,82042,820420609,General López,SANTA FE,124,148,176,145,321
82,82042,820420504,General López,SANTA FE,188,215,269,237,506
82,82042,820420503,General López,SANTA FE,459,491,730,767,1497
82,82042,820420501,General López,SANTA FE,422,461,645,634,1279
82,82042,820420417,General López,SANTA FE,477,548,699,640,1339
82,82042,820420615,General López,SANTA FE,99,113,149,110,259
82,82042,820420611,General López,SANTA FE,350,425,494,387,881
82,82042,820420311,General López,SANTA FE,284,328,406,447,853
82,82042,820420214,General López,SANTA FE,407,444,670,671,1341
82,82042,820420319,General López,SANTA FE,178,220,254,255,509
82,82042,820420207,General López,SANTA FE,247,284,334,317,651
82,82042,820421207,General López,SANTA FE,288,327,422,349,771
82,82042,820421203,General López,SANTA FE,455,510,759,731,1490
82,82042,820420303,General López,SANTA FE,71,124,79,98,177
82,82042,820421201,General López,SANTA FE,102,145,116,157,273
82,82042,820420218,General López,SANTA FE,122,182,190,206,396
82,82042,820420119,General López,SANTA FE,114,143,152,210,362
82,82042,820420219,General López,SANTA FE,380,432,618,604,1222
82,82042,820420210,General López,SANTA FE,169,209,292,279,571
82,82042,820420104,General López,SANTA FE,110,146,186,166,352
82,82042,820421013,General López,SANTA FE,290,309,467,424,891
82,82042,820420913,General López,SANTA FE,243,276,340,305,645
82,82042,820421002,General López,SANTA FE,462,485,730,727,1457
82,82042,820420905,General López,SANTA FE,352,379,549,520,1069
82,82042,820420719,General López,SANTA FE,209,228,309,269,578
82,82042,820420715,General López,SANTA FE,441,497,771,855,1626
82,82042,820420710,General López,SANTA FE,334,400,452,415,867
82,82042,820420618,General López,SANTA FE,265,285,443,426,869
82,82042,820420602,General López,SANTA FE,269,260,430,455,885
82,82042,820420508,General López,SANTA FE,456,481,676,706,1382
82,82042,820420414,General López,SANTA FE,262,297,410,348,758
82,82042,820420413,General López,SANTA FE,380,400,616,604,1220
82,82042,820420402,General López,SANTA FE,561,587,915,1034,1949
82,82042,820420616,General López,SANTA FE,262,309,392,346,738
82,82042,820420613,General López,SANTA FE,320,380,453,396,849
82,82042,820420213,General López,SANTA FE,305,333,429,361,790
82,82042,820420404,General López,SANTA FE,438,478,688,648,1336
82,82042,820420405,General López,SANTA FE,219,257,330,282,612
82,82042,820420111,General López,SANTA FE,344,390,517,494,1011
82,82042,820420205,General López,SANTA FE,352,403,532,501,1033
82,82042,820421212,General López,SANTA FE,390,415,620,546,1166
82,82042,820420320,General López,SANTA FE,27,36,34,42,76
82,82042,820420209,General López,SANTA FE,35,66,42,58,100
82,82042,820420203,General López,SANTA FE,58,97,85,95,180
82,82042,820420124,General López,SANTA FE,112,184,160,181,341
82,82042,820420307,General López,SANTA FE,46,59,64,80,144
82,82042,820420117,General López,SANTA FE,121,158,212,213,425
82,82042,820420920,General López,SANTA FE,316,324,542,536,1078
82,82042,820420916,General López,SANTA FE,525,556,807,794,1601
82,82042,820421006,General López,SANTA FE,261,263,405,381,786
82,82042,820420906,General López,SANTA FE,545,579,988,993,1981
82,82042,820420721,General López,SANTA FE,232,259,380,342,722
82,82042,820420718,General López,SANTA FE,258,301,391,331,722
82,82042,820420902,General López,SANTA FE,292,327,493,475,968
82,82042,820420702,General López,SANTA FE,262,292,440,457,897
82,82042,820420605,General López,SANTA FE,328,371,495,449,944
82,82042,820420603,General López,SANTA FE,384,422,578,547,1125
82,82042,820420601,General López,SANTA FE,307,323,455,454,909
82,82042,820420505,General López,SANTA FE,279,294,398,299,697
82,82042,820420919,General López,SANTA FE,372,389,624,685,1309
82,82042,820420917,General López,SANTA FE,349,375,604,625,1229
82,82042,820420502,General López,SANTA FE,375,435,537,493,1030
82,82042,820420410,General López,SANTA FE,218,260,288,234,522
82,82042,820420614,General López,SANTA FE,262,289,382,328,710
82,82042,820420612,General López,SANTA FE,307,392,445,377,822
82,82042,820420610,General López,SANTA FE,431,513,595,559,1154
82,82042,820420318,General López,SANTA FE,391,434,612,606,1218
82,82042,820420310,General López,SANTA FE,232,271,352,332,684
82,82042,820420115,General López,SANTA FE,272,302,347,351,698
82,82042,820420103,General López,SANTA FE,283,312,412,389,801
82,82042,820420208,General López,SANTA FE,243,266,342,315,657
82,82042,820421118,General López,SANTA FE,307,366,456,429,885
82,82014,820140419,Caseros,SANTA FE,352,384,522,469,991
82,82014,820140608,Caseros,SANTA FE,357,418,528,519,1047
82,82014,820140503,Caseros,SANTA FE,403,456,624,558,1182
82,82014,820140420,Caseros,SANTA FE,276,294,385,341,726
82,82014,820140506,Caseros,SANTA FE,367,413,531,507,1038
82,82014,820140215,Caseros,SANTA FE,186,213,251,170,421
82,82014,820140212,Caseros,SANTA FE,177,213,261,262,523
82,82014,820140203,Caseros,SANTA FE,304,328,457,392,849
82,82014,820140303,Caseros,SANTA FE,434,491,552,444,996
82,82014,820140114,Caseros,SANTA FE,374,418,541,525,1066
82,82014,820140108,Caseros,SANTA FE,277,299,416,420,836
82,82014,820140414,Caseros,SANTA FE,5,52,4,8,12
82,82014,820140516,Caseros,SANTA FE,23,95,29,40,69
82,82014,820140524,Caseros,SANTA FE,174,214,259,261,520
82,82014,820140510,Caseros,SANTA FE,358,381,542,444,986
82,82014,820140208,Caseros,SANTA FE,263,314,383,333,716
82,82014,820140412,Caseros,SANTA FE,340,337,559,508,1067
82,82014,820140410,Caseros,SANTA FE,285,287,489,478,967
82,82014,820140408,Caseros,SANTA FE,377,357,599,608,1207
82,82014,820140404,Caseros,SANTA FE,328,365,476,488,964
82,82014,820140403,Caseros,SANTA FE,346,363,502,490,992
82,82014,820140307,Caseros,SANTA FE,473,489,829,860,1689
82,82014,820140304,Caseros,SANTA FE,213,241,302,242,544
82,82014,820140219,Caseros,SANTA FE,261,308,426,440,866
82,82014,820140112,Caseros,SANTA FE,410,464,607,546,1153
82,82014,820140106,Caseros,SANTA FE,371,400,528,482,1010
82,82014,820140101,Caseros,SANTA FE,428,486,630,647,1277
82,82014,820140118,Caseros,SANTA FE,7,36,10,10,20
82,82014,820140124,Caseros,SANTA FE,29,70,29,43,72
82,82014,820140121,Caseros,SANTA FE,45,82,60,72,132
82,82014,820140119,Caseros,SANTA FE,23,40,29,39,68
82,82014,820140505,Caseros,SANTA FE,88,241,115,145,260
82,82014,820140502,Caseros,SANTA FE,51,165,61,73,134
82,82014,820140603,Caseros,SANTA FE,224,262,304,248,552
82,82014,820140518,Caseros,SANTA FE,210,242,306,274,580
82,82014,820140504,Caseros,SANTA FE,364,450,527,469,996
82,82014,820140508,Caseros,SANTA FE,342,385,461,380,841
82,82014,820140406,Caseros,SANTA FE,398,441,635,576,1211
82,82014,820140405,Caseros,SANTA FE,309,366,441,410,851
82,82014,820140402,Caseros,SANTA FE,331,358,465,444,909
82,82014,820140107,Caseros,SANTA FE,326,350,536,490,1026
82,82014,820140209,Caseros,SANTA FE,226,259,322,287,609
82,82014,820140413,Caseros,SANTA FE,19,62,16,27,43
82,82014,820140312,Caseros,SANTA FE,39,84,46,60,106
82,82014,820140522,Caseros,SANTA FE,9,28,9,17,26
82,82014,820140512,Caseros,SANTA FE,17,61,20,30,50
82,82014,820140201,Caseros,SANTA FE,54,121,65,78,143
82,82014,820140127,Caseros,SANTA FE,32,80,44,52,96
82,82014,820140517,Caseros,SANTA FE,389,409,543,540,1083
82,82014,820140602,Caseros,SANTA FE,451,496,716,677,1393
82,82014,820140523,Caseros,SANTA FE,269,286,368,325,693
82,82014,820140519,Caseros,SANTA FE,273,307,416,361,777
82,82014,820140513,Caseros,SANTA FE,231,259,337,319,656
82,82014,820140409,Caseros,SANTA FE,231,255,322,291,613
82,82014,820140407,Caseros,SANTA FE,290,307,489,414,903
82,82014,820140401,Caseros,SANTA FE,283,322,482,419,901
82,82014,820140310,Caseros,SANTA FE,313,332,415,392,807
82,82014,820140111,Caseros,SANTA FE,345,375,531,520,1051
82,82014,820140109,Caseros,SANTA FE,451,502,639,567,1206
82,82014,820140521,Caseros,SANTA FE,5,19,6,8,14
82,82014,820140123,Caseros,SANTA FE,6,39,6,11,17
82,82014,820140610,Caseros,SANTA FE,16,47,21,16,37
82,82014,820140607,Caseros,SANTA FE,431,465,667,590,1257
82,82014,820140605,Caseros,SANTA FE,459,529,830,807,1637
82,82014,820140514,Caseros,SANTA FE,326,383,510,486,996
82,82014,820140216,Caseros,SANTA FE,211,242,322,251,573
82,82014,820140213,Caseros,SANTA FE,203,238,279,227,506
82,82014,820140217,Caseros,SANTA FE,234,271,334,276,610
82,82014,820140116,Caseros,SANTA FE,250,261,426,409,835
82,82014,820140105,Caseros,SANTA FE,293,346,437,365,802
82,82014,820140102,Caseros,SANTA FE,419,474,645,646,1291
82,82014,820140417,Caseros,SANTA FE,56,106,96,90,186
82,82014,820140415,Caseros,SANTA FE,97,151,149,164,313
82,82014,820140411,Caseros,SANTA FE,327,368,471,419,890
82,82014,820140205,Caseros,SANTA FE,297,337,436,374,810
82,82014,820140609,Caseros,SANTA FE,403,439,703,689,1392
82,82014,820140601,Caseros,SANTA FE,765,782,1496,1538,3034
82,82014,820140511,Caseros,SANTA FE,328,353,490,504,994
82,82014,820140130,Caseros,SANTA FE,266,301,393,344,737
82,82014,820140306,Caseros,SANTA FE,94,113,158,169,327
82,82014,820140218,Caseros,SANTA FE,398,434,702,677,1379
82,82014,820140117,Caseros,SANTA FE,278,307,386,420,806
82,82014,820149001,Caseros,SANTA FE,23,90,35,40,75
82,82014,820140501,Caseros,SANTA FE,17,64,15,24,39
82,82014,820140416,Caseros,SANTA FE,101,137,143,161,304
82,82014,820140418,Caseros,SANTA FE,80,156,118,135,253
82,82014,820140202,Caseros,SANTA FE,33,69,49,64,113
82,82014,820140126,Caseros,SANTA FE,49,131,59,79,138
82,82014,820140509,Caseros,SANTA FE,231,252,331,326,657
82,82014,820140214,Caseros,SANTA FE,208,260,290,241,531
82,82014,820140207,Caseros,SANTA FE,327,360,510,465,975
82,82014,820140309,Caseros,SANTA FE,282,306,412,386,798
82,82014,820140302,Caseros,SANTA FE,259,301,398,285,683
82,82014,820140115,Caseros,SANTA FE,460,506,694,626,1320
82,82014,820140110,Caseros,SANTA FE,432,486,634,604,1238
82,82014,820140103,Caseros,SANTA FE,281,300,430,406,836
82,82014,820140515,Caseros,SANTA FE,24,33,25,35,60
82,82014,820140125,Caseros,SANTA FE,20,92,17,32,49
82,82014,820140520,Caseros,SANTA FE,10,33,13,17,30
82,82014,820140122,Caseros,SANTA FE,17,53,28,28,56
82,82014,820140120,Caseros,SANTA FE,35,46,50,60,110
82,82014,820140128,Caseros,SANTA FE,64,115,95,101,196
82,82014,820140129,Caseros,SANTA FE,46,52,72,80,152
82,82014,820140606,Caseros,SANTA FE,262,312,437,422,859
82,82014,820140604,Caseros,SANTA FE,356,392,557,527,1084
82,82014,820140507,Caseros,SANTA FE,306,333,425,399,824
82,82014,820140211,Caseros,SANTA FE,240,311,342,282,624
82,82014,820140210,Caseros,SANTA FE,338,426,433,355,788
82,82014,820140206,Caseros,SANTA FE,322,357,505,481,986
82,82014,820140204,Caseros,SANTA FE,491,522,788,817,1605
82,82014,820140311,Caseros,SANTA FE,298,387,434,426,860
82,82014,820140308,Caseros,SANTA FE,259,276,436,459,895
82,82014,820140305,Caseros,SANTA FE,289,312,425,357,782
82,82014,820140301,Caseros,SANTA FE,228,245,312,265,577
82,82014,820140113,Caseros,SANTA FE,313,327,475,470,945
82,82014,820140104,Caseros,SANTA FE,230,267,343,275,618
82,82014,820140611,Caseros,SANTA FE,27,83,36,39,75
62,62084,620840103,Valcheta,RIO NEGRO,122,154,201,206,407
62,62084,620840209,Valcheta,RIO NEGRO,68,131,36,92,128
62,62084,620840206,Valcheta,RIO NEGRO,34,51,22,47,69
62,62084,620840201,Valcheta,RIO NEGRO,9,21,14,18,32
62,62084,620840203,Valcheta,RIO NEGRO,23,33,31,43,74
62,62084,620840208,Valcheta,RIO NEGRO,144,213,81,190,271
62,62084,620840204,Valcheta,RIO NEGRO,54,87,81,87,168
62,62084,620840107,Valcheta,RIO NEGRO,175,220,307,313,620
62,62084,620840105,Valcheta,RIO NEGRO,167,203,297,264,561
62,62084,620840104,Valcheta,RIO NEGRO,248,297,481,425,906
62,62084,620840101,Valcheta,RIO NEGRO,168,185,254,251,505
62,62084,620840205,Valcheta,RIO NEGRO,14,41,11,19,30
62,62084,620840207,Valcheta,RIO NEGRO,39,75,28,55,83
62,62084,620840202,Valcheta,RIO NEGRO,43,46,73,82,155
62,62084,620840106,Valcheta,RIO NEGRO,134,179,236,217,453
62,62084,620840102,Valcheta,RIO NEGRO,153,195,218,197,415
62,62070,620700202,Pilcaniyeu,RIO NEGRO,191,253,285,299,584
62,62070,620700106,Pilcaniyeu,RIO NEGRO,146,194,166,234,400
62,62070,620700101,Pilcaniyeu,RIO NEGRO,236,279,373,384,757
62,62070,620700107,Pilcaniyeu,RIO NEGRO,127,194,162,239,401
62,62070,620700203,Pilcaniyeu,RIO NEGRO,298,363,526,501,1027
62,62070,620700103,Pilcaniyeu,RIO NEGRO,182,219,365,329,694
62,62070,620700204,Pilcaniyeu,RIO NEGRO,181,228,257,256,513
62,62070,620700205,Pilcaniyeu,RIO NEGRO,213,268,336,320,656
62,62070,620700102,Pilcaniyeu,RIO NEGRO,232,297,434,369,803
62,62070,620700104,Pilcaniyeu,RIO NEGRO,217,307,267,335,602
62,62070,620700201,Pilcaniyeu,RIO NEGRO,246,308,350,339,689
62,62070,620700105,Pilcaniyeu,RIO NEGRO,91,61,138,164,302
62,62021,620211111,Bariloche,RIO NEGRO,258,285,455,428,883
62,62021,620210503,Bariloche,RIO NEGRO,16,35,38,72,110
62,62021,620210402,Bariloche,RIO NEGRO,75,101,86,139,225
62,62021,620210702,Bariloche,RIO NEGRO,121,164,166,183,349
62,62021,620211901,Bariloche,RIO NEGRO,185,189,287,241,528
62,62021,620211802,Bariloche,RIO NEGRO,248,289,341,348,689
62,62021,620211801,Bariloche,RIO NEGRO,240,295,345,351,696
62,62021,620211707,Bariloche,RIO NEGRO,232,242,448,432,880
62,62021,620211704,Bariloche,RIO NEGRO,201,238,344,361,705
62,62021,620211511,Bariloche,RIO NEGRO,195,264,253,202,455
62,62021,620211417,Bariloche,RIO NEGRO,216,273,329,367,696
62,62021,620211411,Bariloche,RIO NEGRO,303,330,544,561,1105
62,62021,620211404,Bariloche,RIO NEGRO,334,383,590,692,1282
62,62021,620211307,Bariloche,RIO NEGRO,213,277,337,313,650
62,62021,620211209,Bariloche,RIO NEGRO,37,158,37,51,88
62,62021,620211104,Bariloche,RIO NEGRO,194,255,357,354,711
62,62021,620210908,Bariloche,RIO NEGRO,394,443,593,580,1173
62,62021,620210906,Bariloche,RIO NEGRO,190,240,256,290,546
62,62021,620210805,Bariloche,RIO NEGRO,264,263,437,394,831
62,62021,620210601,Bariloche,RIO NEGRO,108,134,178,153,331
62,62021,620211601,Bariloche,RIO NEGRO,321,361,453,452,905
62,62021,620210313,Bariloche,RIO NEGRO,219,302,271,210,481
62,62021,620210306,Bariloche,RIO NEGRO,116,243,128,90,218
62,62021,620210304,Bariloche,RIO NEGRO,146,212,442,400,842
62,62021,620210212,Bariloche,RIO NEGRO,177,234,329,337,666
62,62021,620210211,Bariloche,RIO NEGRO,316,356,549,537,1086
62,62021,620211910,Bariloche,RIO NEGRO,192,206,331,293,624
62,62021,620211603,Bariloche,RIO NEGRO,357,352,613,552,1165
62,62021,620210403,Bariloche,RIO NEGRO,26,61,26,33,59
62,62021,620210103,Bariloche,RIO NEGRO,94,175,163,158,321
62,62021,620210708,Bariloche,RIO NEGRO,128,122,160,204,364
62,62021,620210502,Bariloche,RIO NEGRO,121,172,137,179,316
62,62021,620211501,Bariloche,RIO NEGRO,147,258,361,304,665
62,62021,620211508,Bariloche,RIO NEGRO,155,184,212,176,388
62,62021,620211504,Bariloche,RIO NEGRO,149,221,182,129,311
62,62021,620211413,Bariloche,RIO NEGRO,192,227,306,307,613
62,62021,620211204,Bariloche,RIO NEGRO,128,172,207,199,406
62,62021,620211006,Bariloche,RIO NEGRO,218,222,428,398,826
62,62021,620211004,Bariloche,RIO NEGRO,191,204,307,329,636
62,62021,620210909,Bariloche,RIO NEGRO,196,214,324,302,626
62,62021,620210901,Bariloche,RIO NEGRO,212,304,318,266,584
62,62021,620210808,Bariloche,RIO NEGRO,241,287,377,396,773
62,62021,620210606,Bariloche,RIO NEGRO,180,232,276,259,535
62,62021,620210604,Bariloche,RIO NEGRO,232,266,314,269,583
62,62021,620210905,Bariloche,RIO NEGRO,328,404,471,437,908
62,62021,620210904,Bariloche,RIO NEGRO,379,415,558,580,1138
62,62021,620210101,Bariloche,RIO NEGRO,119,211,293,244,537
62,62021,620211911,Bariloche,RIO NEGRO,270,309,449,416,865
62,62021,620210303,Bariloche,RIO NEGRO,194,250,182,150,332
62,62021,620210704,Bariloche,RIO NEGRO,128,146,178,228,406
62,62021,620210703,Bariloche,RIO NEGRO,130,121,171,165,336
62,62021,620210201,Bariloche,RIO NEGRO,93,122,145,130,275
62,62021,620210710,Bariloche,RIO NEGRO,140,173,206,207,413
62,62021,620211912,Bariloche,RIO NEGRO,229,268,377,371,748
62,62021,620211903,Bariloche,RIO NEGRO,267,357,354,341,695
62,62021,620211902,Bariloche,RIO NEGRO,234,289,359,352,711
62,62021,620211809,Bariloche,RIO NEGRO,280,267,511,450,961
62,62021,620211808,Bariloche,RIO NEGRO,133,87,246,263,509
62,62021,620211706,Bariloche,RIO NEGRO,239,246,461,468,929
62,62021,620211505,Bariloche,RIO NEGRO,160,180,206,179,385
62,62021,620211410,Bariloche,RIO NEGRO,344,373,546,638,1184
62,62021,620211308,Bariloche,RIO NEGRO,207,261,305,303,608
62,62021,620211306,Bariloche,RIO NEGRO,219,256,307,292,599
62,62021,620211310,Bariloche,RIO NEGRO,200,237,317,267,584
62,62021,620211114,Bariloche,RIO NEGRO,157,221,211,241,452
62,62021,620211113,Bariloche,RIO NEGRO,224,284,323,308,631
62,62021,620211415,Bariloche,RIO NEGRO,260,334,381,395,776
62,62021,620211007,Bariloche,RIO NEGRO,186,213,310,302,612
62,62021,620210810,Bariloche,RIO NEGRO,336,365,608,582,1190
62,62021,620210307,Bariloche,RIO NEGRO,116,203,124,104,228
62,62021,620210204,Bariloche,RIO NEGRO,242,280,438,445,883
62,62021,620211702,Bariloche,RIO NEGRO,210,224,396,388,784
62,62021,620210109,Bariloche,RIO NEGRO,170,211,254,251,505
62,62021,620210108,Bariloche,RIO NEGRO,212,279,293,284,577
62,62021,620210107,Bariloche,RIO NEGRO,219,286,314,293,607
62,62021,620211604,Bariloche,RIO NEGRO,254,268,490,464,954
62,62021,620211909,Bariloche,RIO NEGRO,175,204,254,247,501
62,62021,620211905,Bariloche,RIO NEGRO,197,278,286,304,590
62,62021,620211807,Bariloche,RIO NEGRO,188,225,325,313,638
62,62021,620211806,Bariloche,RIO NEGRO,206,219,267,267,534
62,62021,620211710,Bariloche,RIO NEGRO,249,273,438,416,854
62,62021,620211705,Bariloche,RIO NEGRO,291,253,549,539,1088
62,62021,620211510,Bariloche,RIO NEGRO,152,214,269,248,517
62,62021,620211507,Bariloche,RIO NEGRO,163,203,194,175,369
62,62021,620211506,Bariloche,RIO NEGRO,281,319,422,343,765
62,62021,620211409,Bariloche,RIO NEGRO,379,393,655,629,1284
62,62021,620211406,Bariloche,RIO NEGRO,206,251,325,342,667
62,62021,620211305,Bariloche,RIO NEGRO,129,180,332,316,648
62,62021,620211303,Bariloche,RIO NEGRO,222,295,355,298,653
62,62021,620211208,Bariloche,RIO NEGRO,316,379,570,574,1144
62,62021,620211205,Bariloche,RIO NEGRO,142,193,184,195,379
62,62021,620210907,Bariloche,RIO NEGRO,226,270,327,290,617
62,62021,620210803,Bariloche,RIO NEGRO,258,275,351,347,698
62,62021,620210709,Bariloche,RIO NEGRO,301,379,483,504,987
62,62021,620210903,Bariloche,RIO NEGRO,336,305,581,551,1132
62,62021,620210312,Bariloche,RIO NEGRO,161,208,215,182,397
62,62021,620210310,Bariloche,RIO NEGRO,159,232,321,306,627
62,62021,620210209,Bariloche,RIO NEGRO,181,204,333,316,649
62,62021,620210207,Bariloche,RIO NEGRO,201,211,378,322,700
62,62021,620211207,Bariloche,RIO NEGRO,204,294,285,307,592
62,62021,620211302,Bariloche,RIO NEGRO,276,310,388,348,736
62,62021,620210104,Bariloche,RIO NEGRO,201,318,318,341,659
62,62021,620211908,Bariloche,RIO NEGRO,294,343,536,536,1072
62,62021,620211907,Bariloche,RIO NEGRO,117,174,149,153,302
62,62021,620211904,Bariloche,RIO NEGRO,244,281,405,374,779
62,62021,620211509,Bariloche,RIO NEGRO,145,211,191,152,343
62,62021,620211206,Bariloche,RIO NEGRO,217,264,308,323,631
62,62021,620211203,Bariloche,RIO NEGRO,164,208,219,223,442
62,62021,620211112,Bariloche,RIO NEGRO,311,365,492,505,997
62,62021,620211110,Bariloche,RIO NEGRO,193,232,289,297,586
62,62021,620211108,Bariloche,RIO NEGRO,174,227,255,224,479
62,62021,620211003,Bariloche,RIO NEGRO,254,293,385,413,798
62,62021,620210806,Bariloche,RIO NEGRO,218,240,342,334,676
62,62021,620210105,Bariloche,RIO NEGRO,101,161,151,172,323
62,62021,620210208,Bariloche,RIO NEGRO,267,273,500,464,964
62,62021,620210206,Bariloche,RIO NEGRO,319,360,587,605,1192
62,62021,620211101,Bariloche,RIO NEGRO,163,182,288,380,668
62,62021,620210608,Bariloche,RIO NEGRO,303,322,485,460,945
62,62021,620211418,Bariloche,RIO NEGRO,47,101,64,72,136
62,62021,620210401,Bariloche,RIO NEGRO,40,56,50,89,139
62,62021,620210501,Bariloche,RIO NEGRO,203,210,292,463,755
62,62021,620211906,Bariloche,RIO NEGRO,150,184,233,240,473
62,62021,620211805,Bariloche,RIO NEGRO,240,241,302,289,591
62,62021,620211804,Bariloche,RIO NEGRO,179,205,256,246,502
62,62021,620211502,Bariloche,RIO NEGRO,133,213,363,248,611
62,62021,620211416,Bariloche,RIO NEGRO,292,366,488,469,957
62,62021,620211412,Bariloche,RIO NEGRO,253,282,388,318,706
62,62021,620211311,Bariloche,RIO NEGRO,247,299,359,307,666
62,62021,620211202,Bariloche,RIO NEGRO,186,208,266,274,540
62,62021,620211607,Bariloche,RIO NEGRO,337,369,546,574,1120
62,62021,620211009,Bariloche,RIO NEGRO,189,192,373,379,752
62,62021,620210804,Bariloche,RIO NEGRO,156,191,217,229,446
62,62021,620210809,Bariloche,RIO NEGRO,344,389,581,539,1120
62,62021,620210807,Bariloche,RIO NEGRO,243,248,363,363,726
62,62021,620210603,Bariloche,RIO NEGRO,148,212,200,163,363
62,62021,620210602,Bariloche,RIO NEGRO,184,258,267,243,510
62,62021,620211602,Bariloche,RIO NEGRO,267,284,393,387,780
62,62021,620210309,Bariloche,RIO NEGRO,243,338,294,300,594
62,62021,620210202,Bariloche,RIO NEGRO,148,356,214,246,460
62,62021,620211001,Bariloche,RIO NEGRO,293,325,437,447,884
62,62021,620210705,Bariloche,RIO NEGRO,276,335,421,453,874
62,62021,620211708,Bariloche,RIO NEGRO,314,339,548,545,1093
62,62021,620211703,Bariloche,RIO NEGRO,148,161,318,276,594
62,62021,620211408,Bariloche,RIO NEGRO,249,274,518,527,1045
62,62021,620211407,Bariloche,RIO NEGRO,202,254,294,339,633
62,62021,620211304,Bariloche,RIO NEGRO,153,179,286,284,570
62,62021,620211201,Bariloche,RIO NEGRO,196,225,330,300,630
62,62021,620211105,Bariloche,RIO NEGRO,222,239,324,326,650
62,62021,620211606,Bariloche,RIO NEGRO,286,269,530,524,1054
62,62021,620211010,Bariloche,RIO NEGRO,184,177,351,354,705
62,62021,620211008,Bariloche,RIO NEGRO,209,225,340,381,721
62,62021,620211005,Bariloche,RIO NEGRO,340,383,620,582,1202
62,62021,620210802,Bariloche,RIO NEGRO,188,217,235,214,449
62,62021,620210801,Bariloche,RIO NEGRO,204,237,291,237,528
62,62021,620210902,Bariloche,RIO NEGRO,318,403,430,356,786
62,62021,620210607,Bariloche,RIO NEGRO,255,313,368,320,688
62,62021,620210605,Bariloche,RIO NEGRO,136,171,196,184,380
62,62021,620211605,Bariloche,RIO NEGRO,175,179,374,352,726
62,62021,620210308,Bariloche,RIO NEGRO,142,259,157,139,296
62,62021,620210203,Bariloche,RIO NEGRO,311,448,547,536,1083
62,62021,620210302,Bariloche,RIO NEGRO,149,315,133,97,230
62,62021,620210106,Bariloche,RIO NEGRO,223,264,322,315,637
62,62021,620210205,Bariloche,RIO NEGRO,246,280,480,492,972
62,62021,620211701,Bariloche,RIO NEGRO,246,267,394,384,778
62,62021,620210102,Bariloche,RIO NEGRO,331,428,576,564,1140
62,62021,620211414,Bariloche,RIO NEGRO,224,257,361,372,733
62,62021,620211102,Bariloche,RIO NEGRO,215,273,298,309,607
62,62021,620211608,Bariloche,RIO NEGRO,331,326,612,586,1198
62,62021,620211403,Bariloche,RIO NEGRO,347,399,598,657,1255
62,62021,620211107,Bariloche,RIO NEGRO,191,228,273,253,526
62,62021,620211401,Bariloche,RIO NEGRO,203,236,321,309,630
62,62021,620210701,Bariloche,RIO NEGRO,233,340,325,371,696
62,62021,620210112,Bariloche,RIO NEGRO,121,208,186,204,390
62,62021,620211512,Bariloche,RIO NEGRO,207,266,258,243,501
62,62021,620211803,Bariloche,RIO NEGRO,218,237,319,329,648
62,62021,620211709,Bariloche,RIO NEGRO,211,223,391,414,805
62,62021,620211503,Bariloche,RIO NEGRO,280,361,369,289,658
62,62021,620211405,Bariloche,RIO NEGRO,363,383,727,685,1412
62,62021,620211309,Bariloche,RIO NEGRO,124,149,187,170,357
62,62021,620211402,Bariloche,RIO NEGRO,347,386,628,628,1256
62,62021,620211109,Bariloche,RIO NEGRO,188,182,296,297,593
62,62021,620211106,Bariloche,RIO NEGRO,257,307,375,340,715
62,62021,620211103,Bariloche,RIO NEGRO,279,333,409,400,809
62,62021,620211011,Bariloche,RIO NEGRO,166,161,328,319,647
62,62021,620211002,Bariloche,RIO NEGRO,307,339,482,466,948
62,62021,620210707,Bariloche,RIO NEGRO,412,482,632,687,1319
62,62021,620210706,Bariloche,RIO NEGRO,306,346,509,533,1042
62,62021,620210311,Bariloche,RIO NEGRO,171,251,205,176,381
62,62021,620210111,Bariloche,RIO NEGRO,230,285,366,407,773
62,62021,620210110,Bariloche,RIO NEGRO,241,295,337,385,722
62,62021,620210301,Bariloche,RIO NEGRO,134,248,562,438,1000
62,62021,620210210,Bariloche,RIO NEGRO,240,213,441,418,859
62,62021,620211609,Bariloche,RIO NEGRO,246,266,432,390,822
62,62021,620211301,Bariloche,RIO NEGRO,185,247,242,224,466
62,62021,620210305,Bariloche,RIO NEGRO,133,254,310,257,567
62,62077,620770411,San Antonio,RIO NEGRO,118,368,145,163,308
62,62077,620770410,San Antonio,RIO NEGRO,84,305,122,106,228
62,62077,620770407,San Antonio,RIO NEGRO,38,424,58,59,117
62,62077,620770501,San Antonio,RIO NEGRO,34,51,7,37,44
62,62077,620770102,San Antonio,RIO NEGRO,158,186,237,217,454
62,62077,620770604,San Antonio,RIO NEGRO,93,250,123,125,248
62,62077,620770109,San Antonio,RIO NEGRO,273,300,420,380,800
62,62077,620770502,San Antonio,RIO NEGRO,14,230,11,21,32
62,62077,620770304,San Antonio,RIO NEGRO,77,320,122,135,257
62,62077,620770605,San Antonio,RIO NEGRO,113,317,153,178,331
62,62077,620770205,San Antonio,RIO NEGRO,240,272,409,440,849
62,62077,620770115,San Antonio,RIO NEGRO,139,175,212,185,397
62,62077,620770114,San Antonio,RIO NEGRO,153,192,230,203,433
62,62077,620770112,San Antonio,RIO NEGRO,282,318,494,491,985
62,62077,620770103,San Antonio,RIO NEGRO,156,168,210,201,411
62,62077,620770111,San Antonio,RIO NEGRO,305,328,599,639,1238
62,62077,620770110,San Antonio,RIO NEGRO,243,279,353,326,679
62,62077,620770108,San Antonio,RIO NEGRO,179,201,286,315,601
62,62077,620770607,San Antonio,RIO NEGRO,87,280,104,127,231
62,62077,620770405,San Antonio,RIO NEGRO,291,320,526,527,1053
62,62077,620770606,San Antonio,RIO NEGRO,55,325,64,83,147
62,62077,620770204,San Antonio,RIO NEGRO,113,141,181,165,346
62,62077,620770305,San Antonio,RIO NEGRO,153,357,197,229,426
62,62077,620770107,San Antonio,RIO NEGRO,253,298,414,418,832
62,62077,620770106,San Antonio,RIO NEGRO,198,235,306,303,609
62,62077,620770503,San Antonio,RIO NEGRO,35,267,27,47,74
62,62077,620770412,San Antonio,RIO NEGRO,113,257,148,166,314
62,62077,620770406,San Antonio,RIO NEGRO,320,362,569,572,1141
62,62077,620770302,San Antonio,RIO NEGRO,67,237,72,87,159
62,62077,620770210,San Antonio,RIO NEGRO,275,308,472,437,909
62,62077,620770209,San Antonio,RIO NEGRO,197,237,314,334,648
62,62077,620770207,San Antonio,RIO NEGRO,128,258,170,231,401
62,62077,620770202,San Antonio,RIO NEGRO,165,198,258,246,504
62,62077,620770113,San Antonio,RIO NEGRO,170,196,283,284,567
62,62077,620770413,San Antonio,RIO NEGRO,154,154,352,318,670
62,62077,620770105,San Antonio,RIO NEGRO,127,169,183,162,345
62,62077,620770104,San Antonio,RIO NEGRO,241,285,336,325,661
62,62077,620770601,San Antonio,RIO NEGRO,60,301,70,79,149
62,62077,620770211,San Antonio,RIO NEGRO,255,293,411,332,743
62,62077,620770206,San Antonio,RIO NEGRO,165,194,274,239,513
62,62077,620770408,San Antonio,RIO NEGRO,12,14,8,17,25
62,62077,620770402,San Antonio,RIO NEGRO,132,259,145,207,352
62,62077,620770201,San Antonio,RIO NEGRO,336,385,514,489,1003
62,62077,620770117,San Antonio,RIO NEGRO,197,189,342,366,708
62,62077,620770504,San Antonio,RIO NEGRO,36,291,35,53,88
62,62077,620770409,San Antonio,RIO NEGRO,167,256,255,319,574
62,62077,620770404,San Antonio,RIO NEGRO,313,352,623,670,1293
62,62077,620770403,San Antonio,RIO NEGRO,334,399,564,556,1120
62,62077,620770401,San Antonio,RIO NEGRO,120,198,178,203,381
62,62077,620770303,San Antonio,RIO NEGRO,68,301,77,83,160
62,62077,620770101,San Antonio,RIO NEGRO,211,248,306,328,634
62,62077,620770603,San Antonio,RIO NEGRO,79,249,95,107,202
62,62077,620770602,San Antonio,RIO NEGRO,29,283,42,53,95
62,62077,620770203,San Antonio,RIO NEGRO,183,222,304,299,603
62,62077,620770116,San Antonio,RIO NEGRO,181,217,263,271,534
62,62077,620770307,San Antonio,RIO NEGRO,156,302,224,236,460
62,62077,620770306,San Antonio,RIO NEGRO,59,282,65,70,135
62,62077,620770301,San Antonio,RIO NEGRO,69,301,91,88,179
62,62077,620770208,San Antonio,RIO NEGRO,227,242,416,468,884
62,62014,620140110,Avellaneda,RIO NEGRO,305,333,452,474,926
62,62014,620140104,Avellaneda,RIO NEGRO,331,359,581,601,1182
62,62014,620140501,Avellaneda,RIO NEGRO,24,57,7,36,43
62,62014,620140109,Avellaneda,RIO NEGRO,58,109,81,100,181
62,62014,620140901,Avellaneda,RIO NEGRO,180,249,282,329,611
62,62014,620140202,Avellaneda,RIO NEGRO,200,223,288,278,566
62,62014,620140608,Avellaneda,RIO NEGRO,232,264,439,424,863
62,62014,620140605,Avellaneda,RIO NEGRO,225,256,345,397,742
62,62014,620140903,Avellaneda,RIO NEGRO,17,23,14,27,41
62,62014,620140108,Avellaneda,RIO NEGRO,172,249,314,397,711
62,62014,620140402,Avellaneda,RIO NEGRO,343,399,469,428,897
62,62014,620141103,Avellaneda,RIO NEGRO,172,245,301,296,597
62,62014,620141102,Avellaneda,RIO NEGRO,300,340,537,468,1005
62,62014,620140407,Avellaneda,RIO NEGRO,217,251,354,314,668
62,62014,620140801,Avellaneda,RIO NEGRO,48,68,24,71,95
62,62014,620140607,Avellaneda,RIO NEGRO,237,257,412,458,870
62,62014,620140301,Avellaneda,RIO NEGRO,363,375,635,572,1207
62,62014,620140203,Avellaneda,RIO NEGRO,240,263,391,341,732
62,62014,620140902,Avellaneda,RIO NEGRO,121,144,193,187,380
62,62014,620140409,Avellaneda,RIO NEGRO,208,213,273,250,523
62,62014,620140408,Avellaneda,RIO NEGRO,355,383,634,656,1290
62,62014,620140105,Avellaneda,RIO NEGRO,286,317,503,523,1026
62,62014,620140112,Avellaneda,RIO NEGRO,180,187,320,329,649
62,62014,620140406,Avellaneda,RIO NEGRO,244,260,369,330,699
62,62014,620141101,Avellaneda,RIO NEGRO,160,215,224,272,496
62,62014,620140604,Avellaneda,RIO NEGRO,212,220,348,343,691
62,62014,620140603,Avellaneda,RIO NEGRO,214,254,378,310,688
62,62014,620140403,Avellaneda,RIO NEGRO,264,290,368,351,719
62,62014,620140111,Avellaneda,RIO NEGRO,323,379,625,781,1406
62,62014,620141001,Avellaneda,RIO NEGRO,70,98,76,114,190
62,62014,620140102,Avellaneda,RIO NEGRO,227,283,292,551,843
62,62014,620140204,Avellaneda,RIO NEGRO,298,327,475,449,924
62,62014,620140405,Avellaneda,RIO NEGRO,211,236,348,312,660
62,62014,620140106,Avellaneda,RIO NEGRO,26,44,28,43,71
62,62014,620140606,Avellaneda,RIO NEGRO,173,202,284,266,550
62,62014,620140201,Avellaneda,RIO NEGRO,261,266,428,428,856
62,62014,620140701,Avellaneda,RIO NEGRO,44,66,39,283,322
62,62014,620140107,Avellaneda,RIO NEGRO,0,46,0,0,0
62,62014,620141002,Avellaneda,RIO NEGRO,163,202,255,268,523
62,62014,620140303,Avellaneda,RIO NEGRO,236,312,389,447,836
62,62014,620140302,Avellaneda,RIO NEGRO,156,216,231,269,500
62,62014,620140602,Avellaneda,RIO NEGRO,252,270,413,395,808
62,62014,620140601,Avellaneda,RIO NEGRO,237,264,389,402,791
62,62014,620140103,Avellaneda,RIO NEGRO,319,342,528,516,1044
62,62014,620140609,Avellaneda,RIO NEGRO,224,226,412,419,831
62,62014,620140404,Avellaneda,RIO NEGRO,291,321,481,423,904
62,62014,620141003,Avellaneda,RIO NEGRO,177,225,347,340,687
62,62014,620140410,Avellaneda,RIO NEGRO,270,289,494,418,912
62,62014,620140401,Avellaneda,RIO NEGRO,368,458,641,631,1272
62,62014,620140304,Avellaneda,RIO NEGRO,300,333,573,603,1176
62,62014,620140101,Avellaneda,RIO NEGRO,15,31,29,90,119
62,62007,620070812,Adolfo Alsina,RIO NEGRO,167,182,270,265,535
62,62007,620070511,Adolfo Alsina,RIO NEGRO,241,299,290,251,541
62,62007,620070605,Adolfo Alsina,RIO NEGRO,6,29,3,8,11
62,62007,620070707,Adolfo Alsina,RIO NEGRO,403,427,761,682,1443
62,62007,620070604,Adolfo Alsina,RIO NEGRO,117,170,148,666,814
62,62007,620071107,Adolfo Alsina,RIO NEGRO,222,239,366,390,756
62,62007,620071103,Adolfo Alsina,RIO NEGRO,338,377,550,589,1139
62,62007,620071102,Adolfo Alsina,RIO NEGRO,185,206,296,251,547
62,62007,620071003,Adolfo Alsina,RIO NEGRO,236,304,349,263,612
62,62007,620071002,Adolfo Alsina,RIO NEGRO,180,243,241,208,449
62,62007,620071012,Adolfo Alsina,RIO NEGRO,218,246,323,295,618
62,62007,620070814,Adolfo Alsina,RIO NEGRO,188,206,274,272,546
62,62007,620070807,Adolfo Alsina,RIO NEGRO,185,197,359,309,668
62,62007,620070709,Adolfo Alsina,RIO NEGRO,137,155,227,209,436
62,62007,620070510,Adolfo Alsina,RIO NEGRO,373,439,473,465,938
62,62007,620070609,Adolfo Alsina,RIO NEGRO,325,353,560,523,1083
62,62007,620070507,Adolfo Alsina,RIO NEGRO,235,255,289,230,519
62,62007,620070601,Adolfo Alsina,RIO NEGRO,87,130,92,120,212
62,62007,620070905,Adolfo Alsina,RIO NEGRO,32,198,36,50,86
62,62007,620070817,Adolfo Alsina,RIO NEGRO,154,181,221,190,411
62,62007,620070816,Adolfo Alsina,RIO NEGRO,155,229,221,208,429
62,62007,620070811,Adolfo Alsina,RIO NEGRO,258,286,460,447,907
62,62007,620070803,Adolfo Alsina,RIO NEGRO,32,34,29,50,79
62,62007,620070802,Adolfo Alsina,RIO NEGRO,139,149,225,188,413
62,62007,620070505,Adolfo Alsina,RIO NEGRO,182,220,231,198,429
62,62007,620070302,Adolfo Alsina,RIO NEGRO,183,223,257,248,505
62,62007,620070606,Adolfo Alsina,RIO NEGRO,51,92,63,70,133
62,62007,620071110,Adolfo Alsina,RIO NEGRO,197,226,342,325,667
62,62007,620071009,Adolfo Alsina,RIO NEGRO,167,212,223,187,410
62,62007,620071005,Adolfo Alsina,RIO NEGRO,205,249,281,256,537
62,62007,620070710,Adolfo Alsina,RIO NEGRO,57,70,94,85,179
62,62007,620070705,Adolfo Alsina,RIO NEGRO,339,366,555,540,1095
62,62007,620070704,Adolfo Alsina,RIO NEGRO,330,314,583,532,1115
62,62007,620070611,Adolfo Alsina,RIO NEGRO,164,212,304,299,603
62,62007,620070501,Adolfo Alsina,RIO NEGRO,191,200,305,306,611
62,62007,620071111,Adolfo Alsina,RIO NEGRO,315,343,595,587,1182
62,62007,620071106,Adolfo Alsina,RIO NEGRO,188,211,336,334,670
62,62007,620071101,Adolfo Alsina,RIO NEGRO,331,367,624,548,1172
62,62007,620071013,Adolfo Alsina,RIO NEGRO,220,269,337,335,672
62,62007,620070904,Adolfo Alsina,RIO NEGRO,57,335,53,66,119
62,62007,620070713,Adolfo Alsina,RIO NEGRO,249,260,471,448,919
62,62007,620070712,Adolfo Alsina,RIO NEGRO,225,260,426,377,803
62,62007,620070711,Adolfo Alsina,RIO NEGRO,658,472,1109,1015,2124
62,62007,620070509,Adolfo Alsina,RIO NEGRO,166,212,235,194,429
62,62007,620070502,Adolfo Alsina,RIO NEGRO,157,188,242,228,470
62,62007,620070902,Adolfo Alsina,RIO NEGRO,78,361,107,117,224
62,62007,620070603,Adolfo Alsina,RIO NEGRO,204,251,286,363,649
62,62007,620070101,Adolfo Alsina,RIO NEGRO,17,79,14,24,38
62,62007,620070614,Adolfo Alsina,RIO NEGRO,133,200,223,232,455
62,62007,620071105,Adolfo Alsina,RIO NEGRO,126,139,197,239,436
62,62007,620071006,Adolfo Alsina,RIO NEGRO,212,263,269,214,483
62,62007,620070901,Adolfo Alsina,RIO NEGRO,25,192,29,41,70
62,62007,620070808,Adolfo Alsina,RIO NEGRO,207,211,363,352,715
62,62007,620070805,Adolfo Alsina,RIO NEGRO,322,348,580,563,1143
62,62007,620070804,Adolfo Alsina,RIO NEGRO,279,300,506,473,979
62,62007,620070801,Adolfo Alsina,RIO NEGRO,174,206,226,233,459
62,62007,620071010,Adolfo Alsina,RIO NEGRO,171,198,216,179,395
62,62007,620070703,Adolfo Alsina,RIO NEGRO,198,213,293,309,602
62,62007,620071104,Adolfo Alsina,RIO NEGRO,266,275,533,541,1074
62,62007,620070607,Adolfo Alsina,RIO NEGRO,145,163,242,288,530
62,62007,620070401,Adolfo Alsina,RIO NEGRO,33,122,4,43,47
62,62007,620071004,Adolfo Alsina,RIO NEGRO,183,217,240,192,432
62,62007,620071001,Adolfo Alsina,RIO NEGRO,177,262,248,193,441
62,62007,620070815,Adolfo Alsina,RIO NEGRO,162,199,246,226,472
62,62007,620070613,Adolfo Alsina,RIO NEGRO,110,421,185,184,369
62,62007,620070504,Adolfo Alsina,RIO NEGRO,163,186,207,195,402
62,62007,620070503,Adolfo Alsina,RIO NEGRO,275,347,423,432,855
62,62007,620070708,Adolfo Alsina,RIO NEGRO,440,488,773,682,1455
62,62007,620070702,Adolfo Alsina,RIO NEGRO,240,267,374,343,717
62,62007,620070301,Adolfo Alsina,RIO NEGRO,23,50,12,31,43
62,62007,620071109,Adolfo Alsina,RIO NEGRO,232,248,484,451,935
62,62007,620071108,Adolfo Alsina,RIO NEGRO,194,221,427,403,830
62,62007,620071008,Adolfo Alsina,RIO NEGRO,185,210,245,191,436
62,62007,620071007,Adolfo Alsina,RIO NEGRO,263,389,321,300,621
62,62007,620070906,Adolfo Alsina,RIO NEGRO,58,401,90,100,190
62,62007,620071011,Adolfo Alsina,RIO NEGRO,158,184,213,182,395
62,62007,620070813,Adolfo Alsina,RIO NEGRO,223,270,332,310,642
62,62007,620070810,Adolfo Alsina,RIO NEGRO,309,331,461,428,889
62,62007,620070809,Adolfo Alsina,RIO NEGRO,176,205,216,239,455
62,62007,620070806,Adolfo Alsina,RIO NEGRO,347,374,670,655,1325
62,62007,620070506,Adolfo Alsina,RIO NEGRO,214,271,284,212,496
62,62007,620070303,Adolfo Alsina,RIO NEGRO,116,152,174,177,351
62,62007,620070602,Adolfo Alsina,RIO NEGRO,253,372,317,429,746
62,62007,620070201,Adolfo Alsina,RIO NEGRO,38,115,17,47,64
62,62007,620071112,Adolfo Alsina,RIO NEGRO,306,328,622,654,1276
62,62007,620070903,Adolfo Alsina,RIO NEGRO,30,108,35,22,57
62,62007,620070818,Adolfo Alsina,RIO NEGRO,154,187,243,254,497
62,62007,620070706,Adolfo Alsina,RIO NEGRO,210,174,329,352,681
62,62007,620070608,Adolfo Alsina,RIO NEGRO,368,386,695,657,1352
62,62007,620070701,Adolfo Alsina,RIO NEGRO,194,215,275,267,542
62,62007,620070612,Adolfo Alsina,RIO NEGRO,308,332,582,494,1076
62,62007,620070610,Adolfo Alsina,RIO NEGRO,210,269,413,407,820
62,62007,620070508,Adolfo Alsina,RIO NEGRO,191,231,269,212,481
62,62042,620421408,General Roca,RIO NEGRO,233,296,341,370,711
62,62042,620420502,General Roca,RIO NEGRO,146,186,215,249,464
62,62042,620420104,General Roca,RIO NEGRO,31,43,23,46,69
62,62042,620420301,General Roca,RIO NEGRO,19,32,12,24,36
62,62042,620420103,General Roca,RIO NEGRO,131,162,233,215,448
62,62042,620422105,General Roca,RIO NEGRO,215,387,380,406,786
62,62042,620421902,General Roca,RIO NEGRO,193,245,336,371,707
62,62042,620421702,General Roca,RIO NEGRO,207,226,311,398,709
62,62042,620421103,General Roca,RIO NEGRO,179,209,281,293,574
62,62042,620420708,General Roca,RIO NEGRO,184,220,284,291,575
62,62042,620420501,General Roca,RIO NEGRO,139,175,215,234,449
62,62042,620424307,General Roca,RIO NEGRO,291,302,526,441,967
62,62042,620420903,General Roca,RIO NEGRO,256,290,445,495,940
62,62042,620421405,General Roca,RIO NEGRO,319,433,525,555,1080
62,62042,620420102,General Roca,RIO NEGRO,57,78,81,96,177
62,62042,620421213,General Roca,RIO NEGRO,203,255,247,207,454
62,62042,620424203,General Roca,RIO NEGRO,256,300,354,299,653
62,62042,620424202,General Roca,RIO NEGRO,317,328,483,474,957
62,62042,620424112,General Roca,RIO NEGRO,247,275,386,354,740
62,62042,620424104,General Roca,RIO NEGRO,123,158,162,150,312
62,62042,620424103,General Roca,RIO NEGRO,201,249,257,231,488
62,62042,620424004,General Roca,RIO NEGRO,311,334,570,554,1124
62,62042,620424001,General Roca,RIO NEGRO,225,284,379,664,1043
62,62042,620423912,General Roca,RIO NEGRO,222,305,272,201,473
62,62042,620423911,General Roca,RIO NEGRO,243,333,422,311,733
62,62042,620423906,General Roca,RIO NEGRO,281,363,346,301,647
62,62042,620423807,General Roca,RIO NEGRO,152,152,272,589,861
62,62042,620423804,General Roca,RIO NEGRO,216,200,295,308,603
62,62042,620423707,General Roca,RIO NEGRO,315,343,563,575,1138
62,62042,620423701,General Roca,RIO NEGRO,216,253,373,410,783
62,62042,620423210,General Roca,RIO NEGRO,226,244,326,311,637
62,62042,620423107,General Roca,RIO NEGRO,294,269,688,637,1325
62,62042,620423609,General Roca,RIO NEGRO,241,259,394,350,744
62,62042,620423007,General Roca,RIO NEGRO,348,375,587,579,1166
62,62042,620423006,General Roca,RIO NEGRO,39,38,56,59,115
62,62042,620422907,General Roca,RIO NEGRO,278,330,389,434,823
62,62042,620422808,General Roca,RIO NEGRO,202,204,417,413,830
62,62042,620422807,General Roca,RIO NEGRO,196,197,401,427,828
62,62042,620422711,General Roca,RIO NEGRO,148,152,290,281,571
62,62042,620422708,General Roca,RIO NEGRO,310,363,459,403,862
62,62042,620422706,General Roca,RIO NEGRO,188,220,264,237,501
62,62042,620422703,General Roca,RIO NEGRO,188,210,249,204,453
62,62042,620422615,General Roca,RIO NEGRO,147,183,190,183,373
62,62042,620422614,General Roca,RIO NEGRO,198,220,319,257,576
62,62042,620422610,General Roca,RIO NEGRO,183,190,311,332,643
62,62042,620422602,General Roca,RIO NEGRO,237,237,425,418,843
62,62042,620422601,General Roca,RIO NEGRO,270,290,520,478,998
62,62042,620422509,General Roca,RIO NEGRO,282,290,452,446,898
62,62042,620422205,General Roca,RIO NEGRO,324,364,610,616,1226
62,62042,620422201,General Roca,RIO NEGRO,407,437,727,646,1373
62,62042,620422311,General Roca,RIO NEGRO,311,335,563,522,1085
62,62042,620422007,General Roca,RIO NEGRO,243,293,382,344,726
62,62042,620421904,General Roca,RIO NEGRO,260,265,503,528,1031
62,62042,620421903,General Roca,RIO NEGRO,257,269,448,440,888
62,62042,620421901,General Roca,RIO NEGRO,284,288,455,412,867
62,62042,620421508,General Roca,RIO NEGRO,119,127,236,231,467
62,62042,620421412,General Roca,RIO NEGRO,96,124,168,158,326
62,62042,620421403,General Roca,RIO NEGRO,297,315,496,528,1024
62,62042,620421207,General Roca,RIO NEGRO,328,399,460,420,880
62,62042,620421202,General Roca,RIO NEGRO,301,302,595,564,1159
62,62042,620421112,General Roca,RIO NEGRO,224,142,367,416,783
62,62042,620420905,General Roca,RIO NEGRO,243,263,442,387,829
62,62042,620420808,General Roca,RIO NEGRO,258,338,342,294,636
62,62042,620420806,General Roca,RIO NEGRO,231,261,350,340,690
62,62042,620420605,General Roca,RIO NEGRO,216,216,394,383,777
62,62042,620423509,General Roca,RIO NEGRO,291,335,451,395,846
62,62042,620423504,General Roca,RIO NEGRO,225,270,346,246,592
62,62042,620423503,General Roca,RIO NEGRO,286,362,361,273,634
62,62042,620422406,General Roca,RIO NEGRO,188,197,298,251,549
62,62042,620420701,General Roca,RIO NEGRO,411,470,695,690,1385
62,62042,620420612,General Roca,RIO NEGRO,165,222,254,186,440
62,62042,620424304,General Roca,RIO NEGRO,196,214,286,222,508
62,62042,620420801,General Roca,RIO NEGRO,292,417,413,393,806
62,62042,620421602,General Roca,RIO NEGRO,131,156,233,248,481
62,62042,620421502,General Roca,RIO NEGRO,219,260,329,369,698
62,62042,620421410,General Roca,RIO NEGRO,111,153,174,186,360
62,62042,620424309,General Roca,RIO NEGRO,335,334,568,510,1078
62,62042,620424207,General Roca,RIO NEGRO,414,407,650,619,1269
62,62042,620424107,General Roca,RIO NEGRO,181,205,250,204,454
62,62042,620423704,General Roca,RIO NEGRO,233,252,442,446,888
62,62042,620423612,General Roca,RIO NEGRO,230,252,387,350,737
62,62042,620423310,General Roca,RIO NEGRO,231,270,315,255,570
62,62042,620423308,General Roca,RIO NEGRO,163,189,205,177,382
62,62042,620423004,General Roca,RIO NEGRO,254,262,390,379,769
62,62042,620423011,General Roca,RIO NEGRO,291,308,495,543,1038
62,62042,620422909,General Roca,RIO NEGRO,294,333,520,559,1079
62,62042,620422905,General Roca,RIO NEGRO,244,256,413,426,839
62,62042,620422805,General Roca,RIO NEGRO,333,351,623,611,1234
62,62042,620422802,General Roca,RIO NEGRO,193,211,337,324,661
62,62042,620422715,General Roca,RIO NEGRO,165,172,297,305,602
62,62042,620422710,General Roca,RIO NEGRO,257,244,453,393,846
62,62042,620422704,General Roca,RIO NEGRO,187,210,253,197,450
62,62042,620422607,General Roca,RIO NEGRO,176,185,309,302,611
62,62042,620422504,General Roca,RIO NEGRO,216,176,341,327,668
62,62042,620422308,General Roca,RIO NEGRO,180,183,281,276,557
62,62042,620422106,General Roca,RIO NEGRO,184,217,341,352,693
62,62042,620422006,General Roca,RIO NEGRO,248,238,411,403,814
62,62042,620422001,General Roca,RIO NEGRO,69,76,117,144,261
62,62042,620421804,General Roca,RIO NEGRO,247,254,399,373,772
62,62042,620421803,General Roca,RIO NEGRO,316,341,568,548,1116
62,62042,620421802,General Roca,RIO NEGRO,138,154,231,195,426
62,62042,620421507,General Roca,RIO NEGRO,241,252,436,376,812
62,62042,620421209,General Roca,RIO NEGRO,231,269,327,278,605
62,62042,620421201,General Roca,RIO NEGRO,282,299,461,472,933
62,62042,620421011,General Roca,RIO NEGRO,234,274,353,354,707
62,62042,620421002,General Roca,RIO NEGRO,246,254,407,402,809
62,62042,620421001,General Roca,RIO NEGRO,326,345,595,577,1172
62,62042,620420610,General Roca,RIO NEGRO,219,248,320,290,610
62,62042,620423305,General Roca,RIO NEGRO,228,255,332,304,636
62,62042,620420712,General Roca,RIO NEGRO,132,193,178,201,379
62,62042,620420702,General Roca,RIO NEGRO,446,468,738,795,1533
62,62042,620420401,General Roca,RIO NEGRO,347,372,631,625,1256
62,62042,620420609,General Roca,RIO NEGRO,250,297,375,312,687
62,62042,620421905,General Roca,RIO NEGRO,89,119,146,149,295
62,62042,620422107,General Roca,RIO NEGRO,257,320,446,502,948
62,62042,620421701,General Roca,RIO NEGRO,265,378,471,513,984
62,62042,620421407,General Roca,RIO NEGRO,278,329,394,428,822
62,62042,620421109,General Roca,RIO NEGRO,237,243,392,413,805
62,62042,620421108,General Roca,RIO NEGRO,160,189,243,270,513
62,62042,620420902,General Roca,RIO NEGRO,357,446,557,600,1157
62,62042,620424311,General Roca,RIO NEGRO,311,327,501,502,1003
62,62042,620424302,General Roca,RIO NEGRO,123,148,175,160,335
62,62042,620424209,General Roca,RIO NEGRO,277,295,530,533,1063
62,62042,620424206,General Roca,RIO NEGRO,336,338,600,601,1201
62,62042,620424204,General Roca,RIO NEGRO,271,318,392,374,766
62,62042,620424305,General Roca,RIO NEGRO,248,267,457,422,879
62,62042,620424105,General Roca,RIO NEGRO,239,261,335,315,650
62,62042,620424102,General Roca,RIO NEGRO,236,271,301,256,557
62,62042,620423910,General Roca,RIO NEGRO,195,267,243,188,431
62,62042,620423908,General Roca,RIO NEGRO,208,252,252,220,472
62,62042,620423907,General Roca,RIO NEGRO,309,380,415,361,776
62,62042,620423903,General Roca,RIO NEGRO,169,228,208,172,380
62,62042,620423808,General Roca,RIO NEGRO,218,265,362,338,700
62,62042,620423402,General Roca,RIO NEGRO,383,405,724,712,1436
62,62042,620423401,General Roca,RIO NEGRO,228,255,423,390,813
62,62042,620423211,General Roca,RIO NEGRO,251,268,367,347,714
62,62042,620423205,General Roca,RIO NEGRO,197,183,302,304,606
62,62042,620423202,General Roca,RIO NEGRO,228,238,397,356,753
62,62042,620423103,General Roca,RIO NEGRO,265,252,552,532,1084
62,62042,620423010,General Roca,RIO NEGRO,233,240,455,425,880
62,62042,620423009,General Roca,RIO NEGRO,328,342,580,552,1132
62,62042,620423005,General Roca,RIO NEGRO,200,214,344,331,675
62,62042,620422901,General Roca,RIO NEGRO,235,284,392,408,800
62,62042,620422707,General Roca,RIO NEGRO,171,202,253,241,494
62,62042,620422705,General Roca,RIO NEGRO,207,238,264,237,501
62,62042,620422613,General Roca,RIO NEGRO,247,250,392,356,748
62,62042,620423307,General Roca,RIO NEGRO,168,184,210,188,398
62,62042,620422506,General Roca,RIO NEGRO,245,270,378,362,740
62,62042,620422503,General Roca,RIO NEGRO,386,389,697,614,1311
62,62042,620422301,General Roca,RIO NEGRO,246,261,447,434,881
62,62042,620422011,General Roca,RIO NEGRO,224,269,367,319,686
62,62042,620422008,General Roca,RIO NEGRO,170,181,239,212,451
62,62042,620421107,General Roca,RIO NEGRO,232,255,423,440,863
62,62042,620420910,General Roca,RIO NEGRO,234,268,392,336,728
62,62042,620420901,General Roca,RIO NEGRO,201,203,370,368,738
62,62042,620420810,General Roca,RIO NEGRO,249,346,283,233,516
62,62042,620420201,General Roca,RIO NEGRO,66,461,77,81,158
62,62042,620420606,General Roca,RIO NEGRO,204,201,351,326,677
62,62042,620420412,General Roca,RIO NEGRO,232,252,434,426,860
62,62042,620423502,General Roca,RIO NEGRO,247,297,341,247,588
62,62042,620420613,General Roca,RIO NEGRO,189,196,316,267,583
62,62042,620420603,General Roca,RIO NEGRO,168,175,279,279,558
62,62042,620420804,General Roca,RIO NEGRO,191,202,271,236,507
62,62042,620420410,General Roca,RIO NEGRO,249,284,398,371,769
62,62042,620423301,General Roca,RIO NEGRO,195,196,326,303,629
62,62042,620421805,General Roca,RIO NEGRO,240,255,447,421,868
62,62042,620424111,General Roca,RIO NEGRO,224,264,315,306,621
62,62042,620420717,General Roca,RIO NEGRO,140,174,218,262,480
62,62042,620424108,General Roca,RIO NEGRO,268,317,363,310,673
62,62042,620424106,General Roca,RIO NEGRO,210,233,295,232,527
62,62042,620424013,General Roca,RIO NEGRO,129,180,211,192,403
62,62042,620424012,General Roca,RIO NEGRO,197,229,300,281,581
62,62042,620424011,General Roca,RIO NEGRO,250,271,435,426,861
62,62042,620424005,General Roca,RIO NEGRO,183,215,313,295,608
62,62042,620423814,General Roca,RIO NEGRO,316,283,645,594,1239
62,62042,620423806,General Roca,RIO NEGRO,220,274,296,281,577
62,62042,620423711,General Roca,RIO NEGRO,192,429,347,303,650
62,62042,620423606,General Roca,RIO NEGRO,190,223,310,237,547
62,62042,620423403,General Roca,RIO NEGRO,216,225,417,401,818
62,62042,620423208,General Roca,RIO NEGRO,199,234,311,311,622
62,62042,620423108,General Roca,RIO NEGRO,244,258,450,425,875
62,62042,620423001,General Roca,RIO NEGRO,279,317,376,339,715
62,62042,620422910,General Roca,RIO NEGRO,302,306,490,524,1014
62,62042,620422906,General Roca,RIO NEGRO,272,323,474,420,894
62,62042,620422904,General Roca,RIO NEGRO,312,355,453,494,947
62,62042,620422902,General Roca,RIO NEGRO,171,206,257,253,510
62,62042,620422701,General Roca,RIO NEGRO,214,244,349,346,695
62,62042,620422408,General Roca,RIO NEGRO,344,414,458,415,873
62,62042,620423306,General Roca,RIO NEGRO,192,236,244,206,450
62,62042,620422302,General Roca,RIO NEGRO,208,229,383,381,764
62,62042,620422402,General Roca,RIO NEGRO,218,240,336,318,654
62,62042,620422010,General Roca,RIO NEGRO,134,137,202,168,370
62,62042,620422009,General Roca,RIO NEGRO,151,189,205,160,365
62,62042,620422004,General Roca,RIO NEGRO,191,233,249,184,433
62,62042,620421210,General Roca,RIO NEGRO,202,260,273,221,494
62,62042,620421206,General Roca,RIO NEGRO,166,190,230,226,456
62,62042,620421010,General Roca,RIO NEGRO,273,279,492,449,941
62,62042,620420909,General Roca,RIO NEGRO,210,219,356,355,711
62,62042,620420809,General Roca,RIO NEGRO,196,236,238,159,397
62,62042,620420805,General Roca,RIO NEGRO,164,199,237,220,457
62,62042,620423602,General Roca,RIO NEGRO,234,274,304,286,590
62,62042,620423507,General Roca,RIO NEGRO,283,321,482,453,935
62,62042,620423501,General Roca,RIO NEGRO,227,278,282,241,523
62,62042,620420715,General Roca,RIO NEGRO,215,221,392,392,784
62,62042,620420604,General Roca,RIO NEGRO,212,223,349,325,674
62,62042,620420405,General Roca,RIO NEGRO,301,343,512,488,1000
62,62042,620422404,General Roca,RIO NEGRO,330,360,572,515,1087
62,62042,620423611,General Roca,RIO NEGRO,231,252,406,372,778
62,62042,620421505,General Roca,RIO NEGRO,195,200,320,305,625
62,62042,620420608,General Roca,RIO NEGRO,184,213,262,241,503
62,62042,620422108,General Roca,RIO NEGRO,123,149,211,190,401
62,62042,620421406,General Roca,RIO NEGRO,114,137,161,223,384
62,62042,620420101,General Roca,RIO NEGRO,26,46,33,38,71
62,62042,620421503,General Roca,RIO NEGRO,236,268,367,442,809
62,62042,620421409,General Roca,RIO NEGRO,174,214,241,321,562
62,62042,620421305,General Roca,RIO NEGRO,312,375,435,511,946
62,62042,620421104,General Roca,RIO NEGRO,231,277,331,406,737
62,62042,620421102,General Roca,RIO NEGRO,234,260,363,397,760
62,62042,620423203,General Roca,RIO NEGRO,203,203,361,348,709
62,62042,620424310,General Roca,RIO NEGRO,231,252,419,419,838
62,62042,620424308,General Roca,RIO NEGRO,265,252,516,503,1019
62,62042,620424301,General Roca,RIO NEGRO,218,252,498,501,999
62,62042,620424210,General Roca,RIO NEGRO,244,275,359,322,681
62,62042,620424208,General Roca,RIO NEGRO,316,349,539,505,1044
62,62042,620424101,General Roca,RIO NEGRO,236,284,341,250,591
62,62042,620424014,General Roca,RIO NEGRO,338,367,572,529,1101
62,62042,620424002,General Roca,RIO NEGRO,229,310,323,356,679
62,62042,620423909,General Roca,RIO NEGRO,189,232,219,195,414
62,62042,620423902,General Roca,RIO NEGRO,159,196,196,166,362
62,62042,620423710,General Roca,RIO NEGRO,329,346,580,535,1115
62,62042,620423709,General Roca,RIO NEGRO,316,334,668,628,1296
62,62042,620423703,General Roca,RIO NEGRO,263,308,500,456,956
62,62042,620423702,General Roca,RIO NEGRO,193,215,334,339,673
62,62042,620423605,General Roca,RIO NEGRO,204,241,279,248,527
62,62042,620423309,General Roca,RIO NEGRO,230,264,288,231,519
62,62042,620423109,General Roca,RIO NEGRO,297,260,516,546,1062
62,62042,620423102,General Roca,RIO NEGRO,369,355,723,766,1489
62,62042,620422806,General Roca,RIO NEGRO,352,400,624,623,1247
62,62042,620422714,General Roca,RIO NEGRO,237,228,384,364,748
62,62042,620422709,General Roca,RIO NEGRO,213,229,427,409,836
62,62042,620422612,General Roca,RIO NEGRO,230,259,372,368,740
62,62042,620422611,General Roca,RIO NEGRO,155,210,251,243,494
62,62042,620422608,General Roca,RIO NEGRO,173,172,290,265,555
62,62042,620422505,General Roca,RIO NEGRO,374,407,593,573,1166
62,62042,620422502,General Roca,RIO NEGRO,301,323,487,508,995
62,62042,620422501,General Roca,RIO NEGRO,320,355,539,533,1072
62,62042,620422310,General Roca,RIO NEGRO,170,195,266,280,546
62,62042,620422303,General Roca,RIO NEGRO,191,208,304,308,612
62,62042,620422012,General Roca,RIO NEGRO,226,255,305,290,595
62,62042,620422003,General Roca,RIO NEGRO,151,190,227,174,401
62,62042,620421601,General Roca,RIO NEGRO,246,289,469,447,916
62,62042,620421411,General Roca,RIO NEGRO,211,223,393,395,788
62,62042,620421302,General Roca,RIO NEGRO,331,371,569,594,1163
62,62042,620421301,General Roca,RIO NEGRO,233,241,425,436,861
62,62042,620421004,General Roca,RIO NEGRO,174,175,267,252,519
62,62042,620420807,General Roca,RIO NEGRO,263,332,381,324,705
62,62042,620422407,General Roca,RIO NEGRO,185,200,260,227,487
62,62042,620423508,General Roca,RIO NEGRO,201,241,321,294,615
62,62042,620423408,General Roca,RIO NEGRO,160,227,263,258,521
62,62042,620423406,General Roca,RIO NEGRO,166,197,299,253,552
62,62042,620420713,General Roca,RIO NEGRO,355,432,598,578,1176
62,62042,620420506,General Roca,RIO NEGRO,230,241,489,443,932
62,62042,620420504,General Roca,RIO NEGRO,191,184,373,348,721
62,62042,620423304,General Roca,RIO NEGRO,295,312,475,388,863
62,62042,620424109,General Roca,RIO NEGRO,183,224,234,221,455
62,62042,620421506,General Roca,RIO NEGRO,185,203,332,321,653
62,62042,620421003,General Roca,RIO NEGRO,222,210,384,353,737
62,62042,620420402,General Roca,RIO NEGRO,261,302,388,426,814
62,62042,620420709,General Roca,RIO NEGRO,193,257,288,356,644
62,62042,620420503,General Roca,RIO NEGRO,45,65,77,86,163
62,62042,620421401,General Roca,RIO NEGRO,224,164,374,412,786
62,62042,620424113,General Roca,RIO NEGRO,190,217,252,267,519
62,62042,620424006,General Roca,RIO NEGRO,182,211,325,307,632
62,62042,620423904,General Roca,RIO NEGRO,211,269,287,228,515
62,62042,620423901,General Roca,RIO NEGRO,268,377,341,254,595
62,62042,620423805,General Roca,RIO NEGRO,246,280,416,361,777
62,62042,620423803,General Roca,RIO NEGRO,231,196,398,399,797
62,62042,620423207,General Roca,RIO NEGRO,205,217,321,304,625
62,62042,620423204,General Roca,RIO NEGRO,384,432,622,534,1156
62,62042,620423201,General Roca,RIO NEGRO,262,301,382,323,705
62,62042,620423105,General Roca,RIO NEGRO,345,363,712,637,1349
62,62042,620423104,General Roca,RIO NEGRO,307,307,644,603,1247
62,62042,620423002,General Roca,RIO NEGRO,392,421,550,524,1074
62,62042,620422713,General Roca,RIO NEGRO,330,373,461,435,896
62,62042,620422702,General Roca,RIO NEGRO,263,273,405,346,751
62,62042,620422609,General Roca,RIO NEGRO,278,287,443,442,885
62,62042,620422605,General Roca,RIO NEGRO,186,183,325,333,658
62,62042,620422604,General Roca,RIO NEGRO,172,185,319,303,622
62,62042,620422103,General Roca,RIO NEGRO,295,344,606,563,1169
62,62042,620422101,General Roca,RIO NEGRO,268,279,437,465,902
62,62042,620422002,General Roca,RIO NEGRO,237,255,344,299,643
62,62042,620421801,General Roca,RIO NEGRO,245,260,399,343,742
62,62042,620421501,General Roca,RIO NEGRO,380,396,627,598,1225
62,62042,620421402,General Roca,RIO NEGRO,23,81,25,41,66
62,62042,620421303,General Roca,RIO NEGRO,281,299,463,427,890
62,62042,620421204,General Roca,RIO NEGRO,235,262,375,359,734
62,62042,620421212,General Roca,RIO NEGRO,194,205,251,210,461
62,62042,620421007,General Roca,RIO NEGRO,202,217,357,355,712
62,62042,620421005,General Roca,RIO NEGRO,256,221,371,390,761
62,62042,620420908,General Roca,RIO NEGRO,213,250,395,402,797
62,62042,620420906,General Roca,RIO NEGRO,325,353,514,509,1023
62,62042,620420611,General Roca,RIO NEGRO,212,247,280,232,512
62,62042,620423601,General Roca,RIO NEGRO,271,285,394,398,792
62,62042,620423410,General Roca,RIO NEGRO,348,370,564,555,1119
62,62042,620423409,General Roca,RIO NEGRO,188,235,342,356,698
62,62042,620423303,General Roca,RIO NEGRO,373,398,589,522,1111
62,62042,620423302,General Roca,RIO NEGRO,201,213,339,323,662
62,62042,620420802,General Roca,RIO NEGRO,288,330,419,395,814
62,62042,620420711,General Roca,RIO NEGRO,189,252,342,342,684
62,62042,620420710,General Roca,RIO NEGRO,206,226,382,385,767
62,62042,620420614,General Roca,RIO NEGRO,198,193,315,284,599
62,62042,620420404,General Roca,RIO NEGRO,222,262,388,403,791
62,62042,620423212,General Roca,RIO NEGRO,194,200,280,245,525
62,62042,620421214,General Roca,RIO NEGRO,128,170,158,119,277
62,62042,620422305,General Roca,RIO NEGRO,388,426,673,659,1332
62,62042,620420411,General Roca,RIO NEGRO,182,215,340,332,672
62,62042,620422109,General Roca,RIO NEGRO,113,131,159,212,371
62,62042,620420409,General Roca,RIO NEGRO,124,160,138,191,329
62,62042,620420406,General Roca,RIO NEGRO,216,219,301,370,671
62,62042,620420407,General Roca,RIO NEGRO,81,121,113,143,256
62,62042,620422206,General Roca,RIO NEGRO,241,289,394,413,807
62,62042,620421306,General Roca,RIO NEGRO,369,413,615,617,1232
62,62042,620421101,General Roca,RIO NEGRO,211,274,332,377,709
62,62042,620420707,General Roca,RIO NEGRO,237,314,329,401,730
62,62042,620420704,General Roca,RIO NEGRO,212,232,355,370,725
62,62042,620420706,General Roca,RIO NEGRO,117,139,190,226,416
62,62042,620424312,General Roca,RIO NEGRO,312,295,626,626,1252
62,62042,620424306,General Roca,RIO NEGRO,352,378,663,593,1256
62,62042,620424201,General Roca,RIO NEGRO,284,304,441,453,894
62,62042,620424010,General Roca,RIO NEGRO,146,166,219,238,457
62,62042,620424009,General Roca,RIO NEGRO,318,346,584,582,1166
62,62042,620424008,General Roca,RIO NEGRO,169,189,289,243,532
62,62042,620424007,General Roca,RIO NEGRO,221,229,437,399,836
62,62042,620424003,General Roca,RIO NEGRO,355,367,662,592,1254
62,62042,620423905,General Roca,RIO NEGRO,272,288,402,382,784
62,62042,620423812,General Roca,RIO NEGRO,179,184,295,273,568
62,62042,620423811,General Roca,RIO NEGRO,315,327,562,534,1096
62,62042,620423810,General Roca,RIO NEGRO,211,227,389,321,710
62,62042,620423809,General Roca,RIO NEGRO,203,223,336,327,663
62,62042,620423802,General Roca,RIO NEGRO,323,341,509,480,989
62,62042,620423801,General Roca,RIO NEGRO,286,292,496,428,924
62,62042,620423708,General Roca,RIO NEGRO,108,152,173,181,354
62,62042,620423706,General Roca,RIO NEGRO,331,357,638,615,1253
62,62042,620423705,General Roca,RIO NEGRO,291,291,541,535,1076
62,62042,620423404,General Roca,RIO NEGRO,177,215,332,334,666
62,62042,620423209,General Roca,RIO NEGRO,239,256,355,351,706
62,62042,620423106,General Roca,RIO NEGRO,269,277,544,514,1058
62,62042,620423101,General Roca,RIO NEGRO,356,336,655,667,1322
62,62042,620423003,General Roca,RIO NEGRO,247,281,352,321,673
62,62042,620423012,General Roca,RIO NEGRO,107,115,190,180,370
62,62042,620422908,General Roca,RIO NEGRO,309,332,533,550,1083
62,62042,620422804,General Roca,RIO NEGRO,320,341,620,567,1187
62,62042,620422803,General Roca,RIO NEGRO,367,402,681,639,1320
62,62042,620422801,General Roca,RIO NEGRO,315,333,553,535,1088
62,62042,620422712,General Roca,RIO NEGRO,196,202,351,369,720
62,62042,620422606,General Roca,RIO NEGRO,212,239,392,364,756
62,62042,620422603,General Roca,RIO NEGRO,312,302,602,628,1230
62,62042,620422507,General Roca,RIO NEGRO,290,328,462,439,901
62,62042,620422307,General Roca,RIO NEGRO,204,227,297,313,610
62,62042,620422403,General Roca,RIO NEGRO,222,231,406,345,751
62,62042,620422104,General Roca,RIO NEGRO,143,177,292,273,565
62,62042,620422005,General Roca,RIO NEGRO,150,191,192,144,336
62,62042,620421603,General Roca,RIO NEGRO,201,217,352,336,688
62,62042,620421806,General Roca,RIO NEGRO,203,231,359,324,683
62,62042,620421304,General Roca,RIO NEGRO,321,345,533,564,1097
62,62042,620421208,General Roca,RIO NEGRO,255,299,388,324,712
62,62042,620421203,General Roca,RIO NEGRO,348,357,507,515,1022
62,62042,620421013,General Roca,RIO NEGRO,188,235,260,218,478
62,62042,620421012,General Roca,RIO NEGRO,198,231,285,245,530
62,62042,620421008,General Roca,RIO NEGRO,241,254,377,397,774
62,62042,620421006,General Roca,RIO NEGRO,252,259,414,385,799
62,62042,620420904,General Roca,RIO NEGRO,201,236,346,288,634
62,62042,620421211,General Roca,RIO NEGRO,169,220,227,176,403
62,62042,620420607,General Roca,RIO NEGRO,282,306,457,447,904
62,62042,620423506,General Roca,RIO NEGRO,255,397,308,265,573
62,62042,620423505,General Roca,RIO NEGRO,244,330,318,251,569
62,62042,620423405,General Roca,RIO NEGRO,295,334,492,488,980
62,62042,620420602,General Roca,RIO NEGRO,327,372,591,569,1160
62,62042,620420601,General Roca,RIO NEGRO,262,277,522,480,1002
62,62042,620421106,General Roca,RIO NEGRO,228,253,393,441,834
62,62042,620420703,General Roca,RIO NEGRO,158,187,227,272,499
62,62042,620422204,General Roca,RIO NEGRO,80,109,105,146,251
62,62042,620422203,General Roca,RIO NEGRO,254,271,460,509,969
62,62042,620422102,General Roca,RIO NEGRO,154,173,236,254,490
62,62042,620421604,General Roca,RIO NEGRO,199,215,317,381,698
62,62042,620420705,General Roca,RIO NEGRO,383,454,617,728,1345
62,62042,620420202,General Roca,RIO NEGRO,177,203,241,324,565
62,62042,620420408,General Roca,RIO NEGRO,168,214,201,302,503
62,62042,620424303,General Roca,RIO NEGRO,192,226,289,292,581
62,62042,620424205,General Roca,RIO NEGRO,170,165,297,292,589
62,62042,620424114,General Roca,RIO NEGRO,179,222,255,241,496
62,62042,620423813,General Roca,RIO NEGRO,188,166,369,332,701
62,62042,620423610,General Roca,RIO NEGRO,158,166,290,257,547
62,62042,620423608,General Roca,RIO NEGRO,243,261,433,410,843
62,62042,620423607,General Roca,RIO NEGRO,267,312,397,388,785
62,62042,620423311,General Roca,RIO NEGRO,331,407,458,408,866
62,62042,620423206,General Roca,RIO NEGRO,205,222,315,323,638
62,62042,620423008,General Roca,RIO NEGRO,350,376,618,592,1210
62,62042,620422903,General Roca,RIO NEGRO,312,334,558,553,1111
62,62042,620422510,General Roca,RIO NEGRO,332,339,557,533,1090
62,62042,620422508,General Roca,RIO NEGRO,412,430,601,584,1185
62,62042,620422309,General Roca,RIO NEGRO,212,210,317,298,615
62,62042,620422306,General Roca,RIO NEGRO,217,216,382,363,745
62,62042,620422304,General Roca,RIO NEGRO,220,228,380,357,737
62,62042,620422401,General Roca,RIO NEGRO,220,222,456,393,849
62,62042,620422202,General Roca,RIO NEGRO,67,71,125,114,239
62,62042,620422013,General Roca,RIO NEGRO,244,250,454,397,851
62,62042,620421807,General Roca,RIO NEGRO,301,360,615,598,1213
62,62042,620421404,General Roca,RIO NEGRO,169,179,282,282,564
62,62042,620421205,General Roca,RIO NEGRO,153,191,217,187,404
62,62042,620421111,General Roca,RIO NEGRO,166,166,300,265,565
62,62042,620421110,General Roca,RIO NEGRO,299,328,559,559,1118
62,62042,620421105,General Roca,RIO NEGRO,235,249,422,494,916
62,62042,620421009,General Roca,RIO NEGRO,292,318,489,453,942
62,62042,620420907,General Roca,RIO NEGRO,277,300,530,542,1072
62,62042,620420803,General Roca,RIO NEGRO,212,204,305,331,636
62,62042,620423604,General Roca,RIO NEGRO,245,263,401,357,758
62,62042,620423603,General Roca,RIO NEGRO,276,330,388,349,737
62,62042,620423407,General Roca,RIO NEGRO,159,196,258,253,511
62,62042,620422405,General Roca,RIO NEGRO,315,323,498,515,1013
62,62042,620420716,General Roca,RIO NEGRO,210,221,358,365,723
62,62042,620420714,General Roca,RIO NEGRO,356,389,685,713,1398
62,62042,620420615,General Roca,RIO NEGRO,270,275,498,430,928
62,62042,620420505,General Roca,RIO NEGRO,185,213,308,300,608
62,62042,620424110,General Roca,RIO NEGRO,155,182,223,176,399
62,62042,620420403,General Roca,RIO NEGRO,172,184,284,323,607
62,62042,620421504,General Roca,RIO NEGRO,213,259,314,389,703
62,62063,620630205,Pichi Mahuida,RIO NEGRO,193,308,318,385,703
62,62063,620630101,Pichi Mahuida,RIO NEGRO,204,239,373,311,684
62,62063,620630109,Pichi Mahuida,RIO NEGRO,294,354,434,384,818
62,62063,620630106,Pichi Mahuida,RIO NEGRO,328,384,510,479,989
62,62063,620630114,Pichi Mahuida,RIO NEGRO,152,140,214,165,379
62,62063,620630113,Pichi Mahuida,RIO NEGRO,316,339,582,524,1106
62,62063,620630117,Pichi Mahuida,RIO NEGRO,214,235,357,351,708
62,62063,620630108,Pichi Mahuida,RIO NEGRO,215,220,358,368,726
62,62063,620630103,Pichi Mahuida,RIO NEGRO,220,269,340,249,589
62,62063,620630201,Pichi Mahuida,RIO NEGRO,305,335,466,470,936
62,62063,620630102,Pichi Mahuida,RIO NEGRO,188,218,239,203,442
62,62063,620630110,Pichi Mahuida,RIO NEGRO,171,206,232,198,430
62,62063,620630107,Pichi Mahuida,RIO NEGRO,79,86,116,138,254
62,62063,620630301,Pichi Mahuida,RIO NEGRO,18,47,17,37,54
62,62063,620630203,Pichi Mahuida,RIO NEGRO,68,99,77,99,176
62,62063,620630401,Pichi Mahuida,RIO NEGRO,56,145,21,103,124
62,62063,620630202,Pichi Mahuida,RIO NEGRO,108,169,125,160,285
62,62063,620630115,Pichi Mahuida,RIO NEGRO,191,219,345,339,684
62,62063,620630112,Pichi Mahuida,RIO NEGRO,228,249,341,355,696
62,62063,620630104,Pichi Mahuida,RIO NEGRO,242,309,373,347,720
62,62063,620630302,Pichi Mahuida,RIO NEGRO,67,164,28,73,101
62,62063,620630118,Pichi Mahuida,RIO NEGRO,145,161,254,268,522
62,62063,620630116,Pichi Mahuida,RIO NEGRO,150,199,193,176,369
62,62063,620630105,Pichi Mahuida,RIO NEGRO,224,240,397,340,737
62,62063,620630204,Pichi Mahuida,RIO NEGRO,127,217,189,195,384
62,62063,620630111,Pichi Mahuida,RIO NEGRO,184,223,265,226,491
54,54014,540140805,Cainguás,MISIONES,67,69,110,145,255
54,54014,540140602,Cainguás,MISIONES,267,278,441,524,965
54,54014,540140402,Cainguás,MISIONES,71,83,116,155,271
54,54014,540140401,Cainguás,MISIONES,136,147,218,280,498
54,54014,540140605,Cainguás,MISIONES,112,123,230,257,487
54,54014,540140603,Cainguás,MISIONES,84,84,135,161,296
54,54014,540140906,Cainguás,MISIONES,183,189,332,400,732
54,54014,540140210,Cainguás,MISIONES,312,338,501,505,1006
54,54014,540140209,Cainguás,MISIONES,306,306,538,538,1076
54,54014,540140206,Cainguás,MISIONES,158,162,273,264,537
54,54014,540140204,Cainguás,MISIONES,199,219,361,377,738
54,54014,540141006,Cainguás,MISIONES,136,146,221,232,453
54,54014,540141002,Cainguás,MISIONES,149,190,295,314,609
54,54014,540140802,Cainguás,MISIONES,110,126,181,172,353
54,54014,540140510,Cainguás,MISIONES,121,130,208,208,416
54,54014,540140807,Cainguás,MISIONES,181,200,354,285,639
54,54014,540140508,Cainguás,MISIONES,294,312,484,433,917
54,54014,540140506,Cainguás,MISIONES,227,210,409,419,828
54,54014,540140202,Cainguás,MISIONES,230,265,352,349,701
54,54014,540140111,Cainguás,MISIONES,335,367,705,663,1368
54,54014,540140208,Cainguás,MISIONES,311,307,491,438,929
54,54014,540140512,Cainguás,MISIONES,190,200,321,309,630
54,54014,540141004,Cainguás,MISIONES,111,117,228,257,485
54,54014,540140905,Cainguás,MISIONES,83,90,166,165,331
54,54014,540140304,Cainguás,MISIONES,168,188,273,324,597
54,54014,540140803,Cainguás,MISIONES,52,61,91,96,187
54,54014,540140403,Cainguás,MISIONES,97,95,159,176,335
54,54014,540140308,Cainguás,MISIONES,124,138,213,237,450
54,54014,540140211,Cainguás,MISIONES,321,326,642,671,1313
54,54014,540140103,Cainguás,MISIONES,299,333,493,425,918
54,54014,540140801,Cainguás,MISIONES,151,163,315,286,601
54,54014,540140201,Cainguás,MISIONES,119,122,241,263,504
54,54014,540140203,Cainguás,MISIONES,200,219,340,320,660
54,54014,540140104,Cainguás,MISIONES,275,302,456,453,909
54,54014,540141005,Cainguás,MISIONES,99,102,162,181,343
54,54014,540140902,Cainguás,MISIONES,104,123,201,239,440
54,54014,540140704,Cainguás,MISIONES,183,204,334,386,720
54,54014,540140703,Cainguás,MISIONES,177,205,323,383,706
54,54014,540140608,Cainguás,MISIONES,308,319,684,733,1417
54,54014,540140601,Cainguás,MISIONES,99,106,178,219,397
54,54014,540140404,Cainguás,MISIONES,259,277,448,538,986
54,54014,540140305,Cainguás,MISIONES,77,88,112,161,273
54,54014,540140302,Cainguás,MISIONES,91,94,145,154,299
54,54014,540140105,Cainguás,MISIONES,39,43,73,63,136
54,54014,540140309,Cainguás,MISIONES,169,175,344,383,727
54,54014,540140212,Cainguás,MISIONES,245,270,480,482,962
54,54014,540140205,Cainguás,MISIONES,235,268,381,357,738
54,54014,540141001,Cainguás,MISIONES,118,123,252,274,526
54,54014,540140301,Cainguás,MISIONES,96,104,139,157,296
54,54014,540140101,Cainguás,MISIONES,46,55,67,95,162
54,54014,540140607,Cainguás,MISIONES,414,463,812,876,1688
54,54014,540140504,Cainguás,MISIONES,198,168,363,374,737
54,54014,540140505,Cainguás,MISIONES,250,276,414,403,817
54,54014,540140808,Cainguás,MISIONES,261,284,517,499,1016
54,54014,540140509,Cainguás,MISIONES,189,195,370,342,712
54,54014,540140303,Cainguás,MISIONES,324,349,541,542,1083
54,54014,540140207,Cainguás,MISIONES,134,137,266,262,528
54,54014,540140109,Cainguás,MISIONES,299,329,519,496,1015
54,54014,540140904,Cainguás,MISIONES,36,45,67,73,140
54,54014,540140507,Cainguás,MISIONES,140,159,255,264,519
54,54014,540140306,Cainguás,MISIONES,32,35,65,66,131
54,54014,540140102,Cainguás,MISIONES,128,173,212,252,464
54,54014,540140604,Cainguás,MISIONES,209,214,413,434,847
54,54014,540140502,Cainguás,MISIONES,204,212,346,379,725
54,54014,540140107,Cainguás,MISIONES,135,135,279,286,565
54,54014,540140511,Cainguás,MISIONES,369,403,678,787,1465
54,54014,540140307,Cainguás,MISIONES,303,322,631,652,1283
54,54014,540140806,Cainguás,MISIONES,284,319,587,630,1217
54,54014,540141003,Cainguás,MISIONES,68,91,123,127,250
54,54014,540140903,Cainguás,MISIONES,87,88,185,213,398
54,54014,540140901,Cainguás,MISIONES,85,99,152,165,317
54,54014,540140705,Cainguás,MISIONES,142,145,287,304,591
54,54014,540140702,Cainguás,MISIONES,86,103,147,156,303
54,54014,540140606,Cainguás,MISIONES,172,177,321,405,726
54,54014,540140106,Cainguás,MISIONES,73,93,102,129,231
54,54014,540140501,Cainguás,MISIONES,152,157,261,268,529
54,54014,540140112,Cainguás,MISIONES,87,98,142,154,296
54,54014,540140110,Cainguás,MISIONES,261,296,447,381,828
54,54014,540140108,Cainguás,MISIONES,222,232,398,362,760
54,54014,540140609,Cainguás,MISIONES,157,166,320,338,658
54,54014,540140804,Cainguás,MISIONES,63,64,108,147,255
54,54014,540140701,Cainguás,MISIONES,138,161,266,268,534
54,54014,540140503,Cainguás,MISIONES,161,142,288,365,653
54,54007,540070505,Apóstoles,MISIONES,6,11,11,12,23
54,54007,540070402,Apóstoles,MISIONES,87,96,190,181,371
54,54007,540070308,Apóstoles,MISIONES,29,38,54,48,102
54,54007,540070304,Apóstoles,MISIONES,104,123,165,184,349
54,54007,540070201,Apóstoles,MISIONES,40,52,71,80,151
54,54007,540070506,Apóstoles,MISIONES,100,164,192,209,401
54,54007,540070503,Apóstoles,MISIONES,91,104,169,199,368
54,54007,540070105,Apóstoles,MISIONES,140,173,251,249,500
54,54007,540070618,Apóstoles,MISIONES,262,322,365,365,730
54,54007,540070610,Apóstoles,MISIONES,226,252,343,285,628
54,54007,540070107,Apóstoles,MISIONES,206,231,381,351,732
54,54007,540070605,Apóstoles,MISIONES,238,269,388,336,724
54,54007,540070603,Apóstoles,MISIONES,278,276,499,492,991
54,54007,540070606,Apóstoles,MISIONES,282,308,532,478,1010
54,54007,540070501,Apóstoles,MISIONES,25,35,26,46,72
54,54007,540070404,Apóstoles,MISIONES,28,29,51,67,118
54,54007,540070307,Apóstoles,MISIONES,46,60,70,101,171
54,54007,540070305,Apóstoles,MISIONES,59,72,96,122,218
54,54007,540070302,Apóstoles,MISIONES,115,141,209,194,403
54,54007,540070301,Apóstoles,MISIONES,34,36,42,73,115
54,54007,540070202,Apóstoles,MISIONES,25,29,33,36,69
54,54007,540070620,Apóstoles,MISIONES,103,107,205,228,433
54,54007,540070611,Apóstoles,MISIONES,260,256,424,371,795
54,54007,540070602,Apóstoles,MISIONES,296,333,562,452,1014
54,54007,540070102,Apóstoles,MISIONES,245,287,468,439,907
54,54007,540070316,Apóstoles,MISIONES,308,340,562,539,1101
54,54007,540070311,Apóstoles,MISIONES,260,234,496,427,923
54,54007,540070110,Apóstoles,MISIONES,145,132,310,332,642
54,54007,540070306,Apóstoles,MISIONES,46,81,60,84,144
54,54007,540070101,Apóstoles,MISIONES,39,56,65,66,131
54,54007,540070317,Apóstoles,MISIONES,161,174,358,365,723
54,54007,540070613,Apóstoles,MISIONES,331,378,540,542,1082
54,54007,540070612,Apóstoles,MISIONES,223,248,406,363,769
54,54007,540070313,Apóstoles,MISIONES,301,331,573,543,1116
54,54007,540070403,Apóstoles,MISIONES,163,195,317,341,658
54,54007,540070504,Apóstoles,MISIONES,246,292,403,411,814
54,54007,540070509,Apóstoles,MISIONES,192,217,365,379,744
54,54007,540070508,Apóstoles,MISIONES,335,372,644,639,1283
54,54007,540070312,Apóstoles,MISIONES,433,407,960,951,1911
54,54007,540070310,Apóstoles,MISIONES,192,206,392,396,788
54,54007,540070608,Apóstoles,MISIONES,173,193,257,211,468
54,54007,540070106,Apóstoles,MISIONES,6,18,12,23,35
54,54007,540070315,Apóstoles,MISIONES,270,267,532,504,1036
54,54007,540070109,Apóstoles,MISIONES,262,274,550,544,1094
54,54007,540070604,Apóstoles,MISIONES,231,245,411,395,806
54,54007,540070619,Apóstoles,MISIONES,277,308,499,478,977
54,54007,540070319,Apóstoles,MISIONES,245,245,540,556,1096
54,54007,540070318,Apóstoles,MISIONES,300,321,607,571,1178
54,54007,540070108,Apóstoles,MISIONES,330,349,600,549,1149
54,54007,540070502,Apóstoles,MISIONES,70,80,124,141,265
54,54007,540070406,Apóstoles,MISIONES,18,21,23,30,53
54,54007,540070405,Apóstoles,MISIONES,10,14,19,19,38
54,54007,540070303,Apóstoles,MISIONES,318,359,646,625,1271
54,54007,540070104,Apóstoles,MISIONES,95,102,162,178,340
54,54007,540070617,Apóstoles,MISIONES,209,241,332,296,628
54,54007,540070615,Apóstoles,MISIONES,337,367,696,695,1391
54,54007,540070103,Apóstoles,MISIONES,340,360,702,643,1345
54,54007,540070401,Apóstoles,MISIONES,55,83,107,101,208
54,54007,540070309,Apóstoles,MISIONES,25,44,56,56,112
54,54007,540070507,Apóstoles,MISIONES,53,67,60,83,143
54,54007,540070616,Apóstoles,MISIONES,359,385,706,721,1427
54,54007,540070614,Apóstoles,MISIONES,200,222,297,255,552
54,54007,540070601,Apóstoles,MISIONES,28,66,56,55,111
54,54007,540070314,Apóstoles,MISIONES,135,147,257,254,511
54,54007,540070609,Apóstoles,MISIONES,156,194,211,197,408
54,54007,540070607,Apóstoles,MISIONES,354,362,696,687,1383
54,54084,540840801,Montecarlo,MISIONES,11,33,5,31,36
54,54084,540840406,Montecarlo,MISIONES,11,11,17,16,33
54,54084,540840404,Montecarlo,MISIONES,38,47,60,65,125
54,54084,540840602,Montecarlo,MISIONES,109,114,220,252,472
54,54084,540840405,Montecarlo,MISIONES,217,231,419,466,885
54,54084,540840402,Montecarlo,MISIONES,87,94,194,198,392
54,54084,540840104,Montecarlo,MISIONES,192,205,376,404,780
54,54084,540840606,Montecarlo,MISIONES,177,197,344,364,708
54,54084,540840605,Montecarlo,MISIONES,100,112,205,198,403
54,54084,540840908,Montecarlo,MISIONES,249,288,402,323,725
54,54084,540840108,Montecarlo,MISIONES,275,322,518,515,1033
54,54084,540840701,Montecarlo,MISIONES,37,46,74,76,150
54,54084,540840603,Montecarlo,MISIONES,79,80,115,137,252
54,54084,540840204,Montecarlo,MISIONES,1,4,0,1,1
54,54084,540840906,Montecarlo,MISIONES,267,280,418,439,857
54,54084,540840909,Montecarlo,MISIONES,340,367,698,692,1390
54,54084,540840409,Montecarlo,MISIONES,220,235,462,465,927
54,54084,540840102,Montecarlo,MISIONES,285,310,499,459,958
54,54084,540840502,Montecarlo,MISIONES,49,47,81,100,181
54,54084,540840501,Montecarlo,MISIONES,34,36,38,68,106
54,54084,540840308,Montecarlo,MISIONES,25,30,23,34,57
54,54084,540840201,Montecarlo,MISIONES,57,75,92,107,199
54,54084,540840607,Montecarlo,MISIONES,227,261,449,510,959
54,54084,540840314,Montecarlo,MISIONES,200,231,327,290,617
54,54084,540840907,Montecarlo,MISIONES,364,400,617,590,1207
54,54084,540840304,Montecarlo,MISIONES,356,389,663,614,1277
54,54084,540840101,Montecarlo,MISIONES,89,100,134,142,276
54,54084,540840910,Montecarlo,MISIONES,192,219,276,260,536
54,54084,540840305,Montecarlo,MISIONES,193,204,293,245,538
54,54084,540840313,Montecarlo,MISIONES,158,166,426,432,858
54,54084,540840109,Montecarlo,MISIONES,311,340,640,623,1263
54,54084,540840311,Montecarlo,MISIONES,71,78,138,135,273
54,54084,540840202,Montecarlo,MISIONES,85,97,180,197,377
54,54084,540840903,Montecarlo,MISIONES,193,230,285,259,544
54,54084,540840312,Montecarlo,MISIONES,256,256,482,435,917
54,54084,540840301,Montecarlo,MISIONES,376,381,708,707,1415
54,54084,540840110,Montecarlo,MISIONES,223,247,443,474,917
54,54084,540840106,Montecarlo,MISIONES,248,272,441,423,864
54,54084,540840601,Montecarlo,MISIONES,39,51,62,92,154
54,54084,540840306,Montecarlo,MISIONES,26,33,54,50,104
54,54084,540840203,Montecarlo,MISIONES,21,28,37,52,89
54,54084,540840103,Montecarlo,MISIONES,31,41,76,77,153
54,54084,540840702,Montecarlo,MISIONES,7,12,2,9,11
54,54084,540840904,Montecarlo,MISIONES,307,333,511,521,1032
54,54084,540840408,Montecarlo,MISIONES,187,205,383,408,791
54,54084,540840303,Montecarlo,MISIONES,191,196,352,339,691
54,54084,540840604,Montecarlo,MISIONES,35,56,60,85,145
54,54084,540840310,Montecarlo,MISIONES,34,40,60,67,127
54,54084,540840407,Montecarlo,MISIONES,45,48,81,78,159
54,54084,540840403,Montecarlo,MISIONES,316,341,596,606,1202
54,54084,540840309,Montecarlo,MISIONES,151,166,286,312,598
54,54084,540840307,Montecarlo,MISIONES,182,177,367,384,751
54,54084,540840905,Montecarlo,MISIONES,169,194,350,355,705
54,54084,540840901,Montecarlo,MISIONES,287,327,610,561,1171
54,54084,540840302,Montecarlo,MISIONES,291,272,557,509,1066
54,54084,540840105,Montecarlo,MISIONES,256,302,438,448,886
54,54084,540840902,Montecarlo,MISIONES,393,386,871,906,1777
54,54084,540840107,Montecarlo,MISIONES,328,345,624,609,1233
54,54084,540840802,Montecarlo,MISIONES,70,112,105,144,249
54,54084,540840401,Montecarlo,MISIONES,37,46,70,73,143
54,54077,540770206,Libertador General San Martín,MISIONES,24,32,32,59,91
54,54077,540770603,Libertador General San Martín,MISIONES,165,196,255,264,519
54,54077,540770306,Libertador General San Martín,MISIONES,72,82,129,167,296
54,54077,540770305,Libertador General San Martín,MISIONES,107,108,214,233,447
54,54077,540770802,Libertador General San Martín,MISIONES,115,119,206,205,411
54,54077,540770801,Libertador General San Martín,MISIONES,284,320,480,435,915
54,54077,540770407,Libertador General San Martín,MISIONES,265,273,457,424,881
54,54077,540770110,Libertador General San Martín,MISIONES,370,394,713,677,1390
54,54077,540770108,Libertador General San Martín,MISIONES,386,403,654,681,1335
54,54077,540770205,Libertador General San Martín,MISIONES,131,144,241,276,517
54,54077,540770204,Libertador General San Martín,MISIONES,11,15,20,23,43
54,54077,540770403,Libertador General San Martín,MISIONES,65,111,107,114,221
54,54077,540770101,Libertador General San Martín,MISIONES,296,309,580,552,1132
54,54077,540770808,Libertador General San Martín,MISIONES,114,124,194,173,367
54,54077,540770602,Libertador General San Martín,MISIONES,362,405,643,735,1378
54,54077,540770501,Libertador General San Martín,MISIONES,125,132,279,334,613
54,54077,540770303,Libertador General San Martín,MISIONES,44,49,67,75,142
54,54077,540770302,Libertador General San Martín,MISIONES,170,203,394,410,804
54,54077,540770106,Libertador General San Martín,MISIONES,44,56,79,94,173
54,54077,540770703,Libertador General San Martín,MISIONES,314,326,682,670,1352
54,54077,540770105,Libertador General San Martín,MISIONES,407,535,639,664,1303
54,54077,540770809,Libertador General San Martín,MISIONES,219,233,320,279,599
54,54077,540770807,Libertador General San Martín,MISIONES,239,276,376,348,724
54,54077,540770405,Libertador General San Martín,MISIONES,245,275,357,348,705
54,54077,540770404,Libertador General San Martín,MISIONES,310,322,556,517,1073
54,54077,540770109,Libertador General San Martín,MISIONES,232,249,373,327,700
54,54077,540770503,Libertador General San Martín,MISIONES,9,13,19,21,40
54,54077,540770604,Libertador General San Martín,MISIONES,110,130,178,195,373
54,54077,540770104,Libertador General San Martín,MISIONES,271,304,456,496,952
54,54077,540770806,Libertador General San Martín,MISIONES,298,321,492,425,917
54,54077,540770805,Libertador General San Martín,MISIONES,346,338,693,717,1410
54,54077,540770803,Libertador General San Martín,MISIONES,277,291,401,377,778
54,54077,540770309,Libertador General San Martín,MISIONES,354,402,667,640,1307
54,54077,540770704,Libertador General San Martín,MISIONES,148,158,295,327,622
54,54077,540770304,Libertador General San Martín,MISIONES,140,145,260,302,562
54,54077,540770203,Libertador General San Martín,MISIONES,15,16,19,30,49
54,54077,540770601,Libertador General San Martín,MISIONES,152,163,272,280,552
54,54077,540770202,Libertador General San Martín,MISIONES,110,122,225,244,469
54,54077,540770406,Libertador General San Martín,MISIONES,76,94,137,136,273
54,54077,540770301,Libertador General San Martín,MISIONES,249,285,442,425,867
54,54077,540770209,Libertador General San Martín,MISIONES,290,304,559,563,1122
54,54077,540770107,Libertador General San Martín,MISIONES,265,275,540,509,1049
54,54077,540770102,Libertador General San Martín,MISIONES,379,414,705,745,1450
54,54077,540770605,Libertador General San Martín,MISIONES,189,221,396,417,813
54,54077,540770701,Libertador General San Martín,MISIONES,42,51,89,101,190
54,54077,540770207,Libertador General San Martín,MISIONES,117,139,218,220,438
54,54077,540770811,Libertador General San Martín,MISIONES,190,210,312,305,617
54,54077,540770810,Libertador General San Martín,MISIONES,255,273,429,356,785
54,54077,540770408,Libertador General San Martín,MISIONES,233,259,430,389,819
54,54077,540770308,Libertador General San Martín,MISIONES,195,218,415,445,860
54,54077,540770213,Libertador General San Martín,MISIONES,269,283,521,510,1031
54,54077,540770212,Libertador General San Martín,MISIONES,205,257,381,411,792
54,54077,540770210,Libertador General San Martín,MISIONES,207,228,374,346,720
54,54077,540770208,Libertador General San Martín,MISIONES,372,396,705,738,1443
54,54077,540770502,Libertador General San Martín,MISIONES,7,11,7,12,19
54,54077,540770201,Libertador General San Martín,MISIONES,170,184,367,407,774
54,54077,540770402,Libertador General San Martín,MISIONES,200,233,309,334,643
54,54077,540770401,Libertador General San Martín,MISIONES,342,391,686,796,1482
54,54077,540770103,Libertador General San Martín,MISIONES,254,262,491,529,1020
54,54077,540770812,Libertador General San Martín,MISIONES,190,220,305,295,600
54,54077,540770804,Libertador General San Martín,MISIONES,279,299,457,416,873
54,54077,540770211,Libertador General San Martín,MISIONES,297,336,568,626,1194
54,54077,540770702,Libertador General San Martín,MISIONES,127,142,257,256,513
54,54077,540770307,Libertador General San Martín,MISIONES,6,9,4,8,12
54,54070,540700401,Leandro N. Alem,MISIONES,79,84,158,163,321
54,54070,540700202,Leandro N. Alem,MISIONES,152,175,251,266,517
54,54070,540700102,Leandro N. Alem,MISIONES,62,77,114,129,243
54,54070,540700602,Leandro N. Alem,MISIONES,209,240,375,361,736
54,54070,540700105,Leandro N. Alem,MISIONES,95,101,147,170,317
54,54070,540700801,Leandro N. Alem,MISIONES,230,243,387,376,763
54,54070,540700709,Leandro N. Alem,MISIONES,185,191,287,242,529
54,54070,540700504,Leandro N. Alem,MISIONES,214,228,362,388,750
54,54070,540700309,Leandro N. Alem,MISIONES,397,411,768,801,1569
54,54070,540700307,Leandro N. Alem,MISIONES,289,305,472,446,918
54,54070,540700501,Leandro N. Alem,MISIONES,113,135,171,182,353
54,54070,540700306,Leandro N. Alem,MISIONES,266,296,509,524,1033
54,54070,540700301,Leandro N. Alem,MISIONES,131,138,226,263,489
54,54070,540700103,Leandro N. Alem,MISIONES,21,23,23,39,62
54,54070,540700204,Leandro N. Alem,MISIONES,58,72,85,108,193
54,54070,540700705,Leandro N. Alem,MISIONES,231,240,381,338,719
54,54070,540700704,Leandro N. Alem,MISIONES,280,309,467,452,919
54,54070,540700316,Leandro N. Alem,MISIONES,238,256,433,394,827
54,54070,540700315,Leandro N. Alem,MISIONES,202,208,421,395,816
54,54070,540700308,Leandro N. Alem,MISIONES,401,418,758,809,1567
54,54070,540700312,Leandro N. Alem,MISIONES,198,211,374,328,702
54,54070,540700208,Leandro N. Alem,MISIONES,251,278,497,513,1010
54,54070,540700404,Leandro N. Alem,MISIONES,93,104,174,174,348
54,54070,540700303,Leandro N. Alem,MISIONES,87,97,160,159,319
54,54070,540700205,Leandro N. Alem,MISIONES,227,248,410,430,840
54,54070,540700203,Leandro N. Alem,MISIONES,68,91,126,129,255
54,54070,540700806,Leandro N. Alem,MISIONES,322,352,474,369,843
54,54070,540700314,Leandro N. Alem,MISIONES,203,204,391,423,814
54,54070,540700311,Leandro N. Alem,MISIONES,314,348,591,569,1160
54,54070,540700805,Leandro N. Alem,MISIONES,228,229,405,350,755
54,54070,540700802,Leandro N. Alem,MISIONES,285,329,413,385,798
54,54070,540700708,Leandro N. Alem,MISIONES,336,363,555,505,1060
54,54070,540700707,Leandro N. Alem,MISIONES,301,323,447,420,867
54,54070,540700305,Leandro N. Alem,MISIONES,243,273,456,504,960
54,54070,540700104,Leandro N. Alem,MISIONES,120,133,211,232,443
54,54070,540700101,Leandro N. Alem,MISIONES,206,209,353,420,773
54,54070,540700808,Leandro N. Alem,MISIONES,237,244,439,383,822
54,54070,540700603,Leandro N. Alem,MISIONES,89,89,143,178,321
54,54070,540700502,Leandro N. Alem,MISIONES,138,152,222,245,467
54,54070,540700207,Leandro N. Alem,MISIONES,363,384,653,717,1370
54,54070,540700503,Leandro N. Alem,MISIONES,455,492,873,837,1710
54,54070,540700302,Leandro N. Alem,MISIONES,173,197,321,322,643
54,54070,540700804,Leandro N. Alem,MISIONES,238,252,411,379,790
54,54070,540700706,Leandro N. Alem,MISIONES,273,321,389,363,752
54,54070,540700702,Leandro N. Alem,MISIONES,189,201,249,216,465
54,54070,540700507,Leandro N. Alem,MISIONES,209,196,330,252,582
54,54070,540700506,Leandro N. Alem,MISIONES,84,99,129,163,292
54,54070,540700206,Leandro N. Alem,MISIONES,176,214,319,365,684
54,54070,540700803,Leandro N. Alem,MISIONES,399,421,668,597,1265
54,54070,540700703,Leandro N. Alem,MISIONES,257,289,378,318,696
54,54070,540700701,Leandro N. Alem,MISIONES,272,292,414,333,747
54,54070,540700508,Leandro N. Alem,MISIONES,328,367,545,575,1120
54,54070,540700313,Leandro N. Alem,MISIONES,201,211,374,325,699
54,54070,540700310,Leandro N. Alem,MISIONES,233,270,453,444,897
54,54070,540700505,Leandro N. Alem,MISIONES,154,187,263,317,580
54,54070,540700402,Leandro N. Alem,MISIONES,309,321,569,667,1236
54,54070,540700807,Leandro N. Alem,MISIONES,399,430,655,644,1299
54,54070,540700601,Leandro N. Alem,MISIONES,124,130,179,231,410
54,54070,540700403,Leandro N. Alem,MISIONES,69,69,116,135,251
54,54070,540700304,Leandro N. Alem,MISIONES,279,302,512,569,1081
54,54070,540700201,Leandro N. Alem,MISIONES,80,84,146,162,308
54,54063,540630810,Iguazú,MISIONES,67,77,134,163,297
54,54063,540630504,Iguazú,MISIONES,42,46,79,107,186
54,54063,540630202,Iguazú,MISIONES,1,2,26,22,48
54,54063,540631112,Iguazú,MISIONES,278,306,500,437,937
54,54063,540631109,Iguazú,MISIONES,227,247,436,439,875
54,54063,540631104,Iguazú,MISIONES,394,459,658,669,1327
54,54063,540631014,Iguazú,MISIONES,387,429,742,664,1406
54,54063,540630912,Iguazú,MISIONES,214,236,457,470,927
54,54063,540630910,Iguazú,MISIONES,204,204,434,410,844
54,54063,540630906,Iguazú,MISIONES,254,286,440,428,868
54,54063,540630801,Iguazú,MISIONES,181,186,352,398,750
54,54063,540630408,Iguazú,MISIONES,257,272,419,465,884
54,54063,540630406,Iguazú,MISIONES,342,361,705,711,1416
54,54063,540630903,Iguazú,MISIONES,12,12,20,20,40
54,54063,540630704,Iguazú,MISIONES,53,56,103,128,231
54,54063,540630302,Iguazú,MISIONES,80,101,150,186,336
54,54063,540630104,Iguazú,MISIONES,2,6,2,2,4
54,54063,540630103,Iguazú,MISIONES,2,3,2,2,4
54,54063,540631008,Iguazú,MISIONES,346,360,607,593,1200
54,54063,540631107,Iguazú,MISIONES,376,410,677,578,1255
54,54063,540631003,Iguazú,MISIONES,429,407,758,765,1523
54,54063,540630909,Iguazú,MISIONES,238,273,422,444,866
54,54063,540630807,Iguazú,MISIONES,43,51,66,85,151
54,54063,540630705,Iguazú,MISIONES,25,30,36,59,95
54,54063,540630701,Iguazú,MISIONES,7,11,7,13,20
54,54063,540630502,Iguazú,MISIONES,22,25,30,47,77
54,54063,540630301,Iguazú,MISIONES,59,75,47,93,140
54,54063,540630105,Iguazú,MISIONES,191,202,351,403,754
54,54063,540630404,Iguazú,MISIONES,64,78,96,113,209
54,54063,540630918,Iguazú,MISIONES,167,207,269,279,548
54,54063,540630917,Iguazú,MISIONES,197,208,396,355,751
54,54063,540630911,Iguazú,MISIONES,215,249,379,317,696
54,54063,540630815,Iguazú,MISIONES,386,500,754,750,1504
54,54063,540630812,Iguazú,MISIONES,264,262,519,568,1087
54,54063,540630804,Iguazú,MISIONES,164,194,335,303,638
54,54063,540630802,Iguazú,MISIONES,442,447,777,844,1621
54,54063,540631010,Iguazú,MISIONES,175,181,287,309,596
54,54063,540631011,Iguazú,MISIONES,227,226,435,442,877
54,54063,540630405,Iguazú,MISIONES,218,236,488,433,921
54,54063,540630107,Iguazú,MISIONES,274,309,503,477,980
54,54063,540630819,Iguazú,MISIONES,311,319,749,729,1478
54,54063,540631108,Iguazú,MISIONES,275,295,475,460,935
54,54063,540631102,Iguazú,MISIONES,384,410,1079,1156,2235
54,54063,540631013,Iguazú,MISIONES,348,353,662,690,1352
54,54063,540631007,Iguazú,MISIONES,187,208,401,427,828
54,54063,540631002,Iguazú,MISIONES,402,490,718,737,1455
54,54063,540630814,Iguazú,MISIONES,443,455,839,853,1692
54,54063,540631009,Iguazú,MISIONES,199,199,385,379,764
54,54063,540631012,Iguazú,MISIONES,252,272,499,468,967
54,54063,540630806,Iguazú,MISIONES,26,33,44,52,96
54,54063,540630203,Iguazú,MISIONES,0,1,0,0,0
54,54063,540630102,Iguazú,MISIONES,85,90,264,278,542
54,54063,540630811,Iguazú,MISIONES,114,116,258,241,499
54,54063,540631111,Iguazú,MISIONES,188,178,338,297,635
54,54063,540631005,Iguazú,MISIONES,245,244,433,411,844
54,54063,540630915,Iguazú,MISIONES,260,277,585,577,1162
54,54063,540630908,Iguazú,MISIONES,334,363,713,699,1412
54,54063,540630907,Iguazú,MISIONES,232,260,395,408,803
54,54063,540630816,Iguazú,MISIONES,314,338,674,732,1406
54,54063,540630409,Iguazú,MISIONES,182,223,362,363,725
54,54063,540630112,Iguazú,MISIONES,309,328,578,562,1140
54,54063,540630111,Iguazú,MISIONES,319,341,591,635,1226
54,54063,540630809,Iguazú,MISIONES,4,6,7,7,14
54,54063,540630201,Iguazú,MISIONES,5,5,10,9,19
54,54063,540630901,Iguazú,MISIONES,164,193,385,392,777
54,54063,540630410,Iguazú,MISIONES,195,212,387,348,735
54,54063,540631001,Iguazú,MISIONES,273,277,417,392,809
54,54063,540630914,Iguazú,MISIONES,366,368,698,671,1369
54,54063,540630913,Iguazú,MISIONES,121,126,301,295,596
54,54063,540631103,Iguazú,MISIONES,230,250,563,487,1050
54,54063,540630813,Iguazú,MISIONES,411,427,749,722,1471
54,54063,540630808,Iguazú,MISIONES,10,12,9,11,20
54,54063,540630703,Iguazú,MISIONES,17,28,25,34,59
54,54063,540630702,Iguazú,MISIONES,3,8,1,4,5
54,54063,540630505,Iguazú,MISIONES,56,62,65,112,177
54,54063,540630503,Iguazú,MISIONES,33,36,52,73,125
54,54063,540630401,Iguazú,MISIONES,23,29,41,56,97
54,54063,540630501,Iguazú,MISIONES,168,164,277,320,597
54,54063,540630101,Iguazú,MISIONES,126,144,187,229,416
54,54063,540630115,Iguazú,MISIONES,254,318,394,436,830
54,54063,540630109,Iguazú,MISIONES,369,408,706,747,1453
54,54063,540630108,Iguazú,MISIONES,212,204,462,423,885
54,54063,540630106,Iguazú,MISIONES,268,293,478,549,1027
54,54063,540631101,Iguazú,MISIONES,238,277,591,515,1106
54,54063,540630904,Iguazú,MISIONES,177,182,273,270,543
54,54063,540630114,Iguazú,MISIONES,210,292,362,379,741
54,54063,540630818,Iguazú,MISIONES,194,189,325,318,643
54,54063,540630407,Iguazú,MISIONES,236,253,433,431,864
54,54063,540630602,Iguazú,MISIONES,22,24,19,43,62
54,54063,540630402,Iguazú,MISIONES,20,28,15,26,41
54,54063,540630902,Iguazú,MISIONES,82,111,124,162,286
54,54063,540630805,Iguazú,MISIONES,399,395,783,804,1587
54,54063,540630403,Iguazú,MISIONES,84,98,149,177,326
54,54063,540630110,Iguazú,MISIONES,376,351,712,699,1411
54,54063,540631113,Iguazú,MISIONES,338,381,602,589,1191
54,54063,540631110,Iguazú,MISIONES,283,290,487,536,1023
54,54063,540631106,Iguazú,MISIONES,412,433,727,713,1440
54,54063,540631105,Iguazú,MISIONES,441,523,733,730,1463
54,54063,540631006,Iguazú,MISIONES,205,219,420,445,865
54,54063,540631004,Iguazú,MISIONES,389,438,716,671,1387
54,54063,540630803,Iguazú,MISIONES,169,188,227,224,451
54,54063,540630817,Iguazú,MISIONES,246,254,639,638,1277
54,54063,540630916,Iguazú,MISIONES,200,225,441,471,912
54,54063,540630905,Iguazú,MISIONES,246,275,478,489,967
54,54063,540630113,Iguazú,MISIONES,255,271,523,501,1024
54,54063,540630601,Iguazú,MISIONES,1,15,0,1,1
54,54056,540560709,Guaraní,MISIONES,265,273,495,560,1055
54,54056,540560706,Guaraní,MISIONES,68,75,129,155,284
54,54056,540560703,Guaraní,MISIONES,53,62,85,95,180
54,54056,540560606,Guaraní,MISIONES,134,150,271,354,625
54,54056,540560704,Guaraní,MISIONES,59,62,97,128,225
54,54056,540560611,Guaraní,MISIONES,352,391,667,712,1379
54,54056,540560210,Guaraní,MISIONES,285,290,549,500,1049
54,54056,540560612,Guaraní,MISIONES,375,397,744,767,1511
54,54056,540560501,Guaraní,MISIONES,299,313,579,657,1236
54,54056,540560205,Guaraní,MISIONES,289,311,523,589,1112
54,54056,540560802,Guaraní,MISIONES,509,560,908,1032,1940
54,54056,540560603,Guaraní,MISIONES,471,544,902,971,1873
54,54056,540560801,Guaraní,MISIONES,527,636,986,1067,2053
54,54056,540560911,Guaraní,MISIONES,214,208,362,325,687
54,54056,540560902,Guaraní,MISIONES,631,719,1024,1030,2054
54,54056,540560613,Guaraní,MISIONES,398,444,800,814,1614
54,54056,540560503,Guaraní,MISIONES,1,1,1,2,3
54,54056,540560301,Guaraní,MISIONES,435,461,816,931,1747
54,54056,540560204,Guaraní,MISIONES,142,148,240,285,525
54,54056,540560607,Guaraní,MISIONES,236,266,449,501,950
54,54056,540560604,Guaraní,MISIONES,585,660,1215,1199,2414
54,54056,540560308,Guaraní,MISIONES,235,252,429,486,915
54,54056,540560202,Guaraní,MISIONES,176,199,317,311,628
54,54056,540560909,Guaraní,MISIONES,285,315,591,609,1200
54,54056,540560610,Guaraní,MISIONES,355,379,713,685,1398
54,54056,540560209,Guaraní,MISIONES,186,218,336,291,627
54,54056,540560302,Guaraní,MISIONES,224,192,451,491,942
54,54056,540560103,Guaraní,MISIONES,230,230,438,457,895
54,54056,540560203,Guaraní,MISIONES,99,108,169,161,330
54,54056,540560614,Guaraní,MISIONES,239,284,451,482,933
54,54056,540560201,Guaraní,MISIONES,348,388,639,616,1255
54,54056,540560309,Guaraní,MISIONES,159,170,290,275,565
54,54056,540560307,Guaraní,MISIONES,97,110,196,224,420
54,54056,540560207,Guaraní,MISIONES,131,128,228,275,503
54,54056,540560106,Guaraní,MISIONES,98,100,172,195,367
54,54056,540560102,Guaraní,MISIONES,248,261,454,535,989
54,54056,540560910,Guaraní,MISIONES,229,259,392,338,730
54,54056,540560906,Guaraní,MISIONES,221,265,388,364,752
54,54056,540560905,Guaraní,MISIONES,298,322,484,458,942
54,54056,540560206,Guaraní,MISIONES,301,331,502,502,1004
54,54056,540560402,Guaraní,MISIONES,3,6,1,12,13
54,54056,540560502,Guaraní,MISIONES,1,2,0,2,2
54,54056,540560803,Guaraní,MISIONES,218,259,453,525,978
54,54056,540560705,Guaraní,MISIONES,107,118,188,206,394
54,54056,540560609,Guaraní,MISIONES,228,243,436,514,950
54,54056,540560608,Guaraní,MISIONES,465,522,884,937,1821
54,54056,540560101,Guaraní,MISIONES,179,190,322,361,683
54,54056,540560601,Guaraní,MISIONES,549,620,1106,1228,2334
54,54056,540560903,Guaraní,MISIONES,455,524,780,760,1540
54,54056,540560304,Guaraní,MISIONES,131,142,254,256,510
54,54056,540560908,Guaraní,MISIONES,301,314,582,498,1080
54,54056,540560710,Guaraní,MISIONES,266,317,486,581,1067
54,54056,540560711,Guaraní,MISIONES,284,336,505,459,964
54,54056,540560904,Guaraní,MISIONES,294,306,551,512,1063
54,54056,540560208,Guaraní,MISIONES,336,365,617,513,1130
54,54056,540560305,Guaraní,MISIONES,314,355,558,690,1248
54,54056,540560105,Guaraní,MISIONES,105,113,188,217,405
54,54056,540560702,Guaraní,MISIONES,269,327,495,560,1055
54,54056,540560701,Guaraní,MISIONES,90,110,163,169,332
54,54056,540560605,Guaraní,MISIONES,234,249,469,524,993
54,54056,540560401,Guaraní,MISIONES,1,2,0,1,1
54,54056,540560306,Guaraní,MISIONES,144,150,270,331,601
54,54056,540560907,Guaraní,MISIONES,220,229,422,394,816
54,54056,540560901,Guaraní,MISIONES,372,417,631,539,1170
54,54056,540560303,Guaraní,MISIONES,567,572,1053,1207,2260
54,54056,540560104,Guaraní,MISIONES,199,214,343,400,743
54,54056,540560708,Guaraní,MISIONES,338,352,601,714,1315
54,54056,540560707,Guaraní,MISIONES,113,109,185,200,385
54,54056,540560602,Guaraní,MISIONES,466,473,879,1064,1943
54,54056,540560403,Guaraní,MISIONES,53,57,81,109,190
54,54119,541190501,25 de Mayo,MISIONES,96,108,177,207,384
54,54119,541190403,25 de Mayo,MISIONES,417,495,671,704,1375
54,54119,541190304,25 de Mayo,MISIONES,130,136,233,234,467
54,54119,541190101,25 de Mayo,MISIONES,219,231,458,479,937
54,54119,541190603,25 de Mayo,MISIONES,113,147,199,206,405
54,54119,541190402,25 de Mayo,MISIONES,267,293,487,556,1043
54,54119,541190305,25 de Mayo,MISIONES,165,184,293,282,575
54,54119,541190303,25 de Mayo,MISIONES,267,296,436,477,913
54,54119,541190302,25 de Mayo,MISIONES,407,399,690,790,1480
54,54119,541190602,25 de Mayo,MISIONES,188,198,298,356,654
54,54119,541190506,25 de Mayo,MISIONES,118,121,202,192,394
54,54119,541190204,25 de Mayo,MISIONES,137,131,223,253,476
54,54119,541190202,25 de Mayo,MISIONES,271,272,603,660,1263
54,54119,541190401,25 de Mayo,MISIONES,134,127,239,279,518
54,54119,541190503,25 de Mayo,MISIONES,239,262,407,452,859
54,54119,541190508,25 de Mayo,MISIONES,363,395,637,605,1242
54,54119,541190507,25 de Mayo,MISIONES,134,160,254,232,486
54,54119,541190601,25 de Mayo,MISIONES,36,40,78,86,164
54,54119,541190505,25 de Mayo,MISIONES,50,54,76,99,175
54,54119,541190306,25 de Mayo,MISIONES,74,78,136,131,267
54,54119,541190301,25 de Mayo,MISIONES,63,63,128,146,274
54,54119,541190203,25 de Mayo,MISIONES,262,264,485,544,1029
54,54119,541190107,25 de Mayo,MISIONES,525,544,957,865,1822
54,54119,541190105,25 de Mayo,MISIONES,583,603,1084,1174,2258
54,54119,541190502,25 de Mayo,MISIONES,493,512,851,873,1724
54,54119,541190103,25 de Mayo,MISIONES,390,411,686,765,1451
54,54119,541190106,25 de Mayo,MISIONES,287,302,477,444,921
54,54119,541190201,25 de Mayo,MISIONES,142,139,306,334,640
54,54119,541190504,25 de Mayo,MISIONES,158,159,285,326,611
54,54119,541190102,25 de Mayo,MISIONES,190,199,390,413,803
54,54119,541190104,25 de Mayo,MISIONES,352,364,649,663,1312
54,54119,541190307,25 de Mayo,MISIONES,259,289,422,410,832
54,54105,541050306,San Javier,MISIONES,61,70,122,124,246
54,54105,541050302,San Javier,MISIONES,265,303,439,486,925
54,54105,541050223,San Javier,MISIONES,181,207,348,320,668
54,54105,541050222,San Javier,MISIONES,202,225,365,380,745
54,54105,541050403,San Javier,MISIONES,128,120,206,238,444
54,54105,541050208,San Javier,MISIONES,87,94,172,187,359
54,54105,541050207,San Javier,MISIONES,131,155,239,217,456
54,54105,541050214,San Javier,MISIONES,255,275,415,362,777
54,54105,541050402,San Javier,MISIONES,186,185,365,391,756
54,54105,541050301,San Javier,MISIONES,44,57,67,86,153
54,54105,541050212,San Javier,MISIONES,56,64,86,114,200
54,54105,541050209,San Javier,MISIONES,386,319,821,797,1618
54,54105,541050216,San Javier,MISIONES,222,234,414,365,779
54,54105,541050203,San Javier,MISIONES,92,93,166,205,371
54,54105,541050103,San Javier,MISIONES,185,174,338,375,713
54,54105,541050101,San Javier,MISIONES,77,78,130,161,291
54,54105,541050215,San Javier,MISIONES,168,192,323,291,614
54,54105,541050112,San Javier,MISIONES,87,91,157,134,291
54,54105,541050204,San Javier,MISIONES,72,73,119,154,273
54,54105,541050201,San Javier,MISIONES,107,98,168,218,386
54,54105,541050111,San Javier,MISIONES,9,9,15,12,27
54,54105,541050110,San Javier,MISIONES,15,20,15,25,40
54,54105,541050107,San Javier,MISIONES,50,58,81,105,186
54,54105,541050106,San Javier,MISIONES,5,7,7,13,20
54,54105,541050109,San Javier,MISIONES,6,8,10,7,17
54,54105,541050219,San Javier,MISIONES,257,274,405,354,759
54,54105,541050113,San Javier,MISIONES,205,209,356,375,731
54,54105,541050202,San Javier,MISIONES,91,96,150,203,353
54,54105,541050102,San Javier,MISIONES,43,48,76,79,155
54,54105,541050221,San Javier,MISIONES,230,248,450,394,844
54,54105,541050404,San Javier,MISIONES,72,86,110,127,237
54,54105,541050308,San Javier,MISIONES,42,46,81,103,184
54,54105,541050307,San Javier,MISIONES,87,98,152,181,333
54,54105,541050305,San Javier,MISIONES,56,62,104,107,211
54,54105,541050303,San Javier,MISIONES,40,50,86,86,172
54,54105,541050210,San Javier,MISIONES,33,38,43,51,94
54,54105,541050108,San Javier,MISIONES,89,85,164,161,325
54,54105,541050401,San Javier,MISIONES,210,246,374,416,790
54,54105,541050220,San Javier,MISIONES,187,203,370,347,717
54,54105,541050304,San Javier,MISIONES,10,10,13,14,27
54,54105,541050205,San Javier,MISIONES,6,7,13,16,29
54,54105,541050105,San Javier,MISIONES,81,90,155,167,322
54,54105,541050206,San Javier,MISIONES,6,9,18,13,31
54,54105,541050211,San Javier,MISIONES,20,20,41,36,77
54,54105,541050218,San Javier,MISIONES,323,348,612,535,1147
54,54105,541050217,San Javier,MISIONES,256,269,496,408,904
54,54105,541050213,San Javier,MISIONES,221,231,429,400,829
54,54105,541050104,San Javier,MISIONES,72,74,151,129,280
54,54028,540281703,Capital,MISIONES,15,15,31,34,65
54,54028,540281204,Capital,MISIONES,73,79,129,143,272
54,54028,540281013,Capital,MISIONES,225,305,306,216,522
54,54028,540281007,Capital,MISIONES,195,237,345,285,630
54,54028,540281002,Capital,MISIONES,202,291,237,149,386
54,54028,540280822,Capital,MISIONES,167,169,282,288,570
54,54028,540280812,Capital,MISIONES,448,448,636,823,1459
54,54028,540280810,Capital,MISIONES,364,372,697,694,1391
54,54028,540280806,Capital,MISIONES,274,270,603,568,1171
54,54028,540280720,Capital,MISIONES,275,274,527,488,1015
54,54028,540280718,Capital,MISIONES,227,249,342,307,649
54,54028,540280714,Capital,MISIONES,353,326,677,583,1260
54,54028,540280616,Capital,MISIONES,215,211,461,449,910
54,54028,540280611,Capital,MISIONES,300,322,534,503,1037
54,54028,540280419,Capital,MISIONES,373,352,819,741,1560
54,54028,540280418,Capital,MISIONES,250,264,489,477,966
54,54028,540280404,Capital,MISIONES,199,217,294,224,518
54,54028,540280403,Capital,MISIONES,211,222,370,317,687
54,54028,540280307,Capital,MISIONES,436,469,831,804,1635
54,54028,540280216,Capital,MISIONES,128,188,135,129,264
54,54028,540282417,Capital,MISIONES,55,302,95,96,191
54,54028,540282413,Capital,MISIONES,215,239,412,336,748
54,54028,540282405,Capital,MISIONES,267,267,625,603,1228
54,54028,540282308,Capital,MISIONES,230,242,406,368,774
54,54028,540282306,Capital,MISIONES,322,337,617,615,1232
54,54028,540282208,Capital,MISIONES,247,266,341,287,628
54,54028,540282016,Capital,MISIONES,340,308,616,608,1224
54,54028,540282013,Capital,MISIONES,237,246,493,479,972
54,54028,540281925,Capital,MISIONES,382,366,801,767,1568
54,54028,540281923,Capital,MISIONES,525,504,940,880,1820
54,54028,540281912,Capital,MISIONES,412,419,716,687,1403
54,54028,540281811,Capital,MISIONES,312,333,549,549,1098
54,54028,540281808,Capital,MISIONES,187,184,354,362,716
54,54028,540281321,Capital,MISIONES,176,340,326,314,640
54,54028,540281316,Capital,MISIONES,287,306,577,544,1121
54,54028,540281908,Capital,MISIONES,381,393,816,684,1500
54,54028,540281505,Capital,MISIONES,409,438,697,650,1347
54,54028,540280413,Capital,MISIONES,295,293,658,603,1261
54,54028,540280803,Capital,MISIONES,325,335,619,619,1238
54,54028,540282103,Capital,MISIONES,24,35,29,38,67
54,54028,540282101,Capital,MISIONES,6,13,4,11,15
54,54028,540281401,Capital,MISIONES,312,358,543,581,1124
54,54028,540281203,Capital,MISIONES,44,99,81,93,174
54,54028,540281303,Capital,MISIONES,68,101,100,116,216
54,54028,540281601,Capital,MISIONES,475,437,776,919,1695
54,54028,540281301,Capital,MISIONES,110,115,199,215,414
54,54028,540281208,Capital,MISIONES,319,344,580,592,1172
54,54028,540281214,Capital,MISIONES,467,513,874,746,1620
54,54028,540280821,Capital,MISIONES,266,251,516,514,1030
54,54028,540280815,Capital,MISIONES,226,217,489,470,959
54,54028,540280811,Capital,MISIONES,269,273,466,416,882
54,54028,540280716,Capital,MISIONES,340,344,590,569,1159
54,54028,540280610,Capital,MISIONES,172,174,300,242,542
54,54028,540280609,Capital,MISIONES,299,326,464,417,881
54,54028,540280511,Capital,MISIONES,287,252,512,466,978
54,54028,540280510,Capital,MISIONES,109,119,181,157,338
54,54028,540280504,Capital,MISIONES,169,181,326,274,600
54,54028,540280415,Capital,MISIONES,252,274,429,373,802
54,54028,540280409,Capital,MISIONES,277,279,501,420,921
54,54028,540280310,Capital,MISIONES,288,338,441,397,838
54,54028,540280309,Capital,MISIONES,245,282,411,305,716
54,54028,540280304,Capital,MISIONES,226,229,353,329,682
54,54028,540280209,Capital,MISIONES,154,185,210,160,370
54,54028,540280202,Capital,MISIONES,230,305,248,200,448
54,54028,540282416,Capital,MISIONES,356,357,775,796,1571
54,54028,540282305,Capital,MISIONES,430,432,856,768,1624
54,54028,540282303,Capital,MISIONES,343,355,565,530,1095
54,54028,540282210,Capital,MISIONES,321,344,487,427,914
54,54028,540282002,Capital,MISIONES,452,449,950,846,1796
54,54028,540281926,Capital,MISIONES,348,374,721,631,1352
54,54028,540281924,Capital,MISIONES,512,478,1019,968,1987
54,54028,540281911,Capital,MISIONES,354,378,607,481,1088
54,54028,540281910,Capital,MISIONES,262,285,438,370,808
54,54028,540281909,Capital,MISIONES,349,361,705,645,1350
54,54028,540281904,Capital,MISIONES,314,333,625,629,1254
54,54028,540281902,Capital,MISIONES,173,195,308,311,619
54,54028,540281818,Capital,MISIONES,251,270,381,339,720
54,54028,540281812,Capital,MISIONES,233,258,470,445,915
54,54028,540281805,Capital,MISIONES,209,226,405,391,796
54,54028,540281312,Capital,MISIONES,342,373,602,601,1203
54,54028,540281307,Capital,MISIONES,146,157,297,290,587
54,54028,540280106,Capital,MISIONES,105,113,167,149,316
54,54028,540280215,Capital,MISIONES,196,254,277,182,459
54,54028,540281502,Capital,MISIONES,55,75,62,108,170
54,54028,540281403,Capital,MISIONES,1,4,4,2,6
54,54028,540281501,Capital,MISIONES,78,154,100,123,223
54,54028,540281305,Capital,MISIONES,95,107,173,206,379
54,54028,540281102,Capital,MISIONES,110,129,176,249,425
54,54028,540281211,Capital,MISIONES,424,415,959,895,1854
54,54028,540281201,Capital,MISIONES,440,454,817,824,1641
54,54028,540281004,Capital,MISIONES,396,457,593,525,1118
54,54028,540280813,Capital,MISIONES,231,343,409,371,780
54,54028,540280805,Capital,MISIONES,228,248,402,382,784
54,54028,540280608,Capital,MISIONES,235,257,443,409,852
54,54028,540280505,Capital,MISIONES,255,276,698,548,1246
54,54028,540280302,Capital,MISIONES,298,324,556,470,1026
54,54028,540280208,Capital,MISIONES,232,329,280,197,477
54,54028,540280118,Capital,MISIONES,147,182,217,150,367
54,54028,540280117,Capital,MISIONES,206,257,290,214,504
54,54028,540280102,Capital,MISIONES,234,206,452,472,924
54,54028,540280101,Capital,MISIONES,181,203,329,288,617
54,54028,540282408,Capital,MISIONES,366,361,881,855,1736
54,54028,540282309,Capital,MISIONES,281,272,516,467,983
54,54028,540282307,Capital,MISIONES,273,284,467,407,874
54,54028,540282212,Capital,MISIONES,229,245,365,329,694
54,54028,540282211,Capital,MISIONES,234,263,326,262,588
54,54028,540282015,Capital,MISIONES,282,287,576,580,1156
54,54028,540282014,Capital,MISIONES,213,203,391,381,772
54,54028,540282011,Capital,MISIONES,472,492,928,872,1800
54,54028,540282009,Capital,MISIONES,290,306,533,520,1053
54,54028,540282003,Capital,MISIONES,445,426,808,716,1524
54,54028,540281906,Capital,MISIONES,358,378,616,501,1117
54,54028,540281822,Capital,MISIONES,203,230,377,343,720
54,54028,540281807,Capital,MISIONES,360,369,680,690,1370
54,54028,540281319,Capital,MISIONES,479,507,883,864,1747
54,54028,540281309,Capital,MISIONES,155,159,307,265,572
54,54028,540280108,Capital,MISIONES,212,225,349,289,638
54,54028,540281216,Capital,MISIONES,381,399,782,743,1525
54,54028,540282201,Capital,MISIONES,205,196,374,341,715
54,54028,540282006,Capital,MISIONES,312,311,593,531,1124
54,54028,540282005,Capital,MISIONES,358,327,603,549,1152
54,54028,540281209,Capital,MISIONES,376,398,769,694,1463
54,54028,540281206,Capital,MISIONES,317,357,575,560,1135
54,54028,540281304,Capital,MISIONES,7,9,12,9,21
54,54028,540281302,Capital,MISIONES,70,73,141,138,279
54,54028,540282401,Capital,MISIONES,315,336,581,557,1138
54,54028,540282312,Capital,MISIONES,342,346,744,752,1496
54,54028,540281202,Capital,MISIONES,166,211,353,302,655
54,54028,540281213,Capital,MISIONES,458,469,1088,1029,2117
54,54028,540281015,Capital,MISIONES,191,209,339,284,623
54,54028,540280911,Capital,MISIONES,177,232,253,210,463
54,54028,540280902,Capital,MISIONES,227,281,329,251,580
54,54028,540280910,Capital,MISIONES,202,244,231,173,404
54,54028,540280909,Capital,MISIONES,170,231,224,169,393
54,54028,540280814,Capital,MISIONES,246,290,437,464,901
54,54028,540280804,Capital,MISIONES,268,282,445,419,864
54,54028,540280721,Capital,MISIONES,262,272,434,379,813
54,54028,540280715,Capital,MISIONES,261,280,502,424,926
54,54028,540280709,Capital,MISIONES,216,234,397,266,663
54,54028,540280705,Capital,MISIONES,286,337,452,407,859
54,54028,540280613,Capital,MISIONES,335,345,629,563,1192
54,54028,540280605,Capital,MISIONES,217,209,437,452,889
54,54028,540280502,Capital,MISIONES,269,278,443,347,790
54,54028,540280406,Capital,MISIONES,303,379,450,375,825
54,54028,540280311,Capital,MISIONES,425,404,670,648,1318
54,54028,540280308,Capital,MISIONES,441,455,796,744,1540
54,54028,540280218,Capital,MISIONES,135,182,160,122,282
54,54028,540280207,Capital,MISIONES,256,317,354,278,632
54,54028,540280201,Capital,MISIONES,206,220,278,200,478
54,54028,540280113,Capital,MISIONES,179,183,253,242,495
54,54028,540280112,Capital,MISIONES,366,458,519,413,932
54,54028,540280104,Capital,MISIONES,202,209,365,328,693
54,54028,540282207,Capital,MISIONES,352,428,462,362,824
54,54028,540282008,Capital,MISIONES,144,158,230,223,453
54,54028,540281922,Capital,MISIONES,366,390,649,589,1238
54,54028,540281920,Capital,MISIONES,365,393,758,645,1403
54,54028,540281918,Capital,MISIONES,340,342,620,570,1190
54,54028,540281913,Capital,MISIONES,402,359,890,851,1741
54,54028,540281903,Capital,MISIONES,407,433,728,570,1298
54,54028,540281815,Capital,MISIONES,314,330,660,639,1299
54,54028,540281814,Capital,MISIONES,341,343,716,707,1423
54,54028,540281320,Capital,MISIONES,181,202,348,312,660
54,54028,540281317,Capital,MISIONES,167,179,363,365,728
54,54028,540281314,Capital,MISIONES,444,478,892,881,1773
54,54028,540281311,Capital,MISIONES,258,278,537,477,1014
54,54028,540280107,Capital,MISIONES,295,266,469,417,886
54,54028,540282403,Capital,MISIONES,353,409,634,609,1243
54,54028,540281504,Capital,MISIONES,424,429,756,695,1451
54,54028,540281322,Capital,MISIONES,327,351,695,695,1390
54,54028,540281602,Capital,MISIONES,7,22,12,13,25
54,54028,540280110,Capital,MISIONES,179,169,314,235,549
54,54028,540282314,Capital,MISIONES,195,211,308,268,576
54,54028,540280907,Capital,MISIONES,351,456,504,398,902
54,54028,540280901,Capital,MISIONES,244,298,360,254,614
54,54028,540280816,Capital,MISIONES,289,344,517,469,986
54,54028,540281219,Capital,MISIONES,402,466,802,733,1535
54,54028,540280711,Capital,MISIONES,213,243,344,315,659
54,54028,540280708,Capital,MISIONES,255,283,418,360,778
54,54028,540280707,Capital,MISIONES,175,191,274,243,517
54,54028,540280703,Capital,MISIONES,329,359,591,527,1118
54,54028,540280601,Capital,MISIONES,377,420,573,534,1107
54,54028,540280508,Capital,MISIONES,231,294,375,309,684
54,54028,540280410,Capital,MISIONES,373,309,789,697,1486
54,54028,540280407,Capital,MISIONES,290,278,430,388,818
54,54028,540280206,Capital,MISIONES,246,322,295,252,547
54,54028,540280203,Capital,MISIONES,304,375,403,273,676
54,54028,540280114,Capital,MISIONES,174,188,256,210,466
54,54028,540280103,Capital,MISIONES,372,357,787,757,1544
54,54028,540282411,Capital,MISIONES,314,367,546,514,1060
54,54028,540282410,Capital,MISIONES,287,303,630,542,1172
54,54028,540282409,Capital,MISIONES,269,291,583,569,1152
54,54028,540282213,Capital,MISIONES,210,238,315,244,559
54,54028,540282206,Capital,MISIONES,383,426,596,452,1048
54,54028,540282204,Capital,MISIONES,292,273,504,468,972
54,54028,540282203,Capital,MISIONES,220,266,329,250,579
54,54028,540282019,Capital,MISIONES,381,385,708,669,1377
54,54028,540282012,Capital,MISIONES,190,207,337,306,643
54,54028,540281916,Capital,MISIONES,383,420,689,611,1300
54,54028,540281821,Capital,MISIONES,232,258,421,454,875
54,54028,540281820,Capital,MISIONES,198,214,331,353,684
54,54028,540281817,Capital,MISIONES,221,237,394,432,826
54,54028,540281809,Capital,MISIONES,231,249,452,440,892
54,54028,540281318,Capital,MISIONES,133,188,226,228,454
54,54028,540281310,Capital,MISIONES,239,257,455,457,912
54,54028,540281806,Capital,MISIONES,169,184,328,300,628
54,54028,540281928,Capital,MISIONES,288,296,599,528,1127
54,54028,540282313,Capital,MISIONES,275,254,590,558,1148
54,54028,540282404,Capital,MISIONES,405,397,1002,979,1981
54,54028,540280706,Capital,MISIONES,186,212,310,239,549
54,54028,540282102,Capital,MISIONES,112,145,149,202,351
54,54028,540281702,Capital,MISIONES,20,28,28,40,68
54,54028,540281701,Capital,MISIONES,50,71,90,100,190
54,54028,540281005,Capital,MISIONES,271,338,385,295,680
54,54028,540281217,Capital,MISIONES,334,444,571,533,1104
54,54028,540281210,Capital,MISIONES,444,476,891,824,1715
54,54028,540281103,Capital,MISIONES,134,167,247,292,539
54,54028,540281012,Capital,MISIONES,273,299,451,375,826
54,54028,540281011,Capital,MISIONES,299,359,478,418,896
54,54028,540280906,Capital,MISIONES,203,209,311,269,580
54,54028,540280818,Capital,MISIONES,362,379,679,645,1324
54,54028,540280719,Capital,MISIONES,246,257,443,396,839
54,54028,540280713,Capital,MISIONES,428,409,740,738,1478
54,54028,540280704,Capital,MISIONES,269,298,439,393,832
54,54028,540280614,Capital,MISIONES,244,205,431,405,836
54,54028,540280612,Capital,MISIONES,389,431,708,600,1308
54,54028,540280603,Capital,MISIONES,434,445,711,623,1334
54,54028,540280507,Capital,MISIONES,262,308,400,359,759
54,54028,540280506,Capital,MISIONES,417,494,569,469,1038
54,54028,540280412,Capital,MISIONES,353,338,796,762,1558
54,54028,540280314,Capital,MISIONES,260,280,401,361,762
54,54028,540280306,Capital,MISIONES,241,257,455,409,864
54,54028,540280305,Capital,MISIONES,311,337,583,557,1140
54,54028,540280214,Capital,MISIONES,126,162,179,135,314
54,54028,540280119,Capital,MISIONES,198,221,288,228,516
54,54028,540280111,Capital,MISIONES,270,280,400,333,733
54,54028,540282412,Capital,MISIONES,391,413,857,846,1703
54,54028,540282304,Capital,MISIONES,352,335,630,607,1237
54,54028,540282302,Capital,MISIONES,254,277,417,401,818
54,54028,540282007,Capital,MISIONES,313,342,578,561,1139
54,54028,540282001,Capital,MISIONES,418,439,899,820,1719
54,54028,540281921,Capital,MISIONES,394,407,776,713,1489
54,54028,540281919,Capital,MISIONES,407,422,829,816,1645
54,54028,540281914,Capital,MISIONES,345,359,670,624,1294
54,54028,540281907,Capital,MISIONES,375,370,635,533,1168
54,54028,540281905,Capital,MISIONES,414,452,809,687,1496
54,54028,540281901,Capital,MISIONES,417,424,880,844,1724
54,54028,540281816,Capital,MISIONES,215,234,452,417,869
54,54028,540281810,Capital,MISIONES,322,344,554,504,1058
54,54028,540281804,Capital,MISIONES,345,375,602,595,1197
54,54028,540281315,Capital,MISIONES,432,468,840,866,1706
54,54028,540281313,Capital,MISIONES,333,365,699,645,1344
54,54028,540281306,Capital,MISIONES,332,373,633,627,1260
54,54028,540280109,Capital,MISIONES,180,214,253,253,506
54,54028,540281212,Capital,MISIONES,378,392,848,801,1649
54,54028,540281014,Capital,MISIONES,223,281,347,256,603
54,54028,540281009,Capital,MISIONES,422,491,663,558,1221
54,54028,540281006,Capital,MISIONES,238,265,320,270,590
54,54028,540281220,Capital,MISIONES,273,409,523,451,974
54,54028,540280820,Capital,MISIONES,421,430,878,821,1699
54,54028,540280819,Capital,MISIONES,326,512,452,413,865
54,54028,540280817,Capital,MISIONES,163,167,341,308,649
54,54028,540280809,Capital,MISIONES,381,390,795,741,1536
54,54028,540280808,Capital,MISIONES,385,332,832,783,1615
54,54028,540280908,Capital,MISIONES,279,392,436,312,748
54,54028,540280618,Capital,MISIONES,497,320,956,925,1881
54,54028,540280606,Capital,MISIONES,210,241,344,301,645
54,54028,540280604,Capital,MISIONES,165,176,300,298,598
54,54028,540280417,Capital,MISIONES,327,320,688,629,1317
54,54028,540280411,Capital,MISIONES,255,254,515,495,1010
54,54028,540280402,Capital,MISIONES,372,335,813,726,1539
54,54028,540280313,Capital,MISIONES,269,301,451,392,843
54,54028,540280312,Capital,MISIONES,299,316,549,505,1054
54,54028,540280701,Capital,MISIONES,271,291,512,456,968
54,54028,540280301,Capital,MISIONES,436,446,846,765,1611
54,54028,540280217,Capital,MISIONES,216,305,344,229,573
54,54028,540280213,Capital,MISIONES,214,281,289,167,456
54,54028,540280211,Capital,MISIONES,195,277,276,177,453
54,54028,540280204,Capital,MISIONES,215,308,346,239,585
54,54028,540280116,Capital,MISIONES,5,6,7,6,13
54,54028,540280105,Capital,MISIONES,67,67,111,110,221
54,54028,540282415,Capital,MISIONES,416,432,857,913,1770
54,54028,540282407,Capital,MISIONES,380,333,924,843,1767
54,54028,540282406,Capital,MISIONES,202,212,512,491,1003
54,54028,540282310,Capital,MISIONES,248,271,397,336,733
54,54028,540282209,Capital,MISIONES,410,404,641,542,1183
54,54028,540282205,Capital,MISIONES,238,265,316,248,564
54,54028,540282021,Capital,MISIONES,290,304,635,607,1242
54,54028,540282020,Capital,MISIONES,200,283,390,372,762
54,54028,540282018,Capital,MISIONES,231,249,430,418,848
54,54028,540282017,Capital,MISIONES,229,244,501,532,1033
54,54028,540281917,Capital,MISIONES,396,454,843,831,1674
54,54028,540281819,Capital,MISIONES,189,211,447,376,823
54,54028,540281803,Capital,MISIONES,228,243,516,507,1023
54,54028,540281207,Capital,MISIONES,269,264,526,487,1013
54,54028,540281205,Capital,MISIONES,264,261,578,495,1073
54,54028,540281503,Capital,MISIONES,59,69,106,110,216
54,54028,540281101,Capital,MISIONES,120,131,229,259,488
54,54028,540281215,Capital,MISIONES,274,272,484,450,934
54,54028,540281010,Capital,MISIONES,327,362,559,497,1056
54,54028,540281008,Capital,MISIONES,443,475,693,576,1269
54,54028,540281003,Capital,MISIONES,298,326,421,370,791
54,54028,540281001,Capital,MISIONES,223,251,292,236,528
54,54028,540280903,Capital,MISIONES,130,143,227,192,419
54,54028,540281218,Capital,MISIONES,474,480,945,974,1919
54,54028,540280807,Capital,MISIONES,481,467,1005,1030,2035
54,54028,540280717,Capital,MISIONES,243,228,438,379,817
54,54028,540280712,Capital,MISIONES,293,312,522,522,1044
54,54028,540280710,Capital,MISIONES,322,348,549,421,970
54,54028,540280617,Capital,MISIONES,246,264,439,418,857
54,54028,540280615,Capital,MISIONES,60,66,102,93,195
54,54028,540280607,Capital,MISIONES,310,331,545,481,1026
54,54028,540280602,Capital,MISIONES,321,296,509,440,949
54,54028,540280509,Capital,MISIONES,242,287,420,368,788
54,54028,540280501,Capital,MISIONES,304,347,419,329,748
54,54028,540280416,Capital,MISIONES,254,285,395,330,725
54,54028,540280702,Capital,MISIONES,293,301,556,504,1060
54,54028,540280414,Capital,MISIONES,249,269,422,354,776
54,54028,540280408,Capital,MISIONES,430,400,723,629,1352
54,54028,540280405,Capital,MISIONES,309,353,468,398,866
54,54028,540280401,Capital,MISIONES,354,353,621,581,1202
54,54028,540280303,Capital,MISIONES,280,285,554,597,1151
54,54028,540280212,Capital,MISIONES,120,165,182,128,310
54,54028,540280210,Capital,MISIONES,267,356,342,258,600
54,54028,540280205,Capital,MISIONES,181,325,320,306,626
54,54028,540282414,Capital,MISIONES,308,377,553,513,1066
54,54028,540282311,Capital,MISIONES,441,455,889,847,1736
54,54028,540282301,Capital,MISIONES,436,409,792,724,1516
54,54028,540282202,Capital,MISIONES,459,435,720,685,1405
54,54028,540282010,Capital,MISIONES,225,246,398,374,772
54,54028,540282004,Capital,MISIONES,499,544,913,839,1752
54,54028,540281927,Capital,MISIONES,242,298,509,488,997
54,54028,540281915,Capital,MISIONES,284,297,538,495,1033
54,54028,540281813,Capital,MISIONES,374,360,816,797,1613
54,54028,540281802,Capital,MISIONES,242,262,464,477,941
54,54028,540281801,Capital,MISIONES,351,350,802,800,1602
54,54028,540282402,Capital,MISIONES,315,377,537,511,1048
54,54028,540281323,Capital,MISIONES,175,352,317,307,624
54,54028,540281308,Capital,MISIONES,269,285,573,517,1090
54,54028,540281704,Capital,MISIONES,11,17,22,15,37
54,54028,540281402,Capital,MISIONES,0,5,0,0,0
54,54091,540910806,Oberá,MISIONES,32,41,47,59,106
54,54091,540911203,Oberá,MISIONES,111,118,224,225,449
54,54091,540910710,Oberá,MISIONES,144,165,248,526,774
54,54091,540911012,Oberá,MISIONES,23,27,43,44,87
54,54091,540911308,Oberá,MISIONES,272,282,496,426,922
54,54091,540911301,Oberá,MISIONES,324,346,679,722,1401
54,54091,540911211,Oberá,MISIONES,125,130,281,268,549
54,54091,540911210,Oberá,MISIONES,240,256,428,415,843
54,54091,540911209,Oberá,MISIONES,251,267,535,497,1032
54,54091,540910718,Oberá,MISIONES,328,371,590,571,1161
54,54091,540910515,Oberá,MISIONES,328,343,638,594,1232
54,54091,540910514,Oberá,MISIONES,227,275,544,504,1048
54,54091,540910511,Oberá,MISIONES,114,111,211,189,400
54,54091,540910213,Oberá,MISIONES,513,542,1019,969,1988
54,54091,540910114,Oberá,MISIONES,137,152,232,232,464
54,54091,540910103,Oberá,MISIONES,224,250,344,290,634
54,54091,540910102,Oberá,MISIONES,272,300,442,353,795
54,54091,540910505,Oberá,MISIONES,80,86,140,151,291
54,54091,540910504,Oberá,MISIONES,82,89,164,175,339
54,54091,540910403,Oberá,MISIONES,220,235,402,442,844
54,54091,540910508,Oberá,MISIONES,108,121,199,191,390
54,54091,540911206,Oberá,MISIONES,84,98,143,161,304
54,54091,540911011,Oberá,MISIONES,47,55,79,68,147
54,54091,540910707,Oberá,MISIONES,250,279,517,562,1079
54,54091,540911311,Oberá,MISIONES,365,429,591,619,1210
54,54091,540911306,Oberá,MISIONES,252,259,476,449,925
54,54091,540911008,Oberá,MISIONES,154,182,278,265,543
54,54091,540910715,Oberá,MISIONES,373,398,696,619,1315
54,54091,540910714,Oberá,MISIONES,269,328,479,537,1016
54,54091,540910512,Oberá,MISIONES,265,296,427,422,849
54,54091,540910201,Oberá,MISIONES,466,466,1007,1005,2012
54,54091,540910117,Oberá,MISIONES,350,373,683,640,1323
54,54091,540910110,Oberá,MISIONES,203,249,301,224,525
54,54091,540911105,Oberá,MISIONES,78,90,131,147,278
54,54091,540911102,Oberá,MISIONES,82,92,173,165,338
54,54091,540911013,Oberá,MISIONES,86,96,149,200,349
54,54091,540911002,Oberá,MISIONES,124,143,267,293,560
54,54091,540911107,Oberá,MISIONES,65,69,127,149,276
54,54091,540910808,Oberá,MISIONES,126,153,216,241,457
54,54091,540910302,Oberá,MISIONES,81,87,145,159,304
54,54091,540910402,Oberá,MISIONES,140,161,225,252,477
54,54091,540911001,Oberá,MISIONES,260,275,513,527,1040
54,54091,540910902,Oberá,MISIONES,215,220,427,487,914
54,54091,540910709,Oberá,MISIONES,113,127,212,226,438
54,54091,540910705,Oberá,MISIONES,133,170,258,280,538
54,54091,540910601,Oberá,MISIONES,167,183,258,278,536
54,54091,540911304,Oberá,MISIONES,265,274,534,533,1067
54,54091,540910713,Oberá,MISIONES,273,289,567,567,1134
54,54091,540910516,Oberá,MISIONES,164,174,315,304,619
54,54091,540910510,Oberá,MISIONES,71,78,144,158,302
54,54091,540910406,Oberá,MISIONES,188,214,340,338,678
54,54091,540910214,Oberá,MISIONES,242,251,485,515,1000
54,54091,540910212,Oberá,MISIONES,264,273,494,506,1000
54,54091,540910208,Oberá,MISIONES,302,307,506,469,975
54,54091,540910207,Oberá,MISIONES,389,406,556,527,1083
54,54091,540910116,Oberá,MISIONES,507,551,857,777,1634
54,54091,540911204,Oberá,MISIONES,15,17,20,23,43
54,54091,540911004,Oberá,MISIONES,37,36,57,67,124
54,54091,540910805,Oberá,MISIONES,148,179,276,295,571
54,54091,540910603,Oberá,MISIONES,85,95,123,157,280
54,54091,540911005,Oberá,MISIONES,159,174,281,348,629
54,54091,540911312,Oberá,MISIONES,330,359,626,603,1229
54,54091,540910717,Oberá,MISIONES,272,276,551,565,1116
54,54091,540910217,Oberá,MISIONES,206,249,314,255,569
54,54091,540910203,Oberá,MISIONES,270,286,469,449,918
54,54091,540910109,Oberá,MISIONES,254,310,323,263,586
54,54091,540910107,Oberá,MISIONES,314,311,636,624,1260
54,54091,540911103,Oberá,MISIONES,22,22,42,45,87
54,54091,540910904,Oberá,MISIONES,96,105,190,190,380
54,54091,540911106,Oberá,MISIONES,135,152,264,294,558
54,54091,540910809,Oberá,MISIONES,126,149,257,248,505
54,54091,540910702,Oberá,MISIONES,73,80,129,154,283
54,54091,540910506,Oberá,MISIONES,99,102,158,190,348
54,54091,540910501,Oberá,MISIONES,63,69,89,99,188
54,54091,540911201,Oberá,MISIONES,106,141,207,245,452
54,54091,540911313,Oberá,MISIONES,261,261,436,405,841
54,54091,540910905,Oberá,MISIONES,266,292,533,496,1029
54,54091,540910811,Oberá,MISIONES,170,179,353,366,719
54,54091,540910719,Oberá,MISIONES,263,281,513,478,991
54,54091,540910513,Oberá,MISIONES,266,281,450,451,901
54,54091,540910509,Oberá,MISIONES,440,455,876,872,1748
54,54091,540910219,Oberá,MISIONES,250,258,538,500,1038
54,54091,540910218,Oberá,MISIONES,270,289,522,559,1081
54,54091,540910216,Oberá,MISIONES,215,234,341,314,655
54,54091,540910204,Oberá,MISIONES,237,244,454,434,888
54,54091,540910119,Oberá,MISIONES,399,433,570,524,1094
54,54091,540910118,Oberá,MISIONES,360,559,306,402,708
54,54091,540910113,Oberá,MISIONES,225,255,307,246,553
54,54091,540910111,Oberá,MISIONES,256,301,368,280,648
54,54091,540910105,Oberá,MISIONES,368,394,538,493,1031
54,54091,540910101,Oberá,MISIONES,269,299,421,358,779
54,54091,540910210,Oberá,MISIONES,321,325,515,443,958
54,54091,540910115,Oberá,MISIONES,234,272,358,256,614
54,54091,540911207,Oberá,MISIONES,89,116,200,193,393
54,54091,540911010,Oberá,MISIONES,107,115,201,216,417
54,54091,540911202,Oberá,MISIONES,29,32,53,54,107
54,54091,540911003,Oberá,MISIONES,55,65,92,99,191
54,54091,540910903,Oberá,MISIONES,184,188,377,409,786
54,54091,540910801,Oberá,MISIONES,39,47,84,94,178
54,54091,540910602,Oberá,MISIONES,128,158,209,235,444
54,54091,540910405,Oberá,MISIONES,94,109,174,223,397
54,54091,540910304,Oberá,MISIONES,51,53,79,95,174
54,54091,540910901,Oberá,MISIONES,282,350,509,555,1064
54,54091,540911303,Oberá,MISIONES,289,355,560,545,1105
54,54091,540911014,Oberá,MISIONES,194,217,386,409,795
54,54091,540910215,Oberá,MISIONES,313,345,561,541,1102
54,54091,540910112,Oberá,MISIONES,339,364,479,457,936
54,54091,540910108,Oberá,MISIONES,493,620,562,579,1141
54,54091,540910804,Oberá,MISIONES,71,84,139,143,282
54,54091,540910507,Oberá,MISIONES,186,204,333,360,693
54,54091,540910301,Oberá,MISIONES,54,71,96,114,210
54,54091,540910503,Oberá,MISIONES,101,112,169,198,367
54,54091,540910305,Oberá,MISIONES,122,135,210,267,477
54,54091,540911101,Oberá,MISIONES,250,268,542,598,1140
54,54091,540911006,Oberá,MISIONES,83,94,140,160,300
54,54091,540910708,Oberá,MISIONES,125,153,238,254,492
54,54091,540910706,Oberá,MISIONES,164,178,304,312,616
54,54091,540910703,Oberá,MISIONES,120,135,216,234,450
54,54091,540910404,Oberá,MISIONES,237,268,397,450,847
54,54091,540911310,Oberá,MISIONES,459,536,588,575,1163
54,54091,540911307,Oberá,MISIONES,204,230,385,412,797
54,54091,540911305,Oberá,MISIONES,216,211,405,365,770
54,54091,540911302,Oberá,MISIONES,250,271,591,582,1173
54,54091,540910712,Oberá,MISIONES,258,271,458,454,912
54,54091,540910209,Oberá,MISIONES,336,334,608,564,1172
54,54091,540910205,Oberá,MISIONES,329,337,602,583,1185
54,54091,540910202,Oberá,MISIONES,431,433,856,839,1695
54,54091,540910104,Oberá,MISIONES,404,455,632,547,1179
54,54091,540911208,Oberá,MISIONES,56,56,113,138,251
54,54091,540911007,Oberá,MISIONES,34,34,66,66,132
54,54091,540910807,Oberá,MISIONES,97,99,227,235,462
54,54091,540910802,Oberá,MISIONES,168,179,295,334,629
54,54091,540910704,Oberá,MISIONES,66,74,118,138,256
54,54091,540910502,Oberá,MISIONES,98,111,171,192,363
54,54091,540910303,Oberá,MISIONES,52,68,68,82,150
54,54091,540911309,Oberá,MISIONES,445,464,832,747,1579
54,54091,540911009,Oberá,MISIONES,166,207,299,315,614
54,54091,540910810,Oberá,MISIONES,298,327,664,571,1235
54,54091,540910716,Oberá,MISIONES,244,253,448,488,936
54,54091,540910211,Oberá,MISIONES,265,303,504,458,962
54,54091,540910206,Oberá,MISIONES,222,245,354,287,641
54,54091,540910106,Oberá,MISIONES,389,402,690,597,1287
54,54091,540910306,Oberá,MISIONES,238,260,425,390,815
54,54091,540911205,Oberá,MISIONES,90,94,224,210,434
54,54091,540911104,Oberá,MISIONES,33,35,54,61,115
54,54091,540911108,Oberá,MISIONES,126,141,263,260,523
54,54091,540910803,Oberá,MISIONES,191,209,351,402,753
54,54091,540910711,Oberá,MISIONES,19,25,35,38,73
54,54091,540910701,Oberá,MISIONES,61,91,109,128,237
54,54091,540910401,Oberá,MISIONES,124,145,239,269,508
54,54098,540980701,San Ignacio,MISIONES,155,177,285,294,579
54,54098,540980511,San Ignacio,MISIONES,154,171,278,314,592
54,54098,540980202,San Ignacio,MISIONES,352,398,714,731,1445
54,54098,540981212,San Ignacio,MISIONES,200,208,438,409,847
54,54098,540981203,San Ignacio,MISIONES,156,183,301,296,597
54,54098,540981008,San Ignacio,MISIONES,262,283,478,444,922
54,54098,540980908,San Ignacio,MISIONES,314,368,647,572,1219
54,54098,540981006,San Ignacio,MISIONES,266,293,434,409,843
54,54098,540980904,San Ignacio,MISIONES,234,243,409,470,879
54,54098,540980301,San Ignacio,MISIONES,61,82,137,127,264
54,54098,540980204,San Ignacio,MISIONES,43,50,74,81,155
54,54098,540980201,San Ignacio,MISIONES,27,27,59,65,124
54,54098,540981004,San Ignacio,MISIONES,223,245,398,391,789
54,54098,540980515,San Ignacio,MISIONES,180,194,258,258,516
54,54098,540980207,San Ignacio,MISIONES,327,347,608,590,1198
54,54098,540981208,San Ignacio,MISIONES,338,343,648,623,1271
54,54098,540980906,San Ignacio,MISIONES,82,100,155,181,336
54,54098,540980602,San Ignacio,MISIONES,60,77,108,134,242
54,54098,540980601,San Ignacio,MISIONES,69,82,128,131,259
54,54098,540980508,San Ignacio,MISIONES,30,38,51,56,107
54,54098,540980403,San Ignacio,MISIONES,49,37,82,94,176
54,54098,540981213,San Ignacio,MISIONES,171,194,296,238,534
54,54098,540981207,San Ignacio,MISIONES,230,264,409,411,820
54,54098,540981206,San Ignacio,MISIONES,251,268,462,474,936
54,54098,540981205,San Ignacio,MISIONES,367,341,773,782,1555
54,54098,540981201,San Ignacio,MISIONES,148,157,285,242,527
54,54098,540981005,San Ignacio,MISIONES,235,250,434,367,801
54,54098,540980518,San Ignacio,MISIONES,225,271,398,347,745
54,54098,540980517,San Ignacio,MISIONES,115,135,238,257,495
54,54098,540980507,San Ignacio,MISIONES,212,223,431,416,847
54,54098,540981101,San Ignacio,MISIONES,56,60,138,158,296
54,54098,540980803,San Ignacio,MISIONES,118,152,207,239,446
54,54098,540980605,San Ignacio,MISIONES,13,29,20,22,42
54,54098,540980303,San Ignacio,MISIONES,99,106,199,223,422
54,54098,540980205,San Ignacio,MISIONES,31,34,46,67,113
54,54098,540980104,San Ignacio,MISIONES,301,347,555,538,1093
54,54098,540981211,San Ignacio,MISIONES,231,242,385,321,706
54,54098,540981011,San Ignacio,MISIONES,298,325,647,627,1274
54,54098,540980903,San Ignacio,MISIONES,234,206,384,375,759
54,54098,540980512,San Ignacio,MISIONES,89,100,159,167,326
54,54098,540981210,San Ignacio,MISIONES,192,219,333,277,610
54,54098,540980905,San Ignacio,MISIONES,127,139,224,258,482
54,54098,540981214,San Ignacio,MISIONES,290,292,595,568,1163
54,54098,540980907,San Ignacio,MISIONES,299,326,527,502,1029
54,54098,540980704,San Ignacio,MISIONES,146,133,264,250,514
54,54098,540980513,San Ignacio,MISIONES,209,225,413,380,793
54,54098,540980506,San Ignacio,MISIONES,172,195,264,236,500
54,54098,540980106,San Ignacio,MISIONES,316,381,588,541,1129
54,54098,540980401,San Ignacio,MISIONES,124,143,237,252,489
54,54098,540980203,San Ignacio,MISIONES,128,150,263,295,558
54,54098,540981002,San Ignacio,MISIONES,507,557,991,1100,2091
54,54098,540980101,San Ignacio,MISIONES,160,199,266,271,537
54,54098,540981003,San Ignacio,MISIONES,221,228,404,451,855
54,54098,540980504,San Ignacio,MISIONES,236,242,379,377,756
54,54098,540980703,San Ignacio,MISIONES,53,61,86,116,202
54,54098,540980102,San Ignacio,MISIONES,97,112,150,178,328
54,54098,540980802,San Ignacio,MISIONES,121,136,247,297,544
54,54098,540980801,San Ignacio,MISIONES,103,122,169,179,348
54,54098,540981103,San Ignacio,MISIONES,142,166,290,344,634
54,54098,540980902,San Ignacio,MISIONES,353,363,669,721,1390
54,54098,540980510,San Ignacio,MISIONES,84,129,166,174,340
54,54098,540980402,San Ignacio,MISIONES,65,61,133,137,270
54,54098,540980302,San Ignacio,MISIONES,148,172,261,269,530
54,54098,540981209,San Ignacio,MISIONES,231,261,406,399,805
54,54098,540981204,San Ignacio,MISIONES,305,322,701,719,1420
54,54098,540981202,San Ignacio,MISIONES,209,230,425,392,817
54,54098,540981007,San Ignacio,MISIONES,229,247,442,438,880
54,54098,540980516,San Ignacio,MISIONES,337,348,683,710,1393
54,54098,540980514,San Ignacio,MISIONES,210,235,374,308,682
54,54098,540980505,San Ignacio,MISIONES,232,248,328,333,661
54,54098,540980502,San Ignacio,MISIONES,309,324,566,504,1070
54,54098,540980206,San Ignacio,MISIONES,317,313,604,574,1178
54,54098,540981102,San Ignacio,MISIONES,111,108,225,263,488
54,54098,540980105,San Ignacio,MISIONES,56,64,92,112,204
54,54098,540980103,San Ignacio,MISIONES,78,93,133,144,277
54,54098,540980702,San Ignacio,MISIONES,265,223,486,515,1001
54,54098,540981010,San Ignacio,MISIONES,193,208,358,338,696
54,54098,540981009,San Ignacio,MISIONES,190,218,307,283,590
54,54098,540980503,San Ignacio,MISIONES,247,281,371,379,750
54,54098,540980501,San Ignacio,MISIONES,315,331,558,612,1170
54,54098,540981001,San Ignacio,MISIONES,12,19,21,30,51
54,54098,540980901,San Ignacio,MISIONES,169,189,265,309,574
54,54098,540980604,San Ignacio,MISIONES,25,41,30,48,78
54,54098,540980603,San Ignacio,MISIONES,39,46,54,81,135
54,54098,540980509,San Ignacio,MISIONES,154,181,282,337,619
94,94007,940071312,Río Grande,TIERRA DEL FUEGO,293,277,467,491,958
94,94007,940071007,Río Grande,TIERRA DEL FUEGO,337,337,595,575,1170
94,94007,940071011,Río Grande,TIERRA DEL FUEGO,326,343,559,589,1148
94,94007,940071101,Río Grande,TIERRA DEL FUEGO,308,342,445,442,887
94,94007,940071103,Río Grande,TIERRA DEL FUEGO,348,380,461,489,950
94,94007,940071203,Río Grande,TIERRA DEL FUEGO,197,203,265,298,563
94,94007,940071401,Río Grande,TIERRA DEL FUEGO,311,327,536,628,1164
94,94007,940071412,Río Grande,TIERRA DEL FUEGO,358,498,486,583,1069
94,94007,940070801,Río Grande,TIERRA DEL FUEGO,14,16,10,34,44
94,94007,940071402,Río Grande,TIERRA DEL FUEGO,376,384,659,707,1366
94,94007,940071008,Río Grande,TIERRA DEL FUEGO,279,302,511,459,970
94,94007,940071210,Río Grande,TIERRA DEL FUEGO,321,350,445,518,963
94,94007,940071306,Río Grande,TIERRA DEL FUEGO,106,218,192,191,383
94,94007,940071410,Río Grande,TIERRA DEL FUEGO,288,288,494,493,987
94,94007,940070503,Río Grande,TIERRA DEL FUEGO,294,510,507,526,1033
94,94007,940070601,Río Grande,TIERRA DEL FUEGO,31,32,18,59,77
94,94007,940071202,Río Grande,TIERRA DEL FUEGO,274,314,415,408,823
94,94007,940071206,Río Grande,TIERRA DEL FUEGO,342,340,607,564,1171
94,94007,940071211,Río Grande,TIERRA DEL FUEGO,232,262,333,341,674
94,94007,940071302,Río Grande,TIERRA DEL FUEGO,343,374,505,545,1050
94,94007,940071314,Río Grande,TIERRA DEL FUEGO,198,230,296,281,577
94,94007,940071408,Río Grande,TIERRA DEL FUEGO,312,341,479,533,1012
94,94007,940070502,Río Grande,TIERRA DEL FUEGO,150,222,233,262,495
94,94007,940071104,Río Grande,TIERRA DEL FUEGO,453,523,699,685,1384
94,94007,940071311,Río Grande,TIERRA DEL FUEGO,311,345,498,465,963
94,94007,940071308,Río Grande,TIERRA DEL FUEGO,245,347,404,469,873
94,94007,940071413,Río Grande,TIERRA DEL FUEGO,258,334,347,404,751
94,94007,940071403,Río Grande,TIERRA DEL FUEGO,352,360,652,683,1335
94,94007,940071406,Río Grande,TIERRA DEL FUEGO,271,287,382,435,817
94,94007,940071414,Río Grande,TIERRA DEL FUEGO,285,306,406,505,911
94,94007,940071416,Río Grande,TIERRA DEL FUEGO,96,104,121,161,282
94,94007,940071205,Río Grande,TIERRA DEL FUEGO,336,342,640,651,1291
94,94007,940071005,Río Grande,TIERRA DEL FUEGO,303,306,562,560,1122
94,94007,940071313,Río Grande,TIERRA DEL FUEGO,320,337,552,567,1119
94,94007,940071106,Río Grande,TIERRA DEL FUEGO,303,284,410,466,876
94,94007,940071111,Río Grande,TIERRA DEL FUEGO,313,322,476,580,1056
94,94007,940071113,Río Grande,TIERRA DEL FUEGO,358,350,537,541,1078
94,94007,940071201,Río Grande,TIERRA DEL FUEGO,249,240,332,357,689
94,94007,940071212,Río Grande,TIERRA DEL FUEGO,327,366,459,486,945
94,94007,940071303,Río Grande,TIERRA DEL FUEGO,338,364,588,558,1146
94,94007,940071305,Río Grande,TIERRA DEL FUEGO,348,369,477,566,1043
94,94007,940071307,Río Grande,TIERRA DEL FUEGO,352,405,556,584,1140
94,94007,940071404,Río Grande,TIERRA DEL FUEGO,293,317,508,546,1054
94,94007,940070505,Río Grande,TIERRA DEL FUEGO,188,382,315,357,672
94,94007,940070201,Río Grande,TIERRA DEL FUEGO,12,15,10,45,55
94,94007,940070901,Río Grande,TIERRA DEL FUEGO,0,0,0,0,0
94,94007,940070101,Río Grande,TIERRA DEL FUEGO,8,11,29,168,197
94,94007,940071001,Río Grande,TIERRA DEL FUEGO,407,342,649,675,1324
94,94007,940071112,Río Grande,TIERRA DEL FUEGO,329,361,470,498,968
94,94007,940071204,Río Grande,TIERRA DEL FUEGO,339,337,558,594,1152
94,94007,940071209,Río Grande,TIERRA DEL FUEGO,336,334,495,536,1031
94,94007,940071411,Río Grande,TIERRA DEL FUEGO,291,274,446,517,963
94,94007,940071407,Río Grande,TIERRA DEL FUEGO,346,387,520,521,1041
94,94007,940071109,Río Grande,TIERRA DEL FUEGO,280,275,373,397,770
94,94007,940071002,Río Grande,TIERRA DEL FUEGO,119,135,189,246,435
94,94007,940070401,Río Grande,TIERRA DEL FUEGO,17,17,18,40,58
94,94007,940070501,Río Grande,TIERRA DEL FUEGO,8,8,17,55,72
94,94007,940071006,Río Grande,TIERRA DEL FUEGO,336,340,575,554,1129
94,94007,940071102,Río Grande,TIERRA DEL FUEGO,308,326,494,468,962
94,94007,940071105,Río Grande,TIERRA DEL FUEGO,298,327,455,422,877
94,94007,940071108,Río Grande,TIERRA DEL FUEGO,170,190,231,282,513
94,94007,940071208,Río Grande,TIERRA DEL FUEGO,307,320,601,563,1164
94,94007,940071213,Río Grande,TIERRA DEL FUEGO,312,348,419,439,858
94,94007,940071309,Río Grande,TIERRA DEL FUEGO,267,353,447,452,899
94,94007,940071405,Río Grande,TIERRA DEL FUEGO,345,345,539,584,1123
94,94007,940071010,Río Grande,TIERRA DEL FUEGO,287,321,497,509,1006
94,94007,940070701,Río Grande,TIERRA DEL FUEGO,28,27,7,36,43
94,94007,940071415,Río Grande,TIERRA DEL FUEGO,227,219,385,429,814
94,94007,940071110,Río Grande,TIERRA DEL FUEGO,231,221,316,364,680
94,94007,940071107,Río Grande,TIERRA DEL FUEGO,210,305,246,281,527
94,94007,940070504,Río Grande,TIERRA DEL FUEGO,228,273,338,411,749
94,94007,940071003,Río Grande,TIERRA DEL FUEGO,355,328,654,643,1297
94,94007,940071009,Río Grande,TIERRA DEL FUEGO,292,309,542,484,1026
94,94007,940071012,Río Grande,TIERRA DEL FUEGO,279,281,489,498,987
94,94007,940071013,Río Grande,TIERRA DEL FUEGO,290,300,493,484,977
94,94007,940071207,Río Grande,TIERRA DEL FUEGO,296,304,551,500,1051
94,94007,940071301,Río Grande,TIERRA DEL FUEGO,314,314,516,499,1015
94,94007,940071304,Río Grande,TIERRA DEL FUEGO,318,337,528,534,1062
94,94007,940071310,Río Grande,TIERRA DEL FUEGO,195,171,306,326,632
94,94007,940071409,Río Grande,TIERRA DEL FUEGO,338,337,596,622,1218
94,94007,940070301,Río Grande,TIERRA DEL FUEGO,16,20,29,43,72
94,94007,940071004,Río Grande,TIERRA DEL FUEGO,334,306,628,586,1214
94,94014,940140413,Ushuaia,TIERRA DEL FUEGO,326,348,528,577,1105
94,94014,940140506,Ushuaia,TIERRA DEL FUEGO,168,329,369,825,1194
94,94014,940140606,Ushuaia,TIERRA DEL FUEGO,284,329,418,406,824
94,94014,940140801,Ushuaia,TIERRA DEL FUEGO,68,80,108,169,277
94,94014,940140409,Ushuaia,TIERRA DEL FUEGO,319,336,512,508,1020
94,94014,940140407,Ushuaia,TIERRA DEL FUEGO,294,331,430,505,935
94,94014,940140504,Ushuaia,TIERRA DEL FUEGO,103,162,165,175,340
94,94014,940140510,Ushuaia,TIERRA DEL FUEGO,240,280,330,347,677
94,94014,940140605,Ushuaia,TIERRA DEL FUEGO,373,425,537,580,1117
94,94014,940140610,Ushuaia,TIERRA DEL FUEGO,349,398,515,537,1052
94,94014,940140808,Ushuaia,TIERRA DEL FUEGO,368,400,495,544,1039
94,94014,940140706,Ushuaia,TIERRA DEL FUEGO,142,179,274,255,529
94,94014,940140813,Ushuaia,TIERRA DEL FUEGO,319,347,520,554,1074
94,94014,940140103,Ushuaia,TIERRA DEL FUEGO,41,122,30,75,105
94,94014,940140401,Ushuaia,TIERRA DEL FUEGO,148,160,215,214,429
94,94014,940140410,Ushuaia,TIERRA DEL FUEGO,228,264,365,356,721
94,94014,940140707,Ushuaia,TIERRA DEL FUEGO,319,474,585,529,1114
94,94014,940140609,Ushuaia,TIERRA DEL FUEGO,333,346,582,547,1129
94,94014,940140711,Ushuaia,TIERRA DEL FUEGO,370,419,595,636,1231
94,94014,940140812,Ushuaia,TIERRA DEL FUEGO,294,312,478,473,951
94,94014,940140102,Ushuaia,TIERRA DEL FUEGO,53,81,63,101,164
94,94014,940140202,Ushuaia,TIERRA DEL FUEGO,5,6,5,19,24
94,94014,940140502,Ushuaia,TIERRA DEL FUEGO,287,356,396,387,783
94,94014,940140507,Ushuaia,TIERRA DEL FUEGO,182,249,212,224,436
94,94014,940140703,Ushuaia,TIERRA DEL FUEGO,320,349,501,494,995
94,94014,940140709,Ushuaia,TIERRA DEL FUEGO,130,132,242,212,454
94,94014,940140806,Ushuaia,TIERRA DEL FUEGO,366,413,575,579,1154
94,94014,940140414,Ushuaia,TIERRA DEL FUEGO,362,376,587,627,1214
94,94014,940140406,Ushuaia,TIERRA DEL FUEGO,222,250,336,396,732
94,94014,940140511,Ushuaia,TIERRA DEL FUEGO,214,228,329,329,658
94,94014,940140608,Ushuaia,TIERRA DEL FUEGO,293,285,472,422,894
94,94014,940140811,Ushuaia,TIERRA DEL FUEGO,309,324,451,455,906
94,94014,940140713,Ushuaia,TIERRA DEL FUEGO,307,330,467,520,987
94,94014,940140705,Ushuaia,TIERRA DEL FUEGO,306,337,504,518,1022
94,94014,940140101,Ushuaia,TIERRA DEL FUEGO,5,5,9,14,23
94,94014,940140503,Ushuaia,TIERRA DEL FUEGO,300,339,443,419,862
94,94014,940140509,Ushuaia,TIERRA DEL FUEGO,398,459,606,654,1260
94,94014,940140704,Ushuaia,TIERRA DEL FUEGO,295,297,461,486,947
94,94014,940140702,Ushuaia,TIERRA DEL FUEGO,272,309,436,438,874
94,94014,940140809,Ushuaia,TIERRA DEL FUEGO,248,295,369,380,749
94,94014,940140710,Ushuaia,TIERRA DEL FUEGO,107,114,207,200,407
94,94014,940140411,Ushuaia,TIERRA DEL FUEGO,255,269,420,446,866
94,94014,940140505,Ushuaia,TIERRA DEL FUEGO,270,435,424,458,882
94,94014,940140405,Ushuaia,TIERRA DEL FUEGO,151,167,199,243,442
94,94014,940140404,Ushuaia,TIERRA DEL FUEGO,102,119,139,151,290
94,94014,940140602,Ushuaia,TIERRA DEL FUEGO,371,380,580,552,1132
94,94014,940140607,Ushuaia,TIERRA DEL FUEGO,300,324,500,493,993
94,94014,940140408,Ushuaia,TIERRA DEL FUEGO,136,144,236,232,468
94,94014,940140412,Ushuaia,TIERRA DEL FUEGO,274,306,444,437,881
94,94014,940140402,Ushuaia,TIERRA DEL FUEGO,244,294,332,409,741
94,94014,940140415,Ushuaia,TIERRA DEL FUEGO,296,326,499,519,1018
94,94014,940140603,Ushuaia,TIERRA DEL FUEGO,299,314,463,524,987
94,94014,940140601,Ushuaia,TIERRA DEL FUEGO,210,215,333,330,663
94,94014,940140708,Ushuaia,TIERRA DEL FUEGO,248,264,432,444,876
94,94014,940140805,Ushuaia,TIERRA DEL FUEGO,273,339,407,375,782
94,94014,940140416,Ushuaia,TIERRA DEL FUEGO,318,346,604,533,1137
94,94014,940140611,Ushuaia,TIERRA DEL FUEGO,347,381,508,589,1097
94,94014,940140612,Ushuaia,TIERRA DEL FUEGO,312,320,515,601,1116
94,94014,940140701,Ushuaia,TIERRA DEL FUEGO,172,198,385,395,780
94,94014,940140712,Ushuaia,TIERRA DEL FUEGO,343,382,554,536,1090
94,94014,940140803,Ushuaia,TIERRA DEL FUEGO,89,113,203,192,395
94,94014,940140807,Ushuaia,TIERRA DEL FUEGO,268,348,429,401,830
94,94014,940140301,Ushuaia,TIERRA DEL FUEGO,1,1,0,1,1
94,94014,940140508,Ushuaia,TIERRA DEL FUEGO,277,316,359,395,754
94,94014,940140403,Ushuaia,TIERRA DEL FUEGO,137,162,178,207,385
94,94014,940140501,Ushuaia,TIERRA DEL FUEGO,220,248,352,362,714
94,94014,940140604,Ushuaia,TIERRA DEL FUEGO,282,311,569,564,1133
94,94014,940140714,Ushuaia,TIERRA DEL FUEGO,391,424,707,734,1441
94,94014,940140810,Ushuaia,TIERRA DEL FUEGO,439,500,668,676,1344
94,94014,940140802,Ushuaia,TIERRA DEL FUEGO,212,267,281,264,545
94,94014,940140804,Ushuaia,TIERRA DEL FUEGO,220,248,370,349,719
94,94014,940140201,Ushuaia,TIERRA DEL FUEGO,0,1,0,0,0
94,94014,940140302,Ushuaia,TIERRA DEL FUEGO,14,17,14,32,46
86,86028,860280206,Avellaneda,SANTIAGO DEL ESTERO,184,370,434,460,894
86,86028,860280305,Avellaneda,SANTIAGO DEL ESTERO,211,250,431,418,849
86,86028,860280503,Avellaneda,SANTIAGO DEL ESTERO,100,86,230,258,488
86,86028,860280409,Avellaneda,SANTIAGO DEL ESTERO,378,446,736,739,1475
86,86028,860280101,Avellaneda,SANTIAGO DEL ESTERO,95,98,261,230,491
86,86028,860280207,Avellaneda,SANTIAGO DEL ESTERO,304,399,629,593,1222
86,86028,860280504,Avellaneda,SANTIAGO DEL ESTERO,340,461,714,698,1412
86,86028,860280405,Avellaneda,SANTIAGO DEL ESTERO,116,87,245,283,528
86,86028,860280202,Avellaneda,SANTIAGO DEL ESTERO,34,40,76,78,154
86,86028,860280203,Avellaneda,SANTIAGO DEL ESTERO,104,124,222,280,502
86,86028,860280401,Avellaneda,SANTIAGO DEL ESTERO,97,74,203,237,440
86,86028,860280502,Avellaneda,SANTIAGO DEL ESTERO,136,125,299,315,614
86,86028,860280103,Avellaneda,SANTIAGO DEL ESTERO,70,23,127,132,259
86,86028,860280303,Avellaneda,SANTIAGO DEL ESTERO,88,83,145,191,336
86,86028,860280404,Avellaneda,SANTIAGO DEL ESTERO,126,125,256,268,524
86,86028,860280104,Avellaneda,SANTIAGO DEL ESTERO,74,60,139,142,281
86,86028,860280201,Avellaneda,SANTIAGO DEL ESTERO,53,63,107,131,238
86,86028,860280302,Avellaneda,SANTIAGO DEL ESTERO,144,96,322,338,660
86,86028,860280102,Avellaneda,SANTIAGO DEL ESTERO,108,122,207,190,397
86,86028,860280304,Avellaneda,SANTIAGO DEL ESTERO,261,301,531,514,1045
86,86028,860280407,Avellaneda,SANTIAGO DEL ESTERO,245,255,459,466,925
86,86028,860280205,Avellaneda,SANTIAGO DEL ESTERO,82,97,154,165,319
86,86028,860280204,Avellaneda,SANTIAGO DEL ESTERO,60,66,112,111,223
86,86028,860280403,Avellaneda,SANTIAGO DEL ESTERO,190,195,426,440,866
86,86028,860280410,Avellaneda,SANTIAGO DEL ESTERO,249,247,510,540,1050
86,86028,860280408,Avellaneda,SANTIAGO DEL ESTERO,419,522,862,814,1676
86,86028,860280501,Avellaneda,SANTIAGO DEL ESTERO,146,84,321,348,669
86,86028,860280301,Avellaneda,SANTIAGO DEL ESTERO,181,95,397,428,825
86,86028,860280402,Avellaneda,SANTIAGO DEL ESTERO,58,54,119,157,276
86,86028,860280406,Avellaneda,SANTIAGO DEL ESTERO,244,129,541,584,1125
86,86175,861750307,San Martín,SANTIAGO DEL ESTERO,227,256,551,478,1029
86,86175,861750301,San Martín,SANTIAGO DEL ESTERO,190,180,447,461,908
86,86175,861750302,San Martín,SANTIAGO DEL ESTERO,54,71,101,122,223
86,86175,861750204,San Martín,SANTIAGO DEL ESTERO,266,285,624,568,1192
86,86175,861750305,San Martín,SANTIAGO DEL ESTERO,161,190,319,316,635
86,86175,861750103,San Martín,SANTIAGO DEL ESTERO,120,128,228,257,485
86,86175,861750203,San Martín,SANTIAGO DEL ESTERO,126,136,290,286,576
86,86175,861750303,San Martín,SANTIAGO DEL ESTERO,166,160,376,384,760
86,86175,861750202,San Martín,SANTIAGO DEL ESTERO,73,82,153,163,316
86,86175,861750101,San Martín,SANTIAGO DEL ESTERO,323,364,627,847,1474
86,86175,861750201,San Martín,SANTIAGO DEL ESTERO,81,69,194,181,375
86,86175,861750102,San Martín,SANTIAGO DEL ESTERO,63,72,118,129,247
86,86175,861750306,San Martín,SANTIAGO DEL ESTERO,176,211,359,322,681
86,86175,861750304,San Martín,SANTIAGO DEL ESTERO,235,221,449,481,930
86,86021,860210208,Atamisqui,SANTIAGO DEL ESTERO,269,364,611,494,1105
86,86021,860210103,Atamisqui,SANTIAGO DEL ESTERO,147,189,289,301,590
86,86021,860210205,Atamisqui,SANTIAGO DEL ESTERO,77,88,170,218,388
86,86021,860210207,Atamisqui,SANTIAGO DEL ESTERO,249,335,521,507,1028
86,86021,860210206,Atamisqui,SANTIAGO DEL ESTERO,155,232,265,300,565
86,86021,860210304,Atamisqui,SANTIAGO DEL ESTERO,43,58,76,75,151
86,86021,860210101,Atamisqui,SANTIAGO DEL ESTERO,31,30,69,59,128
86,86021,860210104,Atamisqui,SANTIAGO DEL ESTERO,126,147,252,216,468
86,86021,860210301,Atamisqui,SANTIAGO DEL ESTERO,52,64,117,111,228
86,86021,860210306,Atamisqui,SANTIAGO DEL ESTERO,26,33,45,58,103
86,86021,860210209,Atamisqui,SANTIAGO DEL ESTERO,256,359,594,562,1156
86,86021,860210302,Atamisqui,SANTIAGO DEL ESTERO,55,67,81,91,172
86,86021,860210105,Atamisqui,SANTIAGO DEL ESTERO,37,49,69,57,126
86,86021,860210203,Atamisqui,SANTIAGO DEL ESTERO,38,55,89,71,160
86,86021,860210204,Atamisqui,SANTIAGO DEL ESTERO,185,224,454,460,914
86,86021,860210303,Atamisqui,SANTIAGO DEL ESTERO,18,26,25,38,63
86,86021,860210305,Atamisqui,SANTIAGO DEL ESTERO,10,10,17,21,38
86,86021,860210102,Atamisqui,SANTIAGO DEL ESTERO,58,65,127,136,263
86,86021,860210202,Atamisqui,SANTIAGO DEL ESTERO,311,306,788,848,1636
86,86021,860210201,Atamisqui,SANTIAGO DEL ESTERO,377,421,831,810,1641
86,86042,860420205,Belgrano,SANTIAGO DEL ESTERO,233,229,433,461,894
86,86042,860420206,Belgrano,SANTIAGO DEL ESTERO,439,395,801,819,1620
86,86042,860420208,Belgrano,SANTIAGO DEL ESTERO,342,381,608,580,1188
86,86042,860420203,Belgrano,SANTIAGO DEL ESTERO,15,43,34,31,65
86,86042,860420209,Belgrano,SANTIAGO DEL ESTERO,346,352,662,694,1356
86,86042,860420301,Belgrano,SANTIAGO DEL ESTERO,114,146,190,191,381
86,86042,860420102,Belgrano,SANTIAGO DEL ESTERO,16,24,14,31,45
86,86042,860420202,Belgrano,SANTIAGO DEL ESTERO,257,219,570,540,1110
86,86042,860420303,Belgrano,SANTIAGO DEL ESTERO,28,34,43,55,98
86,86042,860420103,Belgrano,SANTIAGO DEL ESTERO,21,31,10,43,53
86,86042,860420304,Belgrano,SANTIAGO DEL ESTERO,17,22,16,45,61
86,86042,860420305,Belgrano,SANTIAGO DEL ESTERO,135,157,247,240,487
86,86042,860420201,Belgrano,SANTIAGO DEL ESTERO,11,12,19,22,41
86,86042,860420101,Belgrano,SANTIAGO DEL ESTERO,83,100,103,180,283
86,86042,860420302,Belgrano,SANTIAGO DEL ESTERO,14,21,15,30,45
86,86042,860420204,Belgrano,SANTIAGO DEL ESTERO,11,12,9,16,25
86,86042,860420207,Belgrano,SANTIAGO DEL ESTERO,391,439,735,756,1491
86,86154,861540107,Rivadavia,SANTIAGO DEL ESTERO,352,439,597,621,1218
86,86154,861540203,Rivadavia,SANTIAGO DEL ESTERO,150,159,257,288,545
86,86154,861540106,Rivadavia,SANTIAGO DEL ESTERO,297,318,551,501,1052
86,86154,861540201,Rivadavia,SANTIAGO DEL ESTERO,29,41,44,66,110
86,86154,861540204,Rivadavia,SANTIAGO DEL ESTERO,10,12,17,23,40
86,86154,861540302,Rivadavia,SANTIAGO DEL ESTERO,54,74,94,99,193
86,86154,861540104,Rivadavia,SANTIAGO DEL ESTERO,45,52,74,100,174
86,86154,861540108,Rivadavia,SANTIAGO DEL ESTERO,230,249,317,291,608
86,86154,861540303,Rivadavia,SANTIAGO DEL ESTERO,63,83,116,135,251
86,86154,861540301,Rivadavia,SANTIAGO DEL ESTERO,26,31,40,53,93
86,86154,861540101,Rivadavia,SANTIAGO DEL ESTERO,31,46,34,60,94
86,86154,861540105,Rivadavia,SANTIAGO DEL ESTERO,31,45,51,70,121
86,86154,861540102,Rivadavia,SANTIAGO DEL ESTERO,76,92,119,133,252
86,86154,861540103,Rivadavia,SANTIAGO DEL ESTERO,14,20,25,33,58
86,86154,861540202,Rivadavia,SANTIAGO DEL ESTERO,60,72,85,121,206
86,86189,861890202,Silípica,SANTIAGO DEL ESTERO,161,181,320,363,683
86,86189,861890201,Silípica,SANTIAGO DEL ESTERO,258,289,499,554,1053
86,86189,861890101,Silípica,SANTIAGO DEL ESTERO,309,319,608,677,1285
86,86189,861890102,Silípica,SANTIAGO DEL ESTERO,117,104,258,304,562
86,86189,861890303,Silípica,SANTIAGO DEL ESTERO,266,282,539,552,1091
86,86189,861890302,Silípica,SANTIAGO DEL ESTERO,278,281,596,600,1196
86,86189,861890301,Silípica,SANTIAGO DEL ESTERO,164,121,313,364,677
86,86189,861890103,Silípica,SANTIAGO DEL ESTERO,257,263,559,577,1136
86,86189,861890203,Silípica,SANTIAGO DEL ESTERO,9,11,9,20,29
86,86182,861820203,Sarmiento,SANTIAGO DEL ESTERO,76,88,159,196,355
86,86182,861820204,Sarmiento,SANTIAGO DEL ESTERO,41,63,66,76,142
86,86182,861820101,Sarmiento,SANTIAGO DEL ESTERO,14,15,18,33,51
86,86182,861820201,Sarmiento,SANTIAGO DEL ESTERO,57,75,113,139,252
86,86182,861820103,Sarmiento,SANTIAGO DEL ESTERO,85,86,183,212,395
86,86182,861820202,Sarmiento,SANTIAGO DEL ESTERO,8,15,69,62,131
86,86182,861820205,Sarmiento,SANTIAGO DEL ESTERO,263,336,560,560,1120
86,86182,861820301,Sarmiento,SANTIAGO DEL ESTERO,73,90,123,178,301
86,86182,861820206,Sarmiento,SANTIAGO DEL ESTERO,343,441,731,733,1464
86,86182,861820102,Sarmiento,SANTIAGO DEL ESTERO,34,35,61,62,123
86,86182,861820302,Sarmiento,SANTIAGO DEL ESTERO,63,71,132,141,273
86,86112,861120104,Mitre,SANTIAGO DEL ESTERO,36,43,61,76,137
86,86112,861120105,Mitre,SANTIAGO DEL ESTERO,47,54,72,82,154
86,86112,861120202,Mitre,SANTIAGO DEL ESTERO,25,33,42,43,85
86,86112,861120301,Mitre,SANTIAGO DEL ESTERO,0,0,0,0,0
86,86112,861120102,Mitre,SANTIAGO DEL ESTERO,69,86,136,158,294
86,86112,861120103,Mitre,SANTIAGO DEL ESTERO,44,50,70,74,144
86,86112,861120302,Mitre,SANTIAGO DEL ESTERO,42,42,82,109,191
86,86112,861120101,Mitre,SANTIAGO DEL ESTERO,36,30,79,82,161
86,86112,861120203,Mitre,SANTIAGO DEL ESTERO,164,220,265,245,510
86,86112,861120201,Mitre,SANTIAGO DEL ESTERO,73,86,86,128,214
82,82112,821120203,San Justo,SANTA FE,276,332,519,502,1021
82,82112,821120305,San Justo,SANTA FE,31,56,45,58,103
82,82112,821120401,San Justo,SANTA FE,446,449,853,829,1682
82,82112,821120312,San Justo,SANTA FE,104,143,159,170,329
82,82112,821120307,San Justo,SANTA FE,77,125,108,130,238
82,82112,821120216,San Justo,SANTA FE,98,162,162,203,365
82,82112,821120212,San Justo,SANTA FE,38,87,52,70,122
82,82112,821120106,San Justo,SANTA FE,49,149,78,93,171
82,82112,821120313,San Justo,SANTA FE,83,154,101,145,246
82,82112,821120408,San Justo,SANTA FE,342,394,466,412,878
82,82112,821120416,San Justo,SANTA FE,299,343,466,401,867
82,82112,821120414,San Justo,SANTA FE,305,344,430,385,815
82,82112,821120402,San Justo,SANTA FE,253,277,387,335,722
82,82112,821120217,San Justo,SANTA FE,270,305,455,488,943
82,82112,821120205,San Justo,SANTA FE,169,147,283,280,563
82,82112,821120306,San Justo,SANTA FE,47,82,65,87,152
82,82112,821120102,San Justo,SANTA FE,64,96,76,95,171
82,82112,821120219,San Justo,SANTA FE,297,317,430,375,805
82,82112,821120218,San Justo,SANTA FE,361,412,625,578,1203
82,82112,821120202,San Justo,SANTA FE,42,50,71,70,141
82,82112,821120103,San Justo,SANTA FE,325,386,510,487,997
82,82112,821120411,San Justo,SANTA FE,244,278,329,284,613
82,82112,821120308,San Justo,SANTA FE,15,24,21,20,41
82,82112,821120204,San Justo,SANTA FE,108,134,225,277,502
82,82112,821120303,San Justo,SANTA FE,179,163,300,295,595
82,82112,821120201,San Justo,SANTA FE,20,47,25,32,57
82,82112,821120301,San Justo,SANTA FE,52,101,61,100,161
82,82112,821120215,San Justo,SANTA FE,20,28,25,30,55
82,82112,821120101,San Justo,SANTA FE,164,183,288,266,554
82,82112,821120409,San Justo,SANTA FE,287,375,392,326,718
82,82112,821120405,San Justo,SANTA FE,459,468,885,877,1762
82,82112,821120403,San Justo,SANTA FE,208,247,301,232,533
82,82112,821120211,San Justo,SANTA FE,52,74,77,84,161
82,82112,821120417,San Justo,SANTA FE,217,254,281,257,538
82,82112,821120413,San Justo,SANTA FE,591,581,1157,1140,2297
82,82112,821120404,San Justo,SANTA FE,383,453,516,431,947
82,82112,821120213,San Justo,SANTA FE,57,93,69,86,155
82,82112,821120407,San Justo,SANTA FE,340,343,553,498,1051
82,82112,821120311,San Justo,SANTA FE,304,340,388,339,727
82,82112,821120105,San Justo,SANTA FE,290,330,487,468,955
82,82112,821120104,San Justo,SANTA FE,177,273,285,346,631
82,82112,821120410,San Justo,SANTA FE,398,474,524,429,953
82,82112,821120406,San Justo,SANTA FE,399,385,714,728,1442
82,82112,821120314,San Justo,SANTA FE,406,454,657,643,1300
82,82112,821120412,San Justo,SANTA FE,452,493,685,703,1388
82,82112,821120108,San Justo,SANTA FE,263,293,389,343,732
82,82112,821120419,San Justo,SANTA FE,393,424,675,662,1337
82,82112,821120210,San Justo,SANTA FE,358,378,536,496,1032
82,82112,821120304,San Justo,SANTA FE,16,20,28,34,62
82,82112,821120315,San Justo,SANTA FE,19,36,21,28,49
82,82112,821120214,San Justo,SANTA FE,18,42,26,35,61
82,82112,821120302,San Justo,SANTA FE,43,80,58,83,141
82,82112,821120415,San Justo,SANTA FE,477,559,700,616,1316
82,82112,821120316,San Justo,SANTA FE,297,324,483,432,915
82,82112,821120310,San Justo,SANTA FE,106,109,171,170,341
82,82112,821120207,San Justo,SANTA FE,188,222,283,267,550
82,82112,821120206,San Justo,SANTA FE,110,129,177,183,360
82,82112,821120209,San Justo,SANTA FE,463,485,760,743,1503
82,82112,821120208,San Justo,SANTA FE,237,282,363,340,703
82,82112,821120418,San Justo,SANTA FE,240,258,416,434,850
82,82112,821120309,San Justo,SANTA FE,30,61,38,43,81
82,82112,821120107,San Justo,SANTA FE,57,171,70,131,201
82,82091,820910615,San Cristóbal,SANTA FE,177,218,282,314,596
82,82091,820910314,San Cristóbal,SANTA FE,337,396,557,650,1207
82,82091,820910607,San Cristóbal,SANTA FE,192,224,283,226,509
82,82091,820910601,San Cristóbal,SANTA FE,486,486,850,835,1685
82,82091,820910504,San Cristóbal,SANTA FE,361,409,537,453,990
82,82091,820910112,San Cristóbal,SANTA FE,262,277,435,462,897
82,82091,820910308,San Cristóbal,SANTA FE,283,296,435,371,806
82,82091,820910213,San Cristóbal,SANTA FE,50,63,80,81,161
82,82091,820910211,San Cristóbal,SANTA FE,205,229,355,310,665
82,82091,820910402,San Cristóbal,SANTA FE,80,103,132,113,245
82,82091,820910616,San Cristóbal,SANTA FE,175,207,233,204,437
82,82091,820910102,San Cristóbal,SANTA FE,383,436,588,509,1097
82,82091,820910412,San Cristóbal,SANTA FE,35,67,71,69,140
82,82091,820910111,San Cristóbal,SANTA FE,88,136,148,187,335
82,82091,820910204,San Cristóbal,SANTA FE,61,120,85,119,204
82,82091,820910605,San Cristóbal,SANTA FE,273,316,373,305,678
82,82091,820910302,San Cristóbal,SANTA FE,303,347,442,429,871
82,82091,820910319,San Cristóbal,SANTA FE,279,302,412,372,784
82,82091,820910105,San Cristóbal,SANTA FE,131,211,171,235,406
82,82091,820910304,San Cristóbal,SANTA FE,482,491,838,911,1749
82,82091,820910603,San Cristóbal,SANTA FE,331,392,484,422,906
82,82091,820910512,San Cristóbal,SANTA FE,198,220,347,344,691
82,82091,820910506,San Cristóbal,SANTA FE,342,397,515,407,922
82,82091,820910410,San Cristóbal,SANTA FE,294,356,496,461,957
82,82091,820910318,San Cristóbal,SANTA FE,335,357,551,559,1110
82,82091,820910313,San Cristóbal,SANTA FE,310,316,485,474,959
82,82091,820910310,San Cristóbal,SANTA FE,374,438,527,530,1057
82,82091,820910510,San Cristóbal,SANTA FE,88,147,145,154,299
82,82091,820910407,San Cristóbal,SANTA FE,37,82,58,56,114
82,82091,820910217,San Cristóbal,SANTA FE,125,201,193,235,428
82,82091,820910401,San Cristóbal,SANTA FE,130,137,212,263,475
82,82091,820910609,San Cristóbal,SANTA FE,325,343,567,511,1078
82,82091,820910606,San Cristóbal,SANTA FE,252,288,338,271,609
82,82091,820910602,San Cristóbal,SANTA FE,322,367,472,431,903
82,82091,820910513,San Cristóbal,SANTA FE,325,360,501,499,1000
82,82091,820910509,San Cristóbal,SANTA FE,489,518,916,889,1805
82,82091,820910508,San Cristóbal,SANTA FE,527,555,916,816,1732
82,82091,820910309,San Cristóbal,SANTA FE,206,234,295,279,574
82,82091,820910316,San Cristóbal,SANTA FE,4,5,10,6,16
82,82091,820910101,San Cristóbal,SANTA FE,203,212,337,341,678
82,82091,820910216,San Cristóbal,SANTA FE,29,55,42,48,90
82,82091,820910305,San Cristóbal,SANTA FE,199,217,328,443,771
82,82091,820910104,San Cristóbal,SANTA FE,138,224,226,270,496
82,82091,820910611,San Cristóbal,SANTA FE,373,409,534,449,983
82,82091,820910610,San Cristóbal,SANTA FE,430,483,721,662,1383
82,82091,820910502,San Cristóbal,SANTA FE,353,405,547,450,997
82,82091,820910106,San Cristóbal,SANTA FE,108,140,147,152,299
82,82091,820910612,San Cristóbal,SANTA FE,510,555,821,746,1567
82,82091,820910109,San Cristóbal,SANTA FE,76,81,115,105,220
82,82091,820910311,San Cristóbal,SANTA FE,185,204,279,240,519
82,82091,820910511,San Cristóbal,SANTA FE,141,243,239,254,493
82,82091,820910415,San Cristóbal,SANTA FE,81,130,133,149,282
82,82091,820910414,San Cristóbal,SANTA FE,44,112,69,77,146
82,82091,820910206,San Cristóbal,SANTA FE,134,177,167,214,381
82,82091,820910505,San Cristóbal,SANTA FE,662,701,1002,974,1976
82,82091,820910614,San Cristóbal,SANTA FE,241,258,324,286,610
82,82091,820910613,San Cristóbal,SANTA FE,199,219,331,324,655
82,82091,820910409,San Cristóbal,SANTA FE,148,198,222,197,419
82,82091,820910207,San Cristóbal,SANTA FE,105,116,252,261,513
82,82091,820910107,San Cristóbal,SANTA FE,253,280,386,375,761
82,82091,820910403,San Cristóbal,SANTA FE,163,207,281,264,545
82,82091,820910323,San Cristóbal,SANTA FE,225,234,302,277,579
82,82091,820910312,San Cristóbal,SANTA FE,482,498,841,796,1637
82,82091,820910209,San Cristóbal,SANTA FE,92,126,136,169,305
82,82091,820910110,San Cristóbal,SANTA FE,46,94,82,85,167
82,82091,820910108,San Cristóbal,SANTA FE,128,232,199,216,415
82,82091,820910413,San Cristóbal,SANTA FE,30,80,61,67,128
82,82091,820910301,San Cristóbal,SANTA FE,77,114,122,169,291
82,82091,820910306,San Cristóbal,SANTA FE,356,435,630,715,1345
82,82091,820910201,San Cristóbal,SANTA FE,68,109,87,119,206
82,82091,820910203,San Cristóbal,SANTA FE,145,199,194,268,462
82,82091,820910604,San Cristóbal,SANTA FE,223,259,356,306,662
82,82091,820910507,San Cristóbal,SANTA FE,744,804,1314,1256,2570
82,82091,820910408,San Cristóbal,SANTA FE,329,383,478,457,935
82,82091,820910214,San Cristóbal,SANTA FE,320,372,542,541,1083
82,82091,820910205,San Cristóbal,SANTA FE,10,16,16,16,32
82,82091,820910103,San Cristóbal,SANTA FE,308,344,482,412,894
82,82091,820910404,San Cristóbal,SANTA FE,108,108,175,172,347
82,82091,820910321,San Cristóbal,SANTA FE,351,382,547,516,1063
82,82091,820910317,San Cristóbal,SANTA FE,499,513,779,736,1515
82,82091,820910411,San Cristóbal,SANTA FE,79,104,130,157,287
82,82091,820910210,San Cristóbal,SANTA FE,54,76,87,99,186
82,82091,820910218,San Cristóbal,SANTA FE,39,64,66,77,143
82,82091,820910202,San Cristóbal,SANTA FE,76,194,101,137,238
82,82091,820910608,San Cristóbal,SANTA FE,476,483,870,791,1661
82,82091,820910303,San Cristóbal,SANTA FE,150,180,284,278,562
82,82091,820910113,San Cristóbal,SANTA FE,318,326,516,487,1003
82,82091,820910503,San Cristóbal,SANTA FE,273,301,476,439,915
82,82091,820910501,San Cristóbal,SANTA FE,296,333,463,438,901
82,82091,820910406,San Cristóbal,SANTA FE,39,57,64,65,129
82,82091,820910208,San Cristóbal,SANTA FE,21,34,41,38,79
82,82091,820910405,San Cristóbal,SANTA FE,24,25,48,54,102
82,82091,820910322,San Cristóbal,SANTA FE,438,490,693,651,1344
82,82091,820910320,San Cristóbal,SANTA FE,237,239,376,382,758
82,82091,820910307,San Cristóbal,SANTA FE,98,100,178,224,402
82,82091,820910212,San Cristóbal,SANTA FE,36,66,38,50,88
82,82091,820910315,San Cristóbal,SANTA FE,149,189,247,316,563
82,82077,820770309,9 de Julio,SANTA FE,247,373,415,448,863
82,82077,820770202,9 de Julio,SANTA FE,203,256,330,400,730
82,82077,820770312,9 de Julio,SANTA FE,255,294,383,317,700
82,82077,820770206,9 de Julio,SANTA FE,454,531,774,843,1617
82,82077,820770314,9 de Julio,SANTA FE,248,288,412,360,772
82,82077,820770304,9 de Julio,SANTA FE,525,559,926,868,1794
82,82077,820770405,9 de Julio,SANTA FE,5,10,5,8,13
82,82077,820770402,9 de Julio,SANTA FE,193,250,333,297,630
82,82077,820770407,9 de Julio,SANTA FE,49,61,51,78,129
82,82077,820770204,9 de Julio,SANTA FE,179,235,243,354,597
82,82077,820770201,9 de Julio,SANTA FE,166,213,320,350,670
82,82077,820770403,9 de Julio,SANTA FE,49,108,84,85,169
82,82077,820770103,9 de Julio,SANTA FE,379,470,678,680,1358
82,82077,820770305,9 de Julio,SANTA FE,455,539,859,799,1658
82,82077,820770106,9 de Julio,SANTA FE,267,308,514,479,993
82,82077,820770401,9 de Julio,SANTA FE,81,159,98,132,230
82,82077,820770102,9 de Julio,SANTA FE,92,138,130,174,304
82,82077,820770313,9 de Julio,SANTA FE,390,451,673,563,1236
82,82077,820770317,9 de Julio,SANTA FE,282,314,464,396,860
82,82077,820770315,9 de Julio,SANTA FE,217,264,279,298,577
82,82077,820770307,9 de Julio,SANTA FE,355,404,554,481,1035
82,82077,820770306,9 de Julio,SANTA FE,322,355,576,588,1164
82,82077,820770203,9 de Julio,SANTA FE,334,357,565,569,1134
82,82077,820770406,9 de Julio,SANTA FE,15,22,20,30,50
82,82077,820770301,9 de Julio,SANTA FE,144,224,177,260,437
82,82077,820770205,9 de Julio,SANTA FE,62,71,92,130,222
82,82077,820770104,9 de Julio,SANTA FE,138,177,138,276,414
82,82077,820770316,9 de Julio,SANTA FE,308,348,642,595,1237
82,82077,820770302,9 de Julio,SANTA FE,287,340,510,470,980
82,82077,820770308,9 de Julio,SANTA FE,419,437,825,817,1642
82,82077,820770303,9 de Julio,SANTA FE,405,457,731,719,1450
82,82077,820770107,9 de Julio,SANTA FE,264,320,497,501,998
82,82077,820770207,9 de Julio,SANTA FE,448,493,798,749,1547
82,82077,820770310,9 de Julio,SANTA FE,97,168,100,182,282
82,82077,820770105,9 de Julio,SANTA FE,109,137,176,196,372
82,82077,820770101,9 de Julio,SANTA FE,106,140,160,217,377
82,82077,820770404,9 de Julio,SANTA FE,57,74,84,85,169
82,82077,820770409,9 de Julio,SANTA FE,3,8,7,6,13
82,82077,820770408,9 de Julio,SANTA FE,44,50,67,79,146
82,82077,820770311,9 de Julio,SANTA FE,91,149,99,164,263
82,82021,820210322,Castellanos,SANTA FE,98,170,146,192,338
82,82021,820210106,Castellanos,SANTA FE,332,385,469,435,904
82,82021,820210604,Castellanos,SANTA FE,288,339,407,336,743
82,82021,820210603,Castellanos,SANTA FE,292,420,387,308,695
82,82021,820210601,Castellanos,SANTA FE,334,337,641,632,1273
82,82021,820210514,Castellanos,SANTA FE,446,454,856,832,1688
82,82021,820210512,Castellanos,SANTA FE,399,343,735,788,1523
82,82021,820210505,Castellanos,SANTA FE,507,500,852,805,1657
82,82021,820210404,Castellanos,SANTA FE,346,375,517,473,990
82,82021,820210320,Castellanos,SANTA FE,107,114,137,150,287
82,82021,820210304,Castellanos,SANTA FE,103,118,169,161,330
82,82021,820210215,Castellanos,SANTA FE,600,668,1012,955,1967
82,82021,820210503,Castellanos,SANTA FE,391,361,618,639,1257
82,82021,820210408,Castellanos,SANTA FE,362,409,536,419,955
82,82021,820210401,Castellanos,SANTA FE,510,499,826,809,1635
82,82021,820210316,Castellanos,SANTA FE,31,32,46,59,105
82,82021,820210105,Castellanos,SANTA FE,238,277,352,310,662
82,82021,820211016,Castellanos,SANTA FE,280,314,380,327,707
82,82021,820210910,Castellanos,SANTA FE,191,211,280,262,542
82,82021,820210909,Castellanos,SANTA FE,264,305,359,346,705
82,82021,820210912,Castellanos,SANTA FE,425,419,658,673,1331
82,82021,820210805,Castellanos,SANTA FE,305,333,433,374,807
82,82021,820210802,Castellanos,SANTA FE,342,416,448,350,798
82,82021,820210725,Castellanos,SANTA FE,213,198,377,341,718
82,82021,820210719,Castellanos,SANTA FE,239,236,456,525,981
82,82021,820210716,Castellanos,SANTA FE,29,23,49,63,112
82,82021,820210323,Castellanos,SANTA FE,37,67,88,78,166
82,82021,820210132,Castellanos,SANTA FE,84,123,149,166,315
82,82021,820210117,Castellanos,SANTA FE,82,103,152,160,312
82,82021,820210111,Castellanos,SANTA FE,88,103,143,186,329
82,82021,820210212,Castellanos,SANTA FE,428,559,720,762,1482
82,82021,820210701,Castellanos,SANTA FE,234,283,310,366,676
82,82021,820210706,Castellanos,SANTA FE,226,253,341,326,667
82,82021,820211004,Castellanos,SANTA FE,44,58,69,73,142
82,82021,820210801,Castellanos,SANTA FE,202,286,266,211,477
82,82021,820210703,Castellanos,SANTA FE,45,74,55,63,118
82,82021,820210510,Castellanos,SANTA FE,207,292,305,215,520
82,82021,820210509,Castellanos,SANTA FE,251,339,347,297,644
82,82021,820210504,Castellanos,SANTA FE,277,275,425,434,859
82,82021,820210317,Castellanos,SANTA FE,373,441,567,521,1088
82,82021,820210309,Castellanos,SANTA FE,10,21,25,11,36
82,82021,820210211,Castellanos,SANTA FE,309,309,494,444,938
82,82021,820210203,Castellanos,SANTA FE,389,394,541,479,1020
82,82021,820210419,Castellanos,SANTA FE,404,404,739,771,1510
82,82021,820210411,Castellanos,SANTA FE,315,347,444,345,789
82,82021,820210410,Castellanos,SANTA FE,160,237,222,175,397
82,82021,820211018,Castellanos,SANTA FE,320,339,437,391,828
82,82021,820210812,Castellanos,SANTA FE,198,240,281,223,504
82,82021,820210808,Castellanos,SANTA FE,271,303,467,417,884
82,82021,820210804,Castellanos,SANTA FE,321,394,431,344,775
82,82021,820210721,Castellanos,SANTA FE,248,247,471,459,930
82,82021,820210724,Castellanos,SANTA FE,255,277,449,458,907
82,82021,820210128,Castellanos,SANTA FE,104,116,182,225,407
82,82021,820210326,Castellanos,SANTA FE,35,64,66,74,140
82,82021,820210319,Castellanos,SANTA FE,68,142,135,140,275
82,82021,820211011,Castellanos,SANTA FE,50,97,71,98,169
82,82021,820211001,Castellanos,SANTA FE,75,98,118,134,252
82,82021,820210616,Castellanos,SANTA FE,984,1068,1533,1489,3022
82,82021,820210713,Castellanos,SANTA FE,237,256,336,354,690
82,82021,820210710,Castellanos,SANTA FE,269,272,397,385,782
82,82021,820210109,Castellanos,SANTA FE,36,36,61,62,123
82,82021,820210614,Castellanos,SANTA FE,380,402,592,573,1165
82,82021,820210611,Castellanos,SANTA FE,350,355,695,689,1384
82,82021,820210608,Castellanos,SANTA FE,400,413,615,557,1172
82,82021,820210511,Castellanos,SANTA FE,277,325,375,331,706
82,82021,820210506,Castellanos,SANTA FE,333,365,506,480,986
82,82021,820210216,Castellanos,SANTA FE,334,352,498,523,1021
82,82021,820210214,Castellanos,SANTA FE,343,346,519,460,979
82,82021,820210207,Castellanos,SANTA FE,399,392,638,628,1266
82,82021,820210206,Castellanos,SANTA FE,319,333,488,451,939
82,82021,820210418,Castellanos,SANTA FE,435,442,804,876,1680
82,82021,820210417,Castellanos,SANTA FE,394,395,904,851,1755
82,82021,820210413,Castellanos,SANTA FE,262,318,372,332,704
82,82021,820210412,Castellanos,SANTA FE,247,279,334,285,619
82,82021,820210409,Castellanos,SANTA FE,349,377,495,432,927
82,82021,820210124,Castellanos,SANTA FE,400,508,666,623,1289
82,82021,820210113,Castellanos,SANTA FE,64,65,85,102,187
82,82021,820210908,Castellanos,SANTA FE,58,84,90,102,192
82,82021,820210814,Castellanos,SANTA FE,386,380,629,626,1255
82,82021,820210813,Castellanos,SANTA FE,284,278,553,526,1079
82,82021,820210807,Castellanos,SANTA FE,400,406,726,727,1453
82,82021,820210722,Castellanos,SANTA FE,567,580,1010,1123,2133
82,82021,820211003,Castellanos,SANTA FE,69,82,118,144,262
82,82021,820210708,Castellanos,SANTA FE,5,9,12,11,23
82,82021,820210330,Castellanos,SANTA FE,43,73,73,93,166
82,82021,820210329,Castellanos,SANTA FE,49,77,89,117,206
82,82021,820210325,Castellanos,SANTA FE,29,76,49,65,114
82,82021,820210303,Castellanos,SANTA FE,67,92,129,138,267
82,82021,820210314,Castellanos,SANTA FE,98,173,157,183,340
82,82021,820210127,Castellanos,SANTA FE,41,49,65,82,147
82,82021,820210122,Castellanos,SANTA FE,52,63,98,110,208
82,82021,820210112,Castellanos,SANTA FE,145,178,263,299,562
82,82021,820210108,Castellanos,SANTA FE,107,203,200,233,433
82,82021,820211014,Castellanos,SANTA FE,358,379,520,560,1080
82,82021,820210312,Castellanos,SANTA FE,40,47,56,57,113
82,82021,820210119,Castellanos,SANTA FE,506,556,762,814,1576
82,82021,820210107,Castellanos,SANTA FE,293,328,417,372,789
82,82021,820210613,Castellanos,SANTA FE,278,298,444,446,890
82,82021,820210610,Castellanos,SANTA FE,370,575,606,596,1202
82,82021,820210609,Castellanos,SANTA FE,427,443,685,656,1341
82,82021,820210602,Castellanos,SANTA FE,362,405,468,429,897
82,82021,820210321,Castellanos,SANTA FE,427,459,624,612,1236
82,82021,820210305,Castellanos,SANTA FE,444,504,709,696,1405
82,82021,820210213,Castellanos,SANTA FE,206,229,298,250,548
82,82021,820210210,Castellanos,SANTA FE,364,392,505,482,987
82,82021,820210501,Castellanos,SANTA FE,319,246,661,654,1315
82,82021,820210422,Castellanos,SANTA FE,975,867,2127,2076,4203
82,82021,820210420,Castellanos,SANTA FE,246,260,395,406,801
82,82021,820210115,Castellanos,SANTA FE,231,257,325,298,623
82,82021,820211009,Castellanos,SANTA FE,415,480,592,560,1152
82,82021,820210902,Castellanos,SANTA FE,358,403,532,469,1001
82,82021,820210809,Castellanos,SANTA FE,318,323,529,484,1013
82,82021,820210806,Castellanos,SANTA FE,205,225,289,276,565
82,82021,820210324,Castellanos,SANTA FE,31,64,55,73,128
82,82021,820210306,Castellanos,SANTA FE,69,121,124,150,274
82,82021,820210416,Castellanos,SANTA FE,925,791,1830,1840,3670
82,82021,820211005,Castellanos,SANTA FE,52,71,83,87,170
82,82021,820210707,Castellanos,SANTA FE,290,299,443,420,863
82,82021,820210906,Castellanos,SANTA FE,255,295,400,303,703
82,82021,820210302,Castellanos,SANTA FE,545,577,853,841,1694
82,82021,820210301,Castellanos,SANTA FE,20,24,23,28,51
82,82021,820210815,Castellanos,SANTA FE,285,281,499,540,1039
82,82021,820210513,Castellanos,SANTA FE,531,517,986,1038,2024
82,82021,820210311,Castellanos,SANTA FE,202,342,310,356,666
82,82021,820210308,Castellanos,SANTA FE,91,100,128,144,272
82,82021,820210218,Castellanos,SANTA FE,379,379,650,667,1317
82,82021,820210204,Castellanos,SANTA FE,432,466,636,557,1193
82,82021,820210415,Castellanos,SANTA FE,331,378,479,459,938
82,82021,820210134,Castellanos,SANTA FE,348,418,562,554,1116
82,82021,820211008,Castellanos,SANTA FE,439,462,726,649,1375
82,82021,820210904,Castellanos,SANTA FE,519,589,873,884,1757
82,82021,820210811,Castellanos,SANTA FE,368,403,508,463,971
82,82021,820210709,Castellanos,SANTA FE,34,61,64,69,133
82,82021,820210704,Castellanos,SANTA FE,51,116,86,119,205
82,82021,820211010,Castellanos,SANTA FE,16,15,21,31,52
82,82021,820210129,Castellanos,SANTA FE,39,44,73,87,160
82,82021,820210130,Castellanos,SANTA FE,60,72,95,118,213
82,82021,820210121,Castellanos,SANTA FE,53,74,87,105,192
82,82021,820210715,Castellanos,SANTA FE,29,48,37,54,91
82,82021,820210702,Castellanos,SANTA FE,530,552,1055,1087,2142
82,82021,820210327,Castellanos,SANTA FE,184,272,316,365,681
82,82021,820210712,Castellanos,SANTA FE,311,374,475,472,947
82,82021,820210615,Castellanos,SANTA FE,133,200,214,231,445
82,82021,820210612,Castellanos,SANTA FE,403,440,637,606,1243
82,82021,820210606,Castellanos,SANTA FE,329,381,428,354,782
82,82021,820210508,Castellanos,SANTA FE,365,396,493,462,955
82,82021,820210208,Castellanos,SANTA FE,368,408,498,410,908
82,82021,820210125,Castellanos,SANTA FE,25,30,46,44,90
82,82021,820210315,Castellanos,SANTA FE,65,75,109,111,220
82,82021,820210133,Castellanos,SANTA FE,360,412,514,543,1057
82,82021,820210103,Castellanos,SANTA FE,426,529,731,740,1471
82,82021,820211007,Castellanos,SANTA FE,380,420,568,504,1072
82,82021,820211006,Castellanos,SANTA FE,462,506,636,615,1251
82,82021,820210803,Castellanos,SANTA FE,270,322,396,339,735
82,82021,820210726,Castellanos,SANTA FE,305,322,568,591,1159
82,82021,820210723,Castellanos,SANTA FE,7,9,9,13,22
82,82021,820210717,Castellanos,SANTA FE,420,458,747,773,1520
82,82021,820210714,Castellanos,SANTA FE,59,89,87,111,198
82,82021,820210310,Castellanos,SANTA FE,137,199,245,277,522
82,82021,820210131,Castellanos,SANTA FE,57,99,106,141,247
82,82021,820210116,Castellanos,SANTA FE,109,129,158,227,385
82,82021,820210114,Castellanos,SANTA FE,53,63,77,103,180
82,82021,820210618,Castellanos,SANTA FE,441,471,711,654,1365
82,82021,820210617,Castellanos,SANTA FE,259,281,384,404,788
82,82021,820211013,Castellanos,SANTA FE,450,507,831,805,1636
82,82021,820210313,Castellanos,SANTA FE,341,444,501,501,1002
82,82021,820210217,Castellanos,SANTA FE,467,463,898,897,1795
82,82021,820210403,Castellanos,SANTA FE,216,221,302,307,609
82,82021,820210307,Castellanos,SANTA FE,64,72,109,117,226
82,82021,820210202,Castellanos,SANTA FE,382,398,565,489,1054
82,82021,820210502,Castellanos,SANTA FE,355,290,664,704,1368
82,82021,820210414,Castellanos,SANTA FE,320,352,413,365,778
82,82021,820210405,Castellanos,SANTA FE,231,256,348,323,671
82,82021,820210333,Castellanos,SANTA FE,144,167,244,244,488
82,82021,820210123,Castellanos,SANTA FE,88,103,139,140,279
82,82021,820210104,Castellanos,SANTA FE,332,369,490,435,925
82,82021,820210110,Castellanos,SANTA FE,388,423,582,587,1169
82,82021,820211017,Castellanos,SANTA FE,367,404,508,480,988
82,82021,820211002,Castellanos,SANTA FE,205,226,308,286,594
82,82021,820210907,Castellanos,SANTA FE,346,408,495,407,902
82,82021,820210905,Castellanos,SANTA FE,258,262,364,364,728
82,82021,820210903,Castellanos,SANTA FE,379,404,531,499,1030
82,82021,820210901,Castellanos,SANTA FE,432,503,614,509,1123
82,82021,820210914,Castellanos,SANTA FE,298,311,423,391,814
82,82021,820210913,Castellanos,SANTA FE,253,272,402,359,761
82,82021,820210911,Castellanos,SANTA FE,383,384,589,598,1187
82,82021,820210718,Castellanos,SANTA FE,357,356,658,646,1304
82,82021,820210711,Castellanos,SANTA FE,37,106,57,74,131
82,82021,820210328,Castellanos,SANTA FE,47,88,82,92,174
82,82021,820210120,Castellanos,SANTA FE,78,90,139,177,316
82,82021,820210331,Castellanos,SANTA FE,47,99,86,98,184
82,82021,820210126,Castellanos,SANTA FE,55,90,99,122,221
82,82021,820210620,Castellanos,SANTA FE,406,441,736,675,1411
82,82021,820210619,Castellanos,SANTA FE,452,434,789,762,1551
82,82021,820210101,Castellanos,SANTA FE,55,62,82,69,151
82,82021,820210507,Castellanos,SANTA FE,242,243,331,297,628
82,82021,820210607,Castellanos,SANTA FE,449,509,627,544,1171
82,82021,820210605,Castellanos,SANTA FE,374,391,553,492,1045
82,82021,820210318,Castellanos,SANTA FE,366,424,531,498,1029
82,82021,820210209,Castellanos,SANTA FE,422,461,598,574,1172
82,82021,820210205,Castellanos,SANTA FE,456,434,764,716,1480
82,82021,820210402,Castellanos,SANTA FE,298,312,451,407,858
82,82021,820210201,Castellanos,SANTA FE,425,428,641,597,1238
82,82021,820210421,Castellanos,SANTA FE,207,217,322,311,633
82,82021,820210407,Castellanos,SANTA FE,147,153,231,226,457
82,82021,820210406,Castellanos,SANTA FE,426,467,690,711,1401
82,82021,820210332,Castellanos,SANTA FE,89,106,137,125,262
82,82021,820210118,Castellanos,SANTA FE,249,217,373,373,746
82,82021,820211015,Castellanos,SANTA FE,397,442,544,517,1061
82,82021,820211012,Castellanos,SANTA FE,80,89,141,128,269
82,82021,820210810,Castellanos,SANTA FE,364,374,571,548,1119
82,82021,820210720,Castellanos,SANTA FE,294,313,445,423,868
82,82021,820210705,Castellanos,SANTA FE,33,63,52,65,117
82,82021,820210102,Castellanos,SANTA FE,21,47,36,41,77
82,82070,820700714,Las Colonias,SANTA FE,54,92,90,95,185
82,82070,820700505,Las Colonias,SANTA FE,193,238,389,370,759
82,82070,820700704,Las Colonias,SANTA FE,239,273,346,305,651
82,82070,820700524,Las Colonias,SANTA FE,419,461,719,701,1420
82,82070,820700305,Las Colonias,SANTA FE,377,442,523,462,985
82,82070,820700213,Las Colonias,SANTA FE,393,434,550,516,1066
82,82070,820700515,Las Colonias,SANTA FE,104,117,181,179,360
82,82070,820700317,Las Colonias,SANTA FE,293,328,455,385,840
82,82070,820700312,Las Colonias,SANTA FE,255,284,344,322,666
82,82070,820700415,Las Colonias,SANTA FE,457,486,790,782,1572
82,82070,820700607,Las Colonias,SANTA FE,220,264,312,318,630
82,82070,820700104,Las Colonias,SANTA FE,329,337,550,487,1037
82,82070,820700408,Las Colonias,SANTA FE,215,274,281,210,491
82,82070,820700404,Las Colonias,SANTA FE,354,387,515,505,1020
82,82070,820700715,Las Colonias,SANTA FE,376,425,608,555,1163
82,82070,820700710,Las Colonias,SANTA FE,233,258,383,371,754
82,82070,820700606,Las Colonias,SANTA FE,74,91,114,135,249
82,82070,820700217,Las Colonias,SANTA FE,62,81,105,133,238
82,82070,820700506,Las Colonias,SANTA FE,48,82,86,101,187
82,82070,820700518,Las Colonias,SANTA FE,120,158,194,202,396
82,82070,820700512,Las Colonias,SANTA FE,256,338,429,463,892
82,82070,820700102,Las Colonias,SANTA FE,92,131,147,160,307
82,82070,820700706,Las Colonias,SANTA FE,240,263,320,277,597
82,82070,820700601,Las Colonias,SANTA FE,515,554,754,779,1533
82,82070,820700307,Las Colonias,SANTA FE,252,272,405,394,799
82,82070,820700111,Las Colonias,SANTA FE,478,528,751,719,1470
82,82070,820700207,Las Colonias,SANTA FE,192,223,283,262,545
82,82070,820700203,Las Colonias,SANTA FE,89,92,159,151,310
82,82070,820700101,Las Colonias,SANTA FE,288,323,441,423,864
82,82070,820700504,Las Colonias,SANTA FE,200,242,305,261,566
82,82070,820700416,Las Colonias,SANTA FE,440,512,661,636,1297
82,82070,820700410,Las Colonias,SANTA FE,550,659,684,728,1412
82,82070,820700409,Las Colonias,SANTA FE,255,308,365,304,669
82,82070,820700406,Las Colonias,SANTA FE,312,334,517,510,1027
82,82070,820700403,Las Colonias,SANTA FE,393,440,579,564,1143
82,82070,820700712,Las Colonias,SANTA FE,348,390,522,534,1056
82,82070,820700115,Las Colonias,SANTA FE,84,144,129,142,271
82,82070,820700216,Las Colonias,SANTA FE,60,78,82,110,192
82,82070,820700109,Las Colonias,SANTA FE,61,113,111,125,236
82,82070,820700105,Las Colonias,SANTA FE,104,156,147,193,340
82,82070,820700513,Las Colonias,SANTA FE,44,59,71,78,149
82,82070,820700214,Las Colonias,SANTA FE,167,213,280,287,567
82,82070,820700702,Las Colonias,SANTA FE,288,320,425,387,812
82,82070,820700318,Las Colonias,SANTA FE,501,501,949,917,1866
82,82070,820700313,Las Colonias,SANTA FE,271,291,453,423,876
82,82070,820700219,Las Colonias,SANTA FE,485,535,780,712,1492
82,82070,820700603,Las Colonias,SANTA FE,238,280,378,364,742
82,82070,820700215,Las Colonias,SANTA FE,41,56,69,68,137
82,82070,820700713,Las Colonias,SANTA FE,295,328,453,408,861
82,82070,820700107,Las Colonias,SANTA FE,53,113,91,113,204
82,82070,820700301,Las Colonias,SANTA FE,210,248,345,323,668
82,82070,820700705,Las Colonias,SANTA FE,308,343,482,432,914
82,82070,820700525,Las Colonias,SANTA FE,427,495,690,721,1411
82,82070,820700522,Las Colonias,SANTA FE,255,283,368,346,714
82,82070,820700310,Las Colonias,SANTA FE,467,503,726,695,1421
82,82070,820700209,Las Colonias,SANTA FE,276,329,440,385,825
82,82070,820700221,Las Colonias,SANTA FE,353,386,534,556,1090
82,82070,820700204,Las Colonias,SANTA FE,345,359,516,472,988
82,82070,820700117,Las Colonias,SANTA FE,207,236,280,270,550
82,82070,820700609,Las Colonias,SANTA FE,72,103,101,117,218
82,82070,820700405,Las Colonias,SANTA FE,295,336,408,346,754
82,82070,820700501,Las Colonias,SANTA FE,397,460,706,660,1366
82,82070,820700418,Las Colonias,SANTA FE,237,295,278,256,534
82,82070,820700407,Las Colonias,SANTA FE,233,270,326,290,616
82,82070,820700402,Las Colonias,SANTA FE,567,628,830,839,1669
82,82070,820700520,Las Colonias,SANTA FE,67,117,110,122,232
82,82070,820700205,Las Colonias,SANTA FE,124,178,209,241,450
82,82070,820700507,Las Colonias,SANTA FE,62,92,103,128,231
82,82070,820700220,Las Colonias,SANTA FE,162,215,277,291,568
82,82070,820700711,Las Colonias,SANTA FE,59,90,90,103,193
82,82070,820700707,Las Colonias,SANTA FE,308,348,463,465,928
82,82070,820700314,Las Colonias,SANTA FE,342,373,536,454,990
82,82070,820700222,Las Colonias,SANTA FE,346,380,494,469,963
82,82070,820700113,Las Colonias,SANTA FE,37,45,48,49,97
82,82070,820700521,Las Colonias,SANTA FE,184,231,246,247,493
82,82070,820700517,Las Colonias,SANTA FE,302,329,431,393,824
82,82070,820700511,Las Colonias,SANTA FE,601,673,871,867,1738
82,82070,820700510,Las Colonias,SANTA FE,354,394,545,450,995
82,82070,820700509,Las Colonias,SANTA FE,282,340,379,365,744
82,82070,820700508,Las Colonias,SANTA FE,440,492,703,680,1383
82,82070,820700503,Las Colonias,SANTA FE,408,455,623,560,1183
82,82070,820700414,Las Colonias,SANTA FE,318,344,477,483,960
82,82070,820700413,Las Colonias,SANTA FE,357,401,494,448,942
82,82070,820700411,Las Colonias,SANTA FE,335,478,415,375,790
82,82070,820700401,Las Colonias,SANTA FE,639,671,1257,1310,2567
82,82070,820700716,Las Colonias,SANTA FE,273,288,438,389,827
82,82070,820700612,Las Colonias,SANTA FE,475,535,784,752,1536
82,82070,820700304,Las Colonias,SANTA FE,179,202,301,291,592
82,82070,820700208,Las Colonias,SANTA FE,110,166,190,197,387
82,82070,820700116,Las Colonias,SANTA FE,47,83,85,82,167
82,82070,820700112,Las Colonias,SANTA FE,79,156,128,144,272
82,82070,820700516,Las Colonias,SANTA FE,51,86,92,106,198
82,82070,820700602,Las Colonias,SANTA FE,98,152,161,212,373
82,82070,820700709,Las Colonias,SANTA FE,106,141,175,185,360
82,82070,820700302,Las Colonias,SANTA FE,113,251,173,195,368
82,82070,820700703,Las Colonias,SANTA FE,281,341,432,349,781
82,82070,820700523,Las Colonias,SANTA FE,474,531,751,703,1454
82,82070,820700308,Las Colonias,SANTA FE,328,408,471,399,870
82,82070,820700306,Las Colonias,SANTA FE,245,293,348,341,689
82,82070,820700211,Las Colonias,SANTA FE,152,202,228,197,425
82,82070,820700605,Las Colonias,SANTA FE,245,277,412,400,812
82,82070,820700108,Las Colonias,SANTA FE,234,265,356,307,663
82,82070,820700103,Las Colonias,SANTA FE,33,46,51,55,106
82,82070,820700502,Las Colonias,SANTA FE,198,231,304,288,592
82,82070,820700420,Las Colonias,SANTA FE,195,229,280,287,567
82,82070,820700419,Las Colonias,SANTA FE,338,414,452,388,840
82,82070,820700412,Las Colonias,SANTA FE,299,347,408,353,761
82,82070,820700718,Las Colonias,SANTA FE,305,364,463,402,865
82,82070,820700717,Las Colonias,SANTA FE,321,358,439,400,839
82,82070,820700114,Las Colonias,SANTA FE,36,58,45,61,106
82,82070,820700604,Las Colonias,SANTA FE,54,86,98,107,205
82,82070,820700610,Las Colonias,SANTA FE,46,89,87,98,185
82,82070,820700613,Las Colonias,SANTA FE,196,288,287,364,651
82,82070,820700303,Las Colonias,SANTA FE,417,626,699,706,1405
82,82070,820700309,Las Colonias,SANTA FE,330,425,392,383,775
82,82070,820700319,Las Colonias,SANTA FE,368,394,629,594,1223
82,82070,820700311,Las Colonias,SANTA FE,418,445,773,750,1523
82,82070,820700201,Las Colonias,SANTA FE,379,391,554,544,1098
82,82070,820700701,Las Colonias,SANTA FE,257,280,378,313,691
82,82070,820700514,Las Colonias,SANTA FE,35,51,69,56,125
82,82070,820700110,Las Colonias,SANTA FE,186,248,285,294,579
82,82070,820700320,Las Colonias,SANTA FE,325,353,509,501,1010
82,82070,820700611,Las Colonias,SANTA FE,338,384,487,430,917
82,82070,820700210,Las Colonias,SANTA FE,145,194,232,274,506
82,82070,820700206,Las Colonias,SANTA FE,69,130,109,163,272
82,82070,820700519,Las Colonias,SANTA FE,107,137,193,183,376
82,82070,820700708,Las Colonias,SANTA FE,499,514,817,810,1627
82,82070,820700316,Las Colonias,SANTA FE,290,323,479,450,929
82,82070,820700315,Las Colonias,SANTA FE,481,489,873,860,1733
82,82070,820700218,Las Colonias,SANTA FE,353,376,557,573,1130
82,82070,820700417,Las Colonias,SANTA FE,633,703,1074,1149,2223
82,82070,820700212,Las Colonias,SANTA FE,98,159,179,214,393
82,82070,820700202,Las Colonias,SANTA FE,164,221,259,283,542
82,82070,820700106,Las Colonias,SANTA FE,28,57,30,51,81
82,82070,820700608,Las Colonias,SANTA FE,113,163,180,207,387
82,82056,820560208,Iriondo,SANTA FE,185,278,267,324,591
82,82056,820560401,Iriondo,SANTA FE,436,490,661,664,1325
82,82056,820560218,Iriondo,SANTA FE,338,353,510,484,994
82,82056,820560212,Iriondo,SANTA FE,127,141,185,187,372
82,82056,820560116,Iriondo,SANTA FE,215,249,297,299,596
82,82056,820560513,Iriondo,SANTA FE,270,330,442,414,856
82,82056,820560507,Iriondo,SANTA FE,495,491,898,892,1790
82,82056,820560502,Iriondo,SANTA FE,510,550,832,743,1575
82,82056,820560306,Iriondo,SANTA FE,258,313,394,346,740
82,82056,820560118,Iriondo,SANTA FE,137,231,251,262,513
82,82056,820560102,Iriondo,SANTA FE,61,105,93,107,200
82,82056,820560112,Iriondo,SANTA FE,141,341,214,228,442
82,82056,820560311,Iriondo,SANTA FE,541,608,796,742,1538
82,82056,820560214,Iriondo,SANTA FE,147,161,241,243,484
82,82056,820560206,Iriondo,SANTA FE,339,353,543,554,1097
82,82056,820560105,Iriondo,SANTA FE,373,422,597,576,1173
82,82056,820560408,Iriondo,SANTA FE,268,331,386,337,723
82,82056,820560405,Iriondo,SANTA FE,412,480,571,492,1063
82,82056,820560202,Iriondo,SANTA FE,339,361,508,492,1000
82,82056,820560314,Iriondo,SANTA FE,89,154,129,175,304
82,82056,820560403,Iriondo,SANTA FE,329,361,544,417,961
82,82056,820560101,Iriondo,SANTA FE,311,376,533,508,1041
82,82056,820560309,Iriondo,SANTA FE,269,301,389,362,751
82,82056,820560103,Iriondo,SANTA FE,330,386,535,534,1069
82,82056,820560514,Iriondo,SANTA FE,320,377,494,444,938
82,82056,820560508,Iriondo,SANTA FE,187,229,265,249,514
82,82056,820560506,Iriondo,SANTA FE,245,266,372,335,707
82,82056,820560504,Iriondo,SANTA FE,279,295,413,344,757
82,82056,820560503,Iriondo,SANTA FE,331,350,518,428,946
82,82056,820560412,Iriondo,SANTA FE,230,247,311,299,610
82,82056,820560510,Iriondo,SANTA FE,296,298,540,502,1042
82,82056,820560107,Iriondo,SANTA FE,13,18,132,230,362
82,82056,820560207,Iriondo,SANTA FE,183,212,301,346,647
82,82056,820560301,Iriondo,SANTA FE,376,424,559,539,1098
82,82056,820560219,Iriondo,SANTA FE,316,313,468,434,902
82,82056,820560310,Iriondo,SANTA FE,223,244,285,246,531
82,82056,820560307,Iriondo,SANTA FE,287,317,409,404,813
82,82056,820560115,Iriondo,SANTA FE,261,263,449,445,894
82,82056,820560111,Iriondo,SANTA FE,262,386,409,419,828
82,82056,820560108,Iriondo,SANTA FE,299,308,521,485,1006
82,82056,820560305,Iriondo,SANTA FE,415,442,653,637,1290
82,82056,820560114,Iriondo,SANTA FE,80,162,108,106,214
82,82056,820560205,Iriondo,SANTA FE,389,443,576,510,1086
82,82056,820560515,Iriondo,SANTA FE,225,244,355,313,668
82,82056,820560411,Iriondo,SANTA FE,317,369,421,389,810
82,82056,820560512,Iriondo,SANTA FE,305,319,519,529,1048
82,82056,820560406,Iriondo,SANTA FE,292,380,456,302,758
82,82056,820560304,Iriondo,SANTA FE,224,243,332,293,625
82,82056,820560303,Iriondo,SANTA FE,527,552,893,891,1784
82,82056,820560414,Iriondo,SANTA FE,506,537,856,810,1666
82,82056,820560210,Iriondo,SANTA FE,317,336,496,430,926
82,82056,820560313,Iriondo,SANTA FE,102,153,141,174,315
82,82056,820560213,Iriondo,SANTA FE,99,130,164,180,344
82,82056,820560415,Iriondo,SANTA FE,241,264,415,379,794
82,82056,820560217,Iriondo,SANTA FE,267,311,366,360,726
82,82056,820560215,Iriondo,SANTA FE,478,520,786,725,1511
82,82056,820560104,Iriondo,SANTA FE,213,273,339,294,633
82,82056,820560516,Iriondo,SANTA FE,259,272,434,446,880
82,82056,820560509,Iriondo,SANTA FE,427,430,723,711,1434
82,82056,820560501,Iriondo,SANTA FE,157,242,227,227,454
82,82056,820560511,Iriondo,SANTA FE,430,436,745,718,1463
82,82056,820560407,Iriondo,SANTA FE,180,227,219,199,418
82,82056,820560413,Iriondo,SANTA FE,178,225,252,177,429
82,82056,820560204,Iriondo,SANTA FE,384,410,590,509,1099
82,82056,820560117,Iriondo,SANTA FE,314,547,465,491,956
82,82056,820560110,Iriondo,SANTA FE,108,161,196,216,412
82,82056,820560402,Iriondo,SANTA FE,378,406,623,583,1206
82,82056,820560216,Iriondo,SANTA FE,236,249,343,319,662
82,82056,820560109,Iriondo,SANTA FE,278,306,407,360,767
82,82056,820560410,Iriondo,SANTA FE,254,277,356,332,688
82,82056,820560209,Iriondo,SANTA FE,106,117,163,193,356
82,82056,820560203,Iriondo,SANTA FE,240,276,326,313,639
82,82056,820560312,Iriondo,SANTA FE,96,174,138,186,324
82,82056,820560201,Iriondo,SANTA FE,178,270,315,328,643
82,82056,820560308,Iriondo,SANTA FE,215,447,355,413,768
82,82056,820560113,Iriondo,SANTA FE,133,354,208,204,412
82,82056,820560404,Iriondo,SANTA FE,271,325,402,331,733
82,82056,820560505,Iriondo,SANTA FE,382,445,559,509,1068
82,82056,820560409,Iriondo,SANTA FE,328,379,491,390,881
82,82056,820560106,Iriondo,SANTA FE,109,198,141,180,321
82,82056,820560211,Iriondo,SANTA FE,81,185,100,137,237
82,82056,820560302,Iriondo,SANTA FE,149,281,208,226,434
82,82098,820980409,San Javier,SANTA FE,211,249,317,294,611
82,82098,820980121,San Javier,SANTA FE,416,433,702,741,1443
82,82098,820980308,San Javier,SANTA FE,43,63,81,92,173
82,82098,820980111,San Javier,SANTA FE,39,51,60,59,119
82,82098,820980110,San Javier,SANTA FE,30,44,38,53,91
82,82098,820980105,San Javier,SANTA FE,41,65,40,69,109
82,82098,820980103,San Javier,SANTA FE,7,11,10,18,28
82,82098,820980118,San Javier,SANTA FE,422,450,619,596,1215
82,82098,820980117,San Javier,SANTA FE,55,78,85,98,183
82,82098,820980120,San Javier,SANTA FE,252,286,340,375,715
82,82098,820980119,San Javier,SANTA FE,280,299,516,526,1042
82,82098,820980305,San Javier,SANTA FE,73,99,96,117,213
82,82098,820980302,San Javier,SANTA FE,161,222,272,317,589
82,82098,820980116,San Javier,SANTA FE,40,65,94,94,188
82,82098,820980112,San Javier,SANTA FE,48,54,69,81,150
82,82098,820980107,San Javier,SANTA FE,15,25,24,29,53
82,82098,820980204,San Javier,SANTA FE,23,43,28,37,65
82,82098,820980404,San Javier,SANTA FE,215,234,373,387,760
82,82098,820980405,San Javier,SANTA FE,263,277,416,427,843
82,82098,820980312,San Javier,SANTA FE,109,152,200,242,442
82,82098,820980402,San Javier,SANTA FE,328,361,603,513,1116
82,82098,820980410,San Javier,SANTA FE,291,308,556,519,1075
82,82098,820980316,San Javier,SANTA FE,792,797,1696,1644,3340
82,82098,820980306,San Javier,SANTA FE,53,97,78,83,161
82,82098,820980303,San Javier,SANTA FE,15,48,8,17,25
82,82098,820980115,San Javier,SANTA FE,32,45,47,43,90
82,82098,820980203,San Javier,SANTA FE,228,269,404,412,816
82,82098,820980403,San Javier,SANTA FE,231,262,363,305,668
82,82098,820980207,San Javier,SANTA FE,419,487,736,674,1410
82,82098,820980408,San Javier,SANTA FE,239,263,380,351,731
82,82098,820980114,San Javier,SANTA FE,395,433,679,578,1257
82,82098,820980407,San Javier,SANTA FE,297,303,552,474,1026
82,82098,820980406,San Javier,SANTA FE,245,269,377,327,704
82,82098,820980205,San Javier,SANTA FE,166,227,238,282,520
82,82098,820980311,San Javier,SANTA FE,497,573,901,914,1815
82,82098,820980401,San Javier,SANTA FE,342,349,585,569,1154
82,82098,820980315,San Javier,SANTA FE,101,124,169,160,329
82,82098,820980313,San Javier,SANTA FE,43,52,72,89,161
82,82098,820980309,San Javier,SANTA FE,40,61,72,74,146
82,82098,820980304,San Javier,SANTA FE,121,197,199,250,449
82,82098,820980102,San Javier,SANTA FE,19,23,21,27,48
82,82098,820980101,San Javier,SANTA FE,24,33,30,45,75
82,82098,820980108,San Javier,SANTA FE,111,156,178,192,370
82,82098,820980314,San Javier,SANTA FE,46,63,68,74,142
82,82098,820980122,San Javier,SANTA FE,339,353,588,686,1274
82,82098,820980113,San Javier,SANTA FE,284,316,412,369,781
82,82098,820980206,San Javier,SANTA FE,284,347,489,495,984
82,82098,820980307,San Javier,SANTA FE,14,29,18,28,46
82,82098,820980301,San Javier,SANTA FE,17,39,15,33,48
82,82098,820980202,San Javier,SANTA FE,40,55,57,54,111
82,82098,820980201,San Javier,SANTA FE,78,161,106,149,255
82,82098,820980106,San Javier,SANTA FE,19,25,28,33,61
82,82098,820980104,San Javier,SANTA FE,19,27,37,35,72
82,82098,820980109,San Javier,SANTA FE,11,18,16,18,34
82,82098,820980310,San Javier,SANTA FE,180,248,304,329,633
82,82119,821190611,San Lorenzo,SANTA FE,331,383,495,446,941
82,82119,821190602,San Lorenzo,SANTA FE,269,311,398,361,759
82,82119,821190312,San Lorenzo,SANTA FE,304,243,531,557,1088
82,82119,821190308,San Lorenzo,SANTA FE,666,642,1216,1211,2427
82,82119,821190306,San Lorenzo,SANTA FE,313,311,536,541,1077
82,82119,821190117,San Lorenzo,SANTA FE,437,472,764,769,1533
82,82119,821190109,San Lorenzo,SANTA FE,195,244,283,304,587
82,82119,821190107,San Lorenzo,SANTA FE,183,192,281,275,556
82,82119,821190418,San Lorenzo,SANTA FE,234,261,330,319,649
82,82119,821190402,San Lorenzo,SANTA FE,308,244,566,545,1111
82,82119,821190813,San Lorenzo,SANTA FE,329,310,520,498,1018
82,82119,821190809,San Lorenzo,SANTA FE,287,312,456,359,815
82,82119,821190807,San Lorenzo,SANTA FE,337,345,574,547,1121
82,82119,821190806,San Lorenzo,SANTA FE,203,217,319,277,596
82,82119,821190805,San Lorenzo,SANTA FE,531,344,1034,1008,2042
82,82119,821190708,San Lorenzo,SANTA FE,297,310,440,432,872
82,82119,821190707,San Lorenzo,SANTA FE,188,214,300,240,540
82,82119,821190702,San Lorenzo,SANTA FE,419,426,724,763,1487
82,82119,821190424,San Lorenzo,SANTA FE,328,315,508,533,1041
82,82119,821190914,San Lorenzo,SANTA FE,47,52,71,74,145
82,82119,821190501,San Lorenzo,SANTA FE,45,74,62,77,139
82,82119,821191007,San Lorenzo,SANTA FE,399,395,734,758,1492
82,82119,821191002,San Lorenzo,SANTA FE,221,249,366,264,630
82,82119,821190906,San Lorenzo,SANTA FE,518,535,861,863,1724
82,82119,821190905,San Lorenzo,SANTA FE,216,168,380,384,764
82,82119,821190902,San Lorenzo,SANTA FE,260,152,469,485,954
82,82119,821190515,San Lorenzo,SANTA FE,540,622,974,953,1927
82,82119,821190110,San Lorenzo,SANTA FE,435,599,735,714,1449
82,82119,821190105,San Lorenzo,SANTA FE,456,453,771,758,1529
82,82119,821190301,San Lorenzo,SANTA FE,68,48,129,130,259
82,82119,821190909,San Lorenzo,SANTA FE,248,267,406,364,770
82,82119,821190814,San Lorenzo,SANTA FE,392,387,710,671,1381
82,82119,821190811,San Lorenzo,SANTA FE,239,225,390,364,754
82,82119,821190415,San Lorenzo,SANTA FE,419,421,780,716,1496
82,82119,821190505,San Lorenzo,SANTA FE,1,2,1,1,2
82,82119,821191010,San Lorenzo,SANTA FE,166,194,283,229,512
82,82119,821191005,San Lorenzo,SANTA FE,281,295,412,363,775
82,82119,821190519,San Lorenzo,SANTA FE,406,705,652,657,1309
82,82119,821190311,San Lorenzo,SANTA FE,267,283,436,450,886
82,82119,821190120,San Lorenzo,SANTA FE,974,945,1939,1954,3893
82,82119,821190201,San Lorenzo,SANTA FE,384,424,608,603,1211
82,82119,821190911,San Lorenzo,SANTA FE,191,233,269,264,533
82,82119,821190812,San Lorenzo,SANTA FE,182,216,272,248,520
82,82119,821190709,San Lorenzo,SANTA FE,297,310,479,464,943
82,82119,821190710,San Lorenzo,SANTA FE,277,283,445,424,869
82,82119,821190701,San Lorenzo,SANTA FE,387,412,706,625,1331
82,82119,821190414,San Lorenzo,SANTA FE,554,549,1056,1034,2090
82,82119,821190413,San Lorenzo,SANTA FE,369,362,734,704,1438
82,82119,821190116,San Lorenzo,SANTA FE,45,57,65,76,141
82,82119,821190112,San Lorenzo,SANTA FE,47,98,69,91,160
82,82119,821199301,San Lorenzo,SANTA FE,21,51,28,39,67
82,82119,821190410,San Lorenzo,SANTA FE,359,370,601,510,1111
82,82119,821191006,San Lorenzo,SANTA FE,281,225,472,469,941
82,82119,821190904,San Lorenzo,SANTA FE,267,310,411,390,801
82,82119,821190715,San Lorenzo,SANTA FE,499,531,923,953,1876
82,82119,821190612,San Lorenzo,SANTA FE,372,428,569,543,1112
82,82119,821190608,San Lorenzo,SANTA FE,522,577,806,752,1558
82,82119,821190503,San Lorenzo,SANTA FE,450,507,717,656,1373
82,82119,821190502,San Lorenzo,SANTA FE,401,469,658,610,1268
82,82119,821190313,San Lorenzo,SANTA FE,267,235,474,432,906
82,82119,821190307,San Lorenzo,SANTA FE,193,147,351,301,652
82,82119,821190204,San Lorenzo,SANTA FE,348,362,530,444,974
82,82119,821190108,San Lorenzo,SANTA FE,285,330,451,399,850
82,82119,821190314,San Lorenzo,SANTA FE,304,317,527,504,1031
82,82119,821190207,San Lorenzo,SANTA FE,204,250,280,239,519
82,82119,821190419,San Lorenzo,SANTA FE,353,397,541,448,989
82,82119,821190304,San Lorenzo,SANTA FE,491,519,743,674,1417
82,82119,821191012,San Lorenzo,SANTA FE,367,433,533,441,974
82,82119,821190802,San Lorenzo,SANTA FE,466,476,777,720,1497
82,82119,821190712,San Lorenzo,SANTA FE,284,320,443,379,822
82,82119,821190511,San Lorenzo,SANTA FE,363,412,613,527,1140
82,82119,821190422,San Lorenzo,SANTA FE,340,338,522,513,1035
82,82119,821190114,San Lorenzo,SANTA FE,2,6,0,2,2
82,82119,821190713,San Lorenzo,SANTA FE,90,138,139,178,317
82,82119,821190506,San Lorenzo,SANTA FE,69,164,118,129,247
82,82119,821190407,San Lorenzo,SANTA FE,333,334,691,638,1329
82,82119,821190405,San Lorenzo,SANTA FE,70,81,116,122,238
82,82119,821191014,San Lorenzo,SANTA FE,215,294,303,254,557
82,82119,821190818,San Lorenzo,SANTA FE,251,270,379,328,707
82,82119,821190816,San Lorenzo,SANTA FE,334,341,499,456,955
82,82119,821190417,San Lorenzo,SANTA FE,515,518,859,806,1665
82,82119,821190604,San Lorenzo,SANTA FE,297,326,462,395,857
82,82119,821190404,San Lorenzo,SANTA FE,311,338,507,473,980
82,82119,821190305,San Lorenzo,SANTA FE,231,263,377,322,699
82,82119,821190704,San Lorenzo,SANTA FE,331,361,525,523,1048
82,82119,821190518,San Lorenzo,SANTA FE,211,553,335,337,672
82,82119,821190703,San Lorenzo,SANTA FE,372,403,680,655,1335
82,82119,821190614,San Lorenzo,SANTA FE,326,357,498,505,1003
82,82119,821190516,San Lorenzo,SANTA FE,119,374,169,181,350
82,82119,821190416,San Lorenzo,SANTA FE,308,305,535,466,1001
82,82119,821190412,San Lorenzo,SANTA FE,297,311,530,458,988
82,82119,821190606,San Lorenzo,SANTA FE,226,264,351,332,683
82,82119,821190605,San Lorenzo,SANTA FE,18,69,26,43,69
82,82119,821190115,San Lorenzo,SANTA FE,40,65,70,70,140
82,82119,821190315,San Lorenzo,SANTA FE,27,28,70,66,136
82,82119,821199402,San Lorenzo,SANTA FE,5,12,5,6,11
82,82119,821190504,San Lorenzo,SANTA FE,81,217,119,136,255
82,82119,821190101,San Lorenzo,SANTA FE,186,392,293,307,600
82,82119,821190409,San Lorenzo,SANTA FE,491,509,814,796,1610
82,82119,821191009,San Lorenzo,SANTA FE,258,310,372,323,695
82,82119,821191001,San Lorenzo,SANTA FE,234,267,339,325,664
82,82119,821190913,San Lorenzo,SANTA FE,503,451,935,940,1875
82,82119,821190901,San Lorenzo,SANTA FE,30,30,49,56,105
82,82119,821190801,San Lorenzo,SANTA FE,330,327,564,635,1199
82,82119,821191011,San Lorenzo,SANTA FE,299,360,425,389,814
82,82119,821190121,San Lorenzo,SANTA FE,563,543,1103,1137,2240
82,82119,821190111,San Lorenzo,SANTA FE,266,344,401,435,836
82,82119,821190106,San Lorenzo,SANTA FE,399,392,632,551,1183
82,82119,821190104,San Lorenzo,SANTA FE,264,253,428,412,840
82,82119,821191003,San Lorenzo,SANTA FE,235,273,331,283,614
82,82119,821190209,San Lorenzo,SANTA FE,239,260,352,308,660
82,82119,821190403,San Lorenzo,SANTA FE,357,373,599,583,1182
82,82119,821190302,San Lorenzo,SANTA FE,510,499,946,878,1824
82,82119,821190912,San Lorenzo,SANTA FE,223,250,338,336,674
82,82119,821190910,San Lorenzo,SANTA FE,179,199,258,236,494
82,82119,821190803,San Lorenzo,SANTA FE,369,385,557,493,1050
82,82119,821190711,San Lorenzo,SANTA FE,208,241,322,258,580
82,82119,821190705,San Lorenzo,SANTA FE,430,447,722,719,1441
82,82119,821190513,San Lorenzo,SANTA FE,267,292,434,402,836
82,82119,821190426,San Lorenzo,SANTA FE,351,138,671,683,1354
82,82119,821199701,San Lorenzo,SANTA FE,2,4,2,3,5
82,82119,821190613,San Lorenzo,SANTA FE,21,45,27,33,60
82,82119,821199401,San Lorenzo,SANTA FE,4,20,5,5,10
82,82119,821190408,San Lorenzo,SANTA FE,370,380,627,572,1199
82,82119,821190406,San Lorenzo,SANTA FE,268,242,534,540,1074
82,82119,821190411,San Lorenzo,SANTA FE,92,95,154,148,302
82,82119,821191008,San Lorenzo,SANTA FE,293,332,413,370,783
82,82119,821191004,San Lorenzo,SANTA FE,280,296,456,433,889
82,82119,821190907,San Lorenzo,SANTA FE,275,297,439,389,828
82,82119,821190716,San Lorenzo,SANTA FE,369,379,628,630,1258
82,82119,821190609,San Lorenzo,SANTA FE,419,447,642,591,1233
82,82119,821190514,San Lorenzo,SANTA FE,362,405,624,602,1226
82,82119,821190310,San Lorenzo,SANTA FE,170,184,320,307,627
82,82119,821190309,San Lorenzo,SANTA FE,270,286,431,392,823
82,82119,821190119,San Lorenzo,SANTA FE,328,272,624,630,1254
82,82119,821190206,San Lorenzo,SANTA FE,373,395,529,508,1037
82,82119,821190118,San Lorenzo,SANTA FE,248,257,462,436,898
82,82119,821190205,San Lorenzo,SANTA FE,385,433,608,516,1124
82,82119,821190203,San Lorenzo,SANTA FE,450,430,722,672,1394
82,82119,821190208,San Lorenzo,SANTA FE,236,262,353,307,660
82,82119,821190122,San Lorenzo,SANTA FE,287,310,573,540,1113
82,82119,821190603,San Lorenzo,SANTA FE,495,526,808,800,1608
82,82119,821190815,San Lorenzo,SANTA FE,403,341,675,621,1296
82,82119,821190810,San Lorenzo,SANTA FE,344,357,501,426,927
82,82119,821190808,San Lorenzo,SANTA FE,375,377,610,516,1126
82,82119,821190804,San Lorenzo,SANTA FE,333,339,501,424,925
82,82119,821190509,San Lorenzo,SANTA FE,263,318,397,351,748
82,82119,821190512,San Lorenzo,SANTA FE,218,272,338,349,687
82,82119,821190425,San Lorenzo,SANTA FE,274,323,435,374,809
82,82119,821190423,San Lorenzo,SANTA FE,237,223,425,420,845
82,82119,821190420,San Lorenzo,SANTA FE,294,299,497,480,977
82,82119,821190610,San Lorenzo,SANTA FE,54,137,62,95,157
82,82119,821190607,San Lorenzo,SANTA FE,17,34,22,25,47
82,82119,821190601,San Lorenzo,SANTA FE,98,123,161,168,329
82,82119,821190113,San Lorenzo,SANTA FE,12,26,20,19,39
82,82119,821190401,San Lorenzo,SANTA FE,43,45,73,96,169
82,82119,821199601,San Lorenzo,SANTA FE,2,4,4,2,6
82,82119,821190903,San Lorenzo,SANTA FE,279,297,488,507,995
82,82119,821191013,San Lorenzo,SANTA FE,278,313,465,401,866
82,82119,821190714,San Lorenzo,SANTA FE,268,295,420,374,794
82,82119,821190202,San Lorenzo,SANTA FE,446,463,763,702,1465
82,82119,821190102,San Lorenzo,SANTA FE,595,653,1098,1063,2161
82,82119,821190706,San Lorenzo,SANTA FE,327,393,475,444,919
82,82119,821190303,San Lorenzo,SANTA FE,265,293,420,364,784
82,82119,821190908,San Lorenzo,SANTA FE,241,282,367,324,691
82,82119,821190517,San Lorenzo,SANTA FE,201,254,338,291,629
82,82119,821190510,San Lorenzo,SANTA FE,417,448,755,763,1518
82,82119,821190508,San Lorenzo,SANTA FE,300,331,509,509,1018
82,82119,821190507,San Lorenzo,SANTA FE,468,472,857,878,1735
82,82119,821190817,San Lorenzo,SANTA FE,59,48,95,108,203
82,82119,821190103,San Lorenzo,SANTA FE,40,69,76,88,164
82,82119,821199403,San Lorenzo,SANTA FE,5,12,2,6,8
82,82007,820070215,Belgrano,SANTA FE,217,251,308,282,590
82,82007,820070410,Belgrano,SANTA FE,242,277,361,354,715
82,82007,820070305,Belgrano,SANTA FE,400,350,682,652,1334
82,82007,820070312,Belgrano,SANTA FE,409,494,631,542,1173
82,82007,820070306,Belgrano,SANTA FE,353,364,612,629,1241
82,82007,820070209,Belgrano,SANTA FE,98,173,138,166,304
82,82007,820070304,Belgrano,SANTA FE,353,424,494,464,958
82,82007,820070303,Belgrano,SANTA FE,376,502,536,451,987
82,82007,820070203,Belgrano,SANTA FE,304,338,448,396,844
82,82007,820070202,Belgrano,SANTA FE,379,394,578,549,1127
82,82007,820070406,Belgrano,SANTA FE,297,308,490,393,883
82,82007,820070414,Belgrano,SANTA FE,315,337,517,444,961
82,82007,820070308,Belgrano,SANTA FE,262,292,392,368,760
82,82007,820070402,Belgrano,SANTA FE,198,242,282,250,532
82,82007,820070307,Belgrano,SANTA FE,97,147,148,189,337
82,82007,820070216,Belgrano,SANTA FE,330,284,645,677,1322
82,82007,820070210,Belgrano,SANTA FE,294,233,498,517,1015
82,82007,820070404,Belgrano,SANTA FE,213,289,345,339,684
82,82007,820070403,Belgrano,SANTA FE,326,365,450,385,835
82,82007,820070212,Belgrano,SANTA FE,97,215,142,174,316
82,82007,820070206,Belgrano,SANTA FE,271,305,384,366,750
82,82007,820070205,Belgrano,SANTA FE,363,340,608,593,1201
82,82007,820070412,Belgrano,SANTA FE,391,417,705,635,1340
82,82007,820070101,Belgrano,SANTA FE,77,115,106,124,230
82,82007,820070213,Belgrano,SANTA FE,246,281,360,323,683
82,82007,820070217,Belgrano,SANTA FE,249,275,358,386,744
82,82007,820070214,Belgrano,SANTA FE,232,260,343,295,638
82,82007,820070409,Belgrano,SANTA FE,466,463,833,841,1674
82,82007,820070314,Belgrano,SANTA FE,243,255,405,356,761
82,82007,820070302,Belgrano,SANTA FE,396,433,615,547,1162
82,82007,820070204,Belgrano,SANTA FE,370,361,722,686,1408
82,82007,820070103,Belgrano,SANTA FE,401,450,607,623,1230
82,82007,820070315,Belgrano,SANTA FE,323,381,500,513,1013
82,82007,820070309,Belgrano,SANTA FE,84,138,124,145,269
82,82007,820070310,Belgrano,SANTA FE,488,556,754,720,1474
82,82007,820070405,Belgrano,SANTA FE,275,318,419,311,730
82,82007,820070301,Belgrano,SANTA FE,302,319,458,399,857
82,82007,820070408,Belgrano,SANTA FE,335,356,569,513,1082
82,82007,820070407,Belgrano,SANTA FE,361,405,539,561,1100
82,82007,820070313,Belgrano,SANTA FE,264,292,413,370,783
82,82007,820070207,Belgrano,SANTA FE,243,276,359,354,713
82,82007,820070201,Belgrano,SANTA FE,332,351,471,456,927
82,82007,820070411,Belgrano,SANTA FE,236,265,347,266,613
82,82007,820070413,Belgrano,SANTA FE,294,316,545,564,1109
82,82007,820070311,Belgrano,SANTA FE,324,382,472,406,878
82,82007,820070401,Belgrano,SANTA FE,254,286,392,418,810
82,82007,820070104,Belgrano,SANTA FE,71,134,120,112,232
82,82007,820070102,Belgrano,SANTA FE,118,180,175,216,391
82,82007,820070208,Belgrano,SANTA FE,520,522,841,888,1729
82,82007,820070211,Belgrano,SANTA FE,392,371,682,657,1339
82,82035,820350210,Garay,SANTA FE,375,444,611,560,1171
82,82035,820350204,Garay,SANTA FE,18,38,29,29,58
82,82035,820350104,Garay,SANTA FE,9,30,13,15,28
82,82035,820350102,Garay,SANTA FE,249,306,456,491,947
82,82035,820350108,Garay,SANTA FE,100,107,172,202,374
82,82035,820350209,Garay,SANTA FE,325,546,541,603,1144
82,82035,820350112,Garay,SANTA FE,240,277,538,532,1070
82,82035,820350205,Garay,SANTA FE,50,75,73,78,151
82,82035,820350101,Garay,SANTA FE,101,139,127,247,374
82,82035,820350111,Garay,SANTA FE,381,436,683,624,1307
82,82035,820350203,Garay,SANTA FE,32,39,43,55,98
82,82035,820350107,Garay,SANTA FE,28,41,24,41,65
82,82035,820350109,Garay,SANTA FE,77,89,128,138,266
82,82035,820350207,Garay,SANTA FE,304,286,520,577,1097
82,82035,820350116,Garay,SANTA FE,144,255,293,295,588
82,82035,820350113,Garay,SANTA FE,327,396,610,590,1200
82,82035,820350206,Garay,SANTA FE,128,162,216,254,470
82,82035,820350117,Garay,SANTA FE,275,300,455,463,918
82,82035,820350213,Garay,SANTA FE,311,338,527,531,1058
82,82035,820350208,Garay,SANTA FE,84,116,148,155,303
82,82035,820350212,Garay,SANTA FE,382,441,640,643,1283
82,82035,820350114,Garay,SANTA FE,348,395,642,559,1201
82,82035,820350201,Garay,SANTA FE,5,19,6,10,16
82,82035,820350106,Garay,SANTA FE,213,277,458,504,962
82,82035,820350103,Garay,SANTA FE,64,126,82,121,203
82,82035,820350202,Garay,SANTA FE,556,813,1048,1001,2049
82,82035,820350211,Garay,SANTA FE,546,649,929,891,1820
82,82035,820350115,Garay,SANTA FE,21,38,26,40,66
82,82035,820350110,Garay,SANTA FE,151,185,271,287,558
82,82035,820350105,Garay,SANTA FE,16,26,24,21,45
78,78049,780490503,Río Chico,SANTA CRUZ,243,378,374,542,916
78,78049,780490301,Río Chico,SANTA CRUZ,20,46,25,142,167
78,78049,780490101,Río Chico,SANTA CRUZ,40,81,24,105,129
78,78049,780490103,Río Chico,SANTA CRUZ,88,157,125,141,266
78,78049,780490201,Río Chico,SANTA CRUZ,30,64,11,37,48
78,78049,780490501,Río Chico,SANTA CRUZ,529,585,901,959,1860
78,78049,780490102,Río Chico,SANTA CRUZ,13,16,14,19,33
78,78049,780490401,Río Chico,SANTA CRUZ,8,28,5,13,18
78,78049,780490502,Río Chico,SANTA CRUZ,458,519,726,995,1721
78,78042,780420301,Magallanes,SANTA CRUZ,307,388,496,477,973
78,78042,780420304,Magallanes,SANTA CRUZ,294,432,404,413,817
78,78042,780420303,Magallanes,SANTA CRUZ,126,156,167,160,327
78,78042,780420202,Magallanes,SANTA CRUZ,190,225,353,335,688
78,78042,780420306,Magallanes,SANTA CRUZ,538,626,859,860,1719
78,78042,780420101,Magallanes,SANTA CRUZ,33,48,11,62,73
78,78042,780420305,Magallanes,SANTA CRUZ,422,492,649,644,1293
78,78042,780420203,Magallanes,SANTA CRUZ,145,146,329,271,600
78,78042,780420201,Magallanes,SANTA CRUZ,15,27,31,516,547
78,78042,780420307,Magallanes,SANTA CRUZ,335,370,566,564,1130
78,78042,780420302,Magallanes,SANTA CRUZ,402,509,543,492,1035
78,78021,780211116,Güer Aike,SANTA CRUZ,194,208,273,259,532
78,78021,780211201,Güer Aike,SANTA CRUZ,381,392,543,555,1098
78,78021,780211412,Güer Aike,SANTA CRUZ,221,243,361,387,748
78,78021,780211410,Güer Aike,SANTA CRUZ,355,343,617,606,1223
78,78021,780211320,Güer Aike,SANTA CRUZ,581,658,1067,1121,2188
78,78021,780211207,Güer Aike,SANTA CRUZ,371,386,638,630,1268
78,78021,780211205,Güer Aike,SANTA CRUZ,437,462,639,598,1237
78,78021,780211102,Güer Aike,SANTA CRUZ,198,267,280,284,564
78,78021,780211101,Güer Aike,SANTA CRUZ,246,297,346,310,656
78,78021,780210805,Güer Aike,SANTA CRUZ,327,339,505,532,1037
78,78021,780210803,Güer Aike,SANTA CRUZ,12,11,112,260,372
78,78021,780210706,Güer Aike,SANTA CRUZ,65,162,115,110,225
78,78021,780211316,Güer Aike,SANTA CRUZ,55,87,83,76,159
78,78021,780211315,Güer Aike,SANTA CRUZ,446,459,961,820,1781
78,78021,780211310,Güer Aike,SANTA CRUZ,322,359,577,588,1165
78,78021,780211220,Güer Aike,SANTA CRUZ,386,420,656,664,1320
78,78021,780211218,Güer Aike,SANTA CRUZ,201,245,304,321,625
78,78021,780211406,Güer Aike,SANTA CRUZ,364,398,558,550,1108
78,78021,780210301,Güer Aike,SANTA CRUZ,88,73,15,89,104
78,78021,780211204,Güer Aike,SANTA CRUZ,285,297,451,491,942
78,78021,780211413,Güer Aike,SANTA CRUZ,148,169,232,234,466
78,78021,780211408,Güer Aike,SANTA CRUZ,339,352,554,535,1089
78,78021,780211118,Güer Aike,SANTA CRUZ,235,248,439,382,821
78,78021,780211117,Güer Aike,SANTA CRUZ,172,222,234,210,444
78,78021,780211114,Güer Aike,SANTA CRUZ,266,312,431,476,907
78,78021,780211112,Güer Aike,SANTA CRUZ,292,313,508,507,1015
78,78021,780211106,Güer Aike,SANTA CRUZ,257,343,351,333,684
78,78021,780211104,Güer Aike,SANTA CRUZ,157,201,196,175,371
78,78021,780211122,Güer Aike,SANTA CRUZ,316,343,523,533,1056
78,78021,780211014,Güer Aike,SANTA CRUZ,333,348,501,504,1005
78,78021,780211007,Güer Aike,SANTA CRUZ,168,214,211,199,410
78,78021,780211005,Güer Aike,SANTA CRUZ,182,256,244,235,479
78,78021,780210902,Güer Aike,SANTA CRUZ,623,692,1038,1126,2164
78,78021,780211121,Güer Aike,SANTA CRUZ,219,207,329,346,675
78,78021,780210405,Güer Aike,SANTA CRUZ,430,860,651,707,1358
78,78021,780210402,Güer Aike,SANTA CRUZ,49,152,58,79,137
78,78021,780210201,Güer Aike,SANTA CRUZ,29,71,30,59,89
78,78021,780210705,Güer Aike,SANTA CRUZ,8,14,9,18,27
78,78021,780211415,Güer Aike,SANTA CRUZ,278,329,431,456,887
78,78021,780211404,Güer Aike,SANTA CRUZ,236,234,421,392,813
78,78021,780211115,Güer Aike,SANTA CRUZ,321,373,475,468,943
78,78021,780211109,Güer Aike,SANTA CRUZ,298,360,461,436,897
78,78021,780211108,Güer Aike,SANTA CRUZ,186,232,256,198,454
78,78021,780211002,Güer Aike,SANTA CRUZ,429,427,601,677,1278
78,78021,780210901,Güer Aike,SANTA CRUZ,513,590,783,862,1645
78,78021,780210804,Güer Aike,SANTA CRUZ,265,295,377,416,793
78,78021,780210703,Güer Aike,SANTA CRUZ,7,12,6,49,55
78,78021,780211314,Güer Aike,SANTA CRUZ,252,262,496,500,996
78,78021,780211312,Güer Aike,SANTA CRUZ,583,652,1243,1118,2361
78,78021,780211309,Güer Aike,SANTA CRUZ,333,362,613,611,1224
78,78021,780211303,Güer Aike,SANTA CRUZ,176,179,349,356,705
78,78021,780211203,Güer Aike,SANTA CRUZ,242,237,343,353,696
78,78021,780210501,Güer Aike,SANTA CRUZ,35,40,8,58,66
78,78021,780211219,Güer Aike,SANTA CRUZ,216,228,384,386,770
78,78021,780211414,Güer Aike,SANTA CRUZ,404,441,697,714,1411
78,78021,780211319,Güer Aike,SANTA CRUZ,159,148,277,284,561
78,78021,780211318,Güer Aike,SANTA CRUZ,188,269,266,290,556
78,78021,780211210,Güer Aike,SANTA CRUZ,229,450,470,600,1070
78,78021,780211209,Güer Aike,SANTA CRUZ,325,372,544,530,1074
78,78021,780211206,Güer Aike,SANTA CRUZ,161,198,231,238,469
78,78021,780211103,Güer Aike,SANTA CRUZ,371,465,554,534,1088
78,78021,780211016,Güer Aike,SANTA CRUZ,233,271,346,338,684
78,78021,780211015,Güer Aike,SANTA CRUZ,192,258,245,228,473
78,78021,780211012,Güer Aike,SANTA CRUZ,331,338,475,500,975
78,78021,780211010,Güer Aike,SANTA CRUZ,355,367,663,661,1324
78,78021,780211008,Güer Aike,SANTA CRUZ,328,383,483,476,959
78,78021,780211006,Güer Aike,SANTA CRUZ,228,250,278,281,559
78,78021,780210807,Güer Aike,SANTA CRUZ,483,522,979,942,1921
78,78021,780210801,Güer Aike,SANTA CRUZ,350,382,582,620,1202
78,78021,780211307,Güer Aike,SANTA CRUZ,486,511,986,957,1943
78,78021,780210404,Güer Aike,SANTA CRUZ,1,5,18,64,82
78,78021,780210701,Güer Aike,SANTA CRUZ,80,149,89,212,301
78,78021,780210102,Güer Aike,SANTA CRUZ,22,43,5,30,35
78,78021,780210704,Güer Aike,SANTA CRUZ,143,92,233,444,677
78,78021,780211405,Güer Aike,SANTA CRUZ,225,224,376,364,740
78,78021,780211401,Güer Aike,SANTA CRUZ,391,387,747,708,1455
78,78021,780211214,Güer Aike,SANTA CRUZ,257,265,415,394,809
78,78021,780211213,Güer Aike,SANTA CRUZ,201,207,347,350,697
78,78021,780211110,Güer Aike,SANTA CRUZ,179,206,295,245,540
78,78021,780211011,Güer Aike,SANTA CRUZ,342,371,541,556,1097
78,78021,780211001,Güer Aike,SANTA CRUZ,244,270,392,390,782
78,78021,780211306,Güer Aike,SANTA CRUZ,531,590,1090,1042,2132
78,78021,780211301,Güer Aike,SANTA CRUZ,328,386,525,545,1070
78,78021,780211217,Güer Aike,SANTA CRUZ,222,233,431,356,787
78,78021,780210403,Güer Aike,SANTA CRUZ,47,108,66,62,128
78,78021,780211211,Güer Aike,SANTA CRUZ,236,256,375,367,742
78,78021,780211123,Güer Aike,SANTA CRUZ,302,280,538,530,1068
78,78021,780211411,Güer Aike,SANTA CRUZ,239,209,438,419,857
78,78021,780211403,Güer Aike,SANTA CRUZ,269,286,488,480,968
78,78021,780211322,Güer Aike,SANTA CRUZ,360,385,738,670,1408
78,78021,780211321,Güer Aike,SANTA CRUZ,338,376,591,630,1221
78,78021,780211105,Güer Aike,SANTA CRUZ,401,413,631,699,1330
78,78021,780211313,Güer Aike,SANTA CRUZ,189,255,287,293,580
78,78021,780211304,Güer Aike,SANTA CRUZ,443,560,664,660,1324
78,78021,780211221,Güer Aike,SANTA CRUZ,557,584,1168,1110,2278
78,78021,780210702,Güer Aike,SANTA CRUZ,90,93,118,175,293
78,78021,780210406,Güer Aike,SANTA CRUZ,44,87,64,79,143
78,78021,780210101,Güer Aike,SANTA CRUZ,77,122,32,255,287
78,78021,780211402,Güer Aike,SANTA CRUZ,340,358,506,574,1080
78,78021,780211208,Güer Aike,SANTA CRUZ,366,387,638,604,1242
78,78021,780211120,Güer Aike,SANTA CRUZ,285,311,413,423,836
78,78021,780211119,Güer Aike,SANTA CRUZ,118,152,141,163,304
78,78021,780211113,Güer Aike,SANTA CRUZ,261,264,464,426,890
78,78021,780211111,Güer Aike,SANTA CRUZ,244,229,336,319,655
78,78021,780211004,Güer Aike,SANTA CRUZ,238,271,300,286,586
78,78021,780210903,Güer Aike,SANTA CRUZ,507,512,1056,1055,2111
78,78021,780210806,Güer Aike,SANTA CRUZ,397,421,599,663,1262
78,78021,780211317,Güer Aike,SANTA CRUZ,497,574,914,931,1845
78,78021,780211407,Güer Aike,SANTA CRUZ,421,443,619,643,1262
78,78021,780211311,Güer Aike,SANTA CRUZ,270,271,555,530,1085
78,78021,780211305,Güer Aike,SANTA CRUZ,463,521,831,857,1688
78,78021,780211302,Güer Aike,SANTA CRUZ,213,273,334,399,733
78,78021,780211216,Güer Aike,SANTA CRUZ,253,269,441,475,916
78,78021,780210601,Güer Aike,SANTA CRUZ,52,56,46,129,175
78,78021,780211202,Güer Aike,SANTA CRUZ,206,212,306,304,610
78,78021,780211409,Güer Aike,SANTA CRUZ,294,317,441,522,963
78,78021,780211215,Güer Aike,SANTA CRUZ,226,233,368,360,728
78,78021,780211212,Güer Aike,SANTA CRUZ,401,446,621,634,1255
78,78021,780211107,Güer Aike,SANTA CRUZ,232,355,282,277,559
78,78021,780211013,Güer Aike,SANTA CRUZ,222,250,297,334,631
78,78021,780211009,Güer Aike,SANTA CRUZ,163,174,242,284,526
78,78021,780211003,Güer Aike,SANTA CRUZ,235,257,338,298,636
78,78021,780210802,Güer Aike,SANTA CRUZ,631,740,1060,1167,2227
78,78021,780211308,Güer Aike,SANTA CRUZ,448,489,929,898,1827
78,78021,780210401,Güer Aike,SANTA CRUZ,117,191,74,329,403
78,78014,780141203,Deseado,SANTA CRUZ,473,516,802,874,1676
78,78014,780141121,Deseado,SANTA CRUZ,287,295,408,403,811
78,78014,780141116,Deseado,SANTA CRUZ,282,269,371,425,796
78,78014,780140903,Deseado,SANTA CRUZ,277,314,429,456,885
78,78014,780140218,Deseado,SANTA CRUZ,382,452,650,708,1358
78,78014,780140203,Deseado,SANTA CRUZ,574,572,957,1022,1979
78,78014,780140103,Deseado,SANTA CRUZ,495,566,728,798,1526
78,78014,780141110,Deseado,SANTA CRUZ,249,293,412,386,798
78,78014,780140302,Deseado,SANTA CRUZ,22,58,9,34,43
78,78014,780140601,Deseado,SANTA CRUZ,17,60,7,28,35
78,78014,780140201,Deseado,SANTA CRUZ,37,73,17,444,461
78,78014,780140101,Deseado,SANTA CRUZ,30,63,6,56,62
78,78014,780140217,Deseado,SANTA CRUZ,283,326,471,504,975
78,78014,780141105,Deseado,SANTA CRUZ,170,238,230,216,446
78,78014,780140505,Deseado,SANTA CRUZ,606,583,1044,1084,2128
78,78014,780140805,Deseado,SANTA CRUZ,370,393,652,653,1305
78,78014,780140804,Deseado,SANTA CRUZ,410,439,599,670,1269
78,78014,780141202,Deseado,SANTA CRUZ,341,362,545,492,1037
78,78014,780140211,Deseado,SANTA CRUZ,478,480,947,979,1926
78,78014,780140208,Deseado,SANTA CRUZ,463,511,945,970,1915
78,78014,780141124,Deseado,SANTA CRUZ,206,232,292,310,602
78,78014,780140109,Deseado,SANTA CRUZ,695,648,1180,1234,2414
78,78014,780140106,Deseado,SANTA CRUZ,626,764,1082,1264,2346
78,78014,780141109,Deseado,SANTA CRUZ,288,339,429,396,825
78,78014,780141201,Deseado,SANTA CRUZ,303,340,474,496,970
78,78014,780140904,Deseado,SANTA CRUZ,247,272,371,375,746
78,78014,780140216,Deseado,SANTA CRUZ,454,495,951,904,1855
78,78014,780141208,Deseado,SANTA CRUZ,351,360,535,510,1045
78,78014,780141107,Deseado,SANTA CRUZ,219,267,322,320,642
78,78014,780140913,Deseado,SANTA CRUZ,374,445,637,633,1270
78,78014,780140909,Deseado,SANTA CRUZ,325,354,541,547,1088
78,78014,780140802,Deseado,SANTA CRUZ,477,544,604,665,1269
78,78014,780140801,Deseado,SANTA CRUZ,214,234,266,325,591
78,78014,780140304,Deseado,SANTA CRUZ,357,642,698,680,1378
78,78014,780141125,Deseado,SANTA CRUZ,219,250,339,324,663
78,78014,780140204,Deseado,SANTA CRUZ,419,403,806,777,1583
78,78014,780140104,Deseado,SANTA CRUZ,514,549,842,929,1771
78,78014,780140401,Deseado,SANTA CRUZ,28,47,8,33,41
78,78014,780141122,Deseado,SANTA CRUZ,242,251,401,411,812
78,78014,780141120,Deseado,SANTA CRUZ,501,551,744,799,1543
78,78014,780141104,Deseado,SANTA CRUZ,291,358,428,443,871
78,78014,780140912,Deseado,SANTA CRUZ,382,423,698,755,1453
78,78014,780140908,Deseado,SANTA CRUZ,485,509,781,845,1626
78,78014,780140504,Deseado,SANTA CRUZ,201,257,407,468,875
78,78014,780140305,Deseado,SANTA CRUZ,529,592,1079,982,2061
78,78014,780140221,Deseado,SANTA CRUZ,455,581,856,811,1667
78,78014,780140212,Deseado,SANTA CRUZ,546,610,1039,990,2029
78,78014,780140206,Deseado,SANTA CRUZ,408,460,750,771,1521
78,78014,780140207,Deseado,SANTA CRUZ,326,369,541,537,1078
78,78014,780140502,Deseado,SANTA CRUZ,26,61,14,110,124
78,78014,780141204,Deseado,SANTA CRUZ,276,278,474,480,954
78,78014,780141117,Deseado,SANTA CRUZ,262,278,418,409,827
78,78014,780141114,Deseado,SANTA CRUZ,360,372,540,553,1093
78,78014,780141113,Deseado,SANTA CRUZ,345,381,528,535,1063
78,78014,780141112,Deseado,SANTA CRUZ,385,428,575,557,1132
78,78014,780141111,Deseado,SANTA CRUZ,408,429,732,775,1507
78,78014,780141103,Deseado,SANTA CRUZ,149,175,200,231,431
78,78014,780141001,Deseado,SANTA CRUZ,251,288,406,473,879
78,78014,780140914,Deseado,SANTA CRUZ,324,348,493,543,1036
78,78014,780140507,Deseado,SANTA CRUZ,382,417,703,676,1379
78,78014,780140403,Deseado,SANTA CRUZ,107,127,155,265,420
78,78014,780140220,Deseado,SANTA CRUZ,359,452,536,601,1137
78,78014,780140213,Deseado,SANTA CRUZ,453,440,754,810,1564
78,78014,780140210,Deseado,SANTA CRUZ,376,415,704,687,1391
78,78014,780140205,Deseado,SANTA CRUZ,426,443,696,683,1379
78,78014,780140303,Deseado,SANTA CRUZ,74,87,119,131,250
78,78014,780140222,Deseado,SANTA CRUZ,411,501,861,779,1640
78,78014,780141207,Deseado,SANTA CRUZ,300,365,414,702,1116
78,78014,780141205,Deseado,SANTA CRUZ,240,292,323,362,685
78,78014,780141123,Deseado,SANTA CRUZ,234,264,362,377,739
78,78014,780141119,Deseado,SANTA CRUZ,226,256,307,313,620
78,78014,780141118,Deseado,SANTA CRUZ,139,151,220,234,454
78,78014,780140907,Deseado,SANTA CRUZ,262,258,399,415,814
78,78014,780140906,Deseado,SANTA CRUZ,495,519,727,770,1497
78,78014,780140902,Deseado,SANTA CRUZ,490,538,709,812,1521
78,78014,780140506,Deseado,SANTA CRUZ,296,305,625,588,1213
78,78014,780140209,Deseado,SANTA CRUZ,216,376,243,339,582
78,78014,780140202,Deseado,SANTA CRUZ,337,393,571,629,1200
78,78014,780141108,Deseado,SANTA CRUZ,457,529,629,721,1350
78,78014,780140701,Deseado,SANTA CRUZ,16,65,3,49,52
78,78014,780141106,Deseado,SANTA CRUZ,234,291,306,297,603
78,78014,780140911,Deseado,SANTA CRUZ,341,354,569,588,1157
78,78014,780140910,Deseado,SANTA CRUZ,383,364,599,668,1267
78,78014,780140803,Deseado,SANTA CRUZ,414,483,591,690,1281
78,78014,780141206,Deseado,SANTA CRUZ,394,435,546,559,1105
78,78014,780140108,Deseado,SANTA CRUZ,492,562,787,874,1661
78,78014,780140105,Deseado,SANTA CRUZ,329,400,479,546,1025
78,78014,780140301,Deseado,SANTA CRUZ,25,41,6,26,32
78,78014,780140102,Deseado,SANTA CRUZ,30,74,11,147,158
78,78014,780141115,Deseado,SANTA CRUZ,441,458,569,606,1175
78,78014,780141102,Deseado,SANTA CRUZ,324,385,463,426,889
78,78014,780141101,Deseado,SANTA CRUZ,500,479,738,766,1504
78,78014,780140905,Deseado,SANTA CRUZ,375,409,459,533,992
78,78014,780140901,Deseado,SANTA CRUZ,575,574,1062,1036,2098
78,78014,780140503,Deseado,SANTA CRUZ,24,68,18,40,58
78,78014,780140402,Deseado,SANTA CRUZ,102,120,144,182,326
78,78014,780140219,Deseado,SANTA CRUZ,466,416,778,843,1621
78,78014,780140215,Deseado,SANTA CRUZ,8,8,16,75,91
78,78014,780140214,Deseado,SANTA CRUZ,295,392,521,525,1046
78,78014,780140107,Deseado,SANTA CRUZ,396,462,673,690,1363
78,78014,780140501,Deseado,SANTA CRUZ,29,65,20,43,63
78,78028,780280512,Lago Argentino,SANTA CRUZ,29,48,76,77,153
78,78028,780280506,Lago Argentino,SANTA CRUZ,101,150,325,312,637
78,78028,780280701,Lago Argentino,SANTA CRUZ,198,265,438,484,922
78,78028,780280402,Lago Argentino,SANTA CRUZ,86,106,114,168,282
78,78028,780280507,Lago Argentino,SANTA CRUZ,4,9,4,5,9
78,78028,780280501,Lago Argentino,SANTA CRUZ,22,26,16,43,59
78,78028,780280502,Lago Argentino,SANTA CRUZ,14,27,5,16,21
78,78028,780280102,Lago Argentino,SANTA CRUZ,25,24,10,62,72
78,78028,780280103,Lago Argentino,SANTA CRUZ,481,511,769,858,1627
78,78028,780280702,Lago Argentino,SANTA CRUZ,296,368,435,496,931
78,78028,780280101,Lago Argentino,SANTA CRUZ,17,19,10,25,35
78,78028,780280601,Lago Argentino,SANTA CRUZ,19,42,5,20,25
78,78028,780280514,Lago Argentino,SANTA CRUZ,424,498,717,735,1452
78,78028,780280513,Lago Argentino,SANTA CRUZ,612,727,975,1005,1980
78,78028,780280511,Lago Argentino,SANTA CRUZ,15,54,18,20,38
78,78028,780280706,Lago Argentino,SANTA CRUZ,280,328,538,515,1053
78,78028,780280705,Lago Argentino,SANTA CRUZ,272,279,437,407,844
78,78028,780280504,Lago Argentino,SANTA CRUZ,763,840,1297,1351,2648
78,78028,780280509,Lago Argentino,SANTA CRUZ,40,55,48,75,123
78,78028,780280401,Lago Argentino,SANTA CRUZ,24,40,13,51,64
78,78028,780280201,Lago Argentino,SANTA CRUZ,9,14,4,7,11
78,78028,780280510,Lago Argentino,SANTA CRUZ,316,430,592,592,1184
78,78028,780280508,Lago Argentino,SANTA CRUZ,16,52,25,53,78
78,78028,780280503,Lago Argentino,SANTA CRUZ,473,677,747,703,1450
78,78028,780280703,Lago Argentino,SANTA CRUZ,363,436,652,640,1292
78,78028,780280505,Lago Argentino,SANTA CRUZ,103,165,187,234,421
78,78028,780280704,Lago Argentino,SANTA CRUZ,498,589,697,743,1440
78,78028,780280301,Lago Argentino,SANTA CRUZ,12,27,1,12,13
78,78007,780070501,Corpen Aike,SANTA CRUZ,320,349,516,570,1086
78,78007,780070101,Corpen Aike,SANTA CRUZ,19,30,11,24,35
78,78007,780070604,Corpen Aike,SANTA CRUZ,304,375,514,483,997
78,78007,780070302,Corpen Aike,SANTA CRUZ,14,50,1,19,20
78,78007,780070602,Corpen Aike,SANTA CRUZ,528,599,896,874,1770
78,78007,780070505,Corpen Aike,SANTA CRUZ,517,562,895,1066,1961
78,78007,780070504,Corpen Aike,SANTA CRUZ,171,204,207,265,472
78,78007,780070502,Corpen Aike,SANTA CRUZ,488,568,728,712,1440
78,78007,780070603,Corpen Aike,SANTA CRUZ,312,385,465,495,960
78,78007,780070601,Corpen Aike,SANTA CRUZ,249,297,353,351,704
78,78007,780070301,Corpen Aike,SANTA CRUZ,12,31,0,14,14
78,78007,780070503,Corpen Aike,SANTA CRUZ,455,594,702,744,1446
78,78007,780070401,Corpen Aike,SANTA CRUZ,61,102,14,115,129
78,78007,780070201,Corpen Aike,SANTA CRUZ,31,50,18,41,59
78,78035,780350602,Lago Buenos Aires,SANTA CRUZ,410,515,632,713,1345
78,78035,780350404,Lago Buenos Aires,SANTA CRUZ,379,432,609,665,1274
78,78035,780350603,Lago Buenos Aires,SANTA CRUZ,404,499,671,737,1408
78,78035,780350101,Lago Buenos Aires,SANTA CRUZ,15,31,2,16,18
78,78035,780350402,Lago Buenos Aires,SANTA CRUZ,250,341,318,395,713
78,78035,780350601,Lago Buenos Aires,SANTA CRUZ,208,234,303,338,641
78,78035,780350403,Lago Buenos Aires,SANTA CRUZ,425,528,670,706,1376
78,78035,780350604,Lago Buenos Aires,SANTA CRUZ,275,319,459,450,909
78,78035,780350301,Lago Buenos Aires,SANTA CRUZ,22,44,9,141,150
78,78035,780350605,Lago Buenos Aires,SANTA CRUZ,104,146,122,192,314
78,78035,780350501,Lago Buenos Aires,SANTA CRUZ,13,12,7,72,79
78,78035,780350401,Lago Buenos Aires,SANTA CRUZ,31,54,10,37,47
78,78035,780350102,Lago Buenos Aires,SANTA CRUZ,14,31,0,23,23
78,78035,780350201,Lago Buenos Aires,SANTA CRUZ,21,42,36,417,453
74,74056,740561902,La Capital,SAN LUIS,53,61,63,111,174
74,74056,740561802,La Capital,SAN LUIS,65,87,104,116,220
74,74056,740561401,La Capital,SAN LUIS,230,345,262,203,465
74,74056,740560716,La Capital,SAN LUIS,303,281,534,544,1078
74,74056,740560203,La Capital,SAN LUIS,104,134,153,177,330
74,74056,740561509,La Capital,SAN LUIS,246,253,507,469,976
74,74056,740561505,La Capital,SAN LUIS,259,243,466,485,951
74,74056,740561503,La Capital,SAN LUIS,307,314,691,680,1371
74,74056,740561501,La Capital,SAN LUIS,206,199,428,885,1313
74,74056,740561412,La Capital,SAN LUIS,234,255,358,340,698
74,74056,740560905,La Capital,SAN LUIS,216,227,428,407,835
74,74056,740560901,La Capital,SAN LUIS,260,250,472,424,896
74,74056,740560815,La Capital,SAN LUIS,236,246,373,359,732
74,74056,740560808,La Capital,SAN LUIS,271,274,538,462,1000
74,74056,740560804,La Capital,SAN LUIS,241,251,439,387,826
74,74056,740560708,La Capital,SAN LUIS,357,356,645,583,1228
74,74056,740560514,La Capital,SAN LUIS,277,284,508,508,1016
74,74056,740560509,La Capital,SAN LUIS,406,485,679,637,1316
74,74056,740561405,La Capital,SAN LUIS,360,373,561,467,1028
74,74056,740561402,La Capital,SAN LUIS,208,296,273,188,461
74,74056,740561310,La Capital,SAN LUIS,213,191,346,309,655
74,74056,740561309,La Capital,SAN LUIS,334,383,474,413,887
74,74056,740561307,La Capital,SAN LUIS,269,324,412,388,800
74,74056,740561304,La Capital,SAN LUIS,219,358,325,235,560
74,74056,740561218,La Capital,SAN LUIS,33,24,58,85,143
74,74056,740561217,La Capital,SAN LUIS,144,144,289,316,605
74,74056,740561215,La Capital,SAN LUIS,430,339,834,826,1660
74,74056,740561110,La Capital,SAN LUIS,206,261,274,210,484
74,74056,740561016,La Capital,SAN LUIS,278,318,410,389,799
74,74056,740561015,La Capital,SAN LUIS,291,319,470,441,911
74,74056,740561005,La Capital,SAN LUIS,370,335,664,621,1285
74,74056,740560909,La Capital,SAN LUIS,246,245,435,420,855
74,74056,740560907,La Capital,SAN LUIS,246,226,523,519,1042
74,74056,740560505,La Capital,SAN LUIS,206,236,293,290,583
74,74056,740560406,La Capital,SAN LUIS,296,457,519,548,1067
74,74056,740560403,La Capital,SAN LUIS,156,297,264,281,545
74,74056,740560706,La Capital,SAN LUIS,504,352,1062,999,2061
74,74056,740560702,La Capital,SAN LUIS,341,350,732,712,1444
74,74056,740560205,La Capital,SAN LUIS,155,116,242,254,496
74,74056,740560711,La Capital,SAN LUIS,141,141,260,263,523
74,74056,740560304,La Capital,SAN LUIS,192,189,406,437,843
74,74056,740561803,La Capital,SAN LUIS,13,25,13,31,44
74,74056,740561904,La Capital,SAN LUIS,3,3,4,6,10
74,74056,740561703,La Capital,SAN LUIS,11,29,6,13,19
74,74056,740561514,La Capital,SAN LUIS,246,244,609,562,1171
74,74056,740560315,La Capital,SAN LUIS,252,256,441,410,851
74,74056,740560104,La Capital,SAN LUIS,73,92,124,148,272
74,74056,740561515,La Capital,SAN LUIS,118,116,251,230,481
74,74056,740561511,La Capital,SAN LUIS,277,279,595,544,1139
74,74056,740561510,La Capital,SAN LUIS,225,224,533,483,1016
74,74056,740561417,La Capital,SAN LUIS,355,363,661,638,1299
74,74056,740561408,La Capital,SAN LUIS,272,261,500,463,963
74,74056,740560902,La Capital,SAN LUIS,267,276,556,561,1117
74,74056,740560725,La Capital,SAN LUIS,233,223,392,399,791
74,74056,740561302,La Capital,SAN LUIS,157,195,298,218,516
74,74056,740561212,La Capital,SAN LUIS,230,235,402,416,818
74,74056,740561114,La Capital,SAN LUIS,121,169,223,157,380
74,74056,740561109,La Capital,SAN LUIS,174,189,284,235,519
74,74056,740561014,La Capital,SAN LUIS,261,264,413,386,799
74,74056,740561001,La Capital,SAN LUIS,325,375,442,417,859
74,74056,740560501,La Capital,SAN LUIS,157,215,273,285,558
74,74056,740560407,La Capital,SAN LUIS,215,336,336,372,708
74,74056,740560404,La Capital,SAN LUIS,149,333,250,222,472
74,74056,740560317,La Capital,SAN LUIS,0,1,0,0,0
74,74056,740560615,La Capital,SAN LUIS,352,307,679,631,1310
74,74056,740560305,La Capital,SAN LUIS,211,248,388,338,726
74,74056,740560302,La Capital,SAN LUIS,207,246,289,278,567
74,74056,740560408,La Capital,SAN LUIS,55,66,90,105,195
74,74056,740560102,La Capital,SAN LUIS,17,20,29,33,62
74,74056,740561508,La Capital,SAN LUIS,321,310,654,697,1351
74,74056,740561415,La Capital,SAN LUIS,348,389,646,531,1177
74,74056,740560809,La Capital,SAN LUIS,242,244,447,384,831
74,74056,740560807,La Capital,SAN LUIS,247,258,462,460,922
74,74056,740560805,La Capital,SAN LUIS,240,256,450,397,847
74,74056,740560723,La Capital,SAN LUIS,168,182,280,261,541
74,74056,740561704,La Capital,SAN LUIS,18,26,36,40,76
74,74056,740560507,La Capital,SAN LUIS,222,283,409,448,857
74,74056,740561303,La Capital,SAN LUIS,249,364,325,255,580
74,74056,740561219,La Capital,SAN LUIS,210,183,392,377,769
74,74056,740561213,La Capital,SAN LUIS,332,303,625,599,1224
74,74056,740561211,La Capital,SAN LUIS,192,184,333,345,678
74,74056,740561209,La Capital,SAN LUIS,228,195,374,376,750
74,74056,740561208,La Capital,SAN LUIS,187,233,298,272,570
74,74056,740561121,La Capital,SAN LUIS,237,251,437,354,791
74,74056,740561118,La Capital,SAN LUIS,396,399,650,640,1290
74,74056,740561116,La Capital,SAN LUIS,168,253,201,151,352
74,74056,740561115,La Capital,SAN LUIS,158,225,201,159,360
74,74056,740561113,La Capital,SAN LUIS,236,295,298,247,545
74,74056,740561011,La Capital,SAN LUIS,390,402,658,674,1332
74,74056,740561003,La Capital,SAN LUIS,354,380,535,510,1045
74,74056,740561002,La Capital,SAN LUIS,205,227,332,294,626
74,74056,740560910,La Capital,SAN LUIS,307,323,603,540,1143
74,74056,740560603,La Capital,SAN LUIS,248,246,494,424,918
74,74056,740560512,La Capital,SAN LUIS,397,425,712,699,1411
74,74056,740560713,La Capital,SAN LUIS,431,412,847,880,1727
74,74056,740560705,La Capital,SAN LUIS,473,429,1052,1074,2126
74,74056,740560704,La Capital,SAN LUIS,473,450,946,1013,1959
74,74056,740560312,La Capital,SAN LUIS,310,341,566,511,1077
74,74056,740560307,La Capital,SAN LUIS,266,308,462,413,875
74,74056,740560303,La Capital,SAN LUIS,129,142,230,212,442
74,74056,740560610,La Capital,SAN LUIS,331,319,624,667,1291
74,74056,740561013,La Capital,SAN LUIS,288,310,467,443,910
74,74056,740561602,La Capital,SAN LUIS,60,67,58,110,168
74,74056,740561702,La Capital,SAN LUIS,4,13,3,5,8
74,74056,740561201,La Capital,SAN LUIS,489,474,1043,1069,2112
74,74056,740561513,La Capital,SAN LUIS,310,315,682,623,1305
74,74056,740561418,La Capital,SAN LUIS,316,285,649,739,1388
74,74056,740560904,La Capital,SAN LUIS,161,166,287,253,540
74,74056,740560814,La Capital,SAN LUIS,229,218,428,396,824
74,74056,740560726,La Capital,SAN LUIS,345,355,591,547,1138
74,74056,740560714,La Capital,SAN LUIS,253,259,533,489,1022
74,74056,740560513,La Capital,SAN LUIS,359,387,609,559,1168
74,74056,740561306,La Capital,SAN LUIS,136,165,205,182,387
74,74056,740561301,La Capital,SAN LUIS,183,204,296,188,484
74,74056,740561205,La Capital,SAN LUIS,235,235,480,492,972
74,74056,740561202,La Capital,SAN LUIS,296,255,646,722,1368
74,74056,740561122,La Capital,SAN LUIS,322,277,601,589,1190
74,74056,740561120,La Capital,SAN LUIS,216,221,404,432,836
74,74056,740561107,La Capital,SAN LUIS,379,510,460,353,813
74,74056,740560602,La Capital,SAN LUIS,62,65,109,101,210
74,74056,740560707,La Capital,SAN LUIS,141,129,291,278,569
74,74056,740560701,La Capital,SAN LUIS,273,267,579,531,1110
74,74056,740560614,La Capital,SAN LUIS,253,258,411,374,785
74,74056,740560611,La Capital,SAN LUIS,293,282,595,582,1177
74,74056,740560712,La Capital,SAN LUIS,324,324,596,599,1195
74,74056,740560311,La Capital,SAN LUIS,351,371,594,597,1191
74,74056,740560310,La Capital,SAN LUIS,332,361,584,545,1129
74,74056,740560309,La Capital,SAN LUIS,0,1,0,0,0
74,74056,740561012,La Capital,SAN LUIS,414,409,756,669,1425
74,74056,740560609,La Capital,SAN LUIS,303,306,491,483,974
74,74056,740561705,La Capital,SAN LUIS,24,41,31,51,82
74,74056,740560401,La Capital,SAN LUIS,61,104,104,138,242
74,74056,740560202,La Capital,SAN LUIS,85,98,136,161,297
74,74056,740561701,La Capital,SAN LUIS,34,38,51,61,112
74,74056,740560402,La Capital,SAN LUIS,84,211,129,130,259
74,74056,740561506,La Capital,SAN LUIS,312,309,603,552,1155
74,74056,740561504,La Capital,SAN LUIS,112,82,246,256,502
74,74056,740561416,La Capital,SAN LUIS,341,359,643,565,1208
74,74056,740561411,La Capital,SAN LUIS,175,198,288,236,524
74,74056,740560813,La Capital,SAN LUIS,239,242,458,445,903
74,74056,740560810,La Capital,SAN LUIS,301,320,560,501,1061
74,74056,740560802,La Capital,SAN LUIS,343,332,850,828,1678
74,74056,740560801,La Capital,SAN LUIS,270,284,638,639,1277
74,74056,740560721,La Capital,SAN LUIS,391,381,619,610,1229
74,74056,740560717,La Capital,SAN LUIS,331,325,690,682,1372
74,74056,740560715,La Capital,SAN LUIS,247,246,506,506,1012
74,74056,740560510,La Capital,SAN LUIS,262,307,460,417,877
74,74056,740560506,La Capital,SAN LUIS,284,285,549,520,1069
74,74056,740561406,La Capital,SAN LUIS,342,345,628,588,1216
74,74056,740561308,La Capital,SAN LUIS,249,275,486,419,905
74,74056,740561216,La Capital,SAN LUIS,392,356,832,803,1635
74,74056,740561214,La Capital,SAN LUIS,293,259,591,610,1201
74,74056,740561210,La Capital,SAN LUIS,206,192,351,342,693
74,74056,740561017,La Capital,SAN LUIS,317,377,447,391,838
74,74056,740560607,La Capital,SAN LUIS,245,253,387,363,750
74,74056,740560405,La Capital,SAN LUIS,146,371,214,208,422
74,74056,740560318,La Capital,SAN LUIS,8,13,0,16,16
74,74056,740560612,La Capital,SAN LUIS,296,301,555,519,1074
74,74056,740560608,La Capital,SAN LUIS,159,180,253,229,482
74,74056,740560313,La Capital,SAN LUIS,336,367,648,616,1264
74,74056,740561801,La Capital,SAN LUIS,4,6,4,6,10
74,74056,740561706,La Capital,SAN LUIS,5,11,3,10,13
74,74056,740561601,La Capital,SAN LUIS,94,119,158,193,351
74,74056,740561901,La Capital,SAN LUIS,28,39,63,62,125
74,74056,740561410,La Capital,SAN LUIS,183,201,276,190,466
74,74056,740561409,La Capital,SAN LUIS,290,310,470,420,890
74,74056,740560718,La Capital,SAN LUIS,205,206,339,308,647
74,74056,740561404,La Capital,SAN LUIS,344,384,505,393,898
74,74056,740561312,La Capital,SAN LUIS,241,263,424,381,805
74,74056,740561311,La Capital,SAN LUIS,352,374,558,518,1076
74,74056,740561119,La Capital,SAN LUIS,210,166,422,443,865
74,74056,740561105,La Capital,SAN LUIS,262,288,353,272,625
74,74056,740561104,La Capital,SAN LUIS,278,327,398,389,787
74,74056,740561103,La Capital,SAN LUIS,352,362,592,508,1100
74,74056,740561101,La Capital,SAN LUIS,254,217,502,506,1008
74,74056,740560916,La Capital,SAN LUIS,136,168,240,229,469
74,74056,740560908,La Capital,SAN LUIS,288,292,610,586,1196
74,74056,740561117,La Capital,SAN LUIS,225,308,319,248,567
74,74056,740560613,La Capital,SAN LUIS,289,271,520,462,982
74,74056,740560601,La Capital,SAN LUIS,8,224,5,8,13
74,74056,740560308,La Capital,SAN LUIS,283,315,477,416,893
74,74056,740561903,La Capital,SAN LUIS,5,5,5,11,16
74,74056,740561804,La Capital,SAN LUIS,13,16,11,21,32
74,74056,740561603,La Capital,SAN LUIS,47,66,57,70,127
74,74056,740560201,La Capital,SAN LUIS,62,72,67,88,155
74,74056,740560101,La Capital,SAN LUIS,34,39,47,54,101
74,74056,740561707,La Capital,SAN LUIS,246,265,477,480,957
74,74056,740561204,La Capital,SAN LUIS,393,308,874,808,1682
74,74056,740561108,La Capital,SAN LUIS,259,293,312,266,578
74,74056,740560314,La Capital,SAN LUIS,285,311,504,452,956
74,74056,740561507,La Capital,SAN LUIS,314,318,652,637,1289
74,74056,740561502,La Capital,SAN LUIS,227,194,517,471,988
74,74056,740561414,La Capital,SAN LUIS,313,306,642,617,1259
74,74056,740560906,La Capital,SAN LUIS,262,281,495,457,952
74,74056,740560812,La Capital,SAN LUIS,291,298,519,525,1044
74,74056,740560811,La Capital,SAN LUIS,177,186,281,282,563
74,74056,740560803,La Capital,SAN LUIS,228,235,423,361,784
74,74056,740560722,La Capital,SAN LUIS,240,224,414,401,815
74,74056,740560720,La Capital,SAN LUIS,308,167,508,485,993
74,74056,740560709,La Capital,SAN LUIS,298,318,505,429,934
74,74056,740560511,La Capital,SAN LUIS,127,187,152,161,313
74,74056,740560508,La Capital,SAN LUIS,310,377,548,523,1071
74,74056,740561403,La Capital,SAN LUIS,302,354,492,385,877
74,74056,740561207,La Capital,SAN LUIS,228,196,358,364,722
74,74056,740561112,La Capital,SAN LUIS,228,312,348,226,574
74,74056,740561106,La Capital,SAN LUIS,265,356,299,243,542
74,74056,740561010,La Capital,SAN LUIS,301,323,516,495,1011
74,74056,740561007,La Capital,SAN LUIS,320,320,631,557,1188
74,74056,740560915,La Capital,SAN LUIS,282,300,478,457,935
74,74056,740560914,La Capital,SAN LUIS,226,255,416,371,787
74,74056,740560913,La Capital,SAN LUIS,67,93,103,119,222
74,74056,740560912,La Capital,SAN LUIS,161,179,306,279,585
74,74056,740560911,La Capital,SAN LUIS,227,238,406,375,781
74,74056,740560503,La Capital,SAN LUIS,102,119,199,178,377
74,74056,740560605,La Capital,SAN LUIS,362,339,602,638,1240
74,74056,740560604,La Capital,SAN LUIS,224,213,449,423,872
74,74056,740560502,La Capital,SAN LUIS,347,411,570,523,1093
74,74056,740560703,La Capital,SAN LUIS,25,24,41,52,93
74,74056,740560616,La Capital,SAN LUIS,250,244,371,378,749
74,74056,740560515,La Capital,SAN LUIS,32,27,57,76,133
74,74056,740560204,La Capital,SAN LUIS,499,344,845,825,1670
74,74056,740560316,La Capital,SAN LUIS,339,368,631,582,1213
74,74056,740560306,La Capital,SAN LUIS,329,350,571,548,1119
74,74056,740560301,La Capital,SAN LUIS,9,38,5,15,20
74,74056,740560103,La Capital,SAN LUIS,56,58,69,73,142
74,74056,740561006,La Capital,SAN LUIS,321,336,604,557,1161
74,74056,740561512,La Capital,SAN LUIS,291,304,600,607,1207
74,74056,740561413,La Capital,SAN LUIS,285,326,436,386,822
74,74056,740561407,La Capital,SAN LUIS,205,209,366,346,712
74,74056,740560903,La Capital,SAN LUIS,273,280,532,491,1023
74,74056,740560806,La Capital,SAN LUIS,99,102,195,195,390
74,74056,740560724,La Capital,SAN LUIS,224,230,383,354,737
74,74056,740560719,La Capital,SAN LUIS,286,289,522,507,1029
74,74056,740561305,La Capital,SAN LUIS,238,311,323,263,586
74,74056,740561220,La Capital,SAN LUIS,280,224,451,520,971
74,74056,740561206,La Capital,SAN LUIS,241,218,513,476,989
74,74056,740561203,La Capital,SAN LUIS,426,413,876,863,1739
74,74056,740561111,La Capital,SAN LUIS,204,274,219,205,424
74,74056,740561102,La Capital,SAN LUIS,360,367,638,598,1236
74,74056,740561018,La Capital,SAN LUIS,341,376,496,368,864
74,74056,740561009,La Capital,SAN LUIS,133,147,263,248,511
74,74056,740561008,La Capital,SAN LUIS,217,223,391,346,737
74,74056,740561004,La Capital,SAN LUIS,275,274,451,453,904
74,74056,740560504,La Capital,SAN LUIS,212,251,316,309,625
74,74056,740560606,La Capital,SAN LUIS,413,433,724,785,1509
74,74056,740560617,La Capital,SAN LUIS,384,400,597,567,1164
74,74056,740560206,La Capital,SAN LUIS,334,226,644,604,1248
74,74056,740560710,La Capital,SAN LUIS,376,367,739,682,1421
74,74056,740560105,La Capital,SAN LUIS,175,213,286,303,589
74,74056,740561805,La Capital,SAN LUIS,5,9,6,15,21
74,74049,740490304,Junín,SAN LUIS,286,416,419,435,854
74,74049,740490103,Junín,SAN LUIS,115,171,204,227,431
74,74049,740490412,Junín,SAN LUIS,218,376,397,326,723
74,74049,740490411,Junín,SAN LUIS,315,673,494,459,953
74,74049,740490402,Junín,SAN LUIS,314,402,498,458,956
74,74049,740490213,Junín,SAN LUIS,84,99,89,132,221
74,74049,740490106,Junín,SAN LUIS,46,57,100,105,205
74,74049,740490306,Junín,SAN LUIS,214,322,367,365,732
74,74049,740490107,Junín,SAN LUIS,10,13,12,12,24
74,74049,740490416,Junín,SAN LUIS,268,367,464,416,880
74,74049,740490401,Junín,SAN LUIS,431,499,686,674,1360
74,74049,740490208,Junín,SAN LUIS,200,219,294,276,570
74,74049,740490417,Junín,SAN LUIS,200,260,360,365,725
74,74049,740490415,Junín,SAN LUIS,466,513,817,828,1645
74,74049,740490410,Junín,SAN LUIS,270,406,435,358,793
74,74049,740490102,Junín,SAN LUIS,48,54,79,90,169
74,74049,740490104,Junín,SAN LUIS,73,101,114,124,238
74,74049,740490414,Junín,SAN LUIS,262,295,396,371,767
74,74049,740490209,Junín,SAN LUIS,255,291,386,352,738
74,74049,740490204,Junín,SAN LUIS,259,327,413,444,857
74,74049,740490419,Junín,SAN LUIS,186,358,297,250,547
74,74049,740490409,Junín,SAN LUIS,200,294,342,315,657
74,74049,740490405,Junín,SAN LUIS,459,479,789,757,1546
74,74049,740490404,Junín,SAN LUIS,172,186,281,277,558
74,74049,740490201,Junín,SAN LUIS,66,81,107,126,233
74,74049,740490101,Junín,SAN LUIS,29,40,39,54,93
74,74049,740490303,Junín,SAN LUIS,423,659,661,654,1315
74,74049,740490207,Junín,SAN LUIS,215,272,363,360,723
74,74049,740490205,Junín,SAN LUIS,195,230,316,285,601
74,74049,740490413,Junín,SAN LUIS,367,435,684,580,1264
74,74049,740490408,Junín,SAN LUIS,182,235,259,225,484
74,74049,740490406,Junín,SAN LUIS,437,510,694,619,1313
74,74049,740490301,Junín,SAN LUIS,102,144,162,196,358
74,74049,740490305,Junín,SAN LUIS,230,360,339,326,665
74,74049,740490211,Junín,SAN LUIS,132,154,251,240,491
74,74049,740490210,Junín,SAN LUIS,187,220,308,319,627
74,74049,740490418,Junín,SAN LUIS,186,274,339,291,630
74,74049,740490407,Junín,SAN LUIS,243,306,354,320,674
74,74049,740490203,Junín,SAN LUIS,51,76,71,80,151
74,74049,740490202,Junín,SAN LUIS,59,33,96,137,233
74,74049,740490105,Junín,SAN LUIS,41,45,68,91,159
74,74049,740490206,Junín,SAN LUIS,253,292,462,442,904
74,74049,740490403,Junín,SAN LUIS,197,289,303,306,609
74,74049,740490302,Junín,SAN LUIS,43,59,52,70,122
74,74049,740490212,Junín,SAN LUIS,44,68,61,74,135
74,74063,740630503,Libertador General San Martín,SAN LUIS,141,181,211,216,427
74,74063,740630301,Libertador General San Martín,SAN LUIS,159,160,224,266,490
74,74063,740630502,Libertador General San Martín,SAN LUIS,16,38,19,36,55
74,74063,740630304,Libertador General San Martín,SAN LUIS,60,60,82,99,181
74,74063,740630305,Libertador General San Martín,SAN LUIS,67,88,111,121,232
74,74063,740630401,Libertador General San Martín,SAN LUIS,119,166,119,188,307
74,74063,740630202,Libertador General San Martín,SAN LUIS,140,161,232,255,487
74,74063,740630101,Libertador General San Martín,SAN LUIS,83,88,110,128,238
74,74063,740630504,Libertador General San Martín,SAN LUIS,119,160,144,184,328
74,74063,740630402,Libertador General San Martín,SAN LUIS,149,157,202,222,424
74,74063,740630302,Libertador General San Martín,SAN LUIS,60,72,93,88,181
74,74063,740630501,Libertador General San Martín,SAN LUIS,39,62,53,66,119
74,74063,740630102,Libertador General San Martín,SAN LUIS,224,306,340,357,697
74,74063,740630303,Libertador General San Martín,SAN LUIS,80,98,110,144,254
74,74063,740630201,Libertador General San Martín,SAN LUIS,74,85,134,153,287
74,74035,740351210,General Pedernera,SAN LUIS,337,375,532,507,1039
74,74035,740351703,General Pedernera,SAN LUIS,20,28,34,34,68
74,74035,740351701,General Pedernera,SAN LUIS,60,93,105,119,224
74,74035,740351601,General Pedernera,SAN LUIS,210,225,382,377,759
74,74035,740351505,General Pedernera,SAN LUIS,3,5,7,33,40
74,74035,740350819,General Pedernera,SAN LUIS,317,338,610,581,1191
74,74035,740351609,General Pedernera,SAN LUIS,254,267,435,407,842
74,74035,740351310,General Pedernera,SAN LUIS,292,283,506,509,1015
74,74035,740351307,General Pedernera,SAN LUIS,41,40,64,67,131
74,74035,740351303,General Pedernera,SAN LUIS,351,383,593,569,1162
74,74035,740351216,General Pedernera,SAN LUIS,235,234,494,512,1006
74,74035,740351109,General Pedernera,SAN LUIS,165,210,209,204,413
74,74035,740351106,General Pedernera,SAN LUIS,214,311,324,275,599
74,74035,740351101,General Pedernera,SAN LUIS,61,86,106,113,219
74,74035,740350908,General Pedernera,SAN LUIS,282,337,442,364,806
74,74035,740350814,General Pedernera,SAN LUIS,311,360,495,434,929
74,74035,740350811,General Pedernera,SAN LUIS,381,376,781,778,1559
74,74035,740350712,General Pedernera,SAN LUIS,263,254,427,379,806
74,74035,740350707,General Pedernera,SAN LUIS,259,263,428,396,824
74,74035,740350603,General Pedernera,SAN LUIS,34,48,33,52,85
74,74035,740350303,General Pedernera,SAN LUIS,20,36,29,34,63
74,74035,740350406,General Pedernera,SAN LUIS,17,24,18,24,42
74,74035,740350204,General Pedernera,SAN LUIS,21,34,20,33,53
74,74035,740350901,General Pedernera,SAN LUIS,261,265,417,336,753
74,74035,740351504,General Pedernera,SAN LUIS,83,139,135,146,281
74,74035,740351003,General Pedernera,SAN LUIS,231,261,380,321,701
74,74035,740350708,General Pedernera,SAN LUIS,299,313,539,554,1093
74,74035,740351606,General Pedernera,SAN LUIS,248,151,530,536,1066
74,74035,740351405,General Pedernera,SAN LUIS,217,237,427,416,843
74,74035,740351402,General Pedernera,SAN LUIS,16,27,21,32,53
74,74035,740351305,General Pedernera,SAN LUIS,358,292,612,582,1194
74,74035,740351218,General Pedernera,SAN LUIS,111,119,219,227,446
74,74035,740351111,General Pedernera,SAN LUIS,368,365,679,652,1331
74,74035,740351104,General Pedernera,SAN LUIS,237,256,377,378,755
74,74035,740351019,General Pedernera,SAN LUIS,357,372,664,633,1297
74,74035,740351018,General Pedernera,SAN LUIS,228,249,419,441,860
74,74035,740351017,General Pedernera,SAN LUIS,221,193,388,388,776
74,74035,740350913,General Pedernera,SAN LUIS,274,314,398,345,743
74,74035,740350905,General Pedernera,SAN LUIS,45,47,92,121,213
74,74035,740350806,General Pedernera,SAN LUIS,195,213,382,394,776
74,74035,740350804,General Pedernera,SAN LUIS,347,380,807,789,1596
74,74035,740350801,General Pedernera,SAN LUIS,296,271,554,558,1112
74,74035,740350815,General Pedernera,SAN LUIS,274,314,418,372,790
74,74035,740350402,General Pedernera,SAN LUIS,27,49,22,44,66
74,74035,740350302,General Pedernera,SAN LUIS,36,57,47,59,106
74,74035,740350301,General Pedernera,SAN LUIS,24,48,34,40,74
74,74035,740350104,General Pedernera,SAN LUIS,18,33,19,31,50
74,74035,740350101,General Pedernera,SAN LUIS,11,9,9,12,21
74,74035,740350716,General Pedernera,SAN LUIS,262,289,379,339,718
74,74035,740351604,General Pedernera,SAN LUIS,230,268,350,347,697
74,74035,740350103,General Pedernera,SAN LUIS,85,103,132,140,272
74,74035,740350817,General Pedernera,SAN LUIS,357,369,565,566,1131
74,74035,740351607,General Pedernera,SAN LUIS,238,279,398,381,779
74,74035,740351409,General Pedernera,SAN LUIS,285,280,579,527,1106
74,74035,740351408,General Pedernera,SAN LUIS,365,356,716,670,1386
74,74035,740351406,General Pedernera,SAN LUIS,372,358,674,615,1289
74,74035,740351306,General Pedernera,SAN LUIS,242,268,404,403,807
74,74035,740351302,General Pedernera,SAN LUIS,5,1,0,5,5
74,74035,740351214,General Pedernera,SAN LUIS,339,294,665,738,1403
74,74035,740351203,General Pedernera,SAN LUIS,209,239,365,363,728
74,74035,740351112,General Pedernera,SAN LUIS,370,355,781,823,1604
74,74035,740351107,General Pedernera,SAN LUIS,185,291,255,199,454
74,74035,740351016,General Pedernera,SAN LUIS,347,397,564,513,1077
74,74035,740351014,General Pedernera,SAN LUIS,163,183,218,191,409
74,74035,740351006,General Pedernera,SAN LUIS,402,420,681,657,1338
74,74035,740350916,General Pedernera,SAN LUIS,265,282,445,400,845
74,74035,740350813,General Pedernera,SAN LUIS,206,217,327,302,629
74,74035,740350810,General Pedernera,SAN LUIS,273,292,532,500,1032
74,74035,740350809,General Pedernera,SAN LUIS,258,284,482,414,896
74,74035,740350803,General Pedernera,SAN LUIS,2,2,2,3,5
74,74035,740350706,General Pedernera,SAN LUIS,234,235,419,407,826
74,74035,740350702,General Pedernera,SAN LUIS,264,212,495,490,985
74,74035,740350818,General Pedernera,SAN LUIS,306,313,536,543,1079
74,74035,740351611,General Pedernera,SAN LUIS,248,254,496,453,949
74,74035,740351804,General Pedernera,SAN LUIS,17,26,10,22,32
74,74035,740351801,General Pedernera,SAN LUIS,52,66,34,94,128
74,74035,740350605,General Pedernera,SAN LUIS,13,23,7,18,25
74,74035,740351008,General Pedernera,SAN LUIS,284,306,526,480,1006
74,74035,740351806,General Pedernera,SAN LUIS,20,25,23,34,57
74,74035,740350407,General Pedernera,SAN LUIS,167,168,238,353,591
74,74035,740351403,General Pedernera,SAN LUIS,304,313,565,528,1093
74,74035,740351401,General Pedernera,SAN LUIS,389,388,741,665,1406
74,74035,740351308,General Pedernera,SAN LUIS,347,354,579,526,1105
74,74035,740351213,General Pedernera,SAN LUIS,160,162,311,305,616
74,74035,740351204,General Pedernera,SAN LUIS,216,235,352,381,733
74,74035,740351201,General Pedernera,SAN LUIS,283,323,383,415,798
74,74035,740351114,General Pedernera,SAN LUIS,316,349,610,603,1213
74,74035,740351010,General Pedernera,SAN LUIS,191,201,314,319,633
74,74035,740351007,General Pedernera,SAN LUIS,322,326,584,535,1119
74,74035,740351005,General Pedernera,SAN LUIS,432,476,746,748,1494
74,74035,740351001,General Pedernera,SAN LUIS,455,482,850,784,1634
74,74035,740350714,General Pedernera,SAN LUIS,272,319,391,376,767
74,74035,740350704,General Pedernera,SAN LUIS,206,204,385,383,768
74,74035,740350701,General Pedernera,SAN LUIS,26,31,49,57,106
74,74035,740350816,General Pedernera,SAN LUIS,242,254,393,367,760
74,74035,740351209,General Pedernera,SAN LUIS,335,305,576,615,1191
74,74035,740351803,General Pedernera,SAN LUIS,34,41,30,66,96
74,74035,740351705,General Pedernera,SAN LUIS,55,84,55,93,148
74,74035,740350405,General Pedernera,SAN LUIS,12,9,12,25,37
74,74035,740350403,General Pedernera,SAN LUIS,42,81,37,65,102
74,74035,740350401,General Pedernera,SAN LUIS,23,46,13,48,61
74,74035,740351211,General Pedernera,SAN LUIS,147,224,198,191,389
74,74035,740351002,General Pedernera,SAN LUIS,203,241,342,316,658
74,74035,740351603,General Pedernera,SAN LUIS,195,237,303,262,565
74,74035,740351506,General Pedernera,SAN LUIS,7,22,6,10,16
74,74035,740350404,General Pedernera,SAN LUIS,50,49,99,102,201
74,74035,740351410,General Pedernera,SAN LUIS,339,357,608,552,1160
74,74035,740351404,General Pedernera,SAN LUIS,294,317,514,439,953
74,74035,740351311,General Pedernera,SAN LUIS,296,314,517,507,1024
74,74035,740351309,General Pedernera,SAN LUIS,348,292,609,595,1204
74,74035,740351217,General Pedernera,SAN LUIS,169,168,318,359,677
74,74035,740351205,General Pedernera,SAN LUIS,320,335,449,400,849
74,74035,740351202,General Pedernera,SAN LUIS,263,288,476,455,931
74,74035,740350915,General Pedernera,SAN LUIS,249,266,474,458,932
74,74035,740350914,General Pedernera,SAN LUIS,299,327,481,440,921
74,74035,740350906,General Pedernera,SAN LUIS,243,224,458,461,919
74,74035,740350904,General Pedernera,SAN LUIS,289,290,541,534,1075
74,74035,740350903,General Pedernera,SAN LUIS,276,284,472,430,902
74,74035,740350808,General Pedernera,SAN LUIS,261,301,419,385,804
74,74035,740350713,General Pedernera,SAN LUIS,372,346,573,507,1080
74,74035,740351612,General Pedernera,SAN LUIS,264,272,479,476,955
74,74035,740350502,General Pedernera,SAN LUIS,22,34,11,51,62
74,74035,740351704,General Pedernera,SAN LUIS,55,69,84,115,199
74,74035,740351304,General Pedernera,SAN LUIS,355,320,624,569,1193
74,74035,740350304,General Pedernera,SAN LUIS,66,96,92,100,192
74,74035,740351605,General Pedernera,SAN LUIS,192,194,359,335,694
74,74035,740351407,General Pedernera,SAN LUIS,315,322,612,599,1211
74,74035,740351301,General Pedernera,SAN LUIS,281,292,467,427,894
74,74035,740351215,General Pedernera,SAN LUIS,252,258,540,541,1081
74,74035,740351206,General Pedernera,SAN LUIS,234,239,495,417,912
74,74035,740351102,General Pedernera,SAN LUIS,217,230,494,473,967
74,74035,740351020,General Pedernera,SAN LUIS,45,76,78,75,153
74,74035,740351012,General Pedernera,SAN LUIS,201,151,305,254,559
74,74035,740351009,General Pedernera,SAN LUIS,257,269,454,441,895
74,74035,740350907,General Pedernera,SAN LUIS,360,377,553,533,1086
74,74035,740350902,General Pedernera,SAN LUIS,274,320,455,378,833
74,74035,740350821,General Pedernera,SAN LUIS,25,29,56,47,103
74,74035,740350805,General Pedernera,SAN LUIS,339,332,756,797,1553
74,74035,740350715,General Pedernera,SAN LUIS,205,234,331,277,608
74,74035,740351805,General Pedernera,SAN LUIS,29,49,38,61,99
74,74035,740351502,General Pedernera,SAN LUIS,135,182,208,226,434
74,74035,740351212,General Pedernera,SAN LUIS,181,262,240,208,448
74,74035,740351602,General Pedernera,SAN LUIS,210,220,333,322,655
74,74035,740350601,General Pedernera,SAN LUIS,73,101,113,136,249
74,74035,740350820,General Pedernera,SAN LUIS,193,195,325,319,644
74,74035,740351208,General Pedernera,SAN LUIS,278,288,564,547,1111
74,74035,740351113,General Pedernera,SAN LUIS,218,200,429,427,856
74,74035,740351105,General Pedernera,SAN LUIS,169,197,267,243,510
74,74035,740351011,General Pedernera,SAN LUIS,289,305,432,409,841
74,74035,740350917,General Pedernera,SAN LUIS,275,274,496,540,1036
74,74035,740350910,General Pedernera,SAN LUIS,330,394,487,432,919
74,74035,740350909,General Pedernera,SAN LUIS,262,322,331,296,627
74,74035,740350812,General Pedernera,SAN LUIS,212,223,367,381,748
74,74035,740350711,General Pedernera,SAN LUIS,246,245,469,483,952
74,74035,740350705,General Pedernera,SAN LUIS,218,191,349,343,692
74,74035,740350703,General Pedernera,SAN LUIS,297,297,525,535,1060
74,74035,740351503,General Pedernera,SAN LUIS,55,73,79,104,183
74,74035,740350602,General Pedernera,SAN LUIS,78,110,118,143,261
74,74035,740350501,General Pedernera,SAN LUIS,35,56,23,57,80
74,74035,740350305,General Pedernera,SAN LUIS,21,39,21,31,52
74,74035,740350205,General Pedernera,SAN LUIS,13,20,22,25,47
74,74035,740350201,General Pedernera,SAN LUIS,10,15,16,16,32
74,74035,740350102,General Pedernera,SAN LUIS,13,19,15,24,39
74,74035,740350202,General Pedernera,SAN LUIS,6,16,9,15,24
74,74035,740351610,General Pedernera,SAN LUIS,358,370,733,683,1416
74,74035,740350203,General Pedernera,SAN LUIS,26,72,46,45,91
74,74035,740351507,General Pedernera,SAN LUIS,22,22,27,47,74
74,74035,740351608,General Pedernera,SAN LUIS,235,240,381,377,758
74,74035,740351207,General Pedernera,SAN LUIS,246,242,444,473,917
74,74035,740351110,General Pedernera,SAN LUIS,306,335,510,436,946
74,74035,740351108,General Pedernera,SAN LUIS,176,216,222,198,420
74,74035,740351103,General Pedernera,SAN LUIS,263,263,438,445,883
74,74035,740351015,General Pedernera,SAN LUIS,200,215,294,236,530
74,74035,740351013,General Pedernera,SAN LUIS,232,179,373,320,693
74,74035,740350912,General Pedernera,SAN LUIS,247,325,328,296,624
74,74035,740350911,General Pedernera,SAN LUIS,318,365,453,421,874
74,74035,740350807,General Pedernera,SAN LUIS,155,147,291,306,597
74,74035,740350802,General Pedernera,SAN LUIS,157,166,330,344,674
74,74035,740350710,General Pedernera,SAN LUIS,343,358,639,622,1261
74,74035,740351004,General Pedernera,SAN LUIS,276,240,448,404,852
74,74035,740350709,General Pedernera,SAN LUIS,224,236,445,416,861
74,74035,740351802,General Pedernera,SAN LUIS,37,42,44,80,124
74,74035,740351702,General Pedernera,SAN LUIS,65,105,77,111,188
74,74035,740351501,General Pedernera,SAN LUIS,11,17,15,16,31
74,74035,740350604,General Pedernera,SAN LUIS,13,20,15,22,37
74,74007,740070507,Ayacucho,SAN LUIS,374,467,638,640,1278
74,74007,740070203,Ayacucho,SAN LUIS,55,66,73,76,149
74,74007,740070202,Ayacucho,SAN LUIS,56,71,65,92,157
74,74007,740070505,Ayacucho,SAN LUIS,77,119,111,129,240
74,74007,740070410,Ayacucho,SAN LUIS,214,254,407,431,838
74,74007,740070409,Ayacucho,SAN LUIS,174,215,317,288,605
74,74007,740070411,Ayacucho,SAN LUIS,66,98,70,110,180
74,74007,740070307,Ayacucho,SAN LUIS,15,21,16,32,48
74,74007,740070306,Ayacucho,SAN LUIS,43,61,63,78,141
74,74007,740070508,Ayacucho,SAN LUIS,300,372,469,446,915
74,74007,740070413,Ayacucho,SAN LUIS,302,364,469,447,916
74,74007,740070402,Ayacucho,SAN LUIS,302,314,561,586,1147
74,74007,740070502,Ayacucho,SAN LUIS,23,32,42,58,100
74,74007,740070510,Ayacucho,SAN LUIS,210,276,334,377,711
74,74007,740070504,Ayacucho,SAN LUIS,117,156,181,198,379
74,74007,740070407,Ayacucho,SAN LUIS,220,258,393,341,734
74,74007,740070305,Ayacucho,SAN LUIS,339,351,630,631,1261
74,74007,740070401,Ayacucho,SAN LUIS,127,150,204,254,458
74,74007,740070301,Ayacucho,SAN LUIS,11,19,25,22,47
74,74007,740070102,Ayacucho,SAN LUIS,71,87,99,123,222
74,74007,740070509,Ayacucho,SAN LUIS,265,333,438,390,828
74,74007,740070304,Ayacucho,SAN LUIS,372,416,710,758,1468
74,74007,740070503,Ayacucho,SAN LUIS,12,20,16,23,39
74,74007,740070501,Ayacucho,SAN LUIS,23,27,45,50,95
74,74007,740070412,Ayacucho,SAN LUIS,8,12,17,13,30
74,74007,740070303,Ayacucho,SAN LUIS,46,55,61,92,153
74,74007,740070414,Ayacucho,SAN LUIS,331,434,553,547,1100
74,74007,740070405,Ayacucho,SAN LUIS,272,317,470,435,905
74,74007,740070506,Ayacucho,SAN LUIS,76,110,111,153,264
74,74007,740070101,Ayacucho,SAN LUIS,47,67,62,85,147
74,74007,740070408,Ayacucho,SAN LUIS,266,314,481,417,898
74,74007,740070406,Ayacucho,SAN LUIS,224,286,375,397,772
74,74007,740070404,Ayacucho,SAN LUIS,248,305,492,456,948
74,74007,740070302,Ayacucho,SAN LUIS,24,34,35,49,84
74,74007,740070201,Ayacucho,SAN LUIS,67,81,95,123,218
74,74007,740070403,Ayacucho,SAN LUIS,157,168,312,300,612
74,74042,740420403,Gobernador Dupuy,SAN LUIS,311,357,482,476,958
74,74042,740420405,Gobernador Dupuy,SAN LUIS,74,86,144,129,273
74,74042,740420306,Gobernador Dupuy,SAN LUIS,381,461,677,676,1353
74,74042,740420102,Gobernador Dupuy,SAN LUIS,46,40,99,106,205
74,74042,740420406,Gobernador Dupuy,SAN LUIS,18,29,20,31,51
74,74042,740420401,Gobernador Dupuy,SAN LUIS,20,28,29,34,63
74,74042,740420101,Gobernador Dupuy,SAN LUIS,18,31,24,35,59
74,74042,740420103,Gobernador Dupuy,SAN LUIS,35,69,42,60,102
74,74042,740420301,Gobernador Dupuy,SAN LUIS,6,9,4,9,13
74,74042,740420602,Gobernador Dupuy,SAN LUIS,31,55,30,51,81
74,74042,740420404,Gobernador Dupuy,SAN LUIS,388,465,611,620,1231
74,74042,740420204,Gobernador Dupuy,SAN LUIS,122,143,224,256,480
74,74042,740420307,Gobernador Dupuy,SAN LUIS,53,72,36,82,118
74,74042,740420303,Gobernador Dupuy,SAN LUIS,23,28,16,36,52
74,74042,740420308,Gobernador Dupuy,SAN LUIS,190,214,321,310,631
74,74042,740420207,Gobernador Dupuy,SAN LUIS,350,395,648,686,1334
74,74042,740420205,Gobernador Dupuy,SAN LUIS,92,143,74,163,237
74,74042,740420501,Gobernador Dupuy,SAN LUIS,28,47,26,39,65
74,74042,740420208,Gobernador Dupuy,SAN LUIS,353,421,656,643,1299
74,74042,740420201,Gobernador Dupuy,SAN LUIS,27,38,25,56,81
74,74042,740420305,Gobernador Dupuy,SAN LUIS,31,49,29,53,82
74,74042,740420302,Gobernador Dupuy,SAN LUIS,67,72,119,111,230
74,74042,740420601,Gobernador Dupuy,SAN LUIS,23,36,8,26,34
74,74042,740420502,Gobernador Dupuy,SAN LUIS,7,10,5,12,17
74,74042,740420402,Gobernador Dupuy,SAN LUIS,62,102,81,107,188
74,74042,740420603,Gobernador Dupuy,SAN LUIS,308,341,520,520,1040
74,74042,740420206,Gobernador Dupuy,SAN LUIS,84,97,147,153,300
74,74042,740420202,Gobernador Dupuy,SAN LUIS,106,116,172,177,349
74,74042,740420304,Gobernador Dupuy,SAN LUIS,235,265,405,408,813
74,74042,740420203,Gobernador Dupuy,SAN LUIS,19,30,8,32,40
74,74028,740280408,Chacabuco,SAN LUIS,268,293,453,436,889
74,74028,740280405,Chacabuco,SAN LUIS,376,414,662,579,1241
74,74028,740280402,Chacabuco,SAN LUIS,166,177,300,326,626
74,74028,740280301,Chacabuco,SAN LUIS,129,155,215,218,433
74,74028,740280205,Chacabuco,SAN LUIS,137,199,207,200,407
74,74028,740280201,Chacabuco,SAN LUIS,73,102,80,121,201
74,74028,740280203,Chacabuco,SAN LUIS,258,473,426,396,822
74,74028,740280404,Chacabuco,SAN LUIS,326,357,500,413,913
74,74028,740280309,Chacabuco,SAN LUIS,236,245,401,440,841
74,74028,740280308,Chacabuco,SAN LUIS,288,309,473,469,942
74,74028,740280106,Chacabuco,SAN LUIS,250,281,400,341,741
74,74028,740280302,Chacabuco,SAN LUIS,73,84,107,134,241
74,74028,740280110,Chacabuco,SAN LUIS,39,60,36,62,98
74,74028,740280109,Chacabuco,SAN LUIS,74,109,117,142,259
74,74028,740280401,Chacabuco,SAN LUIS,18,31,28,31,59
74,74028,740280406,Chacabuco,SAN LUIS,176,193,352,356,708
74,74028,740280310,Chacabuco,SAN LUIS,274,320,453,436,889
74,74028,740280105,Chacabuco,SAN LUIS,176,236,292,275,567
74,74028,740280303,Chacabuco,SAN LUIS,12,22,9,17,26
74,74028,740280411,Chacabuco,SAN LUIS,16,24,21,27,48
74,74028,740280306,Chacabuco,SAN LUIS,235,288,358,393,751
74,74028,740280204,Chacabuco,SAN LUIS,92,147,138,156,294
74,74028,740280407,Chacabuco,SAN LUIS,288,290,470,456,926
74,74028,740280107,Chacabuco,SAN LUIS,332,378,570,542,1112
74,74028,740280202,Chacabuco,SAN LUIS,177,327,272,316,588
74,74028,740280101,Chacabuco,SAN LUIS,52,73,64,84,148
74,74028,740280311,Chacabuco,SAN LUIS,250,280,426,445,871
74,74028,740280307,Chacabuco,SAN LUIS,23,42,25,39,64
74,74028,740280305,Chacabuco,SAN LUIS,40,56,38,64,102
74,74028,740280410,Chacabuco,SAN LUIS,51,91,55,86,141
74,74028,740280403,Chacabuco,SAN LUIS,321,362,499,454,953
74,74028,740280108,Chacabuco,SAN LUIS,63,73,95,97,192
74,74028,740280206,Chacabuco,SAN LUIS,188,272,281,269,550
74,74028,740280409,Chacabuco,SAN LUIS,66,97,86,92,178
74,74028,740280104,Chacabuco,SAN LUIS,175,182,309,275,584
74,74028,740280103,Chacabuco,SAN LUIS,294,321,467,461,928
74,74028,740280102,Chacabuco,SAN LUIS,330,360,584,603,1187
74,74028,740280304,Chacabuco,SAN LUIS,75,110,94,130,224
74,74021,740210302,Coronel Pringles,SAN LUIS,37,50,46,62,108
74,74021,740210304,Coronel Pringles,SAN LUIS,281,342,459,422,881
74,74021,740210306,Coronel Pringles,SAN LUIS,269,290,494,458,952
74,74021,740210407,Coronel Pringles,SAN LUIS,29,35,21,50,71
74,74021,740210310,Coronel Pringles,SAN LUIS,43,65,39,66,105
74,74021,740210303,Coronel Pringles,SAN LUIS,287,323,435,442,877
74,74021,740210308,Coronel Pringles,SAN LUIS,392,411,652,668,1320
74,74021,740210113,Coronel Pringles,SAN LUIS,15,30,24,29,53
74,74021,740210102,Coronel Pringles,SAN LUIS,79,125,116,135,251
74,74021,740210307,Coronel Pringles,SAN LUIS,376,381,628,606,1234
74,74021,740210202,Coronel Pringles,SAN LUIS,42,41,34,62,96
74,74021,740210112,Coronel Pringles,SAN LUIS,92,166,133,169,302
74,74021,740210406,Coronel Pringles,SAN LUIS,42,58,38,62,100
74,74021,740210404,Coronel Pringles,SAN LUIS,47,59,65,82,147
74,74021,740210403,Coronel Pringles,SAN LUIS,26,41,33,53,86
74,74021,740210309,Coronel Pringles,SAN LUIS,189,210,350,309,659
74,74021,740210106,Coronel Pringles,SAN LUIS,46,194,76,79,155
74,74021,740210311,Coronel Pringles,SAN LUIS,29,41,32,60,92
74,74021,740210105,Coronel Pringles,SAN LUIS,73,184,88,124,212
74,74021,740210405,Coronel Pringles,SAN LUIS,308,330,569,558,1127
74,74021,740210401,Coronel Pringles,SAN LUIS,87,129,140,135,275
74,74021,740210109,Coronel Pringles,SAN LUIS,142,385,210,231,441
74,74021,740210108,Coronel Pringles,SAN LUIS,75,269,100,114,214
74,74021,740210305,Coronel Pringles,SAN LUIS,441,474,761,690,1451
74,74021,740210204,Coronel Pringles,SAN LUIS,64,103,96,100,196
74,74021,740210103,Coronel Pringles,SAN LUIS,48,88,54,65,119
74,74021,740210203,Coronel Pringles,SAN LUIS,113,123,182,231,413
74,74021,740210110,Coronel Pringles,SAN LUIS,90,138,153,146,299
74,74021,740210107,Coronel Pringles,SAN LUIS,79,296,121,125,246
74,74021,740210111,Coronel Pringles,SAN LUIS,84,110,139,158,297
74,74021,740210402,Coronel Pringles,SAN LUIS,12,14,13,22,35
74,74021,740210301,Coronel Pringles,SAN LUIS,16,37,16,22,38
74,74021,740210201,Coronel Pringles,SAN LUIS,56,60,79,109,188
74,74021,740210104,Coronel Pringles,SAN LUIS,26,31,34,41,75
74,74021,740210101,Coronel Pringles,SAN LUIS,20,19,19,23,42
74,74014,740140505,Belgrano,SAN LUIS,45,66,54,71,125
74,74014,740140402,Belgrano,SAN LUIS,61,102,66,102,168
74,74014,740140301,Belgrano,SAN LUIS,37,47,39,52,91
74,74014,740140201,Belgrano,SAN LUIS,15,13,14,21,35
74,74014,740140504,Belgrano,SAN LUIS,14,15,7,22,29
74,74014,740140401,Belgrano,SAN LUIS,32,50,29,43,72
74,74014,740140501,Belgrano,SAN LUIS,37,47,50,69,119
74,74014,740140203,Belgrano,SAN LUIS,26,43,23,37,60
74,74014,740140102,Belgrano,SAN LUIS,47,55,74,79,153
74,74014,740140303,Belgrano,SAN LUIS,47,52,51,63,114
74,74014,740140404,Belgrano,SAN LUIS,157,241,211,294,505
74,74014,740140302,Belgrano,SAN LUIS,37,69,40,53,93
74,74014,740140503,Belgrano,SAN LUIS,165,183,283,315,598
74,74014,740140403,Belgrano,SAN LUIS,208,393,355,384,739
74,74014,740140406,Belgrano,SAN LUIS,28,48,19,48,67
74,74014,740140204,Belgrano,SAN LUIS,14,25,16,26,42
74,74014,740140405,Belgrano,SAN LUIS,182,472,246,277,523
74,74014,740140304,Belgrano,SAN LUIS,52,60,78,84,162
74,74014,740140103,Belgrano,SAN LUIS,26,28,30,40,70
74,74014,740140502,Belgrano,SAN LUIS,36,40,66,78,144
74,74014,740140202,Belgrano,SAN LUIS,20,33,24,33,57
74,74014,740140101,Belgrano,SAN LUIS,8,9,3,16,19
70,70035,700350301,Caucete,SAN JUAN,252,279,583,571,1154
70,70035,700350707,Caucete,SAN JUAN,263,271,619,586,1205
70,70035,700350706,Caucete,SAN JUAN,207,220,440,407,847
70,70035,700350704,Caucete,SAN JUAN,234,252,459,430,889
70,70035,700350501,Caucete,SAN JUAN,115,146,224,260,484
70,70035,700350205,Caucete,SAN JUAN,175,200,308,281,589
70,70035,700350105,Caucete,SAN JUAN,344,315,740,693,1433
70,70035,700350104,Caucete,SAN JUAN,271,277,545,560,1105
70,70035,700350701,Caucete,SAN JUAN,213,196,454,452,906
70,70035,700350601,Caucete,SAN JUAN,24,40,48,51,99
70,70035,700350711,Caucete,SAN JUAN,251,261,584,581,1165
70,70035,700350201,Caucete,SAN JUAN,232,242,467,473,940
70,70035,700350114,Caucete,SAN JUAN,348,373,600,513,1113
70,70035,700350110,Caucete,SAN JUAN,259,269,458,427,885
70,70035,700350101,Caucete,SAN JUAN,338,313,747,736,1483
70,70035,700350204,Caucete,SAN JUAN,167,182,352,352,704
70,70035,700350113,Caucete,SAN JUAN,253,265,480,455,935
70,70035,700350503,Caucete,SAN JUAN,95,120,182,222,404
70,70035,700350502,Caucete,SAN JUAN,68,67,132,159,291
70,70035,700350106,Caucete,SAN JUAN,296,295,626,570,1196
70,70035,700350202,Caucete,SAN JUAN,126,151,268,281,549
70,70035,700350403,Caucete,SAN JUAN,208,228,482,471,953
70,70035,700350111,Caucete,SAN JUAN,312,358,513,478,991
70,70035,700350109,Caucete,SAN JUAN,262,259,546,504,1050
70,70035,700350107,Caucete,SAN JUAN,231,228,562,516,1078
70,70035,700350103,Caucete,SAN JUAN,317,308,709,663,1372
70,70035,700350102,Caucete,SAN JUAN,301,292,609,649,1258
70,70035,700350710,Caucete,SAN JUAN,245,241,449,475,924
70,70035,700350302,Caucete,SAN JUAN,249,259,555,575,1130
70,70035,700350402,Caucete,SAN JUAN,239,241,512,508,1020
70,70035,700350703,Caucete,SAN JUAN,246,221,541,479,1020
70,70035,700350702,Caucete,SAN JUAN,451,404,970,846,1816
70,70035,700350112,Caucete,SAN JUAN,320,315,591,514,1105
70,70035,700350709,Caucete,SAN JUAN,284,300,570,596,1166
70,70035,700350401,Caucete,SAN JUAN,104,112,219,248,467
70,70035,700350708,Caucete,SAN JUAN,221,225,467,468,935
70,70035,700350705,Caucete,SAN JUAN,308,323,599,545,1144
70,70035,700350108,Caucete,SAN JUAN,300,282,608,593,1201
70,70035,700350203,Caucete,SAN JUAN,248,281,530,508,1038
70,70035,700350602,Caucete,SAN JUAN,75,71,141,158,299
70,70014,700140105,Angaco,SAN JUAN,241,273,495,495,990
70,70014,700140107,Angaco,SAN JUAN,417,436,897,850,1747
70,70014,700140202,Angaco,SAN JUAN,121,150,271,265,536
70,70014,700140101,Angaco,SAN JUAN,120,128,221,255,476
70,70014,700140201,Angaco,SAN JUAN,74,82,136,153,289
70,70014,700140103,Angaco,SAN JUAN,353,359,678,706,1384
70,70014,700140102,Angaco,SAN JUAN,140,158,232,299,531
70,70014,700140301,Angaco,SAN JUAN,15,32,28,41,69
70,70014,700140104,Angaco,SAN JUAN,217,255,457,461,918
70,70014,700140106,Angaco,SAN JUAN,317,353,635,550,1185
70,70133,701330104,Zonda,SAN JUAN,85,188,132,142,274
70,70133,701330102,Zonda,SAN JUAN,533,565,1141,1144,2285
70,70133,701330103,Zonda,SAN JUAN,419,394,783,815,1598
70,70133,701330201,Zonda,SAN JUAN,4,23,1,47,48
70,70133,701330101,Zonda,SAN JUAN,155,310,320,338,658
70,70126,701260205,25 de Mayo,SAN JUAN,119,134,242,244,486
70,70126,701260103,25 de Mayo,SAN JUAN,248,255,562,606,1168
70,70126,701260201,25 de Mayo,SAN JUAN,340,312,691,757,1448
70,70126,701260401,25 de Mayo,SAN JUAN,58,63,78,95,173
70,70126,701260208,25 de Mayo,SAN JUAN,215,239,436,459,895
70,70126,701260207,25 de Mayo,SAN JUAN,162,153,362,356,718
70,70126,701260206,25 de Mayo,SAN JUAN,215,215,418,436,854
70,70126,701260104,25 de Mayo,SAN JUAN,306,384,709,711,1420
70,70126,701260106,25 de Mayo,SAN JUAN,222,237,412,369,781
70,70126,701260202,25 de Mayo,SAN JUAN,274,271,585,664,1249
70,70126,701260204,25 de Mayo,SAN JUAN,194,215,423,450,873
70,70126,701260105,25 de Mayo,SAN JUAN,192,222,441,431,872
70,70126,701260101,25 de Mayo,SAN JUAN,362,362,747,801,1548
70,70126,701260102,25 de Mayo,SAN JUAN,245,272,502,536,1038
70,70126,701260301,25 de Mayo,SAN JUAN,270,323,623,673,1296
70,70126,701260203,25 de Mayo,SAN JUAN,285,260,594,575,1169
70,70126,701260107,25 de Mayo,SAN JUAN,266,261,572,559,1131
70,70056,700560601,Jáchal,SAN JUAN,65,169,142,148,290
70,70056,700560104,Jáchal,SAN JUAN,207,253,437,466,903
70,70056,700560702,Jáchal,SAN JUAN,57,76,109,831,940
70,70056,700560105,Jáchal,SAN JUAN,347,378,747,692,1439
70,70056,700560204,Jáchal,SAN JUAN,134,202,238,226,464
70,70056,700560202,Jáchal,SAN JUAN,262,274,495,463,958
70,70056,700560108,Jáchal,SAN JUAN,143,172,322,300,622
70,70056,700560205,Jáchal,SAN JUAN,264,286,513,457,970
70,70056,700560102,Jáchal,SAN JUAN,270,344,561,610,1171
70,70056,700560213,Jáchal,SAN JUAN,188,205,338,311,649
70,70056,700560209,Jáchal,SAN JUAN,224,266,455,390,845
70,70056,700560401,Jáchal,SAN JUAN,22,32,30,54,84
70,70056,700560103,Jáchal,SAN JUAN,163,203,291,353,644
70,70056,700560109,Jáchal,SAN JUAN,176,218,339,337,676
70,70056,700560501,Jáchal,SAN JUAN,9,18,12,16,28
70,70056,700560301,Jáchal,SAN JUAN,132,171,255,296,551
70,70056,700560701,Jáchal,SAN JUAN,158,254,278,277,555
70,70056,700560206,Jáchal,SAN JUAN,266,294,543,457,1000
70,70056,700560203,Jáchal,SAN JUAN,307,333,583,522,1105
70,70056,700560201,Jáchal,SAN JUAN,258,280,596,506,1102
70,70056,700560106,Jáchal,SAN JUAN,116,128,255,229,484
70,70056,700560207,Jáchal,SAN JUAN,198,220,441,370,811
70,70056,700560101,Jáchal,SAN JUAN,175,213,374,356,730
70,70056,700560212,Jáchal,SAN JUAN,222,272,407,384,791
70,70056,700560211,Jáchal,SAN JUAN,318,339,631,561,1192
70,70056,700560107,Jáchal,SAN JUAN,97,102,208,200,408
70,70056,700560208,Jáchal,SAN JUAN,284,292,535,518,1053
70,70056,700560302,Jáchal,SAN JUAN,245,290,470,508,978
70,70056,700560210,Jáchal,SAN JUAN,58,59,140,147,287
70,70028,700280907,Capital,SAN JUAN,211,248,372,276,648
70,70028,700280905,Capital,SAN JUAN,257,328,420,324,744
70,70028,700280811,Capital,SAN JUAN,184,220,313,261,574
70,70028,700280713,Capital,SAN JUAN,216,184,407,355,762
70,70028,700280709,Capital,SAN JUAN,322,320,596,506,1102
70,70028,700280610,Capital,SAN JUAN,184,220,301,260,561
70,70028,700280608,Capital,SAN JUAN,305,335,543,436,979
70,70028,700280603,Capital,SAN JUAN,214,224,394,310,704
70,70028,700280516,Capital,SAN JUAN,192,235,332,283,615
70,70028,700280515,Capital,SAN JUAN,192,222,363,341,704
70,70028,700280506,Capital,SAN JUAN,329,378,571,469,1040
70,70028,700280410,Capital,SAN JUAN,248,259,486,417,903
70,70028,700280409,Capital,SAN JUAN,187,191,321,294,615
70,70028,700280405,Capital,SAN JUAN,290,327,639,573,1212
70,70028,700280321,Capital,SAN JUAN,184,253,295,196,491
70,70028,700280116,Capital,SAN JUAN,206,287,316,236,552
70,70028,700280311,Capital,SAN JUAN,198,198,371,313,684
70,70028,700280716,Capital,SAN JUAN,156,182,214,198,412
70,70028,700280211,Capital,SAN JUAN,185,208,317,238,555
70,70028,700280204,Capital,SAN JUAN,178,206,340,313,653
70,70028,700280113,Capital,SAN JUAN,146,193,215,154,369
70,70028,700280108,Capital,SAN JUAN,218,320,272,205,477
70,70028,700280107,Capital,SAN JUAN,158,223,230,186,416
70,70028,700280809,Capital,SAN JUAN,327,361,459,436,895
70,70028,700280707,Capital,SAN JUAN,309,302,547,515,1062
70,70028,700280703,Capital,SAN JUAN,286,333,496,486,982
70,70028,700280619,Capital,SAN JUAN,159,158,254,185,439
70,70028,700280606,Capital,SAN JUAN,174,157,315,272,587
70,70028,700280505,Capital,SAN JUAN,147,211,194,255,449
70,70028,700280414,Capital,SAN JUAN,282,297,549,487,1036
70,70028,700280413,Capital,SAN JUAN,247,273,453,432,885
70,70028,700280412,Capital,SAN JUAN,338,343,588,477,1065
70,70028,700280411,Capital,SAN JUAN,176,189,322,257,579
70,70028,700280318,Capital,SAN JUAN,293,288,650,595,1245
70,70028,700280301,Capital,SAN JUAN,224,223,493,423,916
70,70028,700280913,Capital,SAN JUAN,171,169,304,232,536
70,70028,700280909,Capital,SAN JUAN,244,265,461,367,828
70,70028,700280614,Capital,SAN JUAN,217,246,357,317,674
70,70028,700280914,Capital,SAN JUAN,176,192,285,230,515
70,70028,700280208,Capital,SAN JUAN,187,194,331,298,629
70,70028,700280115,Capital,SAN JUAN,144,279,193,172,365
70,70028,700280804,Capital,SAN JUAN,172,175,317,271,588
70,70028,700280714,Capital,SAN JUAN,305,293,581,527,1108
70,70028,700280712,Capital,SAN JUAN,347,355,648,599,1247
70,70028,700280708,Capital,SAN JUAN,303,334,505,501,1006
70,70028,700280705,Capital,SAN JUAN,289,354,476,415,891
70,70028,700280617,Capital,SAN JUAN,301,309,606,574,1180
70,70028,700280601,Capital,SAN JUAN,310,292,732,667,1399
70,70028,700280613,Capital,SAN JUAN,309,404,465,394,859
70,70028,700280502,Capital,SAN JUAN,305,378,494,403,897
70,70028,700280403,Capital,SAN JUAN,228,258,376,286,662
70,70028,700280401,Capital,SAN JUAN,131,162,201,174,375
70,70028,700280308,Capital,SAN JUAN,262,290,471,424,895
70,70028,700280117,Capital,SAN JUAN,163,257,228,148,376
70,70028,700280702,Capital,SAN JUAN,243,322,323,272,595
70,70028,700280205,Capital,SAN JUAN,206,217,381,322,703
70,70028,700280112,Capital,SAN JUAN,232,412,384,297,681
70,70028,700280111,Capital,SAN JUAN,207,293,314,214,528
70,70028,700280104,Capital,SAN JUAN,222,359,353,323,676
70,70028,700280103,Capital,SAN JUAN,242,356,344,275,619
70,70028,700280906,Capital,SAN JUAN,171,199,266,185,451
70,70028,700280904,Capital,SAN JUAN,170,198,300,233,533
70,70028,700280902,Capital,SAN JUAN,293,385,494,355,849
70,70028,700280805,Capital,SAN JUAN,238,250,427,394,821
70,70028,700280710,Capital,SAN JUAN,267,271,524,450,974
70,70028,700280704,Capital,SAN JUAN,331,352,539,485,1024
70,70028,700280605,Capital,SAN JUAN,315,348,549,445,994
70,70028,700280512,Capital,SAN JUAN,213,301,320,242,562
70,70028,700280507,Capital,SAN JUAN,183,207,306,270,576
70,70028,700280404,Capital,SAN JUAN,166,194,267,210,477
70,70028,700280320,Capital,SAN JUAN,162,215,245,205,450
70,70028,700280313,Capital,SAN JUAN,318,348,583,509,1092
70,70028,700280303,Capital,SAN JUAN,325,341,694,595,1289
70,70028,700280203,Capital,SAN JUAN,350,357,667,636,1303
70,70028,700280109,Capital,SAN JUAN,158,240,202,150,352
70,70028,700280101,Capital,SAN JUAN,285,363,458,390,848
70,70028,700280910,Capital,SAN JUAN,268,326,462,372,834
70,70028,700280802,Capital,SAN JUAN,191,214,316,325,641
70,70028,700280706,Capital,SAN JUAN,266,279,415,379,794
70,70028,700280607,Capital,SAN JUAN,239,248,420,385,805
70,70028,700280602,Capital,SAN JUAN,292,315,605,561,1166
70,70028,700280514,Capital,SAN JUAN,153,199,244,198,442
70,70028,700280513,Capital,SAN JUAN,227,246,375,353,728
70,70028,700280406,Capital,SAN JUAN,301,328,447,345,792
70,70028,700280319,Capital,SAN JUAN,209,244,349,260,609
70,70028,700280316,Capital,SAN JUAN,308,389,451,400,851
70,70028,700280304,Capital,SAN JUAN,323,326,659,590,1249
70,70028,700280110,Capital,SAN JUAN,235,356,338,271,609
70,70028,700280102,Capital,SAN JUAN,240,324,319,277,596
70,70028,700280202,Capital,SAN JUAN,291,290,539,506,1045
70,70028,700280201,Capital,SAN JUAN,263,282,511,454,965
70,70028,700280309,Capital,SAN JUAN,291,318,468,437,905
70,70028,700280908,Capital,SAN JUAN,334,346,601,548,1149
70,70028,700280903,Capital,SAN JUAN,212,253,353,278,631
70,70028,700280810,Capital,SAN JUAN,318,327,514,460,974
70,70028,700280807,Capital,SAN JUAN,251,284,414,351,765
70,70028,700280801,Capital,SAN JUAN,226,237,455,427,882
70,70028,700280711,Capital,SAN JUAN,316,305,585,557,1142
70,70028,700280618,Capital,SAN JUAN,265,254,604,576,1180
70,70028,700280616,Capital,SAN JUAN,144,182,293,240,533
70,70028,700280609,Capital,SAN JUAN,289,347,463,377,840
70,70028,700280604,Capital,SAN JUAN,237,253,434,390,824
70,70028,700280509,Capital,SAN JUAN,185,199,309,282,591
70,70028,700280503,Capital,SAN JUAN,164,186,253,212,465
70,70028,700280408,Capital,SAN JUAN,284,331,497,407,904
70,70028,700280315,Capital,SAN JUAN,153,189,229,184,413
70,70028,700280314,Capital,SAN JUAN,206,222,360,312,672
70,70028,700280307,Capital,SAN JUAN,195,223,335,291,626
70,70028,700280916,Capital,SAN JUAN,307,303,563,536,1099
70,70028,700280915,Capital,SAN JUAN,304,324,550,461,1011
70,70028,700280912,Capital,SAN JUAN,167,171,287,263,550
70,70028,700280118,Capital,SAN JUAN,179,310,242,180,422
70,70028,700280213,Capital,SAN JUAN,181,195,295,264,559
70,70028,700280209,Capital,SAN JUAN,233,277,394,350,744
70,70028,700280206,Capital,SAN JUAN,215,211,360,290,650
70,70028,700280114,Capital,SAN JUAN,236,385,399,291,690
70,70028,700280106,Capital,SAN JUAN,248,366,423,319,742
70,70028,700280901,Capital,SAN JUAN,341,460,564,461,1025
70,70028,700280715,Capital,SAN JUAN,252,299,407,345,752
70,70028,700280511,Capital,SAN JUAN,300,317,499,428,927
70,70028,700280510,Capital,SAN JUAN,200,239,332,328,660
70,70028,700280508,Capital,SAN JUAN,226,240,382,378,760
70,70028,700280611,Capital,SAN JUAN,269,270,484,436,920
70,70028,700280407,Capital,SAN JUAN,240,336,371,313,684
70,70028,700280306,Capital,SAN JUAN,301,349,459,394,853
70,70028,700280305,Capital,SAN JUAN,287,305,489,459,948
70,70028,700280302,Capital,SAN JUAN,226,254,431,421,852
70,70028,700280612,Capital,SAN JUAN,280,300,425,333,758
70,70028,700280501,Capital,SAN JUAN,295,330,477,369,846
70,70028,700280212,Capital,SAN JUAN,138,153,219,195,414
70,70028,700280207,Capital,SAN JUAN,200,216,345,311,656
70,70028,700280310,Capital,SAN JUAN,183,206,340,270,610
70,70028,700280911,Capital,SAN JUAN,84,97,175,127,302
70,70028,700280808,Capital,SAN JUAN,196,213,353,284,637
70,70028,700280806,Capital,SAN JUAN,266,296,439,348,787
70,70028,700280803,Capital,SAN JUAN,211,241,376,314,690
70,70028,700280701,Capital,SAN JUAN,342,387,537,456,993
70,70028,700280615,Capital,SAN JUAN,249,265,492,421,913
70,70028,700280504,Capital,SAN JUAN,307,339,516,403,919
70,70028,700280402,Capital,SAN JUAN,180,203,312,248,560
70,70028,700280317,Capital,SAN JUAN,188,236,306,248,554
70,70028,700280312,Capital,SAN JUAN,179,185,280,232,512
70,70028,700280210,Capital,SAN JUAN,266,293,474,359,833
70,70028,700280105,Capital,SAN JUAN,114,195,193,137,330
70,70070,700700301,Pocito,SAN JUAN,187,218,366,393,759
70,70070,700700107,Pocito,SAN JUAN,266,258,565,536,1101
70,70070,700700504,Pocito,SAN JUAN,177,277,395,393,788
70,70070,700700501,Pocito,SAN JUAN,295,306,670,699,1369
70,70070,700700518,Pocito,SAN JUAN,206,228,397,374,771
70,70070,700700207,Pocito,SAN JUAN,549,554,1126,1032,2158
70,70070,700700113,Pocito,SAN JUAN,333,335,630,638,1268
70,70070,700700110,Pocito,SAN JUAN,202,233,336,296,632
70,70070,700700108,Pocito,SAN JUAN,264,265,532,495,1027
70,70070,700700112,Pocito,SAN JUAN,286,286,548,500,1048
70,70070,700700103,Pocito,SAN JUAN,402,427,817,860,1677
70,70070,700700502,Pocito,SAN JUAN,244,265,478,460,938
70,70070,700700115,Pocito,SAN JUAN,334,519,614,629,1243
70,70070,700700515,Pocito,SAN JUAN,348,306,655,673,1328
70,70070,700700509,Pocito,SAN JUAN,294,280,577,527,1104
70,70070,700700503,Pocito,SAN JUAN,263,254,573,557,1130
70,70070,700700105,Pocito,SAN JUAN,308,319,629,625,1254
70,70070,700700111,Pocito,SAN JUAN,211,232,397,350,747
70,70070,700700517,Pocito,SAN JUAN,299,390,668,673,1341
70,70070,700700203,Pocito,SAN JUAN,349,379,621,638,1259
70,70070,700700507,Pocito,SAN JUAN,282,283,658,626,1284
70,70070,700700302,Pocito,SAN JUAN,236,243,508,465,973
70,70070,700700201,Pocito,SAN JUAN,73,84,158,163,321
70,70070,700700202,Pocito,SAN JUAN,108,129,232,250,482
70,70070,700700512,Pocito,SAN JUAN,376,381,817,767,1584
70,70070,700700304,Pocito,SAN JUAN,294,296,554,580,1134
70,70070,700700109,Pocito,SAN JUAN,268,269,487,439,926
70,70070,700700204,Pocito,SAN JUAN,208,225,455,473,928
70,70070,700700104,Pocito,SAN JUAN,288,266,567,569,1136
70,70070,700700513,Pocito,SAN JUAN,343,326,715,640,1355
70,70070,700700511,Pocito,SAN JUAN,446,404,968,960,1928
70,70070,700700206,Pocito,SAN JUAN,529,539,1014,1023,2037
70,70070,700700102,Pocito,SAN JUAN,399,388,815,846,1661
70,70070,700700401,Pocito,SAN JUAN,39,65,73,79,152
70,70070,700700101,Pocito,SAN JUAN,255,278,505,548,1053
70,70070,700700514,Pocito,SAN JUAN,379,392,757,742,1499
70,70070,700700505,Pocito,SAN JUAN,235,245,517,529,1046
70,70070,700700205,Pocito,SAN JUAN,245,254,486,469,955
70,70070,700700303,Pocito,SAN JUAN,226,265,453,494,947
70,70070,700700114,Pocito,SAN JUAN,431,515,840,850,1690
70,70070,700700516,Pocito,SAN JUAN,377,380,828,797,1625
70,70070,700700510,Pocito,SAN JUAN,300,318,664,674,1338
70,70070,700700508,Pocito,SAN JUAN,304,266,602,588,1190
70,70070,700700506,Pocito,SAN JUAN,293,301,694,685,1379
70,70070,700700106,Pocito,SAN JUAN,274,266,574,546,1120
70,70070,700700305,Pocito,SAN JUAN,129,143,245,232,477
70,70007,700070204,Albardón,SAN JUAN,430,438,1016,1004,2020
70,70007,700070303,Albardón,SAN JUAN,120,130,248,230,478
70,70007,700070101,Albardón,SAN JUAN,330,326,671,617,1288
70,70007,700070203,Albardón,SAN JUAN,211,224,397,389,786
70,70007,700070403,Albardón,SAN JUAN,325,330,608,641,1249
70,70007,700070307,Albardón,SAN JUAN,309,343,697,690,1387
70,70007,700070202,Albardón,SAN JUAN,236,249,468,446,914
70,70007,700070201,Albardón,SAN JUAN,286,332,616,621,1237
70,70007,700070104,Albardón,SAN JUAN,263,270,506,430,936
70,70007,700070206,Albardón,SAN JUAN,323,282,701,619,1320
70,70007,700070205,Albardón,SAN JUAN,453,459,886,863,1749
70,70007,700070103,Albardón,SAN JUAN,303,444,587,579,1166
70,70007,700070207,Albardón,SAN JUAN,161,165,327,345,672
70,70007,700070102,Albardón,SAN JUAN,389,411,716,691,1407
70,70007,700070304,Albardón,SAN JUAN,197,191,361,413,774
70,70007,700070308,Albardón,SAN JUAN,271,235,565,551,1116
70,70007,700070302,Albardón,SAN JUAN,221,232,447,438,885
70,70007,700070306,Albardón,SAN JUAN,258,255,547,559,1106
70,70007,700070305,Albardón,SAN JUAN,57,71,126,114,240
70,70007,700070402,Albardón,SAN JUAN,137,152,294,322,616
70,70007,700070301,Albardón,SAN JUAN,383,414,880,857,1737
70,70007,700070401,Albardón,SAN JUAN,159,183,322,310,632
70,70007,700070501,Albardón,SAN JUAN,41,71,81,92,173
70,70077,700770801,Rawson,SAN JUAN,184,160,348,328,676
70,70077,700771011,Rawson,SAN JUAN,233,219,407,373,780
70,70077,700771008,Rawson,SAN JUAN,233,216,460,416,876
70,70077,700771007,Rawson,SAN JUAN,342,327,695,697,1392
70,70077,700770804,Rawson,SAN JUAN,242,219,468,506,974
70,70077,700770505,Rawson,SAN JUAN,228,215,460,417,877
70,70077,700770502,Rawson,SAN JUAN,334,346,670,719,1389
70,70077,700770412,Rawson,SAN JUAN,352,346,660,584,1244
70,70077,700770405,Rawson,SAN JUAN,264,286,462,416,878
70,70077,700770313,Rawson,SAN JUAN,250,243,463,448,911
70,70077,700770309,Rawson,SAN JUAN,326,291,609,620,1229
70,70077,700770201,Rawson,SAN JUAN,354,352,691,650,1341
70,70077,700770104,Rawson,SAN JUAN,295,315,707,744,1451
70,70077,700770508,Rawson,SAN JUAN,218,260,439,435,874
70,70077,700771002,Rawson,SAN JUAN,420,383,836,741,1577
70,70077,700771001,Rawson,SAN JUAN,199,221,360,335,695
70,70077,700770909,Rawson,SAN JUAN,242,234,614,657,1271
70,70077,700770803,Rawson,SAN JUAN,402,409,772,678,1450
70,70077,700770802,Rawson,SAN JUAN,214,166,401,427,828
70,70077,700770410,Rawson,SAN JUAN,359,365,642,564,1206
70,70077,700770403,Rawson,SAN JUAN,218,212,425,398,823
70,70077,700770307,Rawson,SAN JUAN,391,386,734,702,1436
70,70077,700770213,Rawson,SAN JUAN,312,224,642,641,1283
70,70077,700770910,Rawson,SAN JUAN,326,327,685,663,1348
70,70077,700770501,Rawson,SAN JUAN,276,296,543,465,1008
70,70077,700770402,Rawson,SAN JUAN,188,199,353,281,634
70,70077,700770808,Rawson,SAN JUAN,262,221,601,532,1133
70,70077,700770205,Rawson,SAN JUAN,345,298,661,654,1315
70,70077,700770203,Rawson,SAN JUAN,346,281,712,679,1391
70,70077,700771009,Rawson,SAN JUAN,207,200,410,353,763
70,70077,700770807,Rawson,SAN JUAN,223,213,463,462,925
70,70077,700771004,Rawson,SAN JUAN,305,317,579,546,1125
70,70077,700770908,Rawson,SAN JUAN,250,241,554,512,1066
70,70077,700770906,Rawson,SAN JUAN,270,220,643,567,1210
70,70077,700770814,Rawson,SAN JUAN,293,272,571,526,1097
70,70077,700770805,Rawson,SAN JUAN,319,274,671,623,1294
70,70077,700770504,Rawson,SAN JUAN,148,122,294,301,595
70,70077,700770413,Rawson,SAN JUAN,197,219,342,296,638
70,70077,700770411,Rawson,SAN JUAN,208,209,398,359,757
70,70077,700770409,Rawson,SAN JUAN,201,203,351,360,711
70,70077,700770407,Rawson,SAN JUAN,295,273,533,512,1045
70,70077,700770311,Rawson,SAN JUAN,342,322,639,565,1204
70,70077,700770308,Rawson,SAN JUAN,232,241,479,384,863
70,70077,700770305,Rawson,SAN JUAN,272,258,542,499,1041
70,70077,700770212,Rawson,SAN JUAN,229,204,511,492,1003
70,70077,700770512,Rawson,SAN JUAN,299,339,635,580,1215
70,70077,700770510,Rawson,SAN JUAN,327,394,759,677,1436
70,70077,700770509,Rawson,SAN JUAN,156,166,346,327,673
70,70077,700770506,Rawson,SAN JUAN,147,116,304,280,584
70,70077,700770703,Rawson,SAN JUAN,144,181,279,317,596
70,70077,700770601,Rawson,SAN JUAN,328,386,600,595,1195
70,70077,700770702,Rawson,SAN JUAN,181,226,326,339,665
70,70077,700770701,Rawson,SAN JUAN,227,286,452,462,914
70,70077,700770602,Rawson,SAN JUAN,276,333,510,544,1054
70,70077,700771006,Rawson,SAN JUAN,315,279,603,576,1179
70,70077,700770912,Rawson,SAN JUAN,287,263,537,493,1030
70,70077,700770907,Rawson,SAN JUAN,255,237,582,548,1130
70,70077,700770902,Rawson,SAN JUAN,257,298,478,393,871
70,70077,700770901,Rawson,SAN JUAN,299,298,502,485,987
70,70077,700770812,Rawson,SAN JUAN,289,264,615,572,1187
70,70077,700770810,Rawson,SAN JUAN,405,441,883,822,1705
70,70077,700770416,Rawson,SAN JUAN,208,211,458,426,884
70,70077,700770408,Rawson,SAN JUAN,246,240,435,377,812
70,70077,700770106,Rawson,SAN JUAN,250,220,526,565,1091
70,70077,700770105,Rawson,SAN JUAN,232,277,567,567,1134
70,70077,700770101,Rawson,SAN JUAN,162,165,294,266,560
70,70077,700771003,Rawson,SAN JUAN,212,230,380,334,714
70,70077,700770815,Rawson,SAN JUAN,284,274,580,551,1131
70,70077,700770806,Rawson,SAN JUAN,411,377,909,827,1736
70,70077,700770904,Rawson,SAN JUAN,318,308,614,593,1207
70,70077,700770401,Rawson,SAN JUAN,205,202,394,344,738
70,70077,700770312,Rawson,SAN JUAN,233,207,455,389,844
70,70077,700770304,Rawson,SAN JUAN,354,338,714,643,1357
70,70077,700770301,Rawson,SAN JUAN,262,282,499,436,935
70,70077,700770210,Rawson,SAN JUAN,179,190,342,299,641
70,70077,700770208,Rawson,SAN JUAN,413,373,887,742,1629
70,70077,700770103,Rawson,SAN JUAN,3,297,10,8,18
70,70077,700770511,Rawson,SAN JUAN,375,415,768,723,1491
70,70077,700771005,Rawson,SAN JUAN,301,327,601,550,1151
70,70077,700770911,Rawson,SAN JUAN,340,323,616,580,1196
70,70077,700770809,Rawson,SAN JUAN,363,332,729,707,1436
70,70077,700770905,Rawson,SAN JUAN,398,379,1054,970,2024
70,70077,700770503,Rawson,SAN JUAN,222,232,440,397,837
70,70077,700770415,Rawson,SAN JUAN,221,185,461,398,859
70,70077,700770310,Rawson,SAN JUAN,357,368,665,608,1273
70,70077,700770302,Rawson,SAN JUAN,283,284,543,425,968
70,70077,700770206,Rawson,SAN JUAN,344,356,691,632,1323
70,70077,700770204,Rawson,SAN JUAN,376,343,740,711,1451
70,70077,700770202,Rawson,SAN JUAN,374,378,777,734,1511
70,70077,700770507,Rawson,SAN JUAN,286,327,576,600,1176
70,70077,700770209,Rawson,SAN JUAN,308,314,593,524,1117
70,70077,700771013,Rawson,SAN JUAN,333,323,652,688,1340
70,70077,700771012,Rawson,SAN JUAN,212,205,398,431,829
70,70077,700771010,Rawson,SAN JUAN,308,299,546,461,1007
70,70077,700770903,Rawson,SAN JUAN,275,295,502,455,957
70,70077,700770813,Rawson,SAN JUAN,459,369,886,893,1779
70,70077,700770811,Rawson,SAN JUAN,251,264,610,623,1233
70,70077,700770603,Rawson,SAN JUAN,135,145,268,252,520
70,70077,700770414,Rawson,SAN JUAN,207,198,418,350,768
70,70077,700770406,Rawson,SAN JUAN,306,315,569,485,1054
70,70077,700770404,Rawson,SAN JUAN,260,273,480,425,905
70,70077,700770306,Rawson,SAN JUAN,363,354,680,650,1330
70,70077,700770303,Rawson,SAN JUAN,273,273,536,499,1035
70,70077,700770211,Rawson,SAN JUAN,269,287,535,497,1032
70,70077,700770207,Rawson,SAN JUAN,329,328,642,631,1273
70,70077,700770102,Rawson,SAN JUAN,482,428,1017,997,2014
70,70042,700420416,Chimbas,SAN JUAN,321,363,613,574,1187
70,70042,700420509,Chimbas,SAN JUAN,325,318,643,582,1225
70,70042,700420506,Chimbas,SAN JUAN,347,335,775,699,1474
70,70042,700420408,Chimbas,SAN JUAN,265,198,692,630,1322
70,70042,700420215,Chimbas,SAN JUAN,220,208,475,416,891
70,70042,700420208,Chimbas,SAN JUAN,224,204,502,438,940
70,70042,700420210,Chimbas,SAN JUAN,313,313,658,612,1270
70,70042,700420206,Chimbas,SAN JUAN,327,326,674,657,1331
70,70042,700420205,Chimbas,SAN JUAN,287,244,538,543,1081
70,70042,700420105,Chimbas,SAN JUAN,322,329,683,655,1338
70,70042,700420511,Chimbas,SAN JUAN,252,257,479,442,921
70,70042,700420419,Chimbas,SAN JUAN,184,171,364,326,690
70,70042,700420406,Chimbas,SAN JUAN,359,333,951,929,1880
70,70042,700420214,Chimbas,SAN JUAN,284,266,562,536,1098
70,70042,700420508,Chimbas,SAN JUAN,331,310,685,593,1278
70,70042,700420503,Chimbas,SAN JUAN,253,239,472,458,930
70,70042,700420414,Chimbas,SAN JUAN,410,409,920,905,1825
70,70042,700420404,Chimbas,SAN JUAN,359,333,741,732,1473
70,70042,700420418,Chimbas,SAN JUAN,201,194,417,354,771
70,70042,700420209,Chimbas,SAN JUAN,372,352,772,720,1492
70,70042,700420203,Chimbas,SAN JUAN,365,333,843,827,1670
70,70042,700420104,Chimbas,SAN JUAN,375,343,843,1567,2410
70,70042,700420201,Chimbas,SAN JUAN,371,391,751,687,1438
70,70042,700420106,Chimbas,SAN JUAN,384,362,810,728,1538
70,70042,700420513,Chimbas,SAN JUAN,302,295,627,546,1173
70,70042,700420417,Chimbas,SAN JUAN,447,394,858,849,1707
70,70042,700420409,Chimbas,SAN JUAN,238,183,535,522,1057
70,70042,700420303,Chimbas,SAN JUAN,311,306,653,629,1282
70,70042,700420207,Chimbas,SAN JUAN,506,485,1079,1010,2089
70,70042,700420108,Chimbas,SAN JUAN,256,243,534,545,1079
70,70042,700420107,Chimbas,SAN JUAN,209,188,394,404,798
70,70042,700420403,Chimbas,SAN JUAN,227,201,476,451,927
70,70042,700420103,Chimbas,SAN JUAN,259,237,513,480,993
70,70042,700420510,Chimbas,SAN JUAN,428,416,800,758,1558
70,70042,700420504,Chimbas,SAN JUAN,315,320,680,650,1330
70,70042,700420413,Chimbas,SAN JUAN,360,367,715,671,1386
70,70042,700420407,Chimbas,SAN JUAN,334,325,755,724,1479
70,70042,700420216,Chimbas,SAN JUAN,365,344,809,791,1600
70,70042,700420111,Chimbas,SAN JUAN,203,157,551,505,1056
70,70042,700420110,Chimbas,SAN JUAN,273,263,557,550,1107
70,70042,700420109,Chimbas,SAN JUAN,248,233,504,515,1019
70,70042,700420101,Chimbas,SAN JUAN,190,187,395,384,779
70,70042,700420512,Chimbas,SAN JUAN,290,287,554,532,1086
70,70042,700420507,Chimbas,SAN JUAN,361,355,850,826,1676
70,70042,700420501,Chimbas,SAN JUAN,404,379,787,719,1506
70,70042,700420412,Chimbas,SAN JUAN,367,384,721,687,1408
70,70042,700420401,Chimbas,SAN JUAN,281,410,614,582,1196
70,70042,700420213,Chimbas,SAN JUAN,361,342,749,691,1440
70,70042,700420212,Chimbas,SAN JUAN,403,369,845,880,1725
70,70042,700420211,Chimbas,SAN JUAN,218,223,448,418,866
70,70042,700420202,Chimbas,SAN JUAN,210,292,496,456,952
70,70042,700420514,Chimbas,SAN JUAN,420,401,864,888,1752
70,70042,700420411,Chimbas,SAN JUAN,230,238,496,491,987
70,70042,700420410,Chimbas,SAN JUAN,250,249,517,516,1033
70,70042,700420405,Chimbas,SAN JUAN,310,283,697,668,1365
70,70042,700420301,Chimbas,SAN JUAN,268,232,620,663,1283
70,70042,700420102,Chimbas,SAN JUAN,382,368,835,818,1653
70,70042,700420112,Chimbas,SAN JUAN,206,207,461,466,927
70,70042,700420515,Chimbas,SAN JUAN,251,239,487,476,963
70,70042,700420505,Chimbas,SAN JUAN,399,356,881,911,1792
70,70042,700420502,Chimbas,SAN JUAN,330,324,661,659,1320
70,70042,700420415,Chimbas,SAN JUAN,289,280,571,528,1099
70,70042,700420402,Chimbas,SAN JUAN,491,495,1115,1108,2223
70,70042,700420304,Chimbas,SAN JUAN,48,70,82,84,166
70,70042,700420302,Chimbas,SAN JUAN,323,344,666,663,1329
70,70042,700420217,Chimbas,SAN JUAN,350,324,795,745,1540
70,70042,700420204,Chimbas,SAN JUAN,482,434,1069,1010,2079
70,70021,700210404,Calingasta,SAN JUAN,325,476,681,678,1359
70,70021,700210601,Calingasta,SAN JUAN,10,16,8,26,34
70,70021,700210501,Calingasta,SAN JUAN,11,18,12,76,88
70,70021,700210302,Calingasta,SAN JUAN,250,328,478,510,988
70,70021,700210203,Calingasta,SAN JUAN,269,347,487,572,1059
70,70021,700210701,Calingasta,SAN JUAN,9,18,31,216,247
70,70021,700210405,Calingasta,SAN JUAN,40,46,89,119,208
70,70021,700210402,Calingasta,SAN JUAN,39,76,76,77,153
70,70021,700210101,Calingasta,SAN JUAN,88,136,144,194,338
70,70021,700210702,Calingasta,SAN JUAN,1,10,0,1,1
70,70021,700210204,Calingasta,SAN JUAN,54,61,105,140,245
70,70021,700210202,Calingasta,SAN JUAN,51,58,95,119,214
70,70021,700210401,Calingasta,SAN JUAN,264,395,478,521,999
70,70021,700210205,Calingasta,SAN JUAN,13,21,11,23,34
70,70021,700210201,Calingasta,SAN JUAN,297,362,583,556,1139
70,70021,700210301,Calingasta,SAN JUAN,97,121,179,198,377
70,70021,700210403,Calingasta,SAN JUAN,299,426,569,536,1105
70,70112,701120101,Ullum,SAN JUAN,181,243,316,353,669
70,70112,701120201,Ullum,SAN JUAN,15,18,10,28,38
70,70112,701120104,Ullum,SAN JUAN,247,261,487,513,1000
70,70112,701120102,Ullum,SAN JUAN,367,436,726,714,1440
70,70112,701120105,Ullum,SAN JUAN,293,346,621,641,1262
70,70112,701120103,Ullum,SAN JUAN,127,233,231,246,477
70,70105,701050107,Sarmiento,SAN JUAN,373,400,769,789,1558
70,70105,701050106,Sarmiento,SAN JUAN,240,270,505,549,1054
70,70105,701050104,Sarmiento,SAN JUAN,128,156,210,229,439
70,70105,701050303,Sarmiento,SAN JUAN,412,447,855,936,1791
70,70105,701050103,Sarmiento,SAN JUAN,100,110,191,222,413
70,70105,701050305,Sarmiento,SAN JUAN,266,292,553,644,1197
70,70105,701050202,Sarmiento,SAN JUAN,472,498,1027,1084,2111
70,70105,701050301,Sarmiento,SAN JUAN,307,320,608,598,1206
70,70105,701050304,Sarmiento,SAN JUAN,199,231,488,562,1050
70,70105,701050203,Sarmiento,SAN JUAN,202,228,405,484,889
70,70105,701050201,Sarmiento,SAN JUAN,445,490,921,1030,1951
70,70105,701050307,Sarmiento,SAN JUAN,302,327,615,566,1181
70,70105,701050108,Sarmiento,SAN JUAN,325,326,662,723,1385
70,70105,701050102,Sarmiento,SAN JUAN,170,185,328,373,701
70,70105,701050306,Sarmiento,SAN JUAN,325,335,618,647,1265
70,70105,701050101,Sarmiento,SAN JUAN,101,88,206,220,426
70,70105,701050105,Sarmiento,SAN JUAN,145,211,278,307,585
70,70105,701050302,Sarmiento,SAN JUAN,476,425,985,979,1964
70,70105,701050308,Sarmiento,SAN JUAN,236,247,495,470,965
70,70098,700980402,Santa Lucía,SAN JUAN,243,288,420,331,751
70,70098,700980305,Santa Lucía,SAN JUAN,324,297,697,608,1305
70,70098,700980302,Santa Lucía,SAN JUAN,290,277,530,589,1119
70,70098,700980207,Santa Lucía,SAN JUAN,356,386,713,694,1407
70,70098,700980107,Santa Lucía,SAN JUAN,305,261,624,609,1233
70,70098,700980106,Santa Lucía,SAN JUAN,412,375,835,822,1657
70,70098,700980405,Santa Lucía,SAN JUAN,232,246,440,404,844
70,70098,700980306,Santa Lucía,SAN JUAN,251,232,463,516,979
70,70098,700980116,Santa Lucía,SAN JUAN,428,421,872,827,1699
70,70098,700980204,Santa Lucía,SAN JUAN,226,182,471,453,924
70,70098,700980113,Santa Lucía,SAN JUAN,238,229,361,297,658
70,70098,700980105,Santa Lucía,SAN JUAN,281,267,555,524,1079
70,70098,700980407,Santa Lucía,SAN JUAN,162,167,281,264,545
70,70098,700980308,Santa Lucía,SAN JUAN,308,301,592,583,1175
70,70098,700980301,Santa Lucía,SAN JUAN,429,437,867,733,1600
70,70098,700980206,Santa Lucía,SAN JUAN,366,328,751,762,1513
70,70098,700980202,Santa Lucía,SAN JUAN,180,183,372,387,759
70,70098,700980111,Santa Lucía,SAN JUAN,321,294,604,548,1152
70,70098,700980109,Santa Lucía,SAN JUAN,357,357,654,648,1302
70,70098,700980412,Santa Lucía,SAN JUAN,179,212,335,254,589
70,70098,700980406,Santa Lucía,SAN JUAN,257,244,432,412,844
70,70098,700980401,Santa Lucía,SAN JUAN,423,456,757,602,1359
70,70098,700980303,Santa Lucía,SAN JUAN,176,182,339,324,663
70,70098,700980117,Santa Lucía,SAN JUAN,188,354,384,344,728
70,70098,700980103,Santa Lucía,SAN JUAN,261,258,537,520,1057
70,70098,700980101,Santa Lucía,SAN JUAN,290,299,636,604,1240
70,70098,700980410,Santa Lucía,SAN JUAN,178,184,314,292,606
70,70098,700980403,Santa Lucía,SAN JUAN,290,320,504,418,922
70,70098,700980307,Santa Lucía,SAN JUAN,376,395,663,659,1322
70,70098,700980104,Santa Lucía,SAN JUAN,301,287,580,531,1111
70,70098,700980114,Santa Lucía,SAN JUAN,232,235,491,475,966
70,70098,700980409,Santa Lucía,SAN JUAN,227,255,399,379,778
70,70098,700980304,Santa Lucía,SAN JUAN,325,298,649,581,1230
70,70098,700980205,Santa Lucía,SAN JUAN,392,412,826,822,1648
70,70098,700980102,Santa Lucía,SAN JUAN,215,274,506,508,1014
70,70098,700980408,Santa Lucía,SAN JUAN,151,147,281,267,548
70,70098,700980203,Santa Lucía,SAN JUAN,237,190,543,523,1066
70,70098,700980110,Santa Lucía,SAN JUAN,311,297,659,613,1272
70,70098,700980411,Santa Lucía,SAN JUAN,220,216,449,388,837
70,70098,700980404,Santa Lucía,SAN JUAN,331,313,621,521,1142
70,70098,700980201,Santa Lucía,SAN JUAN,343,348,730,741,1471
70,70098,700980118,Santa Lucía,SAN JUAN,294,352,578,558,1136
70,70098,700980115,Santa Lucía,SAN JUAN,243,248,449,395,844
70,70098,700980112,Santa Lucía,SAN JUAN,300,338,539,499,1038
70,70098,700980108,Santa Lucía,SAN JUAN,275,301,502,453,955
70,70091,700910112,San Martín,SAN JUAN,342,329,670,644,1314
70,70091,700910111,San Martín,SAN JUAN,150,143,305,314,619
70,70091,700910101,San Martín,SAN JUAN,218,240,432,474,906
70,70091,700910102,San Martín,SAN JUAN,230,241,476,496,972
70,70091,700910114,San Martín,SAN JUAN,290,280,625,593,1218
70,70091,700910110,San Martín,SAN JUAN,87,97,187,171,358
70,70091,700910104,San Martín,SAN JUAN,307,313,663,694,1357
70,70091,700910103,San Martín,SAN JUAN,103,120,219,199,418
70,70091,700910106,San Martín,SAN JUAN,109,121,221,221,442
70,70091,700910108,San Martín,SAN JUAN,89,116,180,185,365
70,70091,700910109,San Martín,SAN JUAN,280,262,573,579,1152
70,70091,700910113,San Martín,SAN JUAN,249,255,505,493,998
70,70091,700910201,San Martín,SAN JUAN,15,21,27,36,63
70,70091,700910107,San Martín,SAN JUAN,137,159,310,335,645
70,70091,700910105,San Martín,SAN JUAN,69,93,131,157,288
70,70084,700840215,Rivadavia,SAN JUAN,318,359,613,562,1175
70,70084,700840210,Rivadavia,SAN JUAN,334,363,619,591,1210
70,70084,700840313,Rivadavia,SAN JUAN,259,265,477,464,941
70,70084,700840606,Rivadavia,SAN JUAN,289,304,533,458,991
70,70084,700840605,Rivadavia,SAN JUAN,259,277,465,391,856
70,70084,700840602,Rivadavia,SAN JUAN,417,432,848,857,1705
70,70084,700840318,Rivadavia,SAN JUAN,245,209,411,402,813
70,70084,700840316,Rivadavia,SAN JUAN,294,305,549,513,1062
70,70084,700840308,Rivadavia,SAN JUAN,375,381,662,641,1303
70,70084,700840216,Rivadavia,SAN JUAN,302,250,575,567,1142
70,70084,700840211,Rivadavia,SAN JUAN,364,400,690,565,1255
70,70084,700840209,Rivadavia,SAN JUAN,261,293,474,409,883
70,70084,700840202,Rivadavia,SAN JUAN,207,197,470,446,916
70,70084,700840204,Rivadavia,SAN JUAN,337,295,832,740,1572
70,70084,700840415,Rivadavia,SAN JUAN,245,213,468,418,886
70,70084,700840412,Rivadavia,SAN JUAN,385,371,722,691,1413
70,70084,700840503,Rivadavia,SAN JUAN,428,393,1043,1003,2046
70,70084,700840502,Rivadavia,SAN JUAN,228,253,436,415,851
70,70084,700840314,Rivadavia,SAN JUAN,266,264,550,512,1062
70,70084,700840311,Rivadavia,SAN JUAN,343,358,708,600,1308
70,70084,700840307,Rivadavia,SAN JUAN,418,455,771,666,1437
70,70084,700840201,Rivadavia,SAN JUAN,277,277,660,703,1363
70,70084,700840411,Rivadavia,SAN JUAN,199,213,354,318,672
70,70084,700840611,Rivadavia,SAN JUAN,296,305,692,670,1362
70,70084,700840607,Rivadavia,SAN JUAN,264,281,476,447,923
70,70084,700840603,Rivadavia,SAN JUAN,230,222,453,406,859
70,70084,700840504,Rivadavia,SAN JUAN,559,663,1053,1020,2073
70,70084,700840315,Rivadavia,SAN JUAN,323,345,636,543,1179
70,70084,700840312,Rivadavia,SAN JUAN,345,355,683,601,1284
70,70084,700840309,Rivadavia,SAN JUAN,356,368,675,613,1288
70,70084,700840212,Rivadavia,SAN JUAN,390,434,701,605,1306
70,70084,700840414,Rivadavia,SAN JUAN,215,176,438,390,828
70,70084,700840407,Rivadavia,SAN JUAN,239,204,492,444,936
70,70084,700840613,Rivadavia,SAN JUAN,184,166,362,357,719
70,70084,700840601,Rivadavia,SAN JUAN,323,344,659,600,1259
70,70084,700840604,Rivadavia,SAN JUAN,333,345,678,569,1247
70,70084,700840320,Rivadavia,SAN JUAN,270,311,468,405,873
70,70084,700840305,Rivadavia,SAN JUAN,482,583,851,828,1679
70,70084,700840217,Rivadavia,SAN JUAN,238,253,439,356,795
70,70084,700840208,Rivadavia,SAN JUAN,318,357,587,558,1145
70,70084,700840205,Rivadavia,SAN JUAN,257,269,547,533,1080
70,70084,700840501,Rivadavia,SAN JUAN,329,344,644,642,1286
70,70084,700840101,Rivadavia,SAN JUAN,13,16,25,34,59
70,70084,700840610,Rivadavia,SAN JUAN,475,444,995,1013,2008
70,70084,700840417,Rivadavia,SAN JUAN,213,229,405,385,790
70,70084,700840310,Rivadavia,SAN JUAN,359,356,723,654,1377
70,70084,700840304,Rivadavia,SAN JUAN,327,277,660,615,1275
70,70084,700840301,Rivadavia,SAN JUAN,363,373,763,727,1490
70,70084,700840207,Rivadavia,SAN JUAN,244,258,458,414,872
70,70084,700840409,Rivadavia,SAN JUAN,311,273,659,627,1286
70,70084,700840406,Rivadavia,SAN JUAN,193,200,388,343,731
70,70084,700840612,Rivadavia,SAN JUAN,292,287,670,607,1277
70,70084,700840505,Rivadavia,SAN JUAN,212,240,584,551,1135
70,70084,700840404,Rivadavia,SAN JUAN,223,248,389,340,729
70,70084,700840403,Rivadavia,SAN JUAN,305,325,529,463,992
70,70084,700840401,Rivadavia,SAN JUAN,486,634,911,812,1723
70,70084,700840306,Rivadavia,SAN JUAN,376,396,649,610,1259
70,70084,700840302,Rivadavia,SAN JUAN,322,325,620,553,1173
70,70084,700840206,Rivadavia,SAN JUAN,233,258,421,396,817
70,70084,700840203,Rivadavia,SAN JUAN,262,280,528,539,1067
70,70084,700840413,Rivadavia,SAN JUAN,208,225,372,337,709
70,70084,700840408,Rivadavia,SAN JUAN,269,275,501,437,938
70,70084,700840405,Rivadavia,SAN JUAN,410,382,745,691,1436
70,70084,700840214,Rivadavia,SAN JUAN,217,209,407,339,746
70,70084,700840609,Rivadavia,SAN JUAN,303,262,586,530,1116
70,70084,700840608,Rivadavia,SAN JUAN,280,304,549,479,1028
70,70084,700840506,Rivadavia,SAN JUAN,200,285,501,504,1005
70,70084,700840416,Rivadavia,SAN JUAN,226,236,428,365,793
70,70084,700840402,Rivadavia,SAN JUAN,218,230,404,368,772
70,70084,700840319,Rivadavia,SAN JUAN,262,285,491,467,958
70,70084,700840317,Rivadavia,SAN JUAN,242,213,513,475,988
70,70084,700840303,Rivadavia,SAN JUAN,302,309,623,535,1158
70,70084,700840213,Rivadavia,SAN JUAN,229,219,448,377,825
70,70084,700840102,Rivadavia,SAN JUAN,67,64,131,116,247
70,70084,700840410,Rivadavia,SAN JUAN,267,291,477,402,879
70,70119,701190207,Valle Fértil,SAN JUAN,212,298,380,359,739
70,70119,701190205,Valle Fértil,SAN JUAN,118,181,190,228,418
70,70119,701190202,Valle Fértil,SAN JUAN,442,497,880,812,1692
70,70119,701190301,Valle Fértil,SAN JUAN,67,100,107,142,249
70,70119,701190201,Valle Fértil,SAN JUAN,283,348,595,564,1159
70,70119,701190102,Valle Fértil,SAN JUAN,90,123,177,195,372
70,70119,701190206,Valle Fértil,SAN JUAN,236,303,445,388,833
70,70119,701190303,Valle Fértil,SAN JUAN,176,251,359,381,740
70,70119,701190101,Valle Fértil,SAN JUAN,61,80,80,248,328
70,70119,701190302,Valle Fértil,SAN JUAN,67,94,108,138,246
70,70119,701190204,Valle Fértil,SAN JUAN,28,39,65,62,127
70,70119,701190203,Valle Fértil,SAN JUAN,56,70,89,123,212
70,70119,701190103,Valle Fértil,SAN JUAN,32,69,44,63,107
70,70049,700490203,Iglesia,SAN JUAN,256,317,477,503,980
70,70049,700490202,Iglesia,SAN JUAN,171,261,351,348,699
70,70049,700490204,Iglesia,SAN JUAN,253,363,464,510,974
70,70049,700490303,Iglesia,SAN JUAN,76,178,177,148,325
70,70049,700490201,Iglesia,SAN JUAN,113,139,209,213,422
70,70049,700490207,Iglesia,SAN JUAN,238,366,430,476,906
70,70049,700490401,Iglesia,SAN JUAN,8,14,55,2195,2250
70,70049,700490206,Iglesia,SAN JUAN,83,111,162,182,344
70,70049,700490101,Iglesia,SAN JUAN,98,135,151,200,351
70,70049,700490205,Iglesia,SAN JUAN,168,352,328,343,671
70,70049,700490301,Iglesia,SAN JUAN,87,136,185,216,401
70,70049,700490302,Iglesia,SAN JUAN,172,228,330,331,661
70,70049,700490102,Iglesia,SAN JUAN,30,40,49,66,115
70,70063,700630202,9 de Julio,SAN JUAN,326,327,731,754,1485
70,70063,700630203,9 de Julio,SAN JUAN,302,321,603,577,1180
70,70063,700630205,9 de Julio,SAN JUAN,264,257,483,491,974
70,70063,700630103,9 de Julio,SAN JUAN,367,395,786,767,1553
70,70063,700630104,9 de Julio,SAN JUAN,73,75,160,153,313
70,70063,700630204,9 de Julio,SAN JUAN,240,251,506,487,993
70,70063,700630101,9 de Julio,SAN JUAN,121,147,242,269,511
70,70063,700630201,9 de Julio,SAN JUAN,44,74,75,79,154
70,70063,700630102,9 de Julio,SAN JUAN,181,185,401,398,799
70,70063,700630106,9 de Julio,SAN JUAN,269,293,620,580,1200
70,70063,700630105,9 de Julio,SAN JUAN,34,38,73,72,145
66,66147,661470307,Rosario de Lerma,SALTA,564,733,1108,1148,2256
66,66147,661470502,Rosario de Lerma,SALTA,226,235,519,558,1077
66,66147,661470407,Rosario de Lerma,SALTA,455,436,1196,1188,2384
66,66147,661470514,Rosario de Lerma,SALTA,294,290,624,625,1249
66,66147,661470314,Rosario de Lerma,SALTA,144,224,289,268,557
66,66147,661470405,Rosario de Lerma,SALTA,62,98,85,119,204
66,66147,661470303,Rosario de Lerma,SALTA,12,24,9,18,27
66,66147,661470301,Rosario de Lerma,SALTA,21,71,45,62,107
66,66147,661470102,Rosario de Lerma,SALTA,34,46,89,70,159
66,66147,661470504,Rosario de Lerma,SALTA,317,309,665,642,1307
66,66147,661470510,Rosario de Lerma,SALTA,335,294,775,751,1526
66,66147,661470302,Rosario de Lerma,SALTA,47,74,67,105,172
66,66147,661470505,Rosario de Lerma,SALTA,225,228,460,477,937
66,66147,661470409,Rosario de Lerma,SALTA,277,415,518,513,1031
66,66147,661470408,Rosario de Lerma,SALTA,371,393,924,924,1848
66,66147,661470315,Rosario de Lerma,SALTA,417,434,1013,892,1905
66,66147,661470508,Rosario de Lerma,SALTA,199,218,479,410,889
66,66147,661470404,Rosario de Lerma,SALTA,122,144,266,298,564
66,66147,661470402,Rosario de Lerma,SALTA,180,261,381,394,775
66,66147,661470104,Rosario de Lerma,SALTA,46,101,87,86,173
66,66147,661470312,Rosario de Lerma,SALTA,325,365,740,655,1395
66,66147,661470507,Rosario de Lerma,SALTA,258,233,544,489,1033
66,66147,661470313,Rosario de Lerma,SALTA,185,258,341,351,692
66,66147,661470310,Rosario de Lerma,SALTA,7,16,10,14,24
66,66147,661470304,Rosario de Lerma,SALTA,9,24,10,15,25
66,66147,661470203,Rosario de Lerma,SALTA,20,32,43,41,84
66,66147,661470103,Rosario de Lerma,SALTA,34,47,77,65,142
66,66147,661470503,Rosario de Lerma,SALTA,219,209,603,565,1168
66,66147,661470511,Rosario de Lerma,SALTA,354,365,747,751,1498
66,66147,661470509,Rosario de Lerma,SALTA,285,284,534,507,1041
66,66147,661470506,Rosario de Lerma,SALTA,245,245,499,505,1004
66,66147,661470311,Rosario de Lerma,SALTA,316,332,695,707,1402
66,66147,661470406,Rosario de Lerma,SALTA,5,11,8,7,15
66,66147,661470403,Rosario de Lerma,SALTA,97,106,190,212,402
66,66147,661470401,Rosario de Lerma,SALTA,301,588,555,581,1136
66,66147,661470305,Rosario de Lerma,SALTA,32,50,33,50,83
66,66147,661470202,Rosario de Lerma,SALTA,48,71,79,95,174
66,66147,661470515,Rosario de Lerma,SALTA,237,232,523,526,1049
66,66147,661470513,Rosario de Lerma,SALTA,274,279,616,627,1243
66,66147,661470512,Rosario de Lerma,SALTA,173,186,299,262,561
66,66147,661470205,Rosario de Lerma,SALTA,38,71,64,75,139
66,66147,661470501,Rosario de Lerma,SALTA,221,249,494,487,981
66,66147,661470317,Rosario de Lerma,SALTA,335,364,860,836,1696
66,66147,661470316,Rosario de Lerma,SALTA,336,341,756,719,1475
66,66147,661470309,Rosario de Lerma,SALTA,13,17,33,30,63
66,66147,661470308,Rosario de Lerma,SALTA,7,13,8,15,23
66,66147,661470306,Rosario de Lerma,SALTA,134,212,217,274,491
66,66147,661470204,Rosario de Lerma,SALTA,12,21,24,37,61
66,66147,661470201,Rosario de Lerma,SALTA,31,52,87,57,144
66,66147,661470105,Rosario de Lerma,SALTA,41,64,71,82,153
66,66147,661470101,Rosario de Lerma,SALTA,28,33,90,68,158
66,66133,661330216,Rivadavia,SALTA,243,323,496,534,1030
66,66133,661330101,Rivadavia,SALTA,662,627,1619,1649,3268
66,66133,661330210,Rivadavia,SALTA,98,110,160,188,348
66,66133,661330305,Rivadavia,SALTA,168,162,389,392,781
66,66133,661330303,Rivadavia,SALTA,34,34,64,73,137
66,66133,661330302,Rivadavia,SALTA,111,132,179,245,424
66,66133,661330211,Rivadavia,SALTA,70,75,127,154,281
66,66133,661330209,Rivadavia,SALTA,56,94,95,123,218
66,66133,661330219,Rivadavia,SALTA,128,162,259,270,529
66,66133,661330307,Rivadavia,SALTA,49,50,53,127,180
66,66133,661330217,Rivadavia,SALTA,35,38,39,75,114
66,66133,661330204,Rivadavia,SALTA,33,38,60,95,155
66,66133,661330106,Rivadavia,SALTA,251,220,536,597,1133
66,66133,661330301,Rivadavia,SALTA,188,211,336,409,745
66,66133,661330208,Rivadavia,SALTA,173,204,327,371,698
66,66133,661330308,Rivadavia,SALTA,84,111,220,212,432
66,66133,661330218,Rivadavia,SALTA,55,60,109,139,248
66,66133,661330310,Rivadavia,SALTA,251,316,547,509,1056
66,66133,661330222,Rivadavia,SALTA,139,161,248,253,501
66,66133,661330212,Rivadavia,SALTA,72,65,107,155,262
66,66133,661330201,Rivadavia,SALTA,33,38,62,78,140
66,66133,661330312,Rivadavia,SALTA,282,336,563,565,1128
66,66133,661330309,Rivadavia,SALTA,231,238,496,477,973
66,66133,661330224,Rivadavia,SALTA,238,290,533,510,1043
66,66133,661330223,Rivadavia,SALTA,211,239,397,400,797
66,66133,661330220,Rivadavia,SALTA,251,324,518,555,1073
66,66133,661330205,Rivadavia,SALTA,28,31,33,58,91
66,66133,661330203,Rivadavia,SALTA,101,100,215,269,484
66,66133,661330304,Rivadavia,SALTA,220,235,465,539,1004
66,66133,661330108,Rivadavia,SALTA,429,513,893,916,1809
66,66133,661330102,Rivadavia,SALTA,447,448,997,1005,2002
66,66133,661330306,Rivadavia,SALTA,235,260,429,530,959
66,66133,661330213,Rivadavia,SALTA,40,40,88,108,196
66,66133,661330202,Rivadavia,SALTA,28,27,49,62,111
66,66133,661330311,Rivadavia,SALTA,256,317,511,516,1027
66,66133,661330104,Rivadavia,SALTA,116,123,205,224,429
66,66133,661330215,Rivadavia,SALTA,28,34,43,52,95
66,66133,661330214,Rivadavia,SALTA,163,181,258,268,526
66,66133,661330207,Rivadavia,SALTA,26,31,32,46,78
66,66133,661330206,Rivadavia,SALTA,38,41,58,101,159
66,66133,661330105,Rivadavia,SALTA,64,73,104,154,258
66,66133,661330107,Rivadavia,SALTA,385,404,853,939,1792
66,66133,661330221,Rivadavia,SALTA,273,263,582,564,1146
66,66133,661330103,Rivadavia,SALTA,131,122,224,273,497
66,66126,661260205,Orán,SALTA,246,279,371,459,830
66,66126,661260812,Orán,SALTA,379,381,995,1030,2025
66,66126,661260803,Orán,SALTA,154,199,254,214,468
66,66126,661260708,Orán,SALTA,337,333,744,772,1516
66,66126,661260616,Orán,SALTA,281,282,654,669,1323
66,66126,661260615,Orán,SALTA,304,309,590,646,1236
66,66126,661260416,Orán,SALTA,357,350,750,696,1446
66,66126,661260415,Orán,SALTA,317,279,615,567,1182
66,66126,661260215,Orán,SALTA,329,369,694,645,1339
66,66126,661260210,Orán,SALTA,291,296,680,679,1359
66,66126,661260707,Orán,SALTA,317,315,681,656,1337
66,66126,661260706,Orán,SALTA,290,284,582,558,1140
66,66126,661260624,Orán,SALTA,276,285,531,569,1100
66,66126,661260621,Orán,SALTA,200,223,378,406,784
66,66126,661260503,Orán,SALTA,5,5,9,13,22
66,66126,661260204,Orán,SALTA,35,84,41,59,100
66,66126,661260101,Orán,SALTA,35,60,74,78,152
66,66126,661260805,Orán,SALTA,200,203,340,346,686
66,66126,661260722,Orán,SALTA,218,236,424,414,838
66,66126,661260719,Orán,SALTA,166,179,337,309,646
66,66126,661260614,Orán,SALTA,317,324,765,785,1550
66,66126,661260609,Orán,SALTA,355,297,945,1060,2005
66,66126,661260504,Orán,SALTA,276,332,563,580,1143
66,66126,661260218,Orán,SALTA,224,228,561,556,1117
66,66126,661260105,Orán,SALTA,262,252,627,803,1430
66,66126,661260703,Orán,SALTA,258,238,698,744,1442
66,66126,661260712,Orán,SALTA,213,223,378,373,751
66,66126,661260606,Orán,SALTA,27,42,45,97,142
66,66126,661260403,Orán,SALTA,27,32,47,60,107
66,66126,661260823,Orán,SALTA,291,279,668,635,1303
66,66126,661260806,Orán,SALTA,207,193,350,299,649
66,66126,661260801,Orán,SALTA,360,360,891,936,1827
66,66126,661260718,Orán,SALTA,282,315,522,509,1031
66,66126,661260714,Orán,SALTA,295,274,707,721,1428
66,66126,661260617,Orán,SALTA,238,261,449,443,892
66,66126,661260611,Orán,SALTA,386,382,1012,1070,2082
66,66126,661260506,Orán,SALTA,225,233,576,531,1107
66,66126,661260505,Orán,SALTA,253,255,574,579,1153
66,66126,661260418,Orán,SALTA,229,221,539,498,1037
66,66126,661260211,Orán,SALTA,291,331,515,519,1034
66,66126,661260209,Orán,SALTA,439,480,887,836,1723
66,66126,661260408,Orán,SALTA,189,215,494,497,991
66,66126,661260406,Orán,SALTA,108,137,221,245,466
66,66126,661260723,Orán,SALTA,289,290,637,630,1267
66,66126,661260412,Orán,SALTA,380,406,868,862,1730
66,66126,661260705,Orán,SALTA,209,200,426,440,866
66,66126,661260701,Orán,SALTA,371,358,931,885,1816
66,66126,661260623,Orán,SALTA,136,240,247,258,505
66,66126,661260213,Orán,SALTA,342,361,747,716,1463
66,66126,661260604,Orán,SALTA,42,71,30,68,98
66,66126,661260602,Orán,SALTA,70,102,53,123,176
66,66126,661260202,Orán,SALTA,76,121,98,125,223
66,66126,661260402,Orán,SALTA,160,164,356,368,724
66,66126,661260601,Orán,SALTA,239,353,458,473,931
66,66126,661260816,Orán,SALTA,327,347,607,555,1162
66,66126,661260815,Orán,SALTA,316,299,667,632,1299
66,66126,661260814,Orán,SALTA,390,365,934,817,1751
66,66126,661260720,Orán,SALTA,287,276,665,653,1318
66,66126,661260717,Orán,SALTA,296,313,578,536,1114
66,66126,661260613,Orán,SALTA,302,294,686,670,1356
66,66126,661260610,Orán,SALTA,351,361,980,1035,2015
66,66126,661260212,Orán,SALTA,253,245,537,520,1057
66,66126,661260702,Orán,SALTA,311,274,886,890,1776
66,66126,661260819,Orán,SALTA,325,329,726,736,1462
66,66126,661260711,Orán,SALTA,212,245,393,408,801
66,66126,661260603,Orán,SALTA,222,273,296,461,757
66,66126,661260607,Orán,SALTA,24,33,41,76,117
66,66126,661260203,Orán,SALTA,199,461,352,370,722
66,66126,661260502,Orán,SALTA,266,354,584,545,1129
66,66126,661260401,Orán,SALTA,224,366,558,572,1130
66,66126,661260820,Orán,SALTA,152,160,261,233,494
66,66126,661260818,Orán,SALTA,521,467,1142,1132,2274
66,66126,661260811,Orán,SALTA,231,232,553,520,1073
66,66126,661260810,Orán,SALTA,206,204,452,442,894
66,66126,661260804,Orán,SALTA,182,206,349,332,681
66,66126,661260802,Orán,SALTA,278,259,573,471,1044
66,66126,661260619,Orán,SALTA,358,384,823,891,1714
66,66126,661260612,Orán,SALTA,238,225,659,693,1352
66,66126,661260709,Orán,SALTA,455,410,1057,1016,2073
66,66126,661260414,Orán,SALTA,266,267,599,588,1187
66,66126,661260411,Orán,SALTA,331,335,762,828,1590
66,66126,661260410,Orán,SALTA,460,437,954,957,1911
66,66126,661260409,Orán,SALTA,180,184,532,581,1113
66,66126,661260304,Orán,SALTA,193,223,477,466,943
66,66126,661260104,Orán,SALTA,193,183,475,490,965
66,66126,661260405,Orán,SALTA,23,23,30,41,71
66,66126,661260824,Orán,SALTA,415,405,927,901,1828
66,66126,661260821,Orán,SALTA,362,351,726,730,1456
66,66126,661260817,Orán,SALTA,358,306,676,734,1410
66,66126,661260813,Orán,SALTA,358,342,870,866,1736
66,66126,661260807,Orán,SALTA,193,181,381,347,728
66,66126,661260721,Orán,SALTA,302,324,583,548,1131
66,66126,661260715,Orán,SALTA,199,253,385,406,791
66,66126,661260710,Orán,SALTA,219,227,451,416,867
66,66126,661260618,Orán,SALTA,232,242,485,493,978
66,66126,661260511,Orán,SALTA,296,240,618,640,1258
66,66126,661260413,Orán,SALTA,292,297,770,752,1522
66,66126,661260208,Orán,SALTA,289,306,649,565,1214
66,66126,661260217,Orán,SALTA,469,446,1144,1178,2322
66,66126,661260625,Orán,SALTA,176,195,373,384,757
66,66126,661260713,Orán,SALTA,320,293,872,907,1779
66,66126,661260510,Orán,SALTA,283,218,668,665,1333
66,66126,661260501,Orán,SALTA,14,51,8,15,23
66,66126,661260201,Orán,SALTA,79,202,105,156,261
66,66126,661260822,Orán,SALTA,358,341,735,693,1428
66,66126,661260809,Orán,SALTA,419,406,1019,1022,2041
66,66126,661260808,Orán,SALTA,210,188,425,431,856
66,66126,661260716,Orán,SALTA,191,223,297,241,538
66,66126,661260620,Orán,SALTA,353,384,772,763,1535
66,66126,661260508,Orán,SALTA,315,310,663,666,1329
66,66126,661260507,Orán,SALTA,359,354,709,681,1390
66,66126,661260417,Orán,SALTA,146,164,336,306,642
66,66126,661260303,Orán,SALTA,285,307,611,604,1215
66,66126,661260302,Orán,SALTA,170,177,372,390,762
66,66126,661260216,Orán,SALTA,285,345,518,509,1027
66,66126,661260214,Orán,SALTA,282,305,586,570,1156
66,66126,661260207,Orán,SALTA,236,245,490,498,988
66,66126,661260206,Orán,SALTA,402,420,988,955,1943
66,66126,661260704,Orán,SALTA,272,276,587,527,1114
66,66126,661260622,Orán,SALTA,196,222,451,464,915
66,66126,661260509,Orán,SALTA,378,333,757,792,1549
66,66126,661260608,Orán,SALTA,8,8,4,13,17
66,66126,661260605,Orán,SALTA,67,109,112,146,258
66,66126,661260407,Orán,SALTA,36,51,47,81,128
66,66126,661260404,Orán,SALTA,51,62,119,123,242
66,66126,661260301,Orán,SALTA,59,75,121,134,255
66,66126,661260103,Orán,SALTA,153,181,224,279,503
66,66126,661260102,Orán,SALTA,397,445,689,841,1530
66,66112,661120201,Metán,SALTA,114,146,197,250,447
66,66112,661120403,Metán,SALTA,172,175,321,271,592
66,66112,661120311,Metán,SALTA,214,216,534,485,1019
66,66112,661120207,Metán,SALTA,30,35,8,81,89
66,66112,661120308,Metán,SALTA,179,213,325,263,588
66,66112,661120215,Metán,SALTA,282,303,586,531,1117
66,66112,661120411,Metán,SALTA,299,335,582,515,1097
66,66112,661120110,Metán,SALTA,103,112,170,207,377
66,66112,661120109,Metán,SALTA,308,355,698,722,1420
66,66112,661120104,Metán,SALTA,51,69,53,69,122
66,66112,661120412,Metán,SALTA,345,366,689,680,1369
66,66112,661120408,Metán,SALTA,199,198,429,427,856
66,66112,661120406,Metán,SALTA,248,280,456,439,895
66,66112,661120304,Metán,SALTA,202,208,460,394,854
66,66112,661120302,Metán,SALTA,254,271,511,488,999
66,66112,661120213,Metán,SALTA,347,335,696,758,1454
66,66112,661120212,Metán,SALTA,277,286,540,542,1082
66,66112,661120211,Metán,SALTA,49,61,72,83,155
66,66112,661120413,Metán,SALTA,360,320,789,761,1550
66,66112,661120206,Metán,SALTA,68,86,130,164,294
66,66112,661120203,Metán,SALTA,9,19,0,11,11
66,66112,661120309,Metán,SALTA,223,237,481,414,895
66,66112,661120210,Metán,SALTA,144,173,241,277,518
66,66112,661120405,Metán,SALTA,336,330,600,523,1123
66,66112,661120404,Metán,SALTA,248,312,442,374,816
66,66112,661120301,Metán,SALTA,309,257,632,634,1266
66,66112,661120410,Metán,SALTA,182,217,427,398,825
66,66112,661120204,Metán,SALTA,39,45,41,65,106
66,66112,661120107,Metán,SALTA,65,100,80,141,221
66,66112,661120305,Metán,SALTA,280,292,626,650,1276
66,66112,661120303,Metán,SALTA,204,230,409,435,844
66,66112,661120401,Metán,SALTA,355,369,751,782,1533
66,66112,661120214,Metán,SALTA,404,414,876,838,1714
66,66112,661120409,Metán,SALTA,424,397,1007,937,1944
66,66112,661120407,Metán,SALTA,187,212,377,332,709
66,66112,661120208,Metán,SALTA,159,182,290,325,615
66,66112,661120105,Metán,SALTA,253,344,495,527,1022
66,66112,661120307,Metán,SALTA,181,185,369,297,666
66,66112,661120313,Metán,SALTA,267,263,523,460,983
66,66112,661120312,Metán,SALTA,346,381,725,635,1360
66,66112,661120209,Metán,SALTA,205,223,326,496,822
66,66112,661120101,Metán,SALTA,65,104,108,122,230
66,66112,661120106,Metán,SALTA,105,159,200,249,449
66,66112,661120306,Metán,SALTA,283,286,573,547,1120
66,66112,661120402,Metán,SALTA,179,194,386,318,704
66,66112,661120310,Metán,SALTA,346,375,753,732,1485
66,66112,661120108,Metán,SALTA,82,88,139,158,297
66,66112,661120205,Metán,SALTA,85,117,105,181,286
66,66112,661120102,Metán,SALTA,9,21,7,13,20
66,66112,661120202,Metán,SALTA,31,49,9,46,55
66,66112,661120103,Metán,SALTA,22,38,28,32,60
66,66161,661610105,Santa Victoria,SALTA,142,210,299,286,585
66,66161,661610205,Santa Victoria,SALTA,262,311,513,489,1002
66,66161,661610203,Santa Victoria,SALTA,75,164,127,161,288
66,66161,661610103,Santa Victoria,SALTA,243,300,603,552,1155
66,66161,661610204,Santa Victoria,SALTA,50,81,84,101,185
66,66161,661610109,Santa Victoria,SALTA,90,222,209,191,400
66,66161,661610306,Santa Victoria,SALTA,231,296,475,441,916
66,66161,661610107,Santa Victoria,SALTA,67,104,124,103,227
66,66161,661610301,Santa Victoria,SALTA,78,160,143,140,283
66,66161,661610104,Santa Victoria,SALTA,56,183,109,104,213
66,66161,661610101,Santa Victoria,SALTA,63,89,111,111,222
66,66161,661610110,Santa Victoria,SALTA,298,378,595,556,1151
66,66161,661610202,Santa Victoria,SALTA,97,142,191,182,373
66,66161,661610201,Santa Victoria,SALTA,93,115,153,181,334
66,66161,661610106,Santa Victoria,SALTA,48,72,115,95,210
66,66161,661610102,Santa Victoria,SALTA,213,328,502,467,969
66,66161,661610108,Santa Victoria,SALTA,52,95,102,89,191
66,66161,661610302,Santa Victoria,SALTA,112,197,239,231,470
66,66161,661610303,Santa Victoria,SALTA,41,86,62,54,116
66,66161,661610304,Santa Victoria,SALTA,182,283,402,384,786
66,66161,661610305,Santa Victoria,SALTA,52,111,146,122,268
66,66105,661050202,Los Andes,SALTA,100,178,219,255,474
66,66105,661050103,Los Andes,SALTA,3,3,2,4,6
66,66105,661050213,Los Andes,SALTA,238,263,602,555,1157
66,66105,661050211,Los Andes,SALTA,156,214,372,402,774
66,66105,661050104,Los Andes,SALTA,51,69,117,113,230
66,66105,661050208,Los Andes,SALTA,7,12,8,51,59
66,66105,661050207,Los Andes,SALTA,3,6,1,2,3
66,66105,661050206,Los Andes,SALTA,5,24,0,8,8
66,66105,661050205,Los Andes,SALTA,14,26,5,108,113
66,66105,661050203,Los Andes,SALTA,54,108,83,67,150
66,66105,661050210,Los Andes,SALTA,173,233,433,372,805
66,66105,661050204,Los Andes,SALTA,18,35,31,35,66
66,66105,661050102,Los Andes,SALTA,0,2,0,0,0
66,66105,661050209,Los Andes,SALTA,239,314,659,658,1317
66,66105,661050201,Los Andes,SALTA,36,93,35,143,178
66,66105,661050101,Los Andes,SALTA,0,14,0,0,0
66,66105,661050212,Los Andes,SALTA,153,202,356,354,710
66,66098,660980205,La Viña,SALTA,113,165,199,218,417
66,66098,660980101,La Viña,SALTA,178,294,400,356,756
66,66098,660980104,La Viña,SALTA,31,66,25,60,85
66,66098,660980105,La Viña,SALTA,381,245,776,788,1564
66,66098,660980208,La Viña,SALTA,211,233,438,418,856
66,66098,660980203,La Viña,SALTA,71,141,118,142,260
66,66098,660980201,La Viña,SALTA,18,34,17,29,46
66,66098,660980106,La Viña,SALTA,440,377,961,875,1836
66,66098,660980204,La Viña,SALTA,22,41,25,42,67
66,66098,660980103,La Viña,SALTA,57,147,69,107,176
66,66098,660980206,La Viña,SALTA,4,7,3,8,11
66,66098,660980102,La Viña,SALTA,86,141,124,144,268
66,66098,660980209,La Viña,SALTA,227,221,487,482,969
66,66098,660980207,La Viña,SALTA,28,35,63,55,118
66,66098,660980202,La Viña,SALTA,2,8,2,4,6
66,66056,660560603,General José de San Martín,SALTA,156,172,297,362,659
66,66056,660560402,General José de San Martín,SALTA,222,195,430,419,849
66,66056,660560925,General José de San Martín,SALTA,302,332,641,649,1290
66,66056,660560919,General José de San Martín,SALTA,266,309,547,562,1109
66,66056,660560918,General José de San Martín,SALTA,253,264,637,559,1196
66,66056,660560627,General José de San Martín,SALTA,218,241,454,461,915
66,66056,660560626,General José de San Martín,SALTA,285,281,727,712,1439
66,66056,660560625,General José de San Martín,SALTA,156,152,359,287,646
66,66056,660560614,General José de San Martín,SALTA,350,323,728,684,1412
66,66056,660560216,General José de San Martín,SALTA,210,244,484,497,981
66,66056,660560105,General José de San Martín,SALTA,292,332,686,638,1324
66,66056,660560616,General José de San Martín,SALTA,409,398,955,1006,1961
66,66056,660560811,General José de San Martín,SALTA,152,151,250,217,467
66,66056,660560611,General José de San Martín,SALTA,175,208,387,418,805
66,66056,660560209,General José de San Martín,SALTA,101,111,241,264,505
66,66056,660560502,General José de San Martín,SALTA,39,28,27,76,103
66,66056,660560501,General José de San Martín,SALTA,18,18,1,65,66
66,66056,660560202,General José de San Martín,SALTA,119,150,180,268,448
66,66056,660560609,General José de San Martín,SALTA,44,40,87,105,192
66,66056,660560205,General José de San Martín,SALTA,118,123,236,264,500
66,66056,660560103,General José de San Martín,SALTA,214,243,432,483,915
66,66056,660560102,General José de San Martín,SALTA,311,299,668,720,1388
66,66056,660561014,General José de San Martín,SALTA,159,184,298,292,590
66,66056,660561013,General José de San Martín,SALTA,289,320,634,584,1218
66,66056,660561012,General José de San Martín,SALTA,227,197,452,447,899
66,66056,660561009,General José de San Martín,SALTA,190,200,341,328,669
66,66056,660560916,General José de San Martín,SALTA,327,326,698,645,1343
66,66056,660560915,General José de San Martín,SALTA,416,426,779,737,1516
66,66056,660560904,General José de San Martín,SALTA,269,270,496,434,930
66,66056,660560808,General José de San Martín,SALTA,182,217,275,287,562
66,66056,660560701,General José de San Martín,SALTA,508,534,1197,1147,2344
66,66056,660560630,General José de San Martín,SALTA,124,133,237,294,531
66,66056,660560624,General José de San Martín,SALTA,515,510,1322,1419,2741
66,66056,660560622,General José de San Martín,SALTA,311,384,524,514,1038
66,66056,660560408,General José de San Martín,SALTA,228,273,420,424,844
66,66056,660560218,General José de San Martín,SALTA,319,330,632,602,1234
66,66056,660560212,General José de San Martín,SALTA,223,250,449,416,865
66,66056,660560409,General José de San Martín,SALTA,160,186,329,314,643
66,66056,660560118,General José de San Martín,SALTA,272,334,600,583,1183
66,66056,660560116,General José de San Martín,SALTA,122,148,292,315,607
66,66056,660560110,General José de San Martín,SALTA,254,238,450,410,860
66,66056,660560307,General José de San Martín,SALTA,248,223,615,666,1281
66,66056,660560607,General José de San Martín,SALTA,41,51,56,85,141
66,66056,660560403,General José de San Martín,SALTA,158,170,254,283,537
66,66056,660560401,General José de San Martín,SALTA,148,96,269,331,600
66,66056,660561010,General José de San Martín,SALTA,322,363,615,582,1197
66,66056,660560909,General José de San Martín,SALTA,506,512,1003,935,1938
66,66056,660560907,General José de San Martín,SALTA,320,325,697,696,1393
66,66056,660560906,General José de San Martín,SALTA,282,273,561,577,1138
66,66056,660560905,General José de San Martín,SALTA,299,295,571,576,1147
66,66056,660560903,General José de San Martín,SALTA,244,247,406,362,768
66,66056,660560809,General José de San Martín,SALTA,190,207,311,281,592
66,66056,660560715,General José de San Martín,SALTA,376,392,895,851,1746
66,66056,660560708,General José de San Martín,SALTA,409,434,879,884,1763
66,66056,660560803,General José de San Martín,SALTA,254,263,491,484,975
66,66056,660560706,General José de San Martín,SALTA,349,354,735,668,1403
66,66056,660560704,General José de San Martín,SALTA,232,255,460,420,880
66,66056,660560629,General José de San Martín,SALTA,181,225,349,382,731
66,66056,660560620,General José de San Martín,SALTA,226,260,444,446,890
66,66056,660560411,General José de San Martín,SALTA,180,201,337,368,705
66,66056,660560407,General José de San Martín,SALTA,88,82,174,157,331
66,66056,660560117,General José de San Martín,SALTA,248,265,541,555,1096
66,66056,660560108,General José de San Martín,SALTA,203,234,408,379,787
66,66056,660560305,General José de San Martín,SALTA,232,168,843,843,1686
66,66056,660560214,General José de San Martín,SALTA,193,187,376,341,717
66,66056,660560610,General José de San Martín,SALTA,34,54,43,63,106
66,66056,660560606,General José de San Martín,SALTA,57,52,113,119,232
66,66056,660560104,General José de San Martín,SALTA,23,29,6,38,44
66,66056,660560503,General José de San Martín,SALTA,86,91,144,215,359
66,66056,660560911,General José de San Martín,SALTA,408,443,749,763,1512
66,66056,660560813,General José de San Martín,SALTA,246,217,455,425,880
66,66056,660560812,General José de San Martín,SALTA,297,303,519,447,966
66,66056,660560807,General José de San Martín,SALTA,128,147,244,209,453
66,66056,660560806,General José de San Martín,SALTA,191,329,282,289,571
66,66056,660560713,General José de San Martín,SALTA,312,309,508,484,992
66,66056,660560628,General José de San Martín,SALTA,219,227,524,500,1024
66,66056,660560623,General José de San Martín,SALTA,190,236,364,327,691
66,66056,660560612,General José de San Martín,SALTA,253,304,550,498,1048
66,66056,660560306,General José de San Martín,SALTA,330,282,639,695,1334
66,66056,660560215,General José de San Martín,SALTA,195,212,346,361,707
66,66056,660560211,General José de San Martín,SALTA,236,233,480,521,1001
66,66056,660560410,General José de San Martín,SALTA,283,292,643,681,1324
66,66056,660560119,General José de San Martín,SALTA,338,369,757,750,1507
66,66056,660560112,General José de San Martín,SALTA,493,524,974,944,1918
66,66056,660560208,General José de San Martín,SALTA,122,109,291,329,620
66,66056,660560605,General José de San Martín,SALTA,68,83,126,143,269
66,66056,660560301,General José de San Martín,SALTA,237,263,483,540,1023
66,66056,660560207,General José de San Martín,SALTA,41,47,10,141,151
66,66056,660560608,General José de San Martín,SALTA,266,256,664,720,1384
66,66056,660560203,General José de San Martín,SALTA,319,309,749,744,1493
66,66056,660561011,General José de San Martín,SALTA,300,283,623,506,1129
66,66056,660561008,General José de San Martín,SALTA,236,256,460,426,886
66,66056,660560917,General José de San Martín,SALTA,448,444,998,977,1975
66,66056,660560910,General José de San Martín,SALTA,216,237,448,447,895
66,66056,660560801,General José de San Martín,SALTA,292,305,614,605,1219
66,66056,660560714,General José de San Martín,SALTA,272,248,542,512,1054
66,66056,660560712,General José de San Martín,SALTA,207,208,313,313,626
66,66056,660560618,General José de San Martín,SALTA,427,411,928,833,1761
66,66056,660560217,General José de San Martín,SALTA,190,211,342,326,668
66,66056,660560617,General José de San Martín,SALTA,294,269,619,657,1276
66,66056,660560213,General José de San Martín,SALTA,397,415,754,705,1459
66,66056,660560115,General José de San Martín,SALTA,222,199,563,513,1076
66,66056,660560114,General José de San Martín,SALTA,276,273,683,615,1298
66,66056,660561002,General José de San Martín,SALTA,364,389,797,774,1571
66,66056,660560619,General José de San Martín,SALTA,229,243,398,374,772
66,66056,660560601,General José de San Martín,SALTA,26,33,15,37,52
66,66056,660560404,General José de San Martín,SALTA,6,6,6,80,86
66,66056,660560303,General José de San Martín,SALTA,132,88,235,305,540
66,66056,660561007,General José de San Martín,SALTA,237,249,442,448,890
66,66056,660561004,General José de San Martín,SALTA,260,287,461,420,881
66,66056,660561001,General José de San Martín,SALTA,234,260,496,436,932
66,66056,660560922,General José de San Martín,SALTA,274,278,565,539,1104
66,66056,660560914,General José de San Martín,SALTA,252,257,488,434,922
66,66056,660560810,General José de San Martín,SALTA,234,234,441,423,864
66,66056,660560805,General José de San Martín,SALTA,215,279,319,303,622
66,66056,660560711,General José de San Martín,SALTA,287,301,518,478,996
66,66056,660560710,General José de San Martín,SALTA,398,419,889,860,1749
66,66056,660560705,General José de San Martín,SALTA,275,272,586,539,1125
66,66056,660560802,General José de San Martín,SALTA,301,311,678,694,1372
66,66056,660560621,General José de San Martín,SALTA,290,261,620,619,1239
66,66056,660560615,General José de San Martín,SALTA,347,348,757,816,1573
66,66056,660560405,General José de San Martín,SALTA,290,340,646,636,1282
66,66056,660560120,General José de San Martín,SALTA,168,171,415,410,825
66,66056,660560111,General José de San Martín,SALTA,223,211,486,454,940
66,66056,660560201,General José de San Martín,SALTA,57,68,114,241,355
66,66056,660560604,General José de San Martín,SALTA,56,66,62,98,160
66,66056,660560304,General José de San Martín,SALTA,171,169,367,379,746
66,66056,660560204,General José de San Martín,SALTA,289,305,775,818,1593
66,66056,660561005,General José de San Martín,SALTA,277,285,578,509,1087
66,66056,660561003,General José de San Martín,SALTA,309,306,640,626,1266
66,66056,660560923,General José de San Martín,SALTA,290,306,601,578,1179
66,66056,660560920,General José de San Martín,SALTA,308,294,578,590,1168
66,66056,660560908,General José de San Martín,SALTA,344,363,729,770,1499
66,66056,660560815,General José de San Martín,SALTA,324,333,738,729,1467
66,66056,660560707,General José de San Martín,SALTA,46,459,83,104,187
66,66056,660560113,General José de San Martín,SALTA,148,150,368,360,728
66,66056,660560106,General José de San Martín,SALTA,387,418,931,835,1766
66,66056,660560703,General José de San Martín,SALTA,291,319,659,614,1273
66,66056,660560613,General José de San Martín,SALTA,296,315,665,637,1302
66,66056,660560602,General José de San Martín,SALTA,79,93,188,179,367
66,66056,660560302,General José de San Martín,SALTA,233,161,535,532,1067
66,66056,660561006,General José de San Martín,SALTA,246,250,425,439,864
66,66056,660560924,General José de San Martín,SALTA,284,307,624,624,1248
66,66056,660560921,General José de San Martín,SALTA,213,251,416,641,1057
66,66056,660560913,General José de San Martín,SALTA,324,333,610,616,1226
66,66056,660560912,General José de San Martín,SALTA,265,273,499,536,1035
66,66056,660560902,General José de San Martín,SALTA,259,296,422,411,833
66,66056,660560901,General José de San Martín,SALTA,57,64,94,142,236
66,66056,660560814,General José de San Martín,SALTA,303,310,701,717,1418
66,66056,660560804,General José de San Martín,SALTA,265,289,513,471,984
66,66056,660560709,General José de San Martín,SALTA,248,247,528,518,1046
66,66056,660560702,General José de San Martín,SALTA,290,292,673,622,1295
66,66056,660560505,General José de San Martín,SALTA,233,236,479,502,981
66,66056,660560406,General José de San Martín,SALTA,63,67,135,105,240
66,66056,660560210,General José de San Martín,SALTA,320,348,609,607,1216
66,66056,660560109,General José de San Martín,SALTA,259,247,646,586,1232
66,66056,660560107,General José de San Martín,SALTA,240,273,522,517,1039
66,66056,660561015,General José de San Martín,SALTA,198,209,380,371,751
66,66056,660560504,General José de San Martín,SALTA,234,270,521,569,1090
66,66056,660560206,General José de San Martín,SALTA,52,52,121,154,275
66,66056,660560101,General José de San Martín,SALTA,32,32,66,71,137
66,66042,660420105,Chicoana,SALTA,138,179,290,299,589
66,66042,660420209,Chicoana,SALTA,250,206,532,476,1008
66,66042,660420207,Chicoana,SALTA,336,295,702,650,1352
66,66042,660420101,Chicoana,SALTA,98,166,116,153,269
66,66042,660420107,Chicoana,SALTA,71,105,116,144,260
66,66042,660420103,Chicoana,SALTA,252,323,534,521,1055
66,66042,660420109,Chicoana,SALTA,277,262,606,561,1167
66,66042,660420208,Chicoana,SALTA,371,336,782,790,1572
66,66042,660420202,Chicoana,SALTA,182,227,426,425,851
66,66042,660420102,Chicoana,SALTA,51,67,60,83,143
66,66042,660420210,Chicoana,SALTA,246,204,479,470,949
66,66042,660420111,Chicoana,SALTA,263,249,570,557,1127
66,66042,660420108,Chicoana,SALTA,229,206,528,489,1017
66,66042,660420204,Chicoana,SALTA,4,12,4,5,9
66,66042,660420203,Chicoana,SALTA,363,388,790,789,1579
66,66042,660420206,Chicoana,SALTA,406,276,898,924,1822
66,66042,660420104,Chicoana,SALTA,442,512,881,926,1807
66,66042,660420205,Chicoana,SALTA,451,416,918,941,1859
66,66042,660420201,Chicoana,SALTA,125,143,284,302,586
66,66042,660420110,Chicoana,SALTA,204,195,429,406,835
66,66042,660420106,Chicoana,SALTA,190,226,399,455,854
66,66035,660350202,Cerrillos,SALTA,222,241,372,474,846
66,66035,660350122,Cerrillos,SALTA,322,355,651,603,1254
66,66035,660350208,Cerrillos,SALTA,163,136,355,388,743
66,66035,660350106,Cerrillos,SALTA,359,458,645,752,1397
66,66035,660350103,Cerrillos,SALTA,223,286,384,612,996
66,66035,660350107,Cerrillos,SALTA,33,53,72,79,151
66,66035,660350116,Cerrillos,SALTA,313,305,706,702,1408
66,66035,660350114,Cerrillos,SALTA,282,279,638,625,1263
66,66035,660350109,Cerrillos,SALTA,459,390,999,973,1972
66,66035,660350203,Cerrillos,SALTA,210,371,307,383,690
66,66035,660350105,Cerrillos,SALTA,144,275,244,314,558
66,66035,660350212,Cerrillos,SALTA,360,336,801,714,1515
66,66035,660350117,Cerrillos,SALTA,406,454,900,873,1773
66,66035,660350113,Cerrillos,SALTA,283,282,610,564,1174
66,66035,660350112,Cerrillos,SALTA,294,313,561,523,1084
66,66035,660350110,Cerrillos,SALTA,285,280,615,585,1200
66,66035,660350204,Cerrillos,SALTA,15,16,12,26,38
66,66035,660350120,Cerrillos,SALTA,287,227,705,699,1404
66,66035,660350111,Cerrillos,SALTA,277,307,593,505,1098
66,66035,660350108,Cerrillos,SALTA,173,224,332,363,695
66,66035,660350102,Cerrillos,SALTA,202,208,425,438,863
66,66035,660350210,Cerrillos,SALTA,345,361,779,750,1529
66,66035,660350209,Cerrillos,SALTA,296,242,604,609,1213
66,66035,660350119,Cerrillos,SALTA,174,196,429,384,813
66,66035,660350118,Cerrillos,SALTA,222,253,547,533,1080
66,66035,660350115,Cerrillos,SALTA,212,249,429,395,824
66,66035,660350211,Cerrillos,SALTA,270,284,532,540,1072
66,66035,660350121,Cerrillos,SALTA,189,154,440,458,898
66,66035,660350205,Cerrillos,SALTA,45,83,59,101,160
66,66035,660350104,Cerrillos,SALTA,17,25,15,32,47
66,66035,660350101,Cerrillos,SALTA,63,67,101,121,222
66,66035,660350207,Cerrillos,SALTA,91,115,140,189,329
66,66035,660350206,Cerrillos,SALTA,246,261,580,568,1148
66,66035,660350201,Cerrillos,SALTA,333,410,817,807,1624
66,66035,660350124,Cerrillos,SALTA,347,376,676,634,1310
66,66035,660350123,Cerrillos,SALTA,343,370,723,675,1398
66,66007,660070419,Anta,SALTA,298,259,610,579,1189
66,66007,660070413,Anta,SALTA,39,50,87,89,176
66,66007,660070426,Anta,SALTA,226,205,567,626,1193
66,66007,660070424,Anta,SALTA,397,408,918,945,1863
66,66007,660070308,Anta,SALTA,20,26,43,53,96
66,66007,660070306,Anta,SALTA,11,15,2,11,13
66,66007,660070503,Anta,SALTA,35,36,55,82,137
66,66007,660070501,Anta,SALTA,52,53,59,116,175
66,66007,660070620,Anta,SALTA,199,226,413,382,795
66,66007,660070510,Anta,SALTA,193,225,430,447,877
66,66007,660070108,Anta,SALTA,233,263,537,533,1070
66,66007,660070106,Anta,SALTA,194,227,368,404,772
66,66007,660070321,Anta,SALTA,358,337,805,846,1651
66,66007,660070320,Anta,SALTA,262,239,671,648,1319
66,66007,660070214,Anta,SALTA,204,196,421,437,858
66,66007,660070207,Anta,SALTA,249,275,535,526,1061
66,66007,660070401,Anta,SALTA,26,30,31,46,77
66,66007,660070304,Anta,SALTA,41,52,22,91,113
66,66007,660070101,Anta,SALTA,185,205,286,427,713
66,66007,660070206,Anta,SALTA,15,23,13,25,38
66,66007,660070103,Anta,SALTA,83,86,181,219,400
66,66007,660070613,Anta,SALTA,9,18,5,15,20
66,66007,660070611,Anta,SALTA,86,97,159,178,337
66,66007,660070410,Anta,SALTA,47,51,106,108,214
66,66007,660070607,Anta,SALTA,63,77,104,123,227
66,66007,660070415,Anta,SALTA,164,193,353,328,681
66,66007,660070322,Anta,SALTA,249,210,580,575,1155
66,66007,660070315,Anta,SALTA,189,215,393,365,758
66,66007,660070425,Anta,SALTA,230,248,556,577,1133
66,66007,660070404,Anta,SALTA,15,19,15,29,44
66,66007,660070313,Anta,SALTA,24,29,4,31,35
66,66007,660070311,Anta,SALTA,23,26,14,38,52
66,66007,660070105,Anta,SALTA,86,93,121,162,283
66,66007,660070102,Anta,SALTA,19,24,1,21,22
66,66007,660070610,Anta,SALTA,30,33,63,72,135
66,66007,660070604,Anta,SALTA,20,24,41,50,91
66,66007,660070412,Anta,SALTA,34,43,68,62,130
66,66007,660070606,Anta,SALTA,47,54,94,112,206
66,66007,660070621,Anta,SALTA,291,315,687,735,1422
66,66007,660070619,Anta,SALTA,245,308,546,510,1056
66,66007,660070615,Anta,SALTA,189,205,403,447,850
66,66007,660070418,Anta,SALTA,307,339,693,619,1312
66,66007,660070319,Anta,SALTA,258,284,506,463,969
66,66007,660070317,Anta,SALTA,264,269,573,565,1138
66,66007,660070210,Anta,SALTA,193,194,314,370,684
66,66007,660070208,Anta,SALTA,214,240,434,444,878
66,66007,660070403,Anta,SALTA,23,34,12,41,53
66,66007,660070314,Anta,SALTA,14,14,14,25,39
66,66007,660070310,Anta,SALTA,3,5,4,5,9
66,66007,660070307,Anta,SALTA,13,19,8,23,31
66,66007,660070612,Anta,SALTA,49,54,83,106,189
66,66007,660070507,Anta,SALTA,10,19,5,23,28
66,66007,660070506,Anta,SALTA,45,43,55,79,134
66,66007,660070504,Anta,SALTA,29,36,55,43,98
66,66007,660070406,Anta,SALTA,22,39,21,34,55
66,66007,660070601,Anta,SALTA,432,451,935,971,1906
66,66007,660070407,Anta,SALTA,69,88,161,161,322
66,66007,660070616,Anta,SALTA,183,193,402,403,805
66,66007,660070416,Anta,SALTA,399,439,814,736,1550
66,66007,660070213,Anta,SALTA,210,208,402,423,825
66,66007,660070212,Anta,SALTA,265,282,502,569,1071
66,66007,660070204,Anta,SALTA,94,111,192,237,429
66,66007,660070202,Anta,SALTA,67,68,55,123,178
66,66007,660070309,Anta,SALTA,13,21,17,26,43
66,66007,660070508,Anta,SALTA,65,64,124,133,257
66,66007,660070303,Anta,SALTA,158,186,357,396,753
66,66007,660070205,Anta,SALTA,209,206,402,461,863
66,66007,660070414,Anta,SALTA,104,107,209,223,432
66,66007,660070107,Anta,SALTA,203,247,420,412,832
66,66007,660070211,Anta,SALTA,248,268,479,552,1031
66,66007,660070422,Anta,SALTA,246,266,471,420,891
66,66007,660070405,Anta,SALTA,100,107,178,226,404
66,66007,660070312,Anta,SALTA,6,11,1,11,12
66,66007,660070305,Anta,SALTA,28,69,27,44,71
66,66007,660070402,Anta,SALTA,25,38,16,35,51
66,66007,660070203,Anta,SALTA,11,12,6,13,19
66,66007,660070609,Anta,SALTA,50,64,87,112,199
66,66007,660070505,Anta,SALTA,53,57,76,124,200
66,66007,660070411,Anta,SALTA,17,22,12,33,45
66,66007,660070614,Anta,SALTA,313,356,648,680,1328
66,66007,660070421,Anta,SALTA,195,255,378,324,702
66,66007,660070209,Anta,SALTA,196,202,362,423,785
66,66007,660070302,Anta,SALTA,22,33,10,44,54
66,66007,660070608,Anta,SALTA,38,46,93,81,174
66,66007,660070603,Anta,SALTA,20,23,28,56,84
66,66007,660070602,Anta,SALTA,13,17,18,46,64
66,66007,660070509,Anta,SALTA,21,25,29,39,68
66,66007,660070409,Anta,SALTA,51,63,56,91,147
66,66007,660070408,Anta,SALTA,276,308,676,592,1268
66,66007,660070420,Anta,SALTA,299,324,640,613,1253
66,66007,660070618,Anta,SALTA,193,221,398,378,776
66,66007,660070617,Anta,SALTA,253,279,533,538,1071
66,66007,660070427,Anta,SALTA,263,329,634,609,1243
66,66007,660070417,Anta,SALTA,326,322,766,809,1575
66,66007,660070318,Anta,SALTA,364,359,763,760,1523
66,66007,660070316,Anta,SALTA,309,280,743,707,1450
66,66007,660070423,Anta,SALTA,269,299,510,485,995
66,66007,660070301,Anta,SALTA,5,6,0,8,8
66,66007,660070201,Anta,SALTA,96,124,139,195,334
66,66007,660070104,Anta,SALTA,50,46,53,90,143
66,66007,660070605,Anta,SALTA,19,30,13,37,50
66,66007,660070502,Anta,SALTA,18,8,32,41,73
66,66140,661400414,Rosario de la Frontera,SALTA,343,312,652,636,1288
66,66140,661400413,Rosario de la Frontera,SALTA,243,239,396,372,768
66,66140,661400115,Rosario de la Frontera,SALTA,49,76,71,90,161
66,66140,661400113,Rosario de la Frontera,SALTA,74,107,183,176,359
66,66140,661400411,Rosario de la Frontera,SALTA,287,281,562,540,1102
66,66140,661400405,Rosario de la Frontera,SALTA,274,270,598,552,1150
66,66140,661400308,Rosario de la Frontera,SALTA,15,19,8,25,33
66,66140,661400304,Rosario de la Frontera,SALTA,96,110,194,206,400
66,66140,661400302,Rosario de la Frontera,SALTA,20,26,39,33,72
66,66140,661400121,Rosario de la Frontera,SALTA,493,503,1092,1006,2098
66,66140,661400401,Rosario de la Frontera,SALTA,314,314,543,522,1065
66,66140,661400312,Rosario de la Frontera,SALTA,145,191,268,274,542
66,66140,661400303,Rosario de la Frontera,SALTA,11,14,5,11,16
66,66140,661400102,Rosario de la Frontera,SALTA,35,53,57,66,123
66,66140,661400104,Rosario de la Frontera,SALTA,9,15,9,18,27
66,66140,661400311,Rosario de la Frontera,SALTA,133,194,224,238,462
66,66140,661400117,Rosario de la Frontera,SALTA,370,401,762,744,1506
66,66140,661400116,Rosario de la Frontera,SALTA,266,316,561,583,1144
66,66140,661400415,Rosario de la Frontera,SALTA,325,315,656,605,1261
66,66140,661400402,Rosario de la Frontera,SALTA,301,292,564,531,1095
66,66140,661400305,Rosario de la Frontera,SALTA,12,23,13,24,37
66,66140,661400301,Rosario de la Frontera,SALTA,33,74,33,45,78
66,66140,661400205,Rosario de la Frontera,SALTA,58,63,67,97,164
66,66140,661400105,Rosario de la Frontera,SALTA,34,46,24,46,70
66,66140,661400101,Rosario de la Frontera,SALTA,21,30,22,39,61
66,66140,661400412,Rosario de la Frontera,SALTA,271,258,507,442,949
66,66140,661400408,Rosario de la Frontera,SALTA,236,280,375,331,706
66,66140,661400404,Rosario de la Frontera,SALTA,218,216,380,349,729
66,66140,661400403,Rosario de la Frontera,SALTA,273,294,458,419,877
66,66140,661400407,Rosario de la Frontera,SALTA,204,219,357,282,639
66,66140,661400309,Rosario de la Frontera,SALTA,17,24,21,24,45
66,66140,661400203,Rosario de la Frontera,SALTA,41,59,53,82,135
66,66140,661400202,Rosario de la Frontera,SALTA,19,32,22,40,62
66,66140,661400201,Rosario de la Frontera,SALTA,16,29,10,28,38
66,66140,661400108,Rosario de la Frontera,SALTA,102,111,174,196,370
66,66140,661400107,Rosario de la Frontera,SALTA,42,57,59,69,128
66,66140,661400118,Rosario de la Frontera,SALTA,232,242,517,445,962
66,66140,661400409,Rosario de la Frontera,SALTA,354,309,766,683,1449
66,66140,661400406,Rosario de la Frontera,SALTA,211,214,382,347,729
66,66140,661400307,Rosario de la Frontera,SALTA,27,40,36,44,80
66,66140,661400306,Rosario de la Frontera,SALTA,10,17,6,30,36
66,66140,661400114,Rosario de la Frontera,SALTA,53,65,86,99,185
66,66140,661400111,Rosario de la Frontera,SALTA,36,54,23,61,84
66,66140,661400106,Rosario de la Frontera,SALTA,27,53,16,44,60
66,66140,661400410,Rosario de la Frontera,SALTA,343,347,688,605,1293
66,66140,661400119,Rosario de la Frontera,SALTA,298,280,612,587,1199
66,66140,661400416,Rosario de la Frontera,SALTA,187,166,388,370,758
66,66140,661400112,Rosario de la Frontera,SALTA,36,50,53,63,116
66,66140,661400110,Rosario de la Frontera,SALTA,72,96,110,136,246
66,66140,661400109,Rosario de la Frontera,SALTA,6,12,4,9,13
66,66140,661400204,Rosario de la Frontera,SALTA,45,72,51,81,132
66,66140,661400103,Rosario de la Frontera,SALTA,43,67,59,94,153
66,66140,661400310,Rosario de la Frontera,SALTA,132,171,247,240,487
66,66140,661400120,Rosario de la Frontera,SALTA,291,289,644,607,1251
66,66063,660630110,Guachipas,SALTA,226,268,457,422,879
66,66063,660630109,Guachipas,SALTA,23,38,36,30,66
66,66063,660630107,Guachipas,SALTA,92,140,144,147,291
66,66063,660630101,Guachipas,SALTA,22,31,30,47,77
66,66063,660630106,Guachipas,SALTA,7,16,3,8,11
66,66063,660630104,Guachipas,SALTA,27,39,28,45,73
66,66063,660630103,Guachipas,SALTA,8,16,4,7,11
66,66063,660630203,Guachipas,SALTA,34,38,43,61,104
66,66063,660630201,Guachipas,SALTA,35,44,57,66,123
66,66063,660630111,Guachipas,SALTA,223,270,455,457,912
66,66063,660630105,Guachipas,SALTA,20,26,22,35,57
66,66063,660630108,Guachipas,SALTA,70,97,130,114,244
66,66063,660630102,Guachipas,SALTA,7,12,9,9,18
66,66063,660630202,Guachipas,SALTA,112,156,131,190,321
66,66049,660490305,General Güemes,SALTA,372,336,798,735,1533
66,66049,660490107,General Güemes,SALTA,329,358,653,670,1323
66,66049,660490405,General Güemes,SALTA,320,347,604,569,1173
66,66049,660490422,General Güemes,SALTA,209,201,385,358,743
66,66049,660490415,General Güemes,SALTA,240,213,519,518,1037
66,66049,660490304,General Güemes,SALTA,213,251,430,465,895
66,66049,660490201,General Güemes,SALTA,94,207,181,235,416
66,66049,660490101,General Güemes,SALTA,24,59,25,52,77
66,66049,660490412,General Güemes,SALTA,262,260,565,597,1162
66,66049,660490215,General Güemes,SALTA,221,197,539,526,1065
66,66049,660490411,General Güemes,SALTA,268,232,547,502,1049
66,66049,660490414,General Güemes,SALTA,208,209,420,374,794
66,66049,660490402,General Güemes,SALTA,246,248,530,523,1053
66,66049,660490401,General Güemes,SALTA,318,344,582,537,1119
66,66049,660490309,General Güemes,SALTA,210,235,426,436,862
66,66049,660490204,General Güemes,SALTA,46,62,51,77,128
66,66049,660490306,General Güemes,SALTA,200,207,494,497,991
66,66049,660490214,General Güemes,SALTA,225,214,538,502,1040
66,66049,660490419,General Güemes,SALTA,208,221,402,410,812
66,66049,660490403,General Güemes,SALTA,360,327,819,874,1693
66,66049,660490303,General Güemes,SALTA,31,34,58,62,120
66,66049,660490206,General Güemes,SALTA,44,82,72,99,171
66,66049,660490203,General Güemes,SALTA,10,16,4,9,13
66,66049,660490205,General Güemes,SALTA,86,113,165,159,324
66,66049,660490413,General Güemes,SALTA,297,357,493,454,947
66,66049,660490217,General Güemes,SALTA,326,341,697,684,1381
66,66049,660490211,General Güemes,SALTA,223,234,478,426,904
66,66049,660490409,General Güemes,SALTA,307,272,629,633,1262
66,66049,660490105,General Güemes,SALTA,374,384,898,812,1710
66,66049,660490418,General Güemes,SALTA,277,271,492,474,966
66,66049,660490308,General Güemes,SALTA,231,239,440,399,839
66,66049,660490210,General Güemes,SALTA,13,26,18,25,43
66,66049,660490207,General Güemes,SALTA,18,20,9,32,41
66,66049,660490103,General Güemes,SALTA,143,337,256,291,547
66,66049,660490212,General Güemes,SALTA,214,193,490,486,976
66,66049,660490410,General Güemes,SALTA,445,439,1051,1039,2090
66,66049,660490408,General Güemes,SALTA,271,291,480,414,894
66,66049,660490106,General Güemes,SALTA,287,280,602,618,1220
66,66049,660490421,General Güemes,SALTA,212,218,448,447,895
66,66049,660490104,General Güemes,SALTA,391,374,778,802,1580
66,66049,660490301,General Güemes,SALTA,184,222,310,392,702
66,66049,660490209,General Güemes,SALTA,27,35,64,64,128
66,66049,660490216,General Güemes,SALTA,187,201,444,427,871
66,66049,660490407,General Güemes,SALTA,215,203,405,456,861
66,66049,660490420,General Güemes,SALTA,194,194,370,373,743
66,66049,660490417,General Güemes,SALTA,248,260,408,422,830
66,66049,660490416,General Güemes,SALTA,293,293,606,589,1195
66,66049,660490208,General Güemes,SALTA,33,43,24,56,80
66,66049,660490202,General Güemes,SALTA,25,35,37,45,82
66,66049,660490302,General Güemes,SALTA,228,311,487,509,996
66,66049,660490307,General Güemes,SALTA,218,215,532,454,986
66,66049,660490213,General Güemes,SALTA,343,330,819,786,1605
66,66049,660490406,General Güemes,SALTA,216,225,403,423,826
66,66049,660490404,General Güemes,SALTA,320,304,637,576,1213
66,66049,660490102,General Güemes,SALTA,58,102,93,127,220
66,66028,660282814,Capital,SALTA,252,231,506,468,974
66,66028,660282801,Capital,SALTA,209,229,424,357,781
66,66028,660282614,Capital,SALTA,460,465,1126,1022,2148
66,66028,660282613,Capital,SALTA,435,447,998,933,1931
66,66028,660282512,Capital,SALTA,276,306,507,441,948
66,66028,660282504,Capital,SALTA,279,346,508,510,1018
66,66028,660282404,Capital,SALTA,369,347,880,806,1686
66,66028,660282120,Capital,SALTA,341,323,716,673,1389
66,66028,660282115,Capital,SALTA,368,370,806,724,1530
66,66028,660282111,Capital,SALTA,232,250,457,422,879
66,66028,660282019,Capital,SALTA,263,265,482,446,928
66,66028,660282007,Capital,SALTA,398,360,794,776,1570
66,66028,660282004,Capital,SALTA,295,278,563,513,1076
66,66028,660281607,Capital,SALTA,306,312,601,491,1092
66,66028,660281605,Capital,SALTA,411,362,803,703,1506
66,66028,660282318,Capital,SALTA,324,334,769,735,1504
66,66028,660282311,Capital,SALTA,383,380,913,866,1779
66,66028,660282303,Capital,SALTA,431,380,1026,1023,2049
66,66028,660282212,Capital,SALTA,386,398,784,726,1510
66,66028,660281601,Capital,SALTA,402,350,818,757,1575
66,66028,660281515,Capital,SALTA,427,366,790,738,1528
66,66028,660281504,Capital,SALTA,389,335,806,758,1564
66,66028,660281409,Capital,SALTA,387,307,744,630,1374
66,66028,660281307,Capital,SALTA,386,458,625,521,1146
66,66028,660281215,Capital,SALTA,262,233,557,538,1095
66,66028,660281210,Capital,SALTA,253,264,445,421,866
66,66028,660281907,Capital,SALTA,326,310,663,610,1273
66,66028,660281902,Capital,SALTA,317,294,687,650,1337
66,66028,660281814,Capital,SALTA,342,275,703,679,1382
66,66028,660281813,Capital,SALTA,298,249,639,630,1269
66,66028,660281811,Capital,SALTA,386,337,706,636,1342
66,66028,660281807,Capital,SALTA,249,214,479,436,915
66,66028,660281803,Capital,SALTA,262,235,510,390,900
66,66028,660281716,Capital,SALTA,330,285,682,671,1353
66,66028,660281712,Capital,SALTA,388,270,800,754,1554
66,66028,660281708,Capital,SALTA,361,343,733,667,1400
66,66028,660281619,Capital,SALTA,472,412,1037,1017,2054
66,66028,660281617,Capital,SALTA,437,421,922,906,1828
66,66028,660280609,Capital,SALTA,197,210,408,323,731
66,66028,660280519,Capital,SALTA,182,207,325,276,601
66,66028,660280514,Capital,SALTA,232,234,454,372,826
66,66028,660280501,Capital,SALTA,394,384,878,807,1685
66,66028,660280420,Capital,SALTA,209,196,535,471,1006
66,66028,660280419,Capital,SALTA,294,252,680,631,1311
66,66028,660280414,Capital,SALTA,270,263,406,318,724
66,66028,660280409,Capital,SALTA,332,282,619,491,1110
66,66028,660280405,Capital,SALTA,424,396,950,989,1939
66,66028,660281113,Capital,SALTA,189,443,332,237,569
66,66028,660281110,Capital,SALTA,221,362,316,218,534
66,66028,660281005,Capital,SALTA,327,387,516,408,924
66,66028,660281003,Capital,SALTA,358,272,636,532,1168
66,66028,660281002,Capital,SALTA,330,371,594,499,1093
66,66028,660280910,Capital,SALTA,198,194,377,312,689
66,66028,660280811,Capital,SALTA,235,209,460,425,885
66,66028,660280711,Capital,SALTA,470,390,1048,895,1943
66,66028,660281205,Capital,SALTA,154,228,270,197,467
66,66028,660281406,Capital,SALTA,419,358,702,630,1332
66,66028,660280112,Capital,SALTA,401,441,752,728,1480
66,66028,660280618,Capital,SALTA,195,206,356,308,664
66,66028,660280903,Capital,SALTA,254,288,513,500,1013
66,66028,660280108,Capital,SALTA,160,200,334,324,658
66,66028,660281524,Capital,SALTA,444,379,872,842,1714
66,66028,660280204,Capital,SALTA,13,24,19,24,43
66,66028,660280104,Capital,SALTA,359,324,723,785,1508
66,66028,660282811,Capital,SALTA,343,355,756,710,1466
66,66028,660282806,Capital,SALTA,420,431,887,842,1729
66,66028,660282802,Capital,SALTA,198,199,428,336,764
66,66028,660282714,Capital,SALTA,316,265,686,668,1354
66,66028,660282620,Capital,SALTA,334,309,749,707,1456
66,66028,660282410,Capital,SALTA,445,444,1008,995,2003
66,66028,660282309,Capital,SALTA,389,368,1007,887,1894
66,66028,660282211,Capital,SALTA,275,307,542,476,1018
66,66028,660282605,Capital,SALTA,266,271,559,510,1069
66,66028,660282604,Capital,SALTA,241,280,498,490,988
66,66028,660282009,Capital,SALTA,355,291,746,740,1486
66,66028,660282003,Capital,SALTA,246,281,440,392,832
66,66028,660281915,Capital,SALTA,298,285,673,615,1288
66,66028,660282316,Capital,SALTA,302,298,713,684,1397
66,66028,660282312,Capital,SALTA,291,288,756,751,1507
66,66028,660282302,Capital,SALTA,267,250,606,592,1198
66,66028,660282214,Capital,SALTA,396,410,874,750,1624
66,66028,660281525,Capital,SALTA,354,295,734,703,1437
66,66028,660281518,Capital,SALTA,326,281,684,633,1317
66,66028,660281517,Capital,SALTA,224,227,442,349,791
66,66028,660281516,Capital,SALTA,295,307,522,444,966
66,66028,660281414,Capital,SALTA,248,221,475,416,891
66,66028,660281305,Capital,SALTA,392,399,623,580,1203
66,66028,660281405,Capital,SALTA,283,319,519,432,951
66,66028,660281401,Capital,SALTA,321,352,588,474,1062
66,66028,660280617,Capital,SALTA,220,245,412,317,729
66,66028,660281905,Capital,SALTA,371,369,794,783,1577
66,66028,660281805,Capital,SALTA,265,235,495,487,982
66,66028,660281703,Capital,SALTA,262,224,418,431,849
66,66028,660281613,Capital,SALTA,244,218,544,560,1104
66,66028,660281610,Capital,SALTA,354,285,766,714,1480
66,66028,660280601,Capital,SALTA,331,355,654,604,1258
66,66028,660280502,Capital,SALTA,202,219,416,350,766
66,66028,660280415,Capital,SALTA,302,220,574,559,1133
66,66028,660281114,Capital,SALTA,233,338,402,290,692
66,66028,660281108,Capital,SALTA,181,342,306,202,508
66,66028,660281012,Capital,SALTA,242,232,455,366,821
66,66028,660280908,Capital,SALTA,313,307,630,548,1178
66,66028,660280907,Capital,SALTA,266,309,502,485,987
66,66028,660280901,Capital,SALTA,388,462,753,680,1433
66,66028,660280802,Capital,SALTA,227,196,433,381,814
66,66028,660280801,Capital,SALTA,0,0,22,162,184
66,66028,660280713,Capital,SALTA,312,289,679,608,1287
66,66028,660280207,Capital,SALTA,399,415,804,760,1564
66,66028,660280410,Capital,SALTA,272,253,501,461,962
66,66028,660280118,Capital,SALTA,376,398,784,744,1528
66,66028,660281115,Capital,SALTA,129,254,270,188,458
66,66028,660280116,Capital,SALTA,126,120,214,228,442
66,66028,660282116,Capital,SALTA,409,420,997,871,1868
66,66028,660281519,Capital,SALTA,244,193,470,425,895
66,66028,660281103,Capital,SALTA,325,474,482,365,847
66,66028,660280201,Capital,SALTA,268,248,452,401,853
66,66028,660281102,Capital,SALTA,170,230,271,262,533
66,66028,660282810,Capital,SALTA,403,399,924,867,1791
66,66028,660282710,Capital,SALTA,255,219,551,533,1084
66,66028,660282704,Capital,SALTA,354,273,760,746,1506
66,66028,660282510,Capital,SALTA,380,391,815,725,1540
66,66028,660282507,Capital,SALTA,277,395,531,520,1051
66,66028,660282506,Capital,SALTA,242,342,437,415,852
66,66028,660282501,Capital,SALTA,444,467,807,758,1565
66,66028,660282406,Capital,SALTA,298,301,722,653,1375
66,66028,660282117,Capital,SALTA,381,397,778,762,1540
66,66028,660282112,Capital,SALTA,229,243,452,416,868
66,66028,660282107,Capital,SALTA,290,311,524,481,1005
66,66028,660282105,Capital,SALTA,452,434,970,870,1840
66,66028,660282608,Capital,SALTA,447,459,1009,913,1922
66,66028,660282103,Capital,SALTA,139,139,236,231,467
66,66028,660282017,Capital,SALTA,312,277,772,772,1544
66,66028,660282015,Capital,SALTA,327,307,748,677,1425
66,66028,660282010,Capital,SALTA,215,189,527,483,1010
66,66028,660282002,Capital,SALTA,316,351,648,589,1237
66,66028,660282306,Capital,SALTA,365,337,799,803,1602
66,66028,660282204,Capital,SALTA,390,393,992,961,1953
66,66028,660282203,Capital,SALTA,312,321,762,746,1508
66,66028,660282202,Capital,SALTA,219,238,434,359,793
66,66028,660281510,Capital,SALTA,269,241,519,500,1019
66,66028,660281411,Capital,SALTA,481,413,922,826,1748
66,66028,660281408,Capital,SALTA,386,335,728,678,1406
66,66028,660281306,Capital,SALTA,294,408,498,393,891
66,66028,660281214,Capital,SALTA,268,270,558,501,1059
66,66028,660281404,Capital,SALTA,254,336,445,370,815
66,66028,660281403,Capital,SALTA,334,347,577,482,1059
66,66028,660280703,Capital,SALTA,288,219,619,578,1197
66,66028,660280702,Capital,SALTA,358,317,730,697,1427
66,66028,660280701,Capital,SALTA,335,300,681,628,1309
66,66028,660281909,Capital,SALTA,256,242,583,558,1141
66,66028,660281809,Capital,SALTA,275,249,488,433,921
66,66028,660281713,Capital,SALTA,333,283,706,685,1391
66,66028,660281711,Capital,SALTA,230,168,450,439,889
66,66028,660281615,Capital,SALTA,262,242,599,554,1153
66,66028,660281612,Capital,SALTA,271,250,598,498,1096
66,66028,660281608,Capital,SALTA,285,239,671,660,1331
66,66028,660280518,Capital,SALTA,222,253,401,335,736
66,66028,660280406,Capital,SALTA,433,395,938,940,1878
66,66028,660281107,Capital,SALTA,211,272,379,272,651
66,66028,660281105,Capital,SALTA,276,475,463,381,844
66,66028,660281104,Capital,SALTA,234,320,366,274,640
66,66028,660281013,Capital,SALTA,206,249,396,304,700
66,66028,660281010,Capital,SALTA,305,460,511,391,902
66,66028,660281007,Capital,SALTA,256,335,383,320,703
66,66028,660281001,Capital,SALTA,255,241,469,383,852
66,66028,660280916,Capital,SALTA,221,231,375,334,709
66,66028,660280809,Capital,SALTA,468,390,953,895,1848
66,66028,660280803,Capital,SALTA,234,166,478,378,856
66,66028,660280206,Capital,SALTA,282,340,572,519,1091
66,66028,660280402,Capital,SALTA,336,345,776,736,1512
66,66028,660282110,Capital,SALTA,178,228,234,184,418
66,66028,660280113,Capital,SALTA,200,250,379,375,754
66,66028,660280107,Capital,SALTA,209,230,420,424,844
66,66028,660280105,Capital,SALTA,359,414,618,607,1225
66,66028,660282101,Capital,SALTA,252,294,403,317,720
66,66028,660280604,Capital,SALTA,318,311,556,501,1057
66,66028,660280912,Capital,SALTA,215,222,362,292,654
66,66028,660280202,Capital,SALTA,202,204,396,384,780
66,66028,660280716,Capital,SALTA,332,269,712,648,1360
66,66028,660282713,Capital,SALTA,395,349,861,801,1662
66,66028,660282602,Capital,SALTA,311,311,678,590,1268
66,66028,660282514,Capital,SALTA,314,335,629,552,1181
66,66028,660282513,Capital,SALTA,223,257,438,396,834
66,66028,660282508,Capital,SALTA,393,463,788,743,1531
66,66028,660282503,Capital,SALTA,237,255,455,437,892
66,66028,660282502,Capital,SALTA,243,284,437,437,874
66,66028,660282118,Capital,SALTA,327,344,625,535,1160
66,66028,660282113,Capital,SALTA,240,226,580,523,1103
66,66028,660282611,Capital,SALTA,394,366,920,861,1781
66,66028,660282014,Capital,SALTA,321,299,742,692,1434
66,66028,660282001,Capital,SALTA,223,239,437,403,840
66,66028,660281604,Capital,SALTA,305,270,607,579,1186
66,66028,660282317,Capital,SALTA,327,314,830,771,1601
66,66028,660282314,Capital,SALTA,367,347,897,879,1776
66,66028,660282207,Capital,SALTA,239,238,477,429,906
66,66028,660282206,Capital,SALTA,253,252,524,449,973
66,66028,660281506,Capital,SALTA,326,319,764,722,1486
66,66028,660281412,Capital,SALTA,420,345,836,758,1594
66,66028,660281410,Capital,SALTA,342,299,638,629,1267
66,66028,660280615,Capital,SALTA,226,272,392,332,724
66,66028,660281911,Capital,SALTA,327,295,695,639,1334
66,66028,660281817,Capital,SALTA,297,256,595,567,1162
66,66028,660281806,Capital,SALTA,295,265,582,542,1124
66,66028,660281801,Capital,SALTA,336,352,594,466,1060
66,66028,660281707,Capital,SALTA,385,337,723,672,1395
66,66028,660281611,Capital,SALTA,366,311,735,708,1443
66,66028,660281715,Capital,SALTA,297,234,579,561,1140
66,66028,660280602,Capital,SALTA,335,304,646,588,1234
66,66028,660280516,Capital,SALTA,400,401,792,666,1458
66,66028,660280513,Capital,SALTA,247,257,454,383,837
66,66028,660280508,Capital,SALTA,318,302,690,625,1315
66,66028,660280507,Capital,SALTA,346,331,718,607,1325
66,66028,660280505,Capital,SALTA,264,265,620,545,1165
66,66028,660280421,Capital,SALTA,240,234,459,430,889
66,66028,660280416,Capital,SALTA,278,207,413,402,815
66,66028,660280403,Capital,SALTA,305,293,643,626,1269
66,66028,660281208,Capital,SALTA,159,183,283,231,514
66,66028,660281116,Capital,SALTA,98,220,152,110,262
66,66028,660280913,Capital,SALTA,281,281,467,373,840
66,66028,660280904,Capital,SALTA,250,218,597,516,1113
66,66028,660280815,Capital,SALTA,226,215,397,315,712
66,66028,660280813,Capital,SALTA,289,251,531,440,971
66,66028,660280807,Capital,SALTA,252,248,479,427,906
66,66028,660280710,Capital,SALTA,363,299,755,673,1428
66,66028,660280709,Capital,SALTA,401,357,772,775,1547
66,66028,660281207,Capital,SALTA,177,236,243,185,428
66,66028,660281204,Capital,SALTA,216,284,383,275,658
66,66028,660280411,Capital,SALTA,228,233,373,262,635
66,66028,660281413,Capital,SALTA,423,379,789,703,1492
66,66028,660281008,Capital,SALTA,169,213,282,228,510
66,66028,660280205,Capital,SALTA,231,253,364,383,747
66,66028,660280301,Capital,SALTA,7,9,8,12,20
66,66028,660282805,Capital,SALTA,330,378,611,534,1145
66,66028,660282709,Capital,SALTA,289,278,674,663,1337
66,66028,660282706,Capital,SALTA,244,222,546,486,1032
66,66028,660282701,Capital,SALTA,253,208,552,530,1082
66,66028,660282619,Capital,SALTA,368,364,854,806,1660
66,66028,660282612,Capital,SALTA,489,490,1187,1084,2271
66,66028,660282515,Capital,SALTA,366,400,724,593,1317
66,66028,660282412,Capital,SALTA,428,401,1123,1086,2209
66,66028,660282407,Capital,SALTA,212,208,514,463,977
66,66028,660282210,Capital,SALTA,332,351,670,589,1259
66,66028,660282109,Capital,SALTA,238,296,413,336,749
66,66028,660282104,Capital,SALTA,367,351,771,692,1463
66,66028,660282607,Capital,SALTA,463,482,990,896,1886
66,66028,660282606,Capital,SALTA,319,375,640,622,1262
66,66028,660282008,Capital,SALTA,318,280,606,641,1247
66,66028,660282006,Capital,SALTA,207,284,342,285,627
66,66028,660282307,Capital,SALTA,354,324,818,823,1641
66,66028,660282209,Capital,SALTA,310,343,592,531,1123
66,66028,660282121,Capital,SALTA,398,382,814,752,1566
66,66028,660281508,Capital,SALTA,268,238,587,570,1157
66,66028,660281507,Capital,SALTA,358,301,834,840,1674
66,66028,660281501,Capital,SALTA,227,252,458,446,904
66,66028,660281308,Capital,SALTA,220,306,368,300,668
66,66028,660280704,Capital,SALTA,289,218,619,581,1200
66,66028,660280616,Capital,SALTA,348,371,636,516,1152
66,66028,660280614,Capital,SALTA,223,257,388,336,724
66,66028,660282016,Capital,SALTA,318,306,799,749,1548
66,66028,660281908,Capital,SALTA,279,265,553,530,1083
66,66028,660281906,Capital,SALTA,323,294,653,602,1255
66,66028,660281818,Capital,SALTA,261,249,562,558,1120
66,66028,660281816,Capital,SALTA,296,271,575,532,1107
66,66028,660281710,Capital,SALTA,211,174,442,411,853
66,66028,660281704,Capital,SALTA,238,211,381,381,762
66,66028,660281702,Capital,SALTA,232,279,433,392,825
66,66028,660281714,Capital,SALTA,436,342,955,901,1856
66,66028,660281618,Capital,SALTA,412,436,876,901,1777
66,66028,660281609,Capital,SALTA,317,293,721,635,1356
66,66028,660280610,Capital,SALTA,298,334,527,430,957
66,66028,660280606,Capital,SALTA,235,246,425,442,867
66,66028,660280715,Capital,SALTA,314,243,615,633,1248
66,66028,660280515,Capital,SALTA,256,241,523,481,1004
66,66028,660280510,Capital,SALTA,416,376,809,782,1591
66,66028,660280408,Capital,SALTA,365,352,890,819,1709
66,66028,660281112,Capital,SALTA,212,376,398,281,679
66,66028,660281009,Capital,SALTA,291,398,514,384,898
66,66028,660280906,Capital,SALTA,405,338,862,839,1701
66,66028,660280902,Capital,SALTA,436,481,799,750,1549
66,66028,660280814,Capital,SALTA,193,256,290,245,535
66,66028,660280812,Capital,SALTA,230,200,448,421,869
66,66028,660280804,Capital,SALTA,284,253,488,439,927
66,66028,660280714,Capital,SALTA,315,243,596,585,1181
66,66028,660280708,Capital,SALTA,368,293,758,711,1469
66,66028,660281206,Capital,SALTA,150,173,437,441,878
66,66028,660280401,Capital,SALTA,285,257,495,447,942
66,66028,660280619,Capital,SALTA,318,297,602,510,1112
66,66028,660280208,Capital,SALTA,277,228,483,458,941
66,66028,660280119,Capital,SALTA,329,374,693,602,1295
66,66028,660280117,Capital,SALTA,367,390,752,742,1494
66,66028,660280111,Capital,SALTA,235,248,489,472,961
66,66028,660280909,Capital,SALTA,405,388,821,668,1489
66,66028,660280120,Capital,SALTA,168,200,373,357,730
66,66028,660282123,Capital,SALTA,254,234,506,439,945
66,66028,660282102,Capital,SALTA,225,296,315,275,590
66,66028,660281309,Capital,SALTA,159,215,287,213,500
66,66028,660280302,Capital,SALTA,30,45,17,38,55
66,66028,660280203,Capital,SALTA,25,54,15,29,44
66,66028,660280103,Capital,SALTA,43,38,54,79,133
66,66028,660280121,Capital,SALTA,132,124,255,264,519
66,66028,660280102,Capital,SALTA,64,68,117,113,230
66,66028,660282617,Capital,SALTA,449,455,957,928,1885
66,66028,660282511,Capital,SALTA,384,414,841,746,1587
66,66028,660282509,Capital,SALTA,257,294,519,476,995
66,66028,660282505,Capital,SALTA,162,254,294,281,575
66,66028,660282411,Capital,SALTA,376,387,957,938,1895
66,66028,660282405,Capital,SALTA,339,325,806,791,1597
66,66028,660282119,Capital,SALTA,355,343,684,617,1301
66,66028,660282114,Capital,SALTA,237,235,425,438,863
66,66028,660282106,Capital,SALTA,414,424,811,726,1537
66,66028,660282603,Capital,SALTA,328,350,686,622,1308
66,66028,660282012,Capital,SALTA,333,305,761,729,1490
66,66028,660282011,Capital,SALTA,361,345,888,798,1686
66,66028,660281912,Capital,SALTA,220,215,451,402,853
66,66028,660282310,Capital,SALTA,344,315,838,754,1592
66,66028,660282308,Capital,SALTA,354,349,845,844,1689
66,66028,660282305,Capital,SALTA,380,338,877,856,1733
66,66028,660282205,Capital,SALTA,252,246,479,405,884
66,66028,660282201,Capital,SALTA,337,363,626,586,1212
66,66028,660281521,Capital,SALTA,237,208,479,451,930
66,66028,660281509,Capital,SALTA,276,218,526,508,1034
66,66028,660281522,Capital,SALTA,344,297,702,650,1352
66,66028,660281211,Capital,SALTA,325,329,779,1642,2421
66,66028,660280621,Capital,SALTA,435,394,818,686,1504
66,66028,660280613,Capital,SALTA,226,236,379,362,741
66,66028,660281901,Capital,SALTA,364,393,771,746,1517
66,66028,660281812,Capital,SALTA,286,286,546,461,1007
66,66028,660281808,Capital,SALTA,249,226,474,391,865
66,66028,660281804,Capital,SALTA,225,201,461,461,922
66,66028,660281614,Capital,SALTA,325,318,710,644,1354
66,66028,660280611,Capital,SALTA,382,406,719,608,1327
66,66028,660280608,Capital,SALTA,294,294,565,454,1019
66,66028,660280607,Capital,SALTA,262,267,488,432,920
66,66028,660280605,Capital,SALTA,357,357,698,630,1328
66,66028,660280511,Capital,SALTA,252,249,465,414,879
66,66028,660280509,Capital,SALTA,300,238,687,591,1278
66,66028,660280503,Capital,SALTA,241,216,568,525,1093
66,66028,660280423,Capital,SALTA,460,351,911,820,1731
66,66028,660280407,Capital,SALTA,323,311,765,765,1530
66,66028,660280404,Capital,SALTA,415,413,891,924,1815
66,66028,660281209,Capital,SALTA,174,134,284,240,524
66,66028,660281203,Capital,SALTA,204,252,338,287,625
66,66028,660281202,Capital,SALTA,225,260,361,295,656
66,66028,660281111,Capital,SALTA,193,328,257,211,468
66,66028,660281106,Capital,SALTA,225,342,421,308,729
66,66028,660281006,Capital,SALTA,390,439,669,510,1179
66,66028,660280905,Capital,SALTA,443,401,898,776,1674
66,66028,660280808,Capital,SALTA,253,215,511,457,968
66,66028,660280712,Capital,SALTA,209,168,402,402,804
66,66028,660280706,Capital,SALTA,250,219,545,467,1012
66,66028,660281310,Capital,SALTA,201,236,374,286,660
66,66028,660282809,Capital,SALTA,505,474,1055,966,2021
66,66028,660281303,Capital,SALTA,260,361,469,313,782
66,66028,660280109,Capital,SALTA,222,248,479,492,971
66,66028,660281815,Capital,SALTA,249,217,495,479,974
66,66028,660281523,Capital,SALTA,274,181,522,492,1014
66,66028,660280101,Capital,SALTA,136,128,242,242,484
66,66028,660282812,Capital,SALTA,296,285,724,692,1416
66,66028,660282804,Capital,SALTA,248,272,388,353,741
66,66028,660282712,Capital,SALTA,321,275,697,678,1375
66,66028,660282708,Capital,SALTA,259,215,607,586,1193
66,66028,660282618,Capital,SALTA,342,351,705,646,1351
66,66028,660282616,Capital,SALTA,316,304,749,734,1483
66,66028,660282108,Capital,SALTA,216,239,433,366,799
66,66028,660282610,Capital,SALTA,463,462,1115,1012,2127
66,66028,660282013,Capital,SALTA,230,221,612,535,1147
66,66028,660282005,Capital,SALTA,220,262,362,307,669
66,66028,660281914,Capital,SALTA,300,292,684,636,1320
66,66028,660281606,Capital,SALTA,375,317,729,639,1368
66,66028,660282401,Capital,SALTA,112,96,181,202,383
66,66028,660282315,Capital,SALTA,363,294,789,809,1598
66,66028,660282313,Capital,SALTA,340,334,931,871,1802
66,66028,660282301,Capital,SALTA,335,317,808,846,1654
66,66028,660282208,Capital,SALTA,294,328,603,510,1113
66,66028,660282122,Capital,SALTA,340,356,679,584,1263
66,66028,660281602,Capital,SALTA,569,490,1167,1133,2300
66,66028,660281520,Capital,SALTA,273,222,537,490,1027
66,66028,660281514,Capital,SALTA,291,300,530,408,938
66,66028,660281505,Capital,SALTA,349,341,839,746,1585
66,66028,660280705,Capital,SALTA,254,209,527,515,1042
66,66028,660280612,Capital,SALTA,240,260,452,350,802
66,66028,660281810,Capital,SALTA,263,249,511,512,1023
66,66028,660281709,Capital,SALTA,337,313,683,621,1304
66,66028,660281706,Capital,SALTA,221,197,377,361,738
66,66028,660280517,Capital,SALTA,354,398,693,528,1221
66,66028,660280506,Capital,SALTA,302,304,642,631,1273
66,66028,660280413,Capital,SALTA,444,386,784,591,1375
66,66028,660280412,Capital,SALTA,432,316,676,552,1228
66,66028,660281201,Capital,SALTA,272,321,475,456,931
66,66028,660281011,Capital,SALTA,168,251,338,212,550
66,66028,660281004,Capital,SALTA,327,274,565,484,1049
66,66028,660280914,Capital,SALTA,299,306,529,476,1005
66,66028,660280810,Capital,SALTA,273,274,573,476,1049
66,66028,660280805,Capital,SALTA,261,267,464,401,865
66,66028,660280707,Capital,SALTA,411,309,849,858,1707
66,66028,660280620,Capital,SALTA,252,242,431,352,783
66,66028,660280115,Capital,SALTA,190,239,369,332,701
66,66028,660282408,Capital,SALTA,387,385,954,928,1882
66,66028,660281701,Capital,SALTA,266,301,492,316,808
66,66028,660280304,Capital,SALTA,25,38,30,39,69
66,66028,660280303,Capital,SALTA,15,24,18,25,43
66,66028,660281407,Capital,SALTA,396,382,776,664,1440
66,66028,660282815,Capital,SALTA,228,222,497,474,971
66,66028,660282813,Capital,SALTA,443,409,1016,949,1965
66,66028,660282808,Capital,SALTA,298,302,638,564,1202
66,66028,660282807,Capital,SALTA,332,332,681,653,1334
66,66028,660282803,Capital,SALTA,238,238,471,405,876
66,66028,660282715,Capital,SALTA,348,338,776,784,1560
66,66028,660282711,Capital,SALTA,309,282,660,668,1328
66,66028,660282707,Capital,SALTA,237,240,555,546,1101
66,66028,660282705,Capital,SALTA,298,245,622,604,1226
66,66028,660282703,Capital,SALTA,335,310,760,766,1526
66,66028,660282702,Capital,SALTA,254,254,554,491,1045
66,66028,660282615,Capital,SALTA,333,336,812,786,1598
66,66028,660282601,Capital,SALTA,300,318,593,618,1211
66,66028,660282403,Capital,SALTA,301,288,668,654,1322
66,66028,660282402,Capital,SALTA,201,232,374,369,743
66,66028,660282609,Capital,SALTA,458,454,1075,967,2042
66,66028,660282018,Capital,SALTA,467,379,1136,1077,2213
66,66028,660281913,Capital,SALTA,338,311,658,543,1201
66,66028,660282304,Capital,SALTA,346,328,805,833,1638
66,66028,660282213,Capital,SALTA,332,332,750,695,1445
66,66028,660282124,Capital,SALTA,253,243,495,421,916
66,66028,660281603,Capital,SALTA,233,206,502,431,933
66,66028,660281513,Capital,SALTA,276,257,633,594,1227
66,66028,660281512,Capital,SALTA,377,346,840,763,1603
66,66028,660281511,Capital,SALTA,386,365,832,823,1655
66,66028,660281503,Capital,SALTA,407,389,927,901,1828
66,66028,660281502,Capital,SALTA,390,391,938,883,1821
66,66028,660281304,Capital,SALTA,173,226,277,244,521
66,66028,660281302,Capital,SALTA,132,225,197,166,363
66,66028,660281301,Capital,SALTA,239,325,583,452,1035
66,66028,660281213,Capital,SALTA,480,460,1044,949,1993
66,66028,660281212,Capital,SALTA,462,443,963,936,1899
66,66028,660281402,Capital,SALTA,363,420,638,562,1200
66,66028,660280622,Capital,SALTA,435,439,735,611,1346
66,66028,660281910,Capital,SALTA,427,412,967,947,1914
66,66028,660281904,Capital,SALTA,266,228,535,527,1062
66,66028,660281903,Capital,SALTA,253,221,542,490,1032
66,66028,660281802,Capital,SALTA,434,388,805,720,1525
66,66028,660281705,Capital,SALTA,280,258,508,470,978
66,66028,660281616,Capital,SALTA,332,281,708,728,1436
66,66028,660281311,Capital,SALTA,143,213,264,200,464
66,66028,660280603,Capital,SALTA,374,393,600,585,1185
66,66028,660280520,Capital,SALTA,214,218,349,347,696
66,66028,660280512,Capital,SALTA,249,238,501,399,900
66,66028,660280504,Capital,SALTA,233,233,519,495,1014
66,66028,660280422,Capital,SALTA,416,349,974,874,1848
66,66028,660280418,Capital,SALTA,293,239,699,657,1356
66,66028,660280417,Capital,SALTA,498,431,1159,1109,2268
66,66028,660281109,Capital,SALTA,185,413,333,207,540
66,66028,660281101,Capital,SALTA,264,318,428,389,817
66,66028,660280915,Capital,SALTA,200,219,358,281,639
66,66028,660280911,Capital,SALTA,194,214,372,296,668
66,66028,660280806,Capital,SALTA,284,259,822,582,1404
66,66028,660280717,Capital,SALTA,317,273,665,605,1270
66,66028,660280114,Capital,SALTA,247,320,538,496,1034
66,66028,660280110,Capital,SALTA,265,303,561,557,1118
66,66028,660280106,Capital,SALTA,274,468,482,726,1208
66,66028,660282409,Capital,SALTA,346,331,832,790,1622
66,66084,660840108,La Candelaria,SALTA,196,214,423,420,843
66,66084,660840204,La Candelaria,SALTA,21,42,15,42,57
66,66084,660840203,La Candelaria,SALTA,50,45,84,96,180
66,66084,660840106,La Candelaria,SALTA,224,265,438,504,942
66,66084,660840104,La Candelaria,SALTA,16,26,19,24,43
66,66084,660840102,La Candelaria,SALTA,138,205,242,270,512
66,66084,660840201,La Candelaria,SALTA,29,29,57,72,129
66,66084,660840109,La Candelaria,SALTA,225,241,485,430,915
66,66084,660840107,La Candelaria,SALTA,244,272,419,455,874
66,66084,660840205,La Candelaria,SALTA,160,199,339,310,649
66,66084,660840202,La Candelaria,SALTA,35,46,53,66,119
66,66084,660840105,La Candelaria,SALTA,16,27,17,23,40
66,66084,660840103,La Candelaria,SALTA,12,14,18,24,42
66,66084,660840101,La Candelaria,SALTA,103,126,156,203,359
66,66021,660210112,Cafayate,SALTA,291,259,596,597,1193
66,66021,660210202,Cafayate,SALTA,16,25,15,34,49
66,66021,660210102,Cafayate,SALTA,31,59,60,71,131
66,66021,660210110,Cafayate,SALTA,303,256,658,653,1311
66,66021,660210103,Cafayate,SALTA,200,233,432,436,868
66,66021,660210115,Cafayate,SALTA,290,267,597,604,1201
66,66021,660210108,Cafayate,SALTA,289,238,677,648,1325
66,66021,660210105,Cafayate,SALTA,19,28,39,48,87
66,66021,660210101,Cafayate,SALTA,85,99,142,179,321
66,66021,660210106,Cafayate,SALTA,89,78,151,165,316
66,66021,660210114,Cafayate,SALTA,326,370,693,678,1371
66,66021,660210109,Cafayate,SALTA,283,242,655,594,1249
66,66021,660210107,Cafayate,SALTA,252,279,512,502,1014
66,66021,660210113,Cafayate,SALTA,267,275,525,538,1063
66,66021,660210104,Cafayate,SALTA,263,299,600,557,1157
66,66021,660210116,Cafayate,SALTA,317,291,646,668,1314
66,66021,660210111,Cafayate,SALTA,229,247,455,410,865
66,66021,660210201,Cafayate,SALTA,5,8,9,6,15
66,66154,661540203,San Carlos,SALTA,49,61,107,96,203
66,66154,661540202,San Carlos,SALTA,22,35,25,37,62
66,66154,661540103,San Carlos,SALTA,27,41,49,41,90
66,66154,661540208,San Carlos,SALTA,104,152,205,232,437
66,66154,661540205,San Carlos,SALTA,11,28,13,23,36
66,66154,661540207,San Carlos,SALTA,54,58,69,78,147
66,66154,661540104,San Carlos,SALTA,1,2,2,1,3
66,66154,661540102,San Carlos,SALTA,69,90,176,187,363
66,66154,661540204,San Carlos,SALTA,26,69,36,49,85
66,66154,661540106,San Carlos,SALTA,186,273,410,413,823
66,66154,661540210,San Carlos,SALTA,300,351,614,646,1260
66,66154,661540201,San Carlos,SALTA,61,60,80,82,162
66,66154,661540211,San Carlos,SALTA,228,316,458,477,935
66,66154,661540209,San Carlos,SALTA,277,334,639,637,1276
66,66154,661540105,San Carlos,SALTA,163,131,386,358,744
66,66154,661540101,San Carlos,SALTA,35,44,97,94,191
66,66154,661540206,San Carlos,SALTA,39,63,112,87,199
66,66091,660910104,La Poma,SALTA,38,59,70,61,131
66,66091,660910204,La Poma,SALTA,58,46,115,124,239
66,66091,660910205,La Poma,SALTA,147,208,305,309,614
66,66091,660910105,La Poma,SALTA,39,59,71,72,143
66,66091,660910203,La Poma,SALTA,16,20,40,30,70
66,66091,660910102,La Poma,SALTA,33,96,93,76,169
66,66091,660910101,La Poma,SALTA,15,49,34,26,60
66,66091,660910202,La Poma,SALTA,26,41,48,38,86
66,66091,660910103,La Poma,SALTA,32,30,74,73,147
66,66091,660910201,La Poma,SALTA,19,13,40,39,79
66,66077,660770303,La Caldera,SALTA,105,162,152,157,309
66,66077,660770201,La Caldera,SALTA,20,19,22,33,55
66,66077,660770103,La Caldera,SALTA,69,99,87,108,195
66,66077,660770205,La Caldera,SALTA,291,347,602,644,1246
66,66077,660770301,La Caldera,SALTA,14,31,9,21,30
66,66077,660770203,La Caldera,SALTA,16,25,12,26,38
66,66077,660770107,La Caldera,SALTA,188,220,398,401,799
66,66077,660770304,La Caldera,SALTA,37,62,38,64,102
66,66077,660770204,La Caldera,SALTA,252,323,480,460,940
66,66077,660770108,La Caldera,SALTA,240,282,453,478,931
66,66077,660770202,La Caldera,SALTA,15,27,12,17,29
66,66077,660770104,La Caldera,SALTA,173,230,287,289,576
66,66077,660770109,La Caldera,SALTA,183,201,365,330,695
66,66077,660770106,La Caldera,SALTA,196,216,355,362,717
66,66077,660770105,La Caldera,SALTA,215,252,428,429,857
66,66077,660770302,La Caldera,SALTA,9,17,8,12,20
66,66077,660770102,La Caldera,SALTA,46,46,79,83,162
66,66077,660770101,La Caldera,SALTA,19,19,19,43,62
66,66070,660700502,Iruya,SALTA,5,12,14,8,22
66,66070,660700105,Iruya,SALTA,46,103,105,106,211
66,66070,660700506,Iruya,SALTA,18,23,29,36,65
66,66070,660700504,Iruya,SALTA,81,118,163,164,327
66,66070,660700406,Iruya,SALTA,6,60,17,18,35
66,66070,660700501,Iruya,SALTA,9,17,11,7,18
66,66070,660700404,Iruya,SALTA,21,29,32,40,72
66,66070,660700401,Iruya,SALTA,24,26,70,55,125
66,66070,660700102,Iruya,SALTA,106,198,257,219,476
66,66070,660700302,Iruya,SALTA,11,33,24,22,46
66,66070,660700508,Iruya,SALTA,179,250,357,374,731
66,66070,660700407,Iruya,SALTA,27,88,67,57,124
66,66070,660700303,Iruya,SALTA,17,41,48,47,95
66,66070,660700301,Iruya,SALTA,34,39,68,56,124
66,66070,660700101,Iruya,SALTA,17,41,48,28,76
66,66070,660700104,Iruya,SALTA,12,18,28,35,63
66,66070,660700204,Iruya,SALTA,109,180,223,205,428
66,66070,660700107,Iruya,SALTA,61,127,132,124,256
66,66070,660700103,Iruya,SALTA,19,30,58,42,100
66,66070,660700201,Iruya,SALTA,68,132,134,115,249
66,66070,660700507,Iruya,SALTA,140,151,274,290,564
66,66070,660700202,Iruya,SALTA,24,59,40,35,75
66,66070,660700203,Iruya,SALTA,122,226,226,202,428
66,66070,660700505,Iruya,SALTA,3,33,1,3,4
66,66070,660700503,Iruya,SALTA,12,40,7,15,22
66,66070,660700405,Iruya,SALTA,7,23,9,6,15
66,66070,660700106,Iruya,SALTA,21,35,31,37,68
66,66070,660700205,Iruya,SALTA,277,353,554,516,1070
66,66070,660700403,Iruya,SALTA,15,25,26,19,45
66,66070,660700402,Iruya,SALTA,13,40,29,24,53
66,66014,660140205,Cachi,SALTA,10,15,13,15,28
66,66014,660140207,Cachi,SALTA,186,215,327,308,635
66,66014,660140201,Cachi,SALTA,3,7,9,6,15
66,66014,660140104,Cachi,SALTA,127,168,265,267,532
66,66014,660140102,Cachi,SALTA,37,50,87,83,170
66,66014,660140103,Cachi,SALTA,110,141,237,267,504
66,66014,660140101,Cachi,SALTA,129,186,322,319,641
66,66014,660140206,Cachi,SALTA,295,377,557,580,1137
66,66014,660140203,Cachi,SALTA,210,285,413,440,853
66,66014,660140204,Cachi,SALTA,83,144,136,142,278
66,66014,660140202,Cachi,SALTA,621,834,1230,1292,2522
66,66119,661190202,Molinos,SALTA,48,63,121,124,245
66,66119,661190203,Molinos,SALTA,130,140,341,342,683
66,66119,661190204,Molinos,SALTA,71,92,182,147,329
66,66119,661190201,Molinos,SALTA,18,18,31,39,70
66,66119,661190104,Molinos,SALTA,63,88,123,150,273
66,66119,661190102,Molinos,SALTA,306,388,871,800,1671
66,66119,661190105,Molinos,SALTA,78,97,154,155,309
66,66119,661190103,Molinos,SALTA,162,292,288,288,576
66,66119,661190101,Molinos,SALTA,54,65,174,139,313
66,66119,661190205,Molinos,SALTA,261,308,582,601,1183
62,62049,620490105,9 de julio,RIO NEGRO,114,123,116,196,312
62,62049,620490101,9 de julio,RIO NEGRO,232,296,402,388,790
62,62049,620490106,9 de julio,RIO NEGRO,217,282,320,360,680
62,62049,620490107,9 de julio,RIO NEGRO,80,134,73,129,202
62,62049,620490104,9 de julio,RIO NEGRO,126,213,121,180,301
62,62049,620490103,9 de julio,RIO NEGRO,76,83,106,111,217
62,62049,620490102,9 de julio,RIO NEGRO,278,286,475,498,973
62,62035,620350111,El Cuy,RIO NEGRO,298,297,224,429,653
62,62035,620350109,El Cuy,RIO NEGRO,38,56,29,58,87
62,62035,620350101,El Cuy,RIO NEGRO,161,170,237,288,525
62,62035,620350105,El Cuy,RIO NEGRO,48,94,87,83,170
62,62035,620350110,El Cuy,RIO NEGRO,191,211,343,383,726
62,62035,620350106,El Cuy,RIO NEGRO,88,142,73,137,210
62,62035,620350108,El Cuy,RIO NEGRO,26,44,3,39,42
62,62035,620350112,El Cuy,RIO NEGRO,165,309,209,228,437
62,62035,620350103,El Cuy,RIO NEGRO,82,137,136,116,252
62,62035,620350104,El Cuy,RIO NEGRO,85,108,176,135,311
62,62035,620350102,El Cuy,RIO NEGRO,181,291,254,244,498
62,62035,620350114,El Cuy,RIO NEGRO,206,326,312,332,644
62,62035,620350113,El Cuy,RIO NEGRO,230,374,253,323,576
62,62035,620350107,El Cuy,RIO NEGRO,70,127,57,92,149
62,62056,620560103,Ñorquinco,RIO NEGRO,212,251,191,312,503
62,62056,620560102,Ñorquinco,RIO NEGRO,96,129,141,141,282
62,62056,620560104,Ñorquinco,RIO NEGRO,181,176,137,293,430
62,62056,620560101,Ñorquinco,RIO NEGRO,148,191,262,259,521
62,62091,620910307,25 de Mayo,RIO NEGRO,223,253,337,311,648
62,62091,620910202,25 de Mayo,RIO NEGRO,303,416,531,538,1069
62,62091,620910301,25 de Mayo,RIO NEGRO,221,262,361,312,673
62,62091,620910104,25 de Mayo,RIO NEGRO,193,175,400,414,814
62,62091,620910302,25 de Mayo,RIO NEGRO,153,198,251,234,485
62,62091,620910402,25 de Mayo,RIO NEGRO,51,95,91,85,176
62,62091,620910102,25 de Mayo,RIO NEGRO,240,244,498,520,1018
62,62091,620910403,25 de Mayo,RIO NEGRO,30,54,57,57,114
62,62091,620910203,25 de Mayo,RIO NEGRO,185,231,331,325,656
62,62091,620910201,25 de Mayo,RIO NEGRO,206,268,403,366,769
62,62091,620910308,25 de Mayo,RIO NEGRO,282,331,469,467,936
62,62091,620910103,25 de Mayo,RIO NEGRO,385,397,714,723,1437
62,62091,620910407,25 de Mayo,RIO NEGRO,102,104,67,147,214
62,62091,620910406,25 de Mayo,RIO NEGRO,116,148,114,170,284
62,62091,620910405,25 de Mayo,RIO NEGRO,187,259,105,293,398
62,62091,620910306,25 de Mayo,RIO NEGRO,203,230,308,301,609
62,62091,620910305,25 de Mayo,RIO NEGRO,354,424,635,608,1243
62,62091,620910304,25 de Mayo,RIO NEGRO,261,327,438,428,866
62,62091,620910303,25 de Mayo,RIO NEGRO,266,347,415,386,801
62,62091,620910101,25 de Mayo,RIO NEGRO,395,424,792,745,1537
62,62091,620910404,25 de Mayo,RIO NEGRO,283,275,309,561,870
62,62091,620910401,25 de Mayo,RIO NEGRO,34,46,57,69,126
62,62028,620280301,Conesa,RIO NEGRO,23,58,21,24,45
62,62028,620280407,Conesa,RIO NEGRO,140,183,235,210,445
62,62028,620280404,Conesa,RIO NEGRO,268,265,514,493,1007
62,62028,620280103,Conesa,RIO NEGRO,62,99,73,107,180
62,62028,620280102,Conesa,RIO NEGRO,31,88,34,73,107
62,62028,620280402,Conesa,RIO NEGRO,320,377,463,433,896
62,62028,620280401,Conesa,RIO NEGRO,342,377,526,498,1024
62,62028,620280405,Conesa,RIO NEGRO,181,198,312,304,616
62,62028,620280101,Conesa,RIO NEGRO,9,33,2,13,15
62,62028,620280406,Conesa,RIO NEGRO,304,340,483,446,929
62,62028,620280403,Conesa,RIO NEGRO,199,227,311,256,567
62,62028,620280201,Conesa,RIO NEGRO,25,50,17,53,70
62,62028,620280105,Conesa,RIO NEGRO,126,177,182,217,399
62,62028,620280104,Conesa,RIO NEGRO,224,286,344,425,769
58,58091,580910205,Pehuenches,NEUQUÉN,46,58,81,89,170
58,58091,580910312,Pehuenches,NEUQUÉN,170,199,283,285,568
58,58091,580910309,Pehuenches,NEUQUÉN,196,241,295,329,624
58,58091,580910324,Pehuenches,NEUQUÉN,286,299,553,521,1074
58,58091,580910202,Pehuenches,NEUQUÉN,13,27,8,19,27
58,58091,580910107,Pehuenches,NEUQUÉN,436,507,683,698,1381
58,58091,580910320,Pehuenches,NEUQUÉN,232,256,406,421,827
58,58091,580910322,Pehuenches,NEUQUÉN,245,272,387,441,828
58,58091,580910203,Pehuenches,NEUQUÉN,14,26,10,18,28
58,58091,580910103,Pehuenches,NEUQUÉN,242,309,389,393,782
58,58091,580910316,Pehuenches,NEUQUÉN,133,157,208,228,436
58,58091,580910301,Pehuenches,NEUQUÉN,25,11,24,104,128
58,58091,580910321,Pehuenches,NEUQUÉN,234,256,407,453,860
58,58091,580910317,Pehuenches,NEUQUÉN,229,260,341,376,717
58,58091,580910315,Pehuenches,NEUQUÉN,159,190,205,266,471
58,58091,580910306,Pehuenches,NEUQUÉN,205,251,241,295,536
58,58091,580910310,Pehuenches,NEUQUÉN,165,209,227,273,500
58,58091,580910108,Pehuenches,NEUQUÉN,312,377,525,537,1062
58,58091,580910325,Pehuenches,NEUQUÉN,216,205,367,376,743
58,58091,580910307,Pehuenches,NEUQUÉN,147,211,156,190,346
58,58091,580910102,Pehuenches,NEUQUÉN,74,128,120,107,227
58,58091,580910318,Pehuenches,NEUQUÉN,304,358,510,522,1032
58,58091,580910305,Pehuenches,NEUQUÉN,283,371,382,587,969
58,58091,580910323,Pehuenches,NEUQUÉN,253,339,450,470,920
58,58091,580910302,Pehuenches,NEUQUÉN,147,113,197,382,579
58,58091,580910204,Pehuenches,NEUQUÉN,9,11,4,13,17
58,58091,580910201,Pehuenches,NEUQUÉN,10,16,13,152,165
58,58091,580910109,Pehuenches,NEUQUÉN,55,63,42,92,134
58,58091,580910106,Pehuenches,NEUQUÉN,127,197,195,224,419
58,58091,580910101,Pehuenches,NEUQUÉN,22,40,21,44,65
58,58091,580910314,Pehuenches,NEUQUÉN,178,221,229,266,495
58,58091,580910313,Pehuenches,NEUQUÉN,176,196,270,283,553
58,58091,580910311,Pehuenches,NEUQUÉN,286,342,470,527,997
58,58091,580910327,Pehuenches,NEUQUÉN,232,262,392,395,787
58,58091,580910308,Pehuenches,NEUQUÉN,197,233,242,294,536
58,58091,580910304,Pehuenches,NEUQUÉN,409,506,653,850,1503
58,58091,580910105,Pehuenches,NEUQUÉN,12,27,13,127,140
58,58091,580910326,Pehuenches,NEUQUÉN,160,215,263,275,538
58,58091,580910319,Pehuenches,NEUQUÉN,250,285,384,427,811
58,58091,580910303,Pehuenches,NEUQUÉN,281,290,435,585,1020
58,58091,580910104,Pehuenches,NEUQUÉN,26,31,26,46,72
58,58035,580352414,Confluencia,NEUQUÉN,196,218,344,346,690
58,58035,580351901,Confluencia,NEUQUÉN,210,307,277,333,610
58,58035,580351812,Confluencia,NEUQUÉN,399,500,617,669,1286
58,58035,580351619,Confluencia,NEUQUÉN,132,142,186,223,409
58,58035,580350801,Confluencia,NEUQUÉN,202,229,339,310,649
58,58035,580352514,Confluencia,NEUQUÉN,305,335,616,621,1237
58,58035,580352409,Confluencia,NEUQUÉN,251,308,426,419,845
58,58035,580352310,Confluencia,NEUQUÉN,264,319,432,352,784
58,58035,580352212,Confluencia,NEUQUÉN,133,169,269,227,496
58,58035,580352204,Confluencia,NEUQUÉN,15,32,27,32,59
58,58035,580352114,Confluencia,NEUQUÉN,256,296,453,430,883
58,58035,580352104,Confluencia,NEUQUÉN,355,416,611,636,1247
58,58035,580352103,Confluencia,NEUQUÉN,274,276,484,444,928
58,58035,580352012,Confluencia,NEUQUÉN,398,407,868,791,1659
58,58035,580352008,Confluencia,NEUQUÉN,438,478,711,728,1439
58,58035,580351902,Confluencia,NEUQUÉN,315,329,526,531,1057
58,58035,580351826,Confluencia,NEUQUÉN,235,242,483,439,922
58,58035,580351821,Confluencia,NEUQUÉN,241,273,397,410,807
58,58035,580351710,Confluencia,NEUQUÉN,358,377,535,570,1105
58,58035,580351707,Confluencia,NEUQUÉN,374,438,516,510,1026
58,58035,580351609,Confluencia,NEUQUÉN,159,194,206,255,461
58,58035,580351509,Confluencia,NEUQUÉN,313,334,496,471,967
58,58035,580351505,Confluencia,NEUQUÉN,435,507,685,627,1312
58,58035,580351416,Confluencia,NEUQUÉN,143,140,233,229,462
58,58035,580351405,Confluencia,NEUQUÉN,295,370,430,389,819
58,58035,580350616,Confluencia,NEUQUÉN,193,250,244,203,447
58,58035,580350501,Confluencia,NEUQUÉN,220,319,219,191,410
58,58035,580350512,Confluencia,NEUQUÉN,119,149,160,365,525
58,58035,580352413,Confluencia,NEUQUÉN,208,239,428,405,833
58,58035,580350402,Confluencia,NEUQUÉN,306,374,413,375,788
58,58035,580350510,Confluencia,NEUQUÉN,282,407,314,238,552
58,58035,580350518,Confluencia,NEUQUÉN,133,182,150,136,286
58,58035,580350413,Confluencia,NEUQUÉN,177,201,260,281,541
58,58035,580350410,Confluencia,NEUQUÉN,354,351,561,479,1040
58,58035,580351401,Confluencia,NEUQUÉN,186,208,279,278,557
58,58035,580351211,Confluencia,NEUQUÉN,171,184,260,231,491
58,58035,580351110,Confluencia,NEUQUÉN,243,307,353,356,709
58,58035,580351004,Confluencia,NEUQUÉN,294,358,432,374,806
58,58035,580350822,Confluencia,NEUQUÉN,363,374,797,721,1518
58,58035,580350821,Confluencia,NEUQUÉN,194,205,378,369,747
58,58035,580350819,Confluencia,NEUQUÉN,219,235,428,383,811
58,58035,580350818,Confluencia,NEUQUÉN,180,190,341,309,650
58,58035,580352112,Confluencia,NEUQUÉN,201,212,370,309,679
58,58035,580352109,Confluencia,NEUQUÉN,258,267,500,454,954
58,58035,580351702,Confluencia,NEUQUÉN,272,307,365,329,694
58,58035,580351506,Confluencia,NEUQUÉN,404,443,655,597,1252
58,58035,580352501,Confluencia,NEUQUÉN,345,386,681,656,1337
58,58035,580352323,Confluencia,NEUQUÉN,189,185,386,408,794
58,58035,580350108,Confluencia,NEUQUÉN,20,32,30,29,59
58,58035,580352007,Confluencia,NEUQUÉN,422,447,698,758,1456
58,58035,580351914,Confluencia,NEUQUÉN,180,240,266,281,547
58,58035,580351601,Confluencia,NEUQUÉN,179,211,274,321,595
58,58035,580350701,Confluencia,NEUQUÉN,55,63,81,60,141
58,58035,580350204,Confluencia,NEUQUÉN,330,306,421,539,960
58,58035,580350201,Confluencia,NEUQUÉN,130,155,218,235,453
58,58035,580352406,Confluencia,NEUQUÉN,256,260,463,483,946
58,58035,580352405,Confluencia,NEUQUÉN,250,158,520,521,1041
58,58035,580352326,Confluencia,NEUQUÉN,224,247,379,370,749
58,58035,580352316,Confluencia,NEUQUÉN,226,220,387,385,772
58,58035,580352315,Confluencia,NEUQUÉN,210,208,367,349,716
58,58035,580352311,Confluencia,NEUQUÉN,318,286,493,420,913
58,58035,580352308,Confluencia,NEUQUÉN,298,320,412,418,830
58,58035,580352215,Confluencia,NEUQUÉN,187,198,263,239,502
58,58035,580352214,Confluencia,NEUQUÉN,286,258,449,427,876
58,58035,580352209,Confluencia,NEUQUÉN,277,293,424,380,804
58,58035,580352111,Confluencia,NEUQUÉN,271,285,500,485,985
58,58035,580352108,Confluencia,NEUQUÉN,271,306,518,559,1077
58,58035,580351819,Confluencia,NEUQUÉN,185,238,291,277,568
58,58035,580351806,Confluencia,NEUQUÉN,214,231,344,327,671
58,58035,580351805,Confluencia,NEUQUÉN,275,295,511,522,1033
58,58035,580351711,Confluencia,NEUQUÉN,424,447,646,601,1247
58,58035,580351508,Confluencia,NEUQUÉN,294,324,448,486,934
58,58035,580351502,Confluencia,NEUQUÉN,260,285,351,288,639
58,58035,580351420,Confluencia,NEUQUÉN,48,81,63,78,141
58,58035,580351419,Confluencia,NEUQUÉN,317,252,544,504,1048
58,58035,580351414,Confluencia,NEUQUÉN,419,438,676,615,1291
58,58035,580350708,Confluencia,NEUQUÉN,395,310,675,700,1375
58,58035,580350617,Confluencia,NEUQUÉN,239,320,303,253,556
58,58035,580350609,Confluencia,NEUQUÉN,296,349,401,354,755
58,58035,580350604,Confluencia,NEUQUÉN,223,258,302,235,537
58,58035,580350507,Confluencia,NEUQUÉN,196,268,252,221,473
58,58035,580350419,Confluencia,NEUQUÉN,364,384,485,456,941
58,58035,580350414,Confluencia,NEUQUÉN,316,344,518,451,969
58,58035,580352506,Confluencia,NEUQUÉN,166,172,298,274,572
58,58035,580352412,Confluencia,NEUQUÉN,315,313,630,561,1191
58,58035,580352410,Confluencia,NEUQUÉN,281,295,595,578,1173
58,58035,580350509,Confluencia,NEUQUÉN,253,373,265,222,487
58,58035,580350207,Confluencia,NEUQUÉN,151,183,216,266,482
58,58035,580350206,Confluencia,NEUQUÉN,45,80,43,59,102
58,58035,580350205,Confluencia,NEUQUÉN,160,130,239,268,507
58,58035,580350516,Confluencia,NEUQUÉN,322,485,367,294,661
58,58035,580350515,Confluencia,NEUQUÉN,202,358,281,238,519
58,58035,580351214,Confluencia,NEUQUÉN,247,286,364,338,702
58,58035,580351212,Confluencia,NEUQUÉN,249,248,338,313,651
58,58035,580351117,Confluencia,NEUQUÉN,386,417,759,774,1533
58,58035,580351113,Confluencia,NEUQUÉN,309,330,593,515,1108
58,58035,580351106,Confluencia,NEUQUÉN,374,409,556,522,1078
58,58035,580351018,Confluencia,NEUQUÉN,150,144,256,255,511
58,58035,580351013,Confluencia,NEUQUÉN,512,451,913,804,1717
58,58035,580350816,Confluencia,NEUQUÉN,378,421,683,664,1347
58,58035,580350513,Confluencia,NEUQUÉN,262,314,323,261,584
58,58035,580351411,Confluencia,NEUQUÉN,418,443,848,820,1668
58,58035,580351213,Confluencia,NEUQUÉN,277,311,352,350,702
58,58035,580350610,Confluencia,NEUQUÉN,223,264,303,281,584
58,58035,580352516,Confluencia,NEUQUÉN,277,282,503,492,995
58,58035,580352201,Confluencia,NEUQUÉN,184,196,232,335,567
58,58035,580350101,Confluencia,NEUQUÉN,26,58,16,42,58
58,58035,580351911,Confluencia,NEUQUÉN,370,359,622,646,1268
58,58035,580351814,Confluencia,NEUQUÉN,142,214,185,239,424
58,58035,580351811,Confluencia,NEUQUÉN,286,454,496,559,1055
58,58035,580351606,Confluencia,NEUQUÉN,188,208,269,318,587
58,58035,580351603,Confluencia,NEUQUÉN,65,94,97,115,212
58,58035,580352513,Confluencia,NEUQUÉN,280,284,567,512,1079
58,58035,580352317,Confluencia,NEUQUÉN,257,246,438,454,892
58,58035,580352313,Confluencia,NEUQUÉN,295,329,467,426,893
58,58035,580352306,Confluencia,NEUQUÉN,163,183,238,274,512
58,58035,580352208,Confluencia,NEUQUÉN,313,322,569,489,1058
58,58035,580352207,Confluencia,NEUQUÉN,272,201,428,416,844
58,58035,580352009,Confluencia,NEUQUÉN,241,292,410,396,806
58,58035,580351912,Confluencia,NEUQUÉN,109,164,160,157,317
58,58035,580351818,Confluencia,NEUQUÉN,273,320,440,405,845
58,58035,580351817,Confluencia,NEUQUÉN,209,240,332,372,704
58,58035,580351815,Confluencia,NEUQUÉN,269,290,479,472,951
58,58035,580351804,Confluencia,NEUQUÉN,180,197,290,277,567
58,58035,580351617,Confluencia,NEUQUÉN,54,78,60,75,135
58,58035,580351616,Confluencia,NEUQUÉN,344,372,645,681,1326
58,58035,580351614,Confluencia,NEUQUÉN,138,202,229,228,457
58,58035,580351908,Confluencia,NEUQUÉN,366,433,607,559,1166
58,58035,580351514,Confluencia,NEUQUÉN,301,350,499,475,974
58,58035,580351503,Confluencia,NEUQUÉN,355,411,506,502,1008
58,58035,580351421,Confluencia,NEUQUÉN,198,183,370,356,726
58,58035,580351415,Confluencia,NEUQUÉN,166,167,333,342,675
58,58035,580351410,Confluencia,NEUQUÉN,380,406,656,628,1284
58,58035,580351403,Confluencia,NEUQUÉN,302,320,505,510,1015
58,58035,580350703,Confluencia,NEUQUÉN,323,367,477,379,856
58,58035,580350602,Confluencia,NEUQUÉN,224,316,255,220,475
58,58035,580350508,Confluencia,NEUQUÉN,177,217,203,169,372
58,58035,580352509,Confluencia,NEUQUÉN,205,196,342,319,661
58,58035,580350405,Confluencia,NEUQUÉN,281,276,492,448,940
58,58035,580350403,Confluencia,NEUQUÉN,136,167,236,197,433
58,58035,580350314,Confluencia,NEUQUÉN,64,52,100,101,201
58,58035,580350306,Confluencia,NEUQUÉN,348,415,569,529,1098
58,58035,580350214,Confluencia,NEUQUÉN,154,189,252,257,509
58,58035,580350213,Confluencia,NEUQUÉN,132,172,194,216,410
58,58035,580350109,Confluencia,NEUQUÉN,13,271,13,11,24
58,58035,580350412,Confluencia,NEUQUÉN,352,358,529,515,1044
58,58035,580351215,Confluencia,NEUQUÉN,336,369,461,471,932
58,58035,580351210,Confluencia,NEUQUÉN,248,220,362,359,721
58,58035,580351209,Confluencia,NEUQUÉN,349,381,517,480,997
58,58035,580351120,Confluencia,NEUQUÉN,202,237,296,289,585
58,58035,580351125,Confluencia,NEUQUÉN,164,189,274,263,537
58,58035,580351109,Confluencia,NEUQUÉN,103,112,173,165,338
58,58035,580351014,Confluencia,NEUQUÉN,197,210,357,323,680
58,58035,580350911,Confluencia,NEUQUÉN,301,301,556,544,1100
58,58035,580350908,Confluencia,NEUQUÉN,323,321,577,548,1125
58,58035,580350907,Confluencia,NEUQUÉN,339,344,619,539,1158
58,58035,580350902,Confluencia,NEUQUÉN,270,277,513,522,1035
58,58035,580350815,Confluencia,NEUQUÉN,296,261,491,467,958
58,58035,580350809,Confluencia,NEUQUÉN,306,331,531,465,996
58,58035,580350303,Confluencia,NEUQUÉN,263,294,461,440,901
58,58035,580351810,Confluencia,NEUQUÉN,359,370,514,476,990
58,58035,580351103,Confluencia,NEUQUÉN,409,406,681,667,1348
58,58035,580351618,Confluencia,NEUQUÉN,60,68,97,124,221
58,58035,580350203,Confluencia,NEUQUÉN,7,14,11,8,19
58,58035,580351801,Confluencia,NEUQUÉN,4,5,1,5,6
58,58035,580350106,Confluencia,NEUQUÉN,27,31,17,54,71
58,58035,580352301,Confluencia,NEUQUÉN,55,63,74,101,175
58,58035,580351402,Confluencia,NEUQUÉN,61,71,106,114,220
58,58035,580350311,Confluencia,NEUQUÉN,123,145,215,189,404
58,58035,580352401,Confluencia,NEUQUÉN,242,251,495,451,946
58,58035,580352325,Confluencia,NEUQUÉN,244,245,364,352,716
58,58035,580352211,Confluencia,NEUQUÉN,384,367,691,647,1338
58,58035,580352115,Confluencia,NEUQUÉN,185,196,323,315,638
58,58035,580352113,Confluencia,NEUQUÉN,139,185,220,219,439
58,58035,580352110,Confluencia,NEUQUÉN,308,356,543,522,1065
58,58035,580352107,Confluencia,NEUQUÉN,346,375,505,450,955
58,58035,580352106,Confluencia,NEUQUÉN,290,321,423,383,806
58,58035,580352217,Confluencia,NEUQUÉN,350,315,673,602,1275
58,58035,580352220,Confluencia,NEUQUÉN,250,245,478,430,908
58,58035,580351913,Confluencia,NEUQUÉN,182,193,364,364,728
58,58035,580351903,Confluencia,NEUQUÉN,259,224,453,407,860
58,58035,580351809,Confluencia,NEUQUÉN,333,378,513,475,988
58,58035,580351802,Confluencia,NEUQUÉN,275,325,458,449,907
58,58035,580351910,Confluencia,NEUQUÉN,242,246,419,414,833
58,58035,580351704,Confluencia,NEUQUÉN,303,347,455,434,889
58,58035,580352219,Confluencia,NEUQUÉN,298,277,555,532,1087
58,58035,580351504,Confluencia,NEUQUÉN,272,316,417,391,808
58,58035,580351413,Confluencia,NEUQUÉN,415,452,599,575,1174
58,58035,580351412,Confluencia,NEUQUÉN,343,373,545,501,1046
58,58035,580351406,Confluencia,NEUQUÉN,200,295,251,216,467
58,58035,580350804,Confluencia,NEUQUÉN,219,219,385,390,775
58,58035,580350714,Confluencia,NEUQUÉN,251,245,428,406,834
58,58035,580350711,Confluencia,NEUQUÉN,361,367,635,644,1279
58,58035,580350710,Confluencia,NEUQUÉN,314,307,548,517,1065
58,58035,580350707,Confluencia,NEUQUÉN,310,266,559,542,1101
58,58035,580350706,Confluencia,NEUQUÉN,333,296,585,605,1190
58,58035,580350704,Confluencia,NEUQUÉN,409,416,700,685,1385
58,58035,580350709,Confluencia,NEUQUÉN,329,351,558,546,1104
58,58035,580350601,Confluencia,NEUQUÉN,383,357,550,522,1072
58,58035,580350519,Confluencia,NEUQUÉN,148,161,204,162,366
58,58035,580350420,Confluencia,NEUQUÉN,292,348,438,387,825
58,58035,580350417,Confluencia,NEUQUÉN,290,367,352,300,652
58,58035,580352508,Confluencia,NEUQUÉN,178,200,289,246,535
58,58035,580352411,Confluencia,NEUQUÉN,391,371,687,691,1378
58,58035,580350408,Confluencia,NEUQUÉN,327,346,465,411,876
58,58035,580350406,Confluencia,NEUQUÉN,287,309,408,366,774
58,58035,580350316,Confluencia,NEUQUÉN,301,329,497,450,947
58,58035,580350511,Confluencia,NEUQUÉN,302,399,344,298,642
58,58035,580350309,Confluencia,NEUQUÉN,345,385,504,435,939
58,58035,580350308,Confluencia,NEUQUÉN,436,452,802,779,1581
58,58035,580350307,Confluencia,NEUQUÉN,376,394,540,527,1067
58,58035,580350208,Confluencia,NEUQUÉN,138,158,170,211,381
58,58035,580350411,Confluencia,NEUQUÉN,311,369,465,423,888
58,58035,580350514,Confluencia,NEUQUÉN,194,274,270,192,462
58,58035,580351310,Confluencia,NEUQUÉN,373,396,548,581,1129
58,58035,580351114,Confluencia,NEUQUÉN,246,249,441,479,920
58,58035,580351107,Confluencia,NEUQUÉN,408,470,603,591,1194
58,58035,580351104,Confluencia,NEUQUÉN,452,524,677,610,1287
58,58035,580351016,Confluencia,NEUQUÉN,234,250,397,372,769
58,58035,580351010,Confluencia,NEUQUÉN,160,221,287,293,580
58,58035,580350904,Confluencia,NEUQUÉN,359,369,709,642,1351
58,58035,580350915,Confluencia,NEUQUÉN,247,229,440,447,887
58,58035,580350820,Confluencia,NEUQUÉN,277,283,454,446,900
58,58035,580350813,Confluencia,NEUQUÉN,246,238,459,444,903
58,58035,580350807,Confluencia,NEUQUÉN,300,297,574,600,1174
58,58035,580351001,Confluencia,NEUQUÉN,178,180,364,319,683
58,58035,580351604,Confluencia,NEUQUÉN,170,179,287,274,561
58,58035,580350104,Confluencia,NEUQUÉN,25,284,23,35,58
58,58035,580352517,Confluencia,NEUQUÉN,332,318,579,591,1170
58,58035,580352321,Confluencia,NEUQUÉN,168,167,317,341,658
58,58035,580352001,Confluencia,NEUQUÉN,116,128,171,156,327
58,58035,580352407,Confluencia,NEUQUÉN,287,295,467,461,928
58,58035,580352319,Confluencia,NEUQUÉN,334,362,588,597,1185
58,58035,580352309,Confluencia,NEUQUÉN,347,394,538,475,1013
58,58035,580352305,Confluencia,NEUQUÉN,245,267,315,326,641
58,58035,580352304,Confluencia,NEUQUÉN,294,322,417,368,785
58,58035,580352116,Confluencia,NEUQUÉN,195,215,382,351,733
58,58035,580351803,Confluencia,NEUQUÉN,275,278,423,421,844
58,58035,580351708,Confluencia,NEUQUÉN,398,416,546,577,1123
58,58035,580351612,Confluencia,NEUQUÉN,216,253,413,446,859
58,58035,580351607,Confluencia,NEUQUÉN,103,112,181,208,389
58,58035,580351605,Confluencia,NEUQUÉN,257,309,447,505,952
58,58035,580351510,Confluencia,NEUQUÉN,370,401,580,583,1163
58,58035,580351501,Confluencia,NEUQUÉN,414,435,619,567,1186
58,58035,580351418,Confluencia,NEUQUÉN,379,406,698,667,1365
58,58035,580350615,Confluencia,NEUQUÉN,238,320,276,215,491
58,58035,580352511,Confluencia,NEUQUÉN,234,229,408,429,837
58,58035,580352503,Confluencia,NEUQUÉN,337,386,661,601,1262
58,58035,580350407,Confluencia,NEUQUÉN,233,243,353,305,658
58,58035,580350310,Confluencia,NEUQUÉN,287,303,403,317,720
58,58035,580350212,Confluencia,NEUQUÉN,143,226,187,217,404
58,58035,580350211,Confluencia,NEUQUÉN,151,207,183,212,395
58,58035,580350302,Confluencia,NEUQUÉN,245,253,442,423,865
58,58035,580350517,Confluencia,NEUQUÉN,206,284,235,176,411
58,58035,580351312,Confluencia,NEUQUÉN,316,344,438,417,855
58,58035,580351311,Confluencia,NEUQUÉN,259,305,353,347,700
58,58035,580351203,Confluencia,NEUQUÉN,223,263,324,294,618
58,58035,580351201,Confluencia,NEUQUÉN,353,403,426,375,801
58,58035,580351119,Confluencia,NEUQUÉN,218,219,365,319,684
58,58035,580351111,Confluencia,NEUQUÉN,0,0,6,21,27
58,58035,580351108,Confluencia,NEUQUÉN,238,266,350,344,694
58,58035,580351101,Confluencia,NEUQUÉN,254,268,418,386,804
58,58035,580351012,Confluencia,NEUQUÉN,299,235,539,544,1083
58,58035,580351009,Confluencia,NEUQUÉN,314,353,473,497,970
58,58035,580351008,Confluencia,NEUQUÉN,277,306,506,424,930
58,58035,580350817,Confluencia,NEUQUÉN,284,291,513,514,1027
58,58035,580352206,Confluencia,NEUQUÉN,286,303,482,454,936
58,58035,580352010,Confluencia,NEUQUÉN,296,326,507,517,1024
58,58035,580352005,Confluencia,NEUQUÉN,20,28,37,53,90
58,58035,580351507,Confluencia,NEUQUÉN,357,381,568,548,1116
58,58035,580350105,Confluencia,NEUQUÉN,24,134,23,39,62
58,58035,580350102,Confluencia,NEUQUÉN,95,133,127,147,274
58,58035,580351825,Confluencia,NEUQUÉN,238,242,412,386,798
58,58035,580351824,Confluencia,NEUQUÉN,253,254,388,413,801
58,58035,580350305,Confluencia,NEUQUÉN,367,385,584,587,1171
58,58035,580352515,Confluencia,NEUQUÉN,264,268,447,469,916
58,58035,580352404,Confluencia,NEUQUÉN,362,385,765,745,1510
58,58035,580352403,Confluencia,NEUQUÉN,444,449,907,878,1785
58,58035,580352318,Confluencia,NEUQUÉN,171,152,290,295,585
58,58035,580352216,Confluencia,NEUQUÉN,177,181,299,273,572
58,58035,580352213,Confluencia,NEUQUÉN,232,240,437,435,872
58,58035,580352105,Confluencia,NEUQUÉN,277,280,390,374,764
58,58035,580352102,Confluencia,NEUQUÉN,294,300,515,504,1019
58,58035,580351823,Confluencia,NEUQUÉN,205,207,414,410,824
58,58035,580351701,Confluencia,NEUQUÉN,331,372,433,442,875
58,58035,580351909,Confluencia,NEUQUÉN,314,341,602,580,1182
58,58035,580351513,Confluencia,NEUQUÉN,287,294,413,426,839
58,58035,580351408,Confluencia,NEUQUÉN,350,400,468,454,922
58,58035,580351407,Confluencia,NEUQUÉN,351,422,448,479,927
58,58035,580350803,Confluencia,NEUQUÉN,386,382,700,644,1344
58,58035,580350715,Confluencia,NEUQUÉN,247,250,521,481,1002
58,58035,580350713,Confluencia,NEUQUÉN,244,238,433,426,859
58,58035,580350712,Confluencia,NEUQUÉN,401,377,679,674,1353
58,58035,580350614,Confluencia,NEUQUÉN,285,380,359,288,647
58,58035,580350607,Confluencia,NEUQUÉN,205,205,366,340,706
58,58035,580350606,Confluencia,NEUQUÉN,182,198,321,287,608
58,58035,580350603,Confluencia,NEUQUÉN,208,244,269,261,530
58,58035,580350502,Confluencia,NEUQUÉN,256,308,413,311,724
58,58035,580352510,Confluencia,NEUQUÉN,279,279,518,485,1003
58,58035,580350216,Confluencia,NEUQUÉN,47,55,73,85,158
58,58035,580350210,Confluencia,NEUQUÉN,245,282,365,397,762
58,58035,580350522,Confluencia,NEUQUÉN,209,260,250,233,483
58,58035,580351304,Confluencia,NEUQUÉN,152,179,202,194,396
58,58035,580351303,Confluencia,NEUQUÉN,120,187,137,138,275
58,58035,580351301,Confluencia,NEUQUÉN,253,312,333,281,614
58,58035,580351204,Confluencia,NEUQUÉN,396,423,601,604,1205
58,58035,580351202,Confluencia,NEUQUÉN,167,193,236,177,413
58,58035,580351123,Confluencia,NEUQUÉN,198,227,379,314,693
58,58035,580351118,Confluencia,NEUQUÉN,222,229,415,382,797
58,58035,580351115,Confluencia,NEUQUÉN,242,250,518,541,1059
58,58035,580351017,Confluencia,NEUQUÉN,256,288,383,362,745
58,58035,580351007,Confluencia,NEUQUÉN,247,235,378,340,718
58,58035,580351003,Confluencia,NEUQUÉN,238,253,350,344,694
58,58035,580350913,Confluencia,NEUQUÉN,374,380,771,688,1459
58,58035,580350912,Confluencia,NEUQUÉN,285,305,547,529,1076
58,58035,580350901,Confluencia,NEUQUÉN,211,225,384,421,805
58,58035,580350826,Confluencia,NEUQUÉN,218,195,435,452,887
58,58035,580350825,Confluencia,NEUQUÉN,228,234,435,459,894
58,58035,580350823,Confluencia,NEUQUÉN,281,269,571,552,1123
58,58035,580350814,Confluencia,NEUQUÉN,388,367,748,747,1495
58,58035,580350808,Confluencia,NEUQUÉN,215,215,339,285,624
58,58035,580350520,Confluencia,NEUQUÉN,124,163,166,141,307
58,58035,580350909,Confluencia,NEUQUÉN,337,356,647,616,1263
58,58035,580350103,Confluencia,NEUQUÉN,18,59,10,21,31
58,58035,580352322,Confluencia,NEUQUÉN,9,12,4,11,15
58,58035,580351608,Confluencia,NEUQUÉN,155,170,220,241,461
58,58035,580350304,Confluencia,NEUQUÉN,374,451,574,520,1094
58,58035,580352408,Confluencia,NEUQUÉN,287,322,504,505,1009
58,58035,580352402,Confluencia,NEUQUÉN,237,250,500,451,951
58,58035,580352327,Confluencia,NEUQUÉN,171,208,344,334,678
58,58035,580352320,Confluencia,NEUQUÉN,199,217,340,330,670
58,58035,580352312,Confluencia,NEUQUÉN,295,271,440,403,843
58,58035,580351906,Confluencia,NEUQUÉN,330,385,473,472,945
58,58035,580351816,Confluencia,NEUQUÉN,253,258,473,443,916
58,58035,580351813,Confluencia,NEUQUÉN,253,212,466,452,918
58,58035,580351807,Confluencia,NEUQUÉN,330,388,524,514,1038
58,58035,580351703,Confluencia,NEUQUÉN,157,176,235,197,432
58,58035,580351620,Confluencia,NEUQUÉN,76,86,112,124,236
58,58035,580351610,Confluencia,NEUQUÉN,212,253,355,382,737
58,58035,580351515,Confluencia,NEUQUÉN,190,186,290,323,613
58,58035,580351907,Confluencia,NEUQUÉN,316,369,456,425,881
58,58035,580351511,Confluencia,NEUQUÉN,339,248,533,508,1041
58,58035,580351422,Confluencia,NEUQUÉN,236,252,381,349,730
58,58035,580351417,Confluencia,NEUQUÉN,305,306,583,569,1152
58,58035,580351409,Confluencia,NEUQUÉN,311,339,446,442,888
58,58035,580350802,Confluencia,NEUQUÉN,480,506,853,772,1625
58,58035,580350702,Confluencia,NEUQUÉN,167,179,257,239,496
58,58035,580350618,Confluencia,NEUQUÉN,98,147,97,81,178
58,58035,580350613,Confluencia,NEUQUÉN,301,454,322,275,597
58,58035,580350612,Confluencia,NEUQUÉN,275,355,339,276,615
58,58035,580350605,Confluencia,NEUQUÉN,263,334,350,304,654
58,58035,580350504,Confluencia,NEUQUÉN,195,357,163,149,312
58,58035,580350503,Confluencia,NEUQUÉN,337,388,449,372,821
58,58035,580350416,Confluencia,NEUQUÉN,270,293,383,363,746
58,58035,580352507,Confluencia,NEUQUÉN,215,226,398,376,774
58,58035,580352505,Confluencia,NEUQUÉN,174,181,297,277,574
58,58035,580352504,Confluencia,NEUQUÉN,223,233,393,354,747
58,58035,580352502,Confluencia,NEUQUÉN,324,359,633,591,1224
58,58035,580350404,Confluencia,NEUQUÉN,470,452,792,769,1561
58,58035,580350401,Confluencia,NEUQUÉN,258,331,323,245,568
58,58035,580350215,Confluencia,NEUQUÉN,203,238,377,335,712
58,58035,580350523,Confluencia,NEUQUÉN,190,252,234,177,411
58,58035,580350409,Confluencia,NEUQUÉN,347,378,507,400,907
58,58035,580351316,Confluencia,NEUQUÉN,317,360,513,453,966
58,58035,580351307,Confluencia,NEUQUÉN,293,341,331,360,691
58,58035,580351302,Confluencia,NEUQUÉN,153,214,209,212,421
58,58035,580351207,Confluencia,NEUQUÉN,205,204,363,329,692
58,58035,580351126,Confluencia,NEUQUÉN,163,234,265,286,551
58,58035,580351105,Confluencia,NEUQUÉN,246,242,344,314,658
58,58035,580351005,Confluencia,NEUQUÉN,396,432,621,636,1257
58,58035,580351002,Confluencia,NEUQUÉN,296,316,471,497,968
58,58035,580350910,Confluencia,NEUQUÉN,303,297,576,501,1077
58,58035,580350906,Confluencia,NEUQUÉN,260,278,515,506,1021
58,58035,580350903,Confluencia,NEUQUÉN,338,357,612,579,1191
58,58035,580350917,Confluencia,NEUQUÉN,323,330,584,553,1137
58,58035,580350824,Confluencia,NEUQUÉN,182,225,329,318,647
58,58035,580350918,Confluencia,NEUQUÉN,285,325,613,550,1163
58,58035,580352324,Confluencia,NEUQUÉN,198,218,340,370,710
58,58035,580352101,Confluencia,NEUQUÉN,112,171,162,198,360
58,58035,580352006,Confluencia,NEUQUÉN,117,170,98,171,269
58,58035,580351613,Confluencia,NEUQUÉN,193,245,292,306,598
58,58035,580351112,Confluencia,NEUQUÉN,353,445,550,551,1101
58,58035,580352512,Confluencia,NEUQUÉN,241,257,502,441,943
58,58035,580352314,Confluencia,NEUQUÉN,267,265,436,432,868
58,58035,580352307,Confluencia,NEUQUÉN,297,335,408,396,804
58,58035,580352302,Confluencia,NEUQUÉN,277,288,475,461,936
58,58035,580352221,Confluencia,NEUQUÉN,216,151,434,440,874
58,58035,580352210,Confluencia,NEUQUÉN,262,268,423,390,813
58,58035,580352205,Confluencia,NEUQUÉN,279,268,532,547,1079
58,58035,580352203,Confluencia,NEUQUÉN,35,36,50,71,121
58,58035,580352202,Confluencia,NEUQUÉN,198,219,374,368,742
58,58035,580352218,Confluencia,NEUQUÉN,121,128,258,241,499
58,58035,580352011,Confluencia,NEUQUÉN,289,299,573,505,1078
58,58035,580352003,Confluencia,NEUQUÉN,52,84,77,63,140
58,58035,580352002,Confluencia,NEUQUÉN,206,278,347,360,707
58,58035,580351905,Confluencia,NEUQUÉN,357,402,560,531,1091
58,58035,580351904,Confluencia,NEUQUÉN,321,342,491,463,954
58,58035,580351822,Confluencia,NEUQUÉN,200,215,334,324,658
58,58035,580351820,Confluencia,NEUQUÉN,197,211,375,360,735
58,58035,580351808,Confluencia,NEUQUÉN,292,329,464,441,905
58,58035,580351709,Confluencia,NEUQUÉN,366,414,598,578,1176
58,58035,580351706,Confluencia,NEUQUÉN,223,248,340,308,648
58,58035,580351705,Confluencia,NEUQUÉN,103,128,181,150,331
58,58035,580351615,Confluencia,NEUQUÉN,192,282,286,313,599
58,58035,580351602,Confluencia,NEUQUÉN,248,275,441,417,858
58,58035,580351512,Confluencia,NEUQUÉN,237,265,398,360,758
58,58035,580351404,Confluencia,NEUQUÉN,298,325,482,459,941
58,58035,580350705,Confluencia,NEUQUÉN,265,264,486,521,1007
58,58035,580350608,Confluencia,NEUQUÉN,378,395,512,504,1016
58,58035,580350506,Confluencia,NEUQUÉN,252,320,299,227,526
58,58035,580350505,Confluencia,NEUQUÉN,212,275,244,224,468
58,58035,580350421,Confluencia,NEUQUÉN,194,212,300,274,574
58,58035,580350418,Confluencia,NEUQUÉN,299,429,298,282,580
58,58035,580350415,Confluencia,NEUQUÉN,310,353,416,383,799
58,58035,580350315,Confluencia,NEUQUÉN,176,227,296,319,615
58,58035,580350313,Confluencia,NEUQUÉN,268,309,475,450,925
58,58035,580350301,Confluencia,NEUQUÉN,250,243,428,403,831
58,58035,580350209,Confluencia,NEUQUÉN,219,233,382,360,742
58,58035,580350202,Confluencia,NEUQUÉN,147,167,258,285,543
58,58035,580351315,Confluencia,NEUQUÉN,373,427,527,479,1006
58,58035,580351314,Confluencia,NEUQUÉN,270,275,361,372,733
58,58035,580351313,Confluencia,NEUQUÉN,407,441,607,562,1169
58,58035,580351309,Confluencia,NEUQUÉN,323,377,471,391,862
58,58035,580351308,Confluencia,NEUQUÉN,205,233,254,244,498
58,58035,580351306,Confluencia,NEUQUÉN,289,340,398,347,745
58,58035,580351305,Confluencia,NEUQUÉN,169,187,222,197,419
58,58035,580351208,Confluencia,NEUQUÉN,262,268,378,349,727
58,58035,580351206,Confluencia,NEUQUÉN,257,244,403,369,772
58,58035,580351205,Confluencia,NEUQUÉN,433,449,733,677,1410
58,58035,580351216,Confluencia,NEUQUÉN,263,272,411,406,817
58,58035,580351124,Confluencia,NEUQUÉN,111,115,227,227,454
58,58035,580351122,Confluencia,NEUQUÉN,255,254,460,464,924
58,58035,580351121,Confluencia,NEUQUÉN,262,298,412,408,820
58,58035,580351116,Confluencia,NEUQUÉN,177,166,286,294,580
58,58035,580351102,Confluencia,NEUQUÉN,258,297,378,365,743
58,58035,580351015,Confluencia,NEUQUÉN,276,248,490,470,960
58,58035,580351011,Confluencia,NEUQUÉN,265,306,393,401,794
58,58035,580351006,Confluencia,NEUQUÉN,434,495,732,646,1378
58,58035,580350905,Confluencia,NEUQUÉN,200,192,413,424,837
58,58035,580350916,Confluencia,NEUQUÉN,284,305,519,475,994
58,58035,580350914,Confluencia,NEUQUÉN,321,347,612,538,1150
58,58035,580350812,Confluencia,NEUQUÉN,239,258,419,349,768
58,58035,580350811,Confluencia,NEUQUÉN,348,370,626,490,1116
58,58035,580350810,Confluencia,NEUQUÉN,350,367,669,595,1264
58,58035,580350806,Confluencia,NEUQUÉN,327,329,592,603,1195
58,58035,580350805,Confluencia,NEUQUÉN,119,130,173,160,333
58,58035,580350521,Confluencia,NEUQUÉN,192,244,250,194,444
58,58035,580352303,Confluencia,NEUQUÉN,213,204,361,342,703
58,58035,580351611,Confluencia,NEUQUÉN,271,297,482,509,991
58,58035,580350611,Confluencia,NEUQUÉN,233,292,305,293,598
58,58035,580350312,Confluencia,NEUQUÉN,135,115,204,206,410
58,58035,580352004,Confluencia,NEUQUÉN,101,118,145,164,309
58,58035,580350107,Confluencia,NEUQUÉN,26,36,13,46,59
58,58077,580770201,Minas,NEUQUÉN,135,162,209,215,424
58,58077,580770204,Minas,NEUQUÉN,81,96,117,181,298
58,58077,580770202,Minas,NEUQUÉN,45,65,100,88,188
58,58077,580770207,Minas,NEUQUÉN,220,249,363,370,733
58,58077,580770205,Minas,NEUQUÉN,226,301,385,370,755
58,58077,580770203,Minas,NEUQUÉN,79,91,135,151,286
58,58077,580770210,Minas,NEUQUÉN,91,139,156,149,305
58,58077,580770208,Minas,NEUQUÉN,376,505,644,651,1295
58,58077,580770206,Minas,NEUQUÉN,92,100,122,155,277
58,58077,580770104,Minas,NEUQUÉN,104,88,137,174,311
58,58077,580770102,Minas,NEUQUÉN,154,170,220,241,461
58,58077,580770105,Minas,NEUQUÉN,165,261,223,253,476
58,58077,580770103,Minas,NEUQUÉN,190,158,273,312,585
58,58077,580770106,Minas,NEUQUÉN,237,261,412,428,840
58,58077,580770101,Minas,NEUQUÉN,0,8,0,0,0
58,58056,580560510,Lácar,NEUQUÉN,207,338,273,250,523
58,58056,580560505,Lácar,NEUQUÉN,353,383,591,552,1143
58,58056,580560503,Lácar,NEUQUÉN,101,112,171,147,318
58,58056,580560408,Lácar,NEUQUÉN,226,233,492,479,971
58,58056,580560404,Lácar,NEUQUÉN,211,276,305,281,586
58,58056,580560309,Lácar,NEUQUÉN,211,271,300,275,575
58,58056,580560306,Lácar,NEUQUÉN,324,353,532,553,1085
58,58056,580560301,Lácar,NEUQUÉN,187,188,275,287,562
58,58056,580560102,Lácar,NEUQUÉN,12,17,18,30,48
58,58056,580560203,Lácar,NEUQUÉN,12,26,10,42,52
58,58056,580560508,Lácar,NEUQUÉN,268,285,469,427,896
58,58056,580560504,Lácar,NEUQUÉN,174,217,255,252,507
58,58056,580560407,Lácar,NEUQUÉN,420,398,726,709,1435
58,58056,580560406,Lácar,NEUQUÉN,286,426,477,506,983
58,58056,580560402,Lácar,NEUQUÉN,204,200,399,392,791
58,58056,580560310,Lácar,NEUQUÉN,114,130,204,224,428
58,58056,580560507,Lácar,NEUQUÉN,366,320,639,635,1274
58,58056,580560410,Lácar,NEUQUÉN,166,245,256,247,503
58,58056,580560405,Lácar,NEUQUÉN,471,534,756,749,1505
58,58056,580560509,Lácar,NEUQUÉN,309,386,445,416,861
58,58056,580560308,Lácar,NEUQUÉN,387,435,618,634,1252
58,58056,580560204,Lácar,NEUQUÉN,8,8,22,32,54
58,58056,580560105,Lácar,NEUQUÉN,121,169,190,197,387
58,58056,580560101,Lácar,NEUQUÉN,72,76,124,138,262
58,58056,580560515,Lácar,NEUQUÉN,174,330,277,218,495
58,58056,580560514,Lácar,NEUQUÉN,113,199,253,230,483
58,58056,580560513,Lácar,NEUQUÉN,139,178,269,273,542
58,58056,580560411,Lácar,NEUQUÉN,69,56,99,94,193
58,58056,580560502,Lácar,NEUQUÉN,156,221,302,252,554
58,58056,580560304,Lácar,NEUQUÉN,283,306,487,517,1004
58,58056,580560202,Lácar,NEUQUÉN,17,27,23,50,73
58,58056,580560206,Lácar,NEUQUÉN,27,183,40,65,105
58,58056,580560403,Lácar,NEUQUÉN,274,373,414,376,790
58,58056,580560307,Lácar,NEUQUÉN,215,251,316,347,663
58,58056,580560501,Lácar,NEUQUÉN,17,24,22,47,69
58,58056,580560512,Lácar,NEUQUÉN,206,208,297,244,541
58,58056,580560511,Lácar,NEUQUÉN,226,309,315,274,589
58,58056,580560409,Lácar,NEUQUÉN,197,264,303,308,611
58,58056,580560305,Lácar,NEUQUÉN,344,374,563,546,1109
58,58056,580560303,Lácar,NEUQUÉN,283,293,499,523,1022
58,58056,580560302,Lácar,NEUQUÉN,292,315,530,548,1078
58,58056,580560516,Lácar,NEUQUÉN,208,368,265,196,461
58,58056,580560205,Lácar,NEUQUÉN,11,100,30,57,87
58,58056,580560401,Lácar,NEUQUÉN,215,290,329,375,704
58,58056,580560517,Lácar,NEUQUÉN,141,203,297,235,532
58,58056,580560506,Lácar,NEUQUÉN,298,355,430,486,916
58,58056,580560104,Lácar,NEUQUÉN,8,9,12,15,27
58,58056,580560201,Lácar,NEUQUÉN,32,59,40,59,99
58,58049,580490414,Huiliches,NEUQUÉN,211,232,372,341,713
58,58049,580490205,Huiliches,NEUQUÉN,103,109,193,175,368
58,58049,580490302,Huiliches,NEUQUÉN,25,40,21,37,58
58,58049,580490413,Huiliches,NEUQUÉN,286,291,575,528,1103
58,58049,580490412,Huiliches,NEUQUÉN,189,196,380,360,740
58,58049,580490204,Huiliches,NEUQUÉN,71,83,137,148,285
58,58049,580490409,Huiliches,NEUQUÉN,269,317,432,428,860
58,58049,580490103,Huiliches,NEUQUÉN,10,14,15,22,37
58,58049,580490101,Huiliches,NEUQUÉN,4,3,4,14,18
58,58049,580490401,Huiliches,NEUQUÉN,281,371,472,472,944
58,58049,580490405,Huiliches,NEUQUÉN,191,215,338,292,630
58,58049,580490203,Huiliches,NEUQUÉN,68,84,99,109,208
58,58049,580490201,Huiliches,NEUQUÉN,16,32,39,34,73
58,58049,580490410,Huiliches,NEUQUÉN,198,214,305,290,595
58,58049,580490102,Huiliches,NEUQUÉN,52,66,56,92,148
58,58049,580490202,Huiliches,NEUQUÉN,121,138,231,271,502
58,58049,580490301,Huiliches,NEUQUÉN,77,120,159,220,379
58,58049,580490402,Huiliches,NEUQUÉN,122,149,250,270,520
58,58049,580490415,Huiliches,NEUQUÉN,185,227,304,303,607
58,58049,580490403,Huiliches,NEUQUÉN,261,277,515,510,1025
58,58049,580490407,Huiliches,NEUQUÉN,462,478,764,763,1527
58,58049,580490406,Huiliches,NEUQUÉN,208,233,395,370,765
58,58049,580490411,Huiliches,NEUQUÉN,215,239,395,397,792
58,58049,580490408,Huiliches,NEUQUÉN,283,331,473,488,961
58,58049,580490404,Huiliches,NEUQUÉN,314,348,438,429,867
58,58042,580420206,Chos Malal,NEUQUÉN,243,289,366,361,727
58,58042,580420216,Chos Malal,NEUQUÉN,196,240,305,314,619
58,58042,580420105,Chos Malal,NEUQUÉN,107,135,182,169,351
58,58042,580420101,Chos Malal,NEUQUÉN,92,144,132,187,319
58,58042,580420202,Chos Malal,NEUQUÉN,218,203,451,389,840
58,58042,580420109,Chos Malal,NEUQUÉN,55,72,105,77,182
58,58042,580420106,Chos Malal,NEUQUÉN,145,175,191,247,438
58,58042,580420204,Chos Malal,NEUQUÉN,177,199,299,287,586
58,58042,580420210,Chos Malal,NEUQUÉN,185,234,312,283,595
58,58042,580420215,Chos Malal,NEUQUÉN,232,285,347,312,659
58,58042,580420108,Chos Malal,NEUQUÉN,46,79,54,64,118
58,58042,580420102,Chos Malal,NEUQUÉN,69,47,62,138,200
58,58042,580420211,Chos Malal,NEUQUÉN,299,339,637,547,1184
58,58042,580420208,Chos Malal,NEUQUÉN,277,329,475,422,897
58,58042,580420201,Chos Malal,NEUQUÉN,229,309,292,372,664
58,58042,580420207,Chos Malal,NEUQUÉN,276,345,426,432,858
58,58042,580420205,Chos Malal,NEUQUÉN,216,251,346,340,686
58,58042,580420203,Chos Malal,NEUQUÉN,214,264,398,392,790
58,58042,580420214,Chos Malal,NEUQUÉN,280,334,459,449,908
58,58042,580420212,Chos Malal,NEUQUÉN,205,225,360,353,713
58,58042,580420104,Chos Malal,NEUQUÉN,62,101,79,100,179
58,58042,580420213,Chos Malal,NEUQUÉN,183,210,320,306,626
58,58042,580420107,Chos Malal,NEUQUÉN,35,50,49,43,92
58,58042,580420209,Chos Malal,NEUQUÉN,192,236,283,299,582
58,58042,580420217,Chos Malal,NEUQUÉN,292,326,606,583,1189
58,58042,580420103,Chos Malal,NEUQUÉN,75,102,113,141,254
58,58112,581120416,Zapala,NEUQUÉN,130,153,209,190,399
58,58112,581120403,Zapala,NEUQUÉN,22,39,37,85,122
58,58112,581120314,Zapala,NEUQUÉN,257,301,416,378,794
58,58112,581120412,Zapala,NEUQUÉN,199,216,320,314,634
58,58112,581120303,Zapala,NEUQUÉN,402,390,860,702,1562
58,58112,581120420,Zapala,NEUQUÉN,307,362,456,419,875
58,58112,581120407,Zapala,NEUQUÉN,207,218,282,313,595
58,58112,581120305,Zapala,NEUQUÉN,333,351,617,622,1239
58,58112,581120302,Zapala,NEUQUÉN,370,385,760,700,1460
58,58112,581120207,Zapala,NEUQUÉN,90,120,162,198,360
58,58112,581120405,Zapala,NEUQUÉN,261,278,418,437,855
58,58112,581120107,Zapala,NEUQUÉN,25,43,58,58,116
58,58112,581120104,Zapala,NEUQUÉN,30,20,46,63,109
58,58112,581120101,Zapala,NEUQUÉN,100,141,115,147,262
58,58112,581120310,Zapala,NEUQUÉN,330,369,615,509,1124
58,58112,581120208,Zapala,NEUQUÉN,224,246,421,400,821
58,58112,581120206,Zapala,NEUQUÉN,214,267,387,373,760
58,58112,581120103,Zapala,NEUQUÉN,98,119,164,205,369
58,58112,581120304,Zapala,NEUQUÉN,375,403,752,693,1445
58,58112,581120401,Zapala,NEUQUÉN,175,231,286,298,584
58,58112,581120414,Zapala,NEUQUÉN,114,129,192,194,386
58,58112,581120410,Zapala,NEUQUÉN,181,224,276,226,502
58,58112,581120404,Zapala,NEUQUÉN,345,375,667,621,1288
58,58112,581120307,Zapala,NEUQUÉN,331,365,622,598,1220
58,58112,581120313,Zapala,NEUQUÉN,233,298,326,294,620
58,58112,581120102,Zapala,NEUQUÉN,23,24,32,34,66
58,58112,581120315,Zapala,NEUQUÉN,145,174,208,212,420
58,58112,581120415,Zapala,NEUQUÉN,313,326,552,502,1054
58,58112,581120205,Zapala,NEUQUÉN,207,267,347,372,719
58,58112,581120419,Zapala,NEUQUÉN,267,325,539,537,1076
58,58112,581120105,Zapala,NEUQUÉN,70,77,68,124,192
58,58112,581120108,Zapala,NEUQUÉN,32,32,33,51,84
58,58112,581120202,Zapala,NEUQUÉN,95,131,171,185,356
58,58112,581120308,Zapala,NEUQUÉN,332,324,740,680,1420
58,58112,581120406,Zapala,NEUQUÉN,176,186,259,263,522
58,58112,581120411,Zapala,NEUQUÉN,198,216,292,270,562
58,58112,581120301,Zapala,NEUQUÉN,127,161,268,246,514
58,58112,581120311,Zapala,NEUQUÉN,239,268,402,412,814
58,58112,581120309,Zapala,NEUQUÉN,294,313,496,479,975
58,58112,581120409,Zapala,NEUQUÉN,155,208,223,197,420
58,58112,581120109,Zapala,NEUQUÉN,38,34,64,61,125
58,58112,581120418,Zapala,NEUQUÉN,413,460,800,748,1548
58,58112,581120201,Zapala,NEUQUÉN,77,97,93,148,241
58,58112,581120203,Zapala,NEUQUÉN,39,39,33,50,83
58,58112,581120106,Zapala,NEUQUÉN,25,18,35,65,100
58,58112,581120417,Zapala,NEUQUÉN,17,17,24,23,47
58,58112,581120312,Zapala,NEUQUÉN,303,342,420,380,800
58,58112,581120316,Zapala,NEUQUÉN,228,279,342,338,680
58,58112,581120413,Zapala,NEUQUÉN,358,365,601,600,1201
58,58112,581120408,Zapala,NEUQUÉN,371,422,522,473,995
58,58112,581120402,Zapala,NEUQUÉN,246,292,459,446,905
58,58112,581120306,Zapala,NEUQUÉN,252,258,464,432,896
58,58112,581120421,Zapala,NEUQUÉN,342,349,624,609,1233
58,58028,580280109,Collón Curá,NEUQUÉN,264,320,443,400,843
58,58028,580280116,Collón Curá,NEUQUÉN,63,80,99,120,219
58,58028,580280104,Collón Curá,NEUQUÉN,55,59,94,95,189
58,58028,580280105,Collón Curá,NEUQUÉN,25,46,30,38,68
58,58028,580280106,Collón Curá,NEUQUÉN,16,27,19,23,42
58,58028,580280107,Collón Curá,NEUQUÉN,282,316,502,510,1012
58,58028,580280103,Collón Curá,NEUQUÉN,50,69,61,81,142
58,58028,580280102,Collón Curá,NEUQUÉN,15,20,13,30,43
58,58028,580280108,Collón Curá,NEUQUÉN,103,106,225,231,456
58,58028,580280117,Collón Curá,NEUQUÉN,258,286,406,425,831
58,58028,580280110,Collón Curá,NEUQUÉN,116,192,269,236,505
58,58028,580280101,Collón Curá,NEUQUÉN,32,45,28,62,90
58,58028,580280115,Collón Curá,NEUQUÉN,37,47,40,52,92
58,58014,580140109,Añelo,NEUQUÉN,491,575,905,894,1799
58,58014,580140111,Añelo,NEUQUÉN,117,161,123,200,323
58,58014,580140114,Añelo,NEUQUÉN,264,406,417,455,872
58,58014,580140115,Añelo,NEUQUÉN,140,172,250,268,518
58,58014,580140112,Añelo,NEUQUÉN,72,115,73,119,192
58,58014,580140106,Añelo,NEUQUÉN,340,381,471,527,998
58,58014,580140104,Añelo,NEUQUÉN,278,327,420,428,848
58,58014,580140116,Añelo,NEUQUÉN,289,332,548,553,1101
58,58014,580140103,Añelo,NEUQUÉN,78,105,91,149,240
58,58014,580140102,Añelo,NEUQUÉN,131,206,140,217,357
58,58014,580140107,Añelo,NEUQUÉN,211,207,396,406,802
58,58014,580140113,Añelo,NEUQUÉN,70,103,89,114,203
58,58014,580140105,Añelo,NEUQUÉN,84,109,92,173,265
58,58014,580140101,Añelo,NEUQUÉN,110,129,104,179,283
58,58014,580140110,Añelo,NEUQUÉN,341,395,627,629,1256
58,58014,580140108,Añelo,NEUQUÉN,222,267,363,366,729
58,58098,580980104,Picún Leufú,NEUQUÉN,461,525,849,823,1672
58,58098,580980204,Picún Leufú,NEUQUÉN,69,105,66,95,161
58,58098,580980202,Picún Leufú,NEUQUÉN,151,200,198,243,441
58,58098,580980105,Picún Leufú,NEUQUÉN,93,132,106,154,260
58,58098,580980201,Picún Leufú,NEUQUÉN,36,46,19,65,84
58,58098,580980203,Picún Leufú,NEUQUÉN,20,22,8,28,36
58,58098,580980102,Picún Leufú,NEUQUÉN,3,4,0,7,7
58,58098,580980205,Picún Leufú,NEUQUÉN,66,78,94,113,207
58,58098,580980101,Picún Leufú,NEUQUÉN,96,157,106,132,238
58,58098,580980103,Picún Leufú,NEUQUÉN,466,527,735,737,1472
58,58105,581050208,Picunches,NEUQUÉN,20,20,19,41,60
58,58105,581050207,Picunches,NEUQUÉN,58,72,74,128,202
58,58105,581050213,Picunches,NEUQUÉN,29,40,47,48,95
58,58105,581050214,Picunches,NEUQUÉN,20,33,34,38,72
58,58105,581050212,Picunches,NEUQUÉN,28,28,7,44,51
58,58105,581050203,Picunches,NEUQUÉN,12,60,10,35,45
58,58105,581050101,Picunches,NEUQUÉN,49,78,71,90,161
58,58105,581050103,Picunches,NEUQUÉN,215,269,430,426,856
58,58105,581050106,Picunches,NEUQUÉN,454,524,878,842,1720
58,58105,581050102,Picunches,NEUQUÉN,128,172,230,202,432
58,58105,581050104,Picunches,NEUQUÉN,308,332,478,487,965
58,58105,581050205,Picunches,NEUQUÉN,25,30,17,64,81
58,58105,581050209,Picunches,NEUQUÉN,63,90,87,95,182
58,58105,581050210,Picunches,NEUQUÉN,34,69,38,54,92
58,58105,581050211,Picunches,NEUQUÉN,213,268,414,378,792
58,58105,581050201,Picunches,NEUQUÉN,4,7,2,7,9
58,58105,581050105,Picunches,NEUQUÉN,236,262,399,431,830
58,58105,581050206,Picunches,NEUQUÉN,11,13,8,21,29
58,58105,581050204,Picunches,NEUQUÉN,58,89,135,176,311
58,58105,581050202,Picunches,NEUQUÉN,14,33,16,21,37
58,58021,580210102,Catán Lil,NEUQUÉN,36,46,49,63,112
58,58021,580210108,Catán Lil,NEUQUÉN,20,25,17,29,46
58,58021,580210103,Catán Lil,NEUQUÉN,78,78,107,119,226
58,58021,580210104,Catán Lil,NEUQUÉN,42,48,61,66,127
58,58021,580210109,Catán Lil,NEUQUÉN,44,48,72,89,161
58,58021,580210106,Catán Lil,NEUQUÉN,13,15,15,20,35
58,58021,580210112,Catán Lil,NEUQUÉN,221,283,397,426,823
58,58021,580210110,Catán Lil,NEUQUÉN,32,32,48,58,106
58,58021,580210107,Catán Lil,NEUQUÉN,48,48,65,79,144
58,58021,580210111,Catán Lil,NEUQUÉN,17,26,27,30,57
58,58021,580210105,Catán Lil,NEUQUÉN,77,80,85,146,231
58,58021,580210101,Catán Lil,NEUQUÉN,33,34,42,45,87
58,58007,580070205,Aluminé,NEUQUÉN,209,246,397,351,748
58,58007,580070301,Aluminé,NEUQUÉN,111,160,151,167,318
58,58007,580070204,Aluminé,NEUQUÉN,32,50,41,48,89
58,58007,580070201,Aluminé,NEUQUÉN,93,99,132,166,298
58,58007,580070105,Aluminé,NEUQUÉN,90,395,116,160,276
58,58007,580070102,Aluminé,NEUQUÉN,133,181,111,201,312
58,58007,580070305,Aluminé,NEUQUÉN,92,143,183,171,354
58,58007,580070304,Aluminé,NEUQUÉN,363,415,573,569,1142
58,58007,580070303,Aluminé,NEUQUÉN,338,368,585,567,1152
58,58007,580070302,Aluminé,NEUQUÉN,547,577,948,947,1895
58,58007,580070103,Aluminé,NEUQUÉN,136,231,311,324,635
58,58007,580070202,Aluminé,NEUQUÉN,31,70,39,56,95
58,58007,580070101,Aluminé,NEUQUÉN,0,62,0,0,0
58,58007,580070104,Aluminé,NEUQUÉN,179,391,332,368,700
58,58007,580070203,Aluminé,NEUQUÉN,78,149,116,176,292
58,58063,580630107,Loncopué,NEUQUÉN,14,23,23,35,58
58,58063,580630101,Loncopué,NEUQUÉN,43,125,42,75,117
58,58063,580630113,Loncopué,NEUQUÉN,333,411,628,605,1233
58,58063,580630104,Loncopué,NEUQUÉN,147,163,267,298,565
58,58063,580630103,Loncopué,NEUQUÉN,26,38,30,45,75
58,58063,580630109,Loncopué,NEUQUÉN,91,121,114,186,300
58,58063,580630108,Loncopué,NEUQUÉN,35,38,29,59,88
58,58063,580630105,Loncopué,NEUQUÉN,92,47,238,198,436
58,58063,580630112,Loncopué,NEUQUÉN,506,568,843,806,1649
58,58063,580630102,Loncopué,NEUQUÉN,76,100,113,142,255
58,58063,580630111,Loncopué,NEUQUÉN,584,623,1035,960,1995
58,58063,580630110,Loncopué,NEUQUÉN,42,62,60,73,133
58,58063,580630106,Loncopué,NEUQUÉN,11,17,4,17,21
58,58084,580840107,Ñorquín,NEUQUÉN,88,115,117,163,280
58,58084,580840104,Ñorquín,NEUQUÉN,40,58,22,68,90
58,58084,580840102,Ñorquín,NEUQUÉN,206,244,359,362,721
58,58084,580840116,Ñorquín,NEUQUÉN,180,352,297,310,607
58,58084,580840106,Ñorquín,NEUQUÉN,252,307,431,447,878
58,58084,580840103,Ñorquín,NEUQUÉN,87,111,129,133,262
58,58084,580840114,Ñorquín,NEUQUÉN,17,44,12,23,35
58,58084,580840115,Ñorquín,NEUQUÉN,0,132,0,1,1
58,58084,580840113,Ñorquín,NEUQUÉN,3,37,4,6,10
58,58084,580840111,Ñorquín,NEUQUÉN,110,121,240,242,482
58,58084,580840105,Ñorquín,NEUQUÉN,133,135,244,269,513
58,58084,580840109,Ñorquín,NEUQUÉN,100,93,163,204,367
58,58084,580840110,Ñorquín,NEUQUÉN,18,21,8,23,31
58,58084,580840112,Ñorquín,NEUQUÉN,20,21,17,33,50
58,58084,580840101,Ñorquín,NEUQUÉN,15,27,11,16,27
58,58084,580840108,Ñorquín,NEUQUÉN,111,146,155,183,338
58,58070,580700108,Los Lagos,NEUQUÉN,199,294,325,324,649
58,58070,580700107,Los Lagos,NEUQUÉN,434,481,762,785,1547
58,58070,580700113,Los Lagos,NEUQUÉN,334,460,480,495,975
58,58070,580700104,Los Lagos,NEUQUÉN,200,324,350,303,653
58,58070,580700204,Los Lagos,NEUQUÉN,102,142,165,191,356
58,58070,580700110,Los Lagos,NEUQUÉN,175,361,513,495,1008
58,58070,580700101,Los Lagos,NEUQUÉN,13,13,31,45,76
58,58070,580700111,Los Lagos,NEUQUÉN,313,360,488,523,1011
58,58070,580700105,Los Lagos,NEUQUÉN,456,496,660,649,1309
58,58070,580700102,Los Lagos,NEUQUÉN,32,49,52,106,158
58,58070,580700112,Los Lagos,NEUQUÉN,164,208,233,257,490
58,58070,580700106,Los Lagos,NEUQUÉN,273,358,378,375,753
58,58070,580700114,Los Lagos,NEUQUÉN,295,311,487,531,1018
58,58070,580700203,Los Lagos,NEUQUÉN,15,15,31,30,61
58,58070,580700109,Los Lagos,NEUQUÉN,194,225,330,319,649
58,58070,580700103,Los Lagos,NEUQUÉN,325,662,495,506,1001
58,58070,580700202,Los Lagos,NEUQUÉN,65,80,53,99,152
58,58070,580700201,Los Lagos,NEUQUÉN,34,46,54,78,132
54,54049,540490103,General Manuel Belgrano,MISIONES,249,232,518,571,1089
54,54049,540490207,General Manuel Belgrano,MISIONES,189,216,341,322,663
54,54049,540490108,General Manuel Belgrano,MISIONES,331,347,616,652,1268
54,54049,540490105,General Manuel Belgrano,MISIONES,559,576,1124,1204,2328
54,54049,540490309,General Manuel Belgrano,MISIONES,328,380,628,598,1226
54,54049,540490201,General Manuel Belgrano,MISIONES,113,134,195,203,398
54,54049,540490112,General Manuel Belgrano,MISIONES,202,208,321,418,739
54,54049,540490203,General Manuel Belgrano,MISIONES,614,667,1118,1338,2456
54,54049,540490202,General Manuel Belgrano,MISIONES,478,532,817,950,1767
54,54049,540490308,General Manuel Belgrano,MISIONES,227,247,415,366,781
54,54049,540490114,General Manuel Belgrano,MISIONES,295,304,588,642,1230
54,54049,540490107,General Manuel Belgrano,MISIONES,334,354,588,593,1181
54,54049,540490311,General Manuel Belgrano,MISIONES,248,246,491,452,943
54,54049,540490310,General Manuel Belgrano,MISIONES,210,262,416,404,820
54,54049,540490401,General Manuel Belgrano,MISIONES,423,303,789,896,1685
54,54049,540490110,General Manuel Belgrano,MISIONES,135,134,267,358,625
54,54049,540490306,General Manuel Belgrano,MISIONES,159,184,311,317,628
54,54049,540490305,General Manuel Belgrano,MISIONES,252,304,487,514,1001
54,54049,540490102,General Manuel Belgrano,MISIONES,531,618,1055,1188,2243
54,54049,540490101,General Manuel Belgrano,MISIONES,369,394,692,812,1504
54,54049,540490304,General Manuel Belgrano,MISIONES,253,303,498,441,939
54,54049,540490106,General Manuel Belgrano,MISIONES,232,254,459,468,927
54,54049,540490111,General Manuel Belgrano,MISIONES,167,173,280,364,644
54,54049,540490303,General Manuel Belgrano,MISIONES,346,404,593,565,1158
54,54049,540490113,General Manuel Belgrano,MISIONES,220,235,484,525,1009
54,54049,540490402,General Manuel Belgrano,MISIONES,34,35,58,73,131
54,54049,540490104,General Manuel Belgrano,MISIONES,510,503,890,1115,2005
54,54049,540490307,General Manuel Belgrano,MISIONES,205,235,403,377,780
54,54049,540490312,General Manuel Belgrano,MISIONES,220,250,395,402,797
54,54049,540490302,General Manuel Belgrano,MISIONES,165,111,309,332,641
54,54049,540490109,General Manuel Belgrano,MISIONES,320,345,619,665,1284
54,54049,540490206,General Manuel Belgrano,MISIONES,558,649,1022,990,2012
54,54049,540490116,General Manuel Belgrano,MISIONES,264,293,486,527,1013
54,54049,540490115,General Manuel Belgrano,MISIONES,212,235,448,444,892
54,54049,540490403,General Manuel Belgrano,MISIONES,24,28,29,41,70
54,54049,540490301,General Manuel Belgrano,MISIONES,542,641,1071,1097,2168
54,54049,540490204,General Manuel Belgrano,MISIONES,219,244,384,356,740
54,54049,540490205,General Manuel Belgrano,MISIONES,305,334,513,604,1117
54,54042,540420801,Eldorado,MISIONES,148,199,270,312,582
54,54042,540420705,Eldorado,MISIONES,29,32,55,56,111
54,54042,540420603,Eldorado,MISIONES,193,242,410,429,839
54,54042,540420710,Eldorado,MISIONES,183,199,336,328,664
54,54042,540420602,Eldorado,MISIONES,262,277,524,785,1309
54,54042,540420519,Eldorado,MISIONES,211,208,377,370,747
54,54042,540420510,Eldorado,MISIONES,181,223,225,216,441
54,54042,540420403,Eldorado,MISIONES,316,330,615,602,1217
54,54042,540420107,Eldorado,MISIONES,298,309,605,611,1216
54,54042,540420413,Eldorado,MISIONES,256,264,406,365,771
54,54042,540420904,Eldorado,MISIONES,24,27,22,34,56
54,54042,540420604,Eldorado,MISIONES,40,50,87,79,166
54,54042,540420102,Eldorado,MISIONES,105,117,204,215,419
54,54042,540420706,Eldorado,MISIONES,24,32,32,46,78
54,54042,540420704,Eldorado,MISIONES,129,141,268,263,531
54,54042,540420614,Eldorado,MISIONES,317,296,602,583,1185
54,54042,540420611,Eldorado,MISIONES,142,152,257,298,555
54,54042,540420520,Eldorado,MISIONES,230,271,325,280,605
54,54042,540420418,Eldorado,MISIONES,298,322,538,536,1074
54,54042,540420408,Eldorado,MISIONES,178,188,318,296,614
54,54042,540420405,Eldorado,MISIONES,416,456,766,723,1489
54,54042,540420308,Eldorado,MISIONES,141,154,274,278,552
54,54042,540420317,Eldorado,MISIONES,285,334,536,518,1054
54,54042,540420312,Eldorado,MISIONES,162,176,281,271,552
54,54042,540420415,Eldorado,MISIONES,284,303,513,553,1066
54,54042,540421007,Eldorado,MISIONES,108,120,249,235,484
54,54042,540420513,Eldorado,MISIONES,309,348,474,400,874
54,54042,540420306,Eldorado,MISIONES,287,299,538,419,957
54,54042,540420707,Eldorado,MISIONES,11,13,15,32,47
54,54042,540420606,Eldorado,MISIONES,81,84,151,187,338
54,54042,540420304,Eldorado,MISIONES,76,87,128,116,244
54,54042,540420202,Eldorado,MISIONES,0,2,0,0,0
54,54042,540420201,Eldorado,MISIONES,1,1,0,1,1
54,54042,540420105,Eldorado,MISIONES,22,24,31,48,79
54,54042,540420103,Eldorado,MISIONES,61,66,119,133,252
54,54042,540421001,Eldorado,MISIONES,275,301,551,628,1179
54,54042,540420613,Eldorado,MISIONES,507,478,1014,1058,2072
54,54042,540420503,Eldorado,MISIONES,248,305,349,344,693
54,54042,540420401,Eldorado,MISIONES,222,224,418,417,835
54,54042,540420307,Eldorado,MISIONES,341,374,572,491,1063
54,54042,540420313,Eldorado,MISIONES,182,214,337,306,643
54,54042,540421004,Eldorado,MISIONES,21,24,36,46,82
54,54042,540420902,Eldorado,MISIONES,9,13,9,16,25
54,54042,540420806,Eldorado,MISIONES,6,13,9,14,23
54,54042,540420702,Eldorado,MISIONES,130,157,268,279,547
54,54042,540420701,Eldorado,MISIONES,265,284,543,543,1086
54,54042,540420605,Eldorado,MISIONES,109,116,217,234,451
54,54042,540420518,Eldorado,MISIONES,274,293,479,425,904
54,54042,540420517,Eldorado,MISIONES,225,245,409,394,803
54,54042,540420511,Eldorado,MISIONES,293,399,386,321,707
54,54042,540420506,Eldorado,MISIONES,271,293,449,356,805
54,54042,540420410,Eldorado,MISIONES,319,330,682,642,1324
54,54042,540420407,Eldorado,MISIONES,353,378,728,716,1444
54,54042,540420406,Eldorado,MISIONES,414,441,699,685,1384
54,54042,540420404,Eldorado,MISIONES,276,289,420,408,828
54,54042,540420402,Eldorado,MISIONES,333,351,629,637,1266
54,54042,540420305,Eldorado,MISIONES,474,513,889,869,1758
54,54042,540421006,Eldorado,MISIONES,150,167,320,331,651
54,54042,540421005,Eldorado,MISIONES,246,245,509,516,1025
54,54042,540420610,Eldorado,MISIONES,255,241,532,571,1103
54,54042,540420104,Eldorado,MISIONES,9,9,13,26,39
54,54042,540420315,Eldorado,MISIONES,208,213,400,423,823
54,54042,540421009,Eldorado,MISIONES,169,198,396,421,817
54,54042,540420515,Eldorado,MISIONES,274,290,433,385,818
54,54042,540420512,Eldorado,MISIONES,268,288,457,459,916
54,54042,540420509,Eldorado,MISIONES,231,273,315,307,622
54,54042,540420504,Eldorado,MISIONES,302,360,435,402,837
54,54042,540420501,Eldorado,MISIONES,220,235,434,408,842
54,54042,540420417,Eldorado,MISIONES,238,251,400,399,799
54,54042,540420409,Eldorado,MISIONES,290,305,589,549,1138
54,54042,540420318,Eldorado,MISIONES,138,148,298,278,576
54,54042,540420309,Eldorado,MISIONES,404,416,769,708,1477
54,54042,540420414,Eldorado,MISIONES,341,376,517,542,1059
54,54042,540421003,Eldorado,MISIONES,77,91,141,176,317
54,54042,540420803,Eldorado,MISIONES,149,151,252,285,537
54,54042,540420607,Eldorado,MISIONES,220,241,389,408,797
54,54042,540420601,Eldorado,MISIONES,285,280,594,645,1239
54,54042,540420310,Eldorado,MISIONES,159,169,316,263,579
54,54042,540421008,Eldorado,MISIONES,231,244,432,460,892
54,54042,540420416,Eldorado,MISIONES,267,289,428,424,852
54,54042,540420314,Eldorado,MISIONES,264,290,490,448,938
54,54042,540420901,Eldorado,MISIONES,35,52,60,79,139
54,54042,540420609,Eldorado,MISIONES,17,21,24,32,56
54,54042,540420106,Eldorado,MISIONES,17,22,29,34,63
54,54042,540420903,Eldorado,MISIONES,3,4,4,8,12
54,54042,540420302,Eldorado,MISIONES,141,156,230,245,475
54,54042,540420101,Eldorado,MISIONES,114,137,249,231,480
54,54042,540420316,Eldorado,MISIONES,228,241,402,421,823
54,54042,540420311,Eldorado,MISIONES,112,91,195,193,388
54,54042,540421002,Eldorado,MISIONES,34,40,71,86,157
54,54042,540420708,Eldorado,MISIONES,20,28,23,31,54
54,54042,540420301,Eldorado,MISIONES,192,219,355,385,740
54,54042,540420703,Eldorado,MISIONES,92,105,192,210,402
54,54042,540420303,Eldorado,MISIONES,239,272,486,472,958
54,54042,540420612,Eldorado,MISIONES,328,290,794,731,1525
54,54042,540420516,Eldorado,MISIONES,271,314,406,400,806
54,54042,540420508,Eldorado,MISIONES,279,346,442,393,835
54,54042,540420507,Eldorado,MISIONES,245,270,389,371,760
54,54042,540420505,Eldorado,MISIONES,335,373,622,549,1171
54,54042,540420502,Eldorado,MISIONES,369,385,670,599,1269
54,54042,540420420,Eldorado,MISIONES,284,309,506,496,1002
54,54042,540420419,Eldorado,MISIONES,231,249,434,392,826
54,54042,540420412,Eldorado,MISIONES,230,253,399,401,800
54,54042,540420411,Eldorado,MISIONES,405,439,765,785,1550
54,54042,540420709,Eldorado,MISIONES,91,104,155,164,319
54,54042,540420514,Eldorado,MISIONES,281,349,421,354,775
54,54042,540420805,Eldorado,MISIONES,48,60,91,111,202
54,54042,540420804,Eldorado,MISIONES,6,12,7,10,17
54,54042,540420802,Eldorado,MISIONES,164,198,282,307,589
54,54042,540420608,Eldorado,MISIONES,39,57,59,69,128
54,54042,540420203,Eldorado,MISIONES,35,51,53,63,116
54,54035,540350103,Concepción,MISIONES,140,155,243,276,519
54,54035,540350402,Concepción,MISIONES,43,52,90,98,188
54,54035,540350206,Concepción,MISIONES,11,26,14,23,37
54,54035,540350106,Concepción,MISIONES,12,16,12,19,31
54,54035,540350307,Concepción,MISIONES,16,23,23,35,58
54,54035,540350301,Concepción,MISIONES,98,110,146,149,295
54,54035,540350204,Concepción,MISIONES,26,38,44,42,86
54,54035,540350101,Concepción,MISIONES,67,70,130,143,273
54,54035,540350414,Concepción,MISIONES,243,269,507,497,1004
54,54035,540350407,Concepción,MISIONES,11,19,9,17,26
54,54035,540350308,Concepción,MISIONES,26,33,50,50,100
54,54035,540350304,Concepción,MISIONES,49,59,79,90,169
54,54035,540350302,Concepción,MISIONES,6,12,2,9,11
54,54035,540350404,Concepción,MISIONES,250,292,426,388,814
54,54035,540350409,Concepción,MISIONES,26,25,29,39,68
54,54035,540350406,Concepción,MISIONES,22,30,34,44,78
54,54035,540350203,Concepción,MISIONES,11,18,19,21,40
54,54035,540350105,Concepción,MISIONES,1,2,3,3,6
54,54035,540350102,Concepción,MISIONES,23,32,40,47,87
54,54035,540350411,Concepción,MISIONES,186,217,352,335,687
54,54035,540350408,Concepción,MISIONES,0,1,0,0,0
54,54035,540350405,Concepción,MISIONES,47,64,84,88,172
54,54035,540350306,Concepción,MISIONES,7,8,11,9,20
54,54035,540350303,Concepción,MISIONES,17,30,30,30,60
54,54035,540350201,Concepción,MISIONES,66,99,131,130,261
54,54035,540350410,Concepción,MISIONES,248,273,411,425,836
54,54035,540350413,Concepción,MISIONES,104,134,229,247,476
54,54035,540350305,Concepción,MISIONES,3,7,5,5,10
54,54035,540350207,Concepción,MISIONES,27,41,49,55,104
54,54035,540350205,Concepción,MISIONES,3,4,6,6,12
54,54035,540350202,Concepción,MISIONES,13,20,21,21,42
54,54035,540350104,Concepción,MISIONES,21,23,45,46,91
54,54035,540350412,Concepción,MISIONES,346,387,757,644,1401
54,54035,540350403,Concepción,MISIONES,261,303,484,439,923
54,54035,540350401,Concepción,MISIONES,154,185,281,311,592
54,54021,540210603,Candelaria,MISIONES,131,123,231,254,485
54,54021,540210602,Candelaria,MISIONES,204,258,401,423,824
54,54021,540210704,Candelaria,MISIONES,261,302,485,469,954
54,54021,540210515,Candelaria,MISIONES,257,305,466,438,904
54,54021,540210510,Candelaria,MISIONES,247,292,474,417,891
54,54021,540210509,Candelaria,MISIONES,284,299,535,470,1005
54,54021,540210508,Candelaria,MISIONES,266,267,504,425,929
54,54021,540210701,Candelaria,MISIONES,63,84,90,125,215
54,54021,540210301,Candelaria,MISIONES,41,45,54,76,130
54,54021,540210401,Candelaria,MISIONES,106,149,214,203,417
54,54021,540210202,Candelaria,MISIONES,250,274,513,541,1054
54,54021,540210518,Candelaria,MISIONES,124,142,212,247,459
54,54021,540210604,Candelaria,MISIONES,37,49,64,100,164
54,54021,540210203,Candelaria,MISIONES,37,42,93,94,187
54,54021,540210302,Candelaria,MISIONES,47,56,75,103,178
54,54021,540210503,Candelaria,MISIONES,39,52,45,57,102
54,54021,540210501,Candelaria,MISIONES,111,219,133,176,309
54,54021,540210102,Candelaria,MISIONES,124,103,248,269,517
54,54021,540210705,Candelaria,MISIONES,252,310,450,438,888
54,54021,540210507,Candelaria,MISIONES,264,298,497,450,947
54,54021,540210403,Candelaria,MISIONES,18,23,20,38,58
54,54021,540210304,Candelaria,MISIONES,37,48,53,76,129
54,54021,540210201,Candelaria,MISIONES,39,46,44,86,130
54,54021,540210502,Candelaria,MISIONES,57,97,133,117,250
54,54021,540210517,Candelaria,MISIONES,162,164,291,267,558
54,54021,540210609,Candelaria,MISIONES,247,230,461,457,918
54,54021,540210608,Candelaria,MISIONES,230,134,395,376,771
54,54021,540210404,Candelaria,MISIONES,4,7,3,8,11
54,54021,540210513,Candelaria,MISIONES,200,220,344,317,661
54,54021,540210511,Candelaria,MISIONES,237,272,413,408,821
54,54021,540210505,Candelaria,MISIONES,249,284,457,642,1099
54,54021,540210303,Candelaria,MISIONES,24,28,29,41,70
54,54021,540210103,Candelaria,MISIONES,36,51,46,74,120
54,54021,540210610,Candelaria,MISIONES,109,105,195,237,432
54,54021,540210514,Candelaria,MISIONES,263,292,534,530,1064
54,54021,540210512,Candelaria,MISIONES,307,339,633,585,1218
54,54021,540210601,Candelaria,MISIONES,287,305,495,475,970
54,54021,540210607,Candelaria,MISIONES,314,370,549,542,1091
54,54021,540210703,Candelaria,MISIONES,38,49,83,97,180
54,54021,540210606,Candelaria,MISIONES,23,28,45,46,91
54,54021,540210101,Candelaria,MISIONES,63,87,108,368,476
54,54021,540210516,Candelaria,MISIONES,269,301,516,447,963
54,54021,540210506,Candelaria,MISIONES,210,250,386,374,760
54,54021,540210402,Candelaria,MISIONES,41,44,62,81,143
54,54021,540210305,Candelaria,MISIONES,47,59,59,83,142
54,54021,540210611,Candelaria,MISIONES,61,62,104,120,224
54,54021,540210504,Candelaria,MISIONES,322,360,638,602,1240
54,54021,540210306,Candelaria,MISIONES,193,241,338,346,684
54,54021,540210702,Candelaria,MISIONES,37,44,55,63,118
54,54021,540210605,Candelaria,MISIONES,30,34,33,56,89
54,54112,541120511,San Pedro,MISIONES,294,309,617,555,1172
54,54112,541120702,San Pedro,MISIONES,370,372,709,902,1611
54,54112,541120102,San Pedro,MISIONES,791,951,1540,1767,3307
54,54112,541120701,San Pedro,MISIONES,18,18,21,26,47
54,54112,541120703,San Pedro,MISIONES,659,726,1276,1434,2710
54,54112,541120704,San Pedro,MISIONES,136,164,294,266,560
54,54112,541120106,San Pedro,MISIONES,89,117,178,172,350
54,54112,541120601,San Pedro,MISIONES,230,288,493,560,1053
54,54112,541120505,San Pedro,MISIONES,340,379,618,730,1348
54,54112,541120504,San Pedro,MISIONES,253,270,536,526,1062
54,54112,541120513,San Pedro,MISIONES,214,234,409,371,780
54,54112,541120509,San Pedro,MISIONES,248,304,509,527,1036
54,54112,541120401,San Pedro,MISIONES,1,14,0,1,1
54,54112,541120201,San Pedro,MISIONES,5,5,2,16,18
54,54112,541120515,San Pedro,MISIONES,241,257,501,474,975
54,54112,541120503,San Pedro,MISIONES,224,238,392,403,795
54,54112,541120301,San Pedro,MISIONES,6,8,13,12,25
54,54112,541120502,San Pedro,MISIONES,289,308,477,438,915
54,54112,541120402,San Pedro,MISIONES,1,12,0,3,3
54,54112,541120507,San Pedro,MISIONES,169,162,343,381,724
54,54112,541120101,San Pedro,MISIONES,478,495,955,1155,2110
54,54112,541120501,San Pedro,MISIONES,335,355,664,611,1275
54,54112,541120302,San Pedro,MISIONES,27,27,48,42,90
54,54112,541120506,San Pedro,MISIONES,256,279,491,623,1114
54,54112,541120105,San Pedro,MISIONES,39,44,25,80,105
54,54112,541120508,San Pedro,MISIONES,337,340,648,707,1355
54,54112,541120514,San Pedro,MISIONES,123,142,255,229,484
54,54112,541120512,San Pedro,MISIONES,245,246,459,487,946
54,54112,541120602,San Pedro,MISIONES,509,530,996,1163,2159
54,54112,541120103,San Pedro,MISIONES,331,401,566,734,1300
54,54112,541120510,San Pedro,MISIONES,346,367,701,671,1372
54,54112,541120202,San Pedro,MISIONES,20,20,26,47,73
54,54112,541120104,San Pedro,MISIONES,41,48,74,102,176
50,50098,500980102,San Martín,MENDOZA,488,516,969,1091,2060
50,50098,500980611,San Martín,MENDOZA,337,351,645,655,1300
50,50098,500980604,San Martín,MENDOZA,308,329,510,604,1114
50,50098,500980905,San Martín,MENDOZA,321,321,567,508,1075
50,50098,500980902,San Martín,MENDOZA,161,167,293,261,554
50,50098,500980818,San Martín,MENDOZA,385,364,798,726,1524
50,50098,500980812,San Martín,MENDOZA,198,210,346,308,654
50,50098,500980805,San Martín,MENDOZA,465,449,898,843,1741
50,50098,500980715,San Martín,MENDOZA,508,533,979,918,1897
50,50098,500980203,San Martín,MENDOZA,65,77,137,154,291
50,50098,500980104,San Martín,MENDOZA,389,482,770,861,1631
50,50098,500980819,San Martín,MENDOZA,321,318,573,605,1178
50,50098,500980909,San Martín,MENDOZA,399,376,775,726,1501
50,50098,500980814,San Martín,MENDOZA,215,234,360,297,657
50,50098,500980709,San Martín,MENDOZA,267,290,415,393,808
50,50098,500980509,San Martín,MENDOZA,186,152,358,330,688
50,50098,500980506,San Martín,MENDOZA,358,356,664,665,1329
50,50098,500980411,San Martín,MENDOZA,292,297,494,447,941
50,50098,500980404,San Martín,MENDOZA,361,362,618,531,1149
50,50098,500980607,San Martín,MENDOZA,235,230,444,449,893
50,50098,500980302,San Martín,MENDOZA,161,177,315,333,648
50,50098,500980103,San Martín,MENDOZA,261,314,517,650,1167
50,50098,500980605,San Martín,MENDOZA,304,338,580,629,1209
50,50098,500980906,San Martín,MENDOZA,308,295,574,504,1078
50,50098,500980903,San Martín,MENDOZA,378,373,654,622,1276
50,50098,500980809,San Martín,MENDOZA,290,289,510,449,959
50,50098,500980714,San Martín,MENDOZA,270,290,469,426,895
50,50098,500980706,San Martín,MENDOZA,295,308,461,375,836
50,50098,500980511,San Martín,MENDOZA,206,232,373,317,690
50,50098,500980505,San Martín,MENDOZA,336,331,692,654,1346
50,50098,500980405,San Martín,MENDOZA,314,313,499,444,943
50,50098,500980811,San Martín,MENDOZA,435,360,823,750,1573
50,50098,500980413,San Martín,MENDOZA,216,231,373,273,646
50,50098,500980601,San Martín,MENDOZA,191,232,354,417,771
50,50098,500980305,San Martín,MENDOZA,285,297,527,534,1061
50,50098,500980609,San Martín,MENDOZA,253,264,453,520,973
50,50098,500980101,San Martín,MENDOZA,326,350,582,632,1214
50,50098,500980907,San Martín,MENDOZA,528,629,1114,1020,2134
50,50098,500980820,San Martín,MENDOZA,252,279,454,472,926
50,50098,500980810,San Martín,MENDOZA,294,296,526,448,974
50,50098,500980904,San Martín,MENDOZA,368,368,677,618,1295
50,50098,500980806,San Martín,MENDOZA,455,459,788,689,1477
50,50098,500980803,San Martín,MENDOZA,414,393,924,880,1804
50,50098,500980718,San Martín,MENDOZA,255,325,444,356,800
50,50098,500980717,San Martín,MENDOZA,203,230,363,292,655
50,50098,500980716,San Martín,MENDOZA,347,380,590,584,1174
50,50098,500980712,San Martín,MENDOZA,227,238,386,324,710
50,50098,500980707,San Martín,MENDOZA,288,306,478,392,870
50,50098,500980510,San Martín,MENDOZA,208,208,343,371,714
50,50098,500980508,San Martín,MENDOZA,410,375,790,793,1583
50,50098,500980412,San Martín,MENDOZA,260,282,428,352,780
50,50098,500980410,San Martín,MENDOZA,205,243,361,311,672
50,50098,500980409,San Martín,MENDOZA,352,333,577,509,1086
50,50098,500980407,San Martín,MENDOZA,408,436,724,716,1440
50,50098,500980308,San Martín,MENDOZA,379,392,677,669,1346
50,50098,500980722,San Martín,MENDOZA,218,220,393,403,796
50,50098,500980721,San Martín,MENDOZA,213,210,393,435,828
50,50098,500980507,San Martín,MENDOZA,257,263,415,404,819
50,50098,500980416,San Martín,MENDOZA,159,191,274,242,516
50,50098,500980612,San Martín,MENDOZA,236,267,429,453,882
50,50098,500980610,San Martín,MENDOZA,154,161,288,317,605
50,50098,500980501,San Martín,MENDOZA,178,207,363,371,734
50,50098,500980304,San Martín,MENDOZA,240,268,470,445,915
50,50098,500980606,San Martín,MENDOZA,320,330,632,678,1310
50,50098,500980108,San Martín,MENDOZA,310,324,602,603,1205
50,50098,500980910,San Martín,MENDOZA,280,273,513,467,980
50,50098,500980802,San Martín,MENDOZA,431,408,846,838,1684
50,50098,500980713,San Martín,MENDOZA,195,208,296,264,560
50,50098,500980708,San Martín,MENDOZA,185,184,317,257,574
50,50098,500980705,San Martín,MENDOZA,344,345,716,653,1369
50,50098,500980703,San Martín,MENDOZA,254,230,506,429,935
50,50098,500980403,San Martín,MENDOZA,333,336,582,483,1065
50,50098,500980202,San Martín,MENDOZA,210,258,381,429,810
50,50098,500980603,San Martín,MENDOZA,266,288,514,540,1054
50,50098,500980608,San Martín,MENDOZA,305,306,542,551,1093
50,50098,500980912,San Martín,MENDOZA,273,261,519,555,1074
50,50098,500980817,San Martín,MENDOZA,187,192,362,339,701
50,50098,500980206,San Martín,MENDOZA,41,53,39,70,109
50,50098,500980201,San Martín,MENDOZA,23,28,40,63,103
50,50098,500980107,San Martín,MENDOZA,135,153,242,304,546
50,50098,500980911,San Martín,MENDOZA,327,299,709,712,1421
50,50098,500980710,San Martín,MENDOZA,158,240,241,214,455
50,50098,500980704,San Martín,MENDOZA,233,235,497,413,910
50,50098,500980702,San Martín,MENDOZA,352,325,665,600,1265
50,50098,500980417,San Martín,MENDOZA,378,439,641,623,1264
50,50098,500980415,San Martín,MENDOZA,402,417,727,664,1391
50,50098,500980402,San Martín,MENDOZA,306,300,570,484,1054
50,50098,500980105,San Martín,MENDOZA,282,291,512,543,1055
50,50098,500980205,San Martín,MENDOZA,100,109,200,213,413
50,50098,500980204,San Martín,MENDOZA,126,149,252,256,508
50,50098,500980908,San Martín,MENDOZA,287,264,647,617,1264
50,50098,500980901,San Martín,MENDOZA,258,272,428,368,796
50,50098,500980821,San Martín,MENDOZA,122,120,278,273,551
50,50098,500980816,San Martín,MENDOZA,167,214,278,213,491
50,50098,500980815,San Martín,MENDOZA,209,219,327,291,618
50,50098,500980813,San Martín,MENDOZA,234,259,438,395,833
50,50098,500980808,San Martín,MENDOZA,351,399,555,452,1007
50,50098,500980807,San Martín,MENDOZA,379,404,592,528,1120
50,50098,500980804,San Martín,MENDOZA,390,385,830,781,1611
50,50098,500980719,San Martín,MENDOZA,344,334,710,678,1388
50,50098,500980711,San Martín,MENDOZA,197,238,314,276,590
50,50098,500980504,San Martín,MENDOZA,325,332,697,641,1338
50,50098,500980406,San Martín,MENDOZA,335,360,618,597,1215
50,50098,500980720,San Martín,MENDOZA,187,221,287,237,524
50,50098,500980502,San Martín,MENDOZA,58,66,97,131,228
50,50098,500980301,San Martín,MENDOZA,264,293,496,502,998
50,50098,500980106,San Martín,MENDOZA,399,425,699,692,1391
50,50098,500980602,San Martín,MENDOZA,237,292,449,497,946
50,50098,500980503,San Martín,MENDOZA,258,279,513,512,1025
50,50098,500980306,San Martín,MENDOZA,407,443,758,727,1485
50,50098,500980303,San Martín,MENDOZA,347,368,699,691,1390
50,50098,500980801,San Martín,MENDOZA,340,316,601,577,1178
50,50098,500980512,San Martín,MENDOZA,393,449,671,608,1279
50,50098,500980408,San Martín,MENDOZA,280,315,519,483,1002
50,50098,500980401,San Martín,MENDOZA,248,214,438,418,856
50,50098,500980701,San Martín,MENDOZA,166,177,345,338,683
50,50098,500980307,San Martín,MENDOZA,174,189,315,302,617
50,50098,500980414,San Martín,MENDOZA,22,21,38,45,83
50,50091,500910301,San Carlos,MENDOZA,256,300,450,518,968
50,50091,500910106,San Carlos,MENDOZA,224,246,353,344,697
50,50091,500910205,San Carlos,MENDOZA,245,287,479,518,997
50,50091,500910113,San Carlos,MENDOZA,231,261,423,455,878
50,50091,500910302,San Carlos,MENDOZA,348,374,685,664,1349
50,50091,500910111,San Carlos,MENDOZA,370,364,685,663,1348
50,50091,500910107,San Carlos,MENDOZA,254,292,404,360,764
50,50091,500910109,San Carlos,MENDOZA,302,335,482,453,935
50,50091,500910601,San Carlos,MENDOZA,79,123,114,144,258
50,50091,500910401,San Carlos,MENDOZA,42,78,39,63,102
50,50091,500910102,San Carlos,MENDOZA,164,175,309,346,655
50,50091,500910303,San Carlos,MENDOZA,249,274,450,511,961
50,50091,500910203,San Carlos,MENDOZA,386,361,728,737,1465
50,50091,500910208,San Carlos,MENDOZA,353,367,651,554,1205
50,50091,500910204,San Carlos,MENDOZA,343,378,576,493,1069
50,50091,500910304,San Carlos,MENDOZA,240,267,422,434,856
50,50091,500910201,San Carlos,MENDOZA,330,359,672,680,1352
50,50091,500910101,San Carlos,MENDOZA,553,579,1067,1037,2104
50,50091,500910206,San Carlos,MENDOZA,314,314,589,556,1145
50,50091,500910306,San Carlos,MENDOZA,357,398,656,688,1344
50,50091,500910207,San Carlos,MENDOZA,292,265,559,560,1119
50,50091,500910104,San Carlos,MENDOZA,165,177,328,360,688
50,50091,500910305,San Carlos,MENDOZA,347,402,617,628,1245
50,50091,500910112,San Carlos,MENDOZA,225,257,423,460,883
50,50091,500910108,San Carlos,MENDOZA,367,383,645,617,1262
50,50091,500910105,San Carlos,MENDOZA,405,428,718,667,1385
50,50091,500910110,San Carlos,MENDOZA,218,226,360,354,714
50,50091,500910209,San Carlos,MENDOZA,311,333,602,557,1159
50,50091,500910202,San Carlos,MENDOZA,548,541,984,976,1960
50,50091,500910501,San Carlos,MENDOZA,26,36,25,56,81
50,50091,500910307,San Carlos,MENDOZA,283,301,514,514,1028
50,50091,500910103,San Carlos,MENDOZA,158,183,309,346,655
50,50084,500840705,Rivadavia,MENDOZA,313,325,596,596,1192
50,50084,500840703,Rivadavia,MENDOZA,168,188,316,323,639
50,50084,500840702,Rivadavia,MENDOZA,244,279,456,441,897
50,50084,500840301,Rivadavia,MENDOZA,222,246,379,368,747
50,50084,500840805,Rivadavia,MENDOZA,390,370,688,617,1305
50,50084,500840216,Rivadavia,MENDOZA,193,198,362,329,691
50,50084,500840214,Rivadavia,MENDOZA,328,337,567,494,1061
50,50084,500840207,Rivadavia,MENDOZA,359,404,636,623,1259
50,50084,500840810,Rivadavia,MENDOZA,323,333,667,599,1266
50,50084,500840706,Rivadavia,MENDOZA,173,187,297,333,630
50,50084,500840302,Rivadavia,MENDOZA,423,429,815,778,1593
50,50084,500840812,Rivadavia,MENDOZA,372,402,590,522,1112
50,50084,500840811,Rivadavia,MENDOZA,299,335,522,485,1007
50,50084,500840809,Rivadavia,MENDOZA,352,367,641,622,1263
50,50084,500840804,Rivadavia,MENDOZA,236,234,392,384,776
50,50084,500840803,Rivadavia,MENDOZA,361,352,664,663,1327
50,50084,500840204,Rivadavia,MENDOZA,505,526,840,708,1548
50,50084,500840407,Rivadavia,MENDOZA,239,250,392,410,802
50,50084,500840305,Rivadavia,MENDOZA,308,322,578,600,1178
50,50084,500840103,Rivadavia,MENDOZA,267,320,465,523,988
50,50084,500840101,Rivadavia,MENDOZA,347,343,630,656,1286
50,50084,500840808,Rivadavia,MENDOZA,430,454,657,571,1228
50,50084,500840202,Rivadavia,MENDOZA,295,305,612,580,1192
50,50084,500840308,Rivadavia,MENDOZA,249,313,469,497,966
50,50084,500840217,Rivadavia,MENDOZA,104,99,202,187,389
50,50084,500840802,Rivadavia,MENDOZA,326,319,707,649,1356
50,50084,500840215,Rivadavia,MENDOZA,290,276,621,630,1251
50,50084,500840213,Rivadavia,MENDOZA,352,378,524,477,1001
50,50084,500840209,Rivadavia,MENDOZA,183,234,297,203,500
50,50084,500840208,Rivadavia,MENDOZA,227,271,337,317,654
50,50084,500840304,Rivadavia,MENDOZA,343,356,683,626,1309
50,50084,500840303,Rivadavia,MENDOZA,266,310,493,444,937
50,50084,500840306,Rivadavia,MENDOZA,254,279,498,524,1022
50,50084,500840813,Rivadavia,MENDOZA,406,377,801,840,1641
50,50084,500840203,Rivadavia,MENDOZA,248,259,457,419,876
50,50084,500840403,Rivadavia,MENDOZA,327,339,610,652,1262
50,50084,500840201,Rivadavia,MENDOZA,519,524,930,998,1928
50,50084,500840704,Rivadavia,MENDOZA,167,192,316,333,649
50,50084,500840401,Rivadavia,MENDOZA,60,67,121,145,266
50,50084,500840801,Rivadavia,MENDOZA,214,226,375,359,734
50,50084,500840212,Rivadavia,MENDOZA,260,297,444,418,862
50,50084,500840701,Rivadavia,MENDOZA,125,151,216,255,471
50,50084,500840501,Rivadavia,MENDOZA,80,125,123,170,293
50,50084,500840405,Rivadavia,MENDOZA,189,215,345,374,719
50,50084,500840807,Rivadavia,MENDOZA,243,256,398,340,738
50,50084,500840806,Rivadavia,MENDOZA,427,422,725,634,1359
50,50084,500840406,Rivadavia,MENDOZA,209,207,387,396,783
50,50084,500840309,Rivadavia,MENDOZA,262,258,481,441,922
50,50084,500840210,Rivadavia,MENDOZA,233,239,425,394,819
50,50084,500840104,Rivadavia,MENDOZA,240,261,387,337,724
50,50084,500840205,Rivadavia,MENDOZA,370,368,648,621,1269
50,50084,500840601,Rivadavia,MENDOZA,48,420,96,107,203
50,50084,500840404,Rivadavia,MENDOZA,99,125,183,173,356
50,50084,500840206,Rivadavia,MENDOZA,284,291,538,485,1023
50,50084,500840105,Rivadavia,MENDOZA,188,200,399,421,820
50,50084,500840102,Rivadavia,MENDOZA,174,204,312,332,644
50,50084,500840307,Rivadavia,MENDOZA,268,278,478,491,969
50,50084,500840211,Rivadavia,MENDOZA,308,330,495,454,949
50,50084,500840402,Rivadavia,MENDOZA,195,224,352,370,722
50,50077,500770121,Malargüe,MENDOZA,191,244,354,410,764
50,50077,500770125,Malargüe,MENDOZA,275,299,499,503,1002
50,50077,500770124,Malargüe,MENDOZA,281,306,504,468,972
50,50077,500770203,Malargüe,MENDOZA,19,29,15,37,52
50,50077,500770201,Malargüe,MENDOZA,183,173,263,307,570
50,50077,500770127,Malargüe,MENDOZA,285,301,553,580,1133
50,50077,500770122,Malargüe,MENDOZA,355,396,677,690,1367
50,50077,500770402,Malargüe,MENDOZA,220,321,348,581,929
50,50077,500770302,Malargüe,MENDOZA,39,48,49,136,185
50,50077,500770401,Malargüe,MENDOZA,14,19,17,41,58
50,50077,500770111,Malargüe,MENDOZA,46,44,71,72,143
50,50077,500770120,Malargüe,MENDOZA,267,205,428,466,894
50,50077,500770119,Malargüe,MENDOZA,315,334,587,616,1203
50,50077,500770117,Malargüe,MENDOZA,321,381,530,504,1034
50,50077,500770112,Malargüe,MENDOZA,297,337,486,430,916
50,50077,500770202,Malargüe,MENDOZA,93,135,146,160,306
50,50077,500770102,Malargüe,MENDOZA,95,107,109,176,285
50,50077,500770301,Malargüe,MENDOZA,228,211,336,416,752
50,50077,500770123,Malargüe,MENDOZA,347,372,654,577,1231
50,50077,500770118,Malargüe,MENDOZA,229,221,407,409,816
50,50077,500770108,Malargüe,MENDOZA,297,361,469,463,932
50,50077,500770103,Malargüe,MENDOZA,159,187,295,324,619
50,50077,500770110,Malargüe,MENDOZA,271,314,389,428,817
50,50077,500770101,Malargüe,MENDOZA,90,88,155,239,394
50,50077,500770115,Malargüe,MENDOZA,229,258,448,412,860
50,50077,500770109,Malargüe,MENDOZA,270,337,412,403,815
50,50077,500770104,Malargüe,MENDOZA,90,107,120,187,307
50,50077,500770116,Malargüe,MENDOZA,394,246,796,675,1471
50,50077,500770113,Malargüe,MENDOZA,311,354,503,474,977
50,50077,500770107,Malargüe,MENDOZA,235,283,368,307,675
50,50077,500770106,Malargüe,MENDOZA,246,274,445,477,922
50,50077,500770128,Malargüe,MENDOZA,4,11,4,5,9
50,50077,500770126,Malargüe,MENDOZA,270,285,526,467,993
50,50077,500770114,Malargüe,MENDOZA,460,492,891,814,1705
50,50077,500770105,Malargüe,MENDOZA,285,315,537,497,1034
50,50077,500770403,Malargüe,MENDOZA,109,161,160,358,518
50,50070,500700414,Maipú,MENDOZA,314,318,624,590,1214
50,50070,500700209,Maipú,MENDOZA,304,318,544,507,1051
50,50070,500701006,Maipú,MENDOZA,400,493,731,709,1440
50,50070,500700913,Maipú,MENDOZA,179,159,427,385,812
50,50070,500700904,Maipú,MENDOZA,369,315,650,640,1290
50,50070,500700811,Maipú,MENDOZA,268,275,467,446,913
50,50070,500700803,Maipú,MENDOZA,297,288,494,444,938
50,50070,500700507,Maipú,MENDOZA,270,261,487,470,957
50,50070,500700424,Maipú,MENDOZA,216,211,376,359,735
50,50070,500700409,Maipú,MENDOZA,477,439,953,886,1839
50,50070,500700208,Maipú,MENDOZA,346,378,560,455,1015
50,50070,500700117,Maipú,MENDOZA,463,451,1018,1005,2023
50,50070,500701009,Maipú,MENDOZA,217,209,359,338,697
50,50070,500700413,Maipú,MENDOZA,432,382,839,832,1671
50,50070,500700419,Maipú,MENDOZA,362,389,652,708,1360
50,50070,500700214,Maipú,MENDOZA,247,247,443,440,883
50,50070,500700207,Maipú,MENDOZA,522,519,1039,965,2004
50,50070,500700105,Maipú,MENDOZA,478,542,956,914,1870
50,50070,500700103,Maipú,MENDOZA,422,484,739,688,1427
50,50070,500701003,Maipú,MENDOZA,253,340,468,473,941
50,50070,500701002,Maipú,MENDOZA,259,272,496,476,972
50,50070,500701001,Maipú,MENDOZA,303,302,613,660,1273
50,50070,500700908,Maipú,MENDOZA,397,387,675,631,1306
50,50070,500700905,Maipú,MENDOZA,223,222,407,353,760
50,50070,500700903,Maipú,MENDOZA,663,590,1445,1430,2875
50,50070,500700815,Maipú,MENDOZA,236,223,413,364,777
50,50070,500700706,Maipú,MENDOZA,413,391,860,824,1684
50,50070,500700613,Maipú,MENDOZA,254,284,493,458,951
50,50070,500700609,Maipú,MENDOZA,227,223,408,363,771
50,50070,500700608,Maipú,MENDOZA,459,406,883,872,1755
50,50070,500700405,Maipú,MENDOZA,404,444,750,756,1506
50,50070,500700213,Maipú,MENDOZA,377,399,690,676,1366
50,50070,500700604,Maipú,MENDOZA,212,204,366,319,685
50,50070,500701004,Maipú,MENDOZA,306,365,539,556,1095
50,50070,500700206,Maipú,MENDOZA,273,303,549,572,1121
50,50070,500700205,Maipú,MENDOZA,293,316,537,602,1139
50,50070,500700115,Maipú,MENDOZA,153,140,284,302,586
50,50070,500700417,Maipú,MENDOZA,382,356,698,708,1406
50,50070,500700902,Maipú,MENDOZA,345,316,775,798,1573
50,50070,500700810,Maipú,MENDOZA,360,381,637,565,1202
50,50070,500700807,Maipú,MENDOZA,211,210,405,349,754
50,50070,500700707,Maipú,MENDOZA,273,271,466,417,883
50,50070,500700705,Maipú,MENDOZA,312,295,597,576,1173
50,50070,500700601,Maipú,MENDOZA,451,440,880,785,1665
50,50070,500700513,Maipú,MENDOZA,320,304,618,595,1213
50,50070,500700410,Maipú,MENDOZA,112,113,217,240,457
50,50070,500700408,Maipú,MENDOZA,526,462,1104,1104,2208
50,50070,500700402,Maipú,MENDOZA,337,341,596,572,1168
50,50070,500700107,Maipú,MENDOZA,148,143,310,314,624
50,50070,500701008,Maipú,MENDOZA,207,213,352,318,670
50,50070,500700412,Maipú,MENDOZA,382,312,781,724,1505
50,50070,500700113,Maipú,MENDOZA,232,273,470,504,974
50,50070,500700112,Maipú,MENDOZA,294,314,574,592,1166
50,50070,500700201,Maipú,MENDOZA,197,236,379,449,828
50,50070,500700422,Maipú,MENDOZA,304,291,545,520,1065
50,50070,500700425,Maipú,MENDOZA,259,319,455,465,920
50,50070,500700411,Maipú,MENDOZA,305,323,570,579,1149
50,50070,500700308,Maipú,MENDOZA,246,245,492,506,998
50,50070,500700116,Maipú,MENDOZA,560,552,1158,1148,2306
50,50070,500700910,Maipú,MENDOZA,238,216,466,444,910
50,50070,500700909,Maipú,MENDOZA,226,202,441,407,848
50,50070,500700907,Maipú,MENDOZA,288,308,533,473,1006
50,50070,500700802,Maipú,MENDOZA,274,291,496,443,939
50,50070,500700602,Maipú,MENDOZA,470,449,896,858,1754
50,50070,500700508,Maipú,MENDOZA,283,274,460,427,887
50,50070,500700506,Maipú,MENDOZA,326,305,601,526,1127
50,50070,500700501,Maipú,MENDOZA,519,531,971,936,1907
50,50070,500700108,Maipú,MENDOZA,205,202,354,316,670
50,50070,500701012,Maipú,MENDOZA,335,398,580,596,1176
50,50070,500701011,Maipú,MENDOZA,199,223,329,260,589
50,50070,500700611,Maipú,MENDOZA,208,207,375,304,679
50,50070,500700504,Maipú,MENDOZA,234,237,420,394,814
50,50070,500700306,Maipú,MENDOZA,172,186,343,387,730
50,50070,500700303,Maipú,MENDOZA,370,422,708,742,1450
50,50070,500700104,Maipú,MENDOZA,183,182,373,354,727
50,50070,500700202,Maipú,MENDOZA,308,338,615,742,1357
50,50070,500700304,Maipú,MENDOZA,292,318,539,586,1125
50,50070,500700211,Maipú,MENDOZA,389,414,732,803,1535
50,50070,500701005,Maipú,MENDOZA,151,157,285,284,569
50,50070,500700901,Maipú,MENDOZA,273,229,482,465,947
50,50070,500700814,Maipú,MENDOZA,307,313,530,485,1015
50,50070,500700812,Maipú,MENDOZA,314,327,614,540,1154
50,50070,500700809,Maipú,MENDOZA,219,220,405,428,833
50,50070,500700808,Maipú,MENDOZA,281,298,521,479,1000
50,50070,500700704,Maipú,MENDOZA,187,214,370,348,718
50,50070,500700610,Maipú,MENDOZA,221,210,383,318,701
50,50070,500700605,Maipú,MENDOZA,252,263,418,395,813
50,50070,500700603,Maipú,MENDOZA,447,473,805,727,1532
50,50070,500700512,Maipú,MENDOZA,373,320,720,701,1421
50,50070,500700511,Maipú,MENDOZA,371,354,648,576,1224
50,50070,500700403,Maipú,MENDOZA,365,374,763,726,1489
50,50070,500700110,Maipú,MENDOZA,804,730,1531,1527,3058
50,50070,500700106,Maipú,MENDOZA,431,450,746,710,1456
50,50070,500701010,Maipú,MENDOZA,322,359,531,460,991
50,50070,500700510,Maipú,MENDOZA,403,390,733,670,1403
50,50070,500700711,Maipú,MENDOZA,263,285,447,385,832
50,50070,500700509,Maipú,MENDOZA,219,209,336,338,674
50,50070,500700102,Maipú,MENDOZA,295,323,611,597,1208
50,50070,500700418,Maipú,MENDOZA,323,357,574,590,1164
50,50070,500700416,Maipú,MENDOZA,396,409,795,763,1558
50,50070,500700415,Maipú,MENDOZA,217,244,397,416,813
50,50070,500700114,Maipú,MENDOZA,305,382,603,652,1255
50,50070,500700118,Maipú,MENDOZA,248,246,443,466,909
50,50070,500700302,Maipú,MENDOZA,563,577,1084,1074,2158
50,50070,500700912,Maipú,MENDOZA,300,275,598,584,1182
50,50070,500700911,Maipú,MENDOZA,403,375,794,823,1617
50,50070,500700816,Maipú,MENDOZA,319,380,600,578,1178
50,50070,500700813,Maipú,MENDOZA,233,230,430,421,851
50,50070,500700804,Maipú,MENDOZA,331,347,641,556,1197
50,50070,500700606,Maipú,MENDOZA,302,309,513,478,991
50,50070,500700407,Maipú,MENDOZA,468,396,907,866,1773
50,50070,500700109,Maipú,MENDOZA,656,603,1268,1349,2617
50,50070,500701007,Maipú,MENDOZA,219,245,395,382,777
50,50070,500700305,Maipú,MENDOZA,567,569,1024,1041,2065
50,50070,500700203,Maipú,MENDOZA,211,243,399,443,842
50,50070,500700805,Maipú,MENDOZA,460,464,854,820,1674
50,50070,500700801,Maipú,MENDOZA,313,354,558,553,1111
50,50070,500700712,Maipú,MENDOZA,173,180,300,285,585
50,50070,500700710,Maipú,MENDOZA,171,176,294,241,535
50,50070,500700703,Maipú,MENDOZA,311,325,609,513,1122
50,50070,500700701,Maipú,MENDOZA,219,272,375,292,667
50,50070,500700514,Maipú,MENDOZA,310,307,559,508,1067
50,50070,500700406,Maipú,MENDOZA,485,440,841,802,1643
50,50070,500700612,Maipú,MENDOZA,428,400,755,725,1480
50,50070,500700420,Maipú,MENDOZA,319,376,607,605,1212
50,50070,500700307,Maipú,MENDOZA,180,221,318,376,694
50,50070,500700215,Maipú,MENDOZA,119,122,251,272,523
50,50070,500700212,Maipú,MENDOZA,337,373,634,623,1257
50,50070,500700111,Maipú,MENDOZA,321,339,637,688,1325
50,50070,500700301,Maipú,MENDOZA,459,471,915,900,1815
50,50070,500700210,Maipú,MENDOZA,359,380,708,765,1473
50,50070,500700421,Maipú,MENDOZA,356,354,628,647,1275
50,50070,500700101,Maipú,MENDOZA,240,263,537,555,1092
50,50070,500700906,Maipú,MENDOZA,197,180,318,321,639
50,50070,500700806,Maipú,MENDOZA,363,375,620,547,1167
50,50070,500700709,Maipú,MENDOZA,178,295,306,266,572
50,50070,500700708,Maipú,MENDOZA,278,291,517,426,943
50,50070,500700702,Maipú,MENDOZA,295,343,547,401,948
50,50070,500700607,Maipú,MENDOZA,287,261,557,539,1096
50,50070,500700505,Maipú,MENDOZA,349,347,635,575,1210
50,50070,500700503,Maipú,MENDOZA,165,209,310,292,602
50,50070,500700502,Maipú,MENDOZA,301,307,607,577,1184
50,50070,500700423,Maipú,MENDOZA,335,360,630,644,1274
50,50070,500700404,Maipú,MENDOZA,467,464,879,911,1790
50,50070,500700401,Maipú,MENDOZA,149,148,240,250,490
50,50070,500701013,Maipú,MENDOZA,199,297,364,405,769
50,50070,500700204,Maipú,MENDOZA,317,331,626,648,1274
50,50063,500630703,Luján de Cuyo,MENDOZA,178,225,318,335,653
50,50063,500630406,Luján de Cuyo,MENDOZA,536,597,1119,1195,2314
50,50063,500631008,Luján de Cuyo,MENDOZA,364,376,663,627,1290
50,50063,500631116,Luján de Cuyo,MENDOZA,231,247,410,342,752
50,50063,500631110,Luján de Cuyo,MENDOZA,128,253,208,198,406
50,50063,500631001,Luján de Cuyo,MENDOZA,244,382,422,405,827
50,50063,500630911,Luján de Cuyo,MENDOZA,192,202,337,315,652
50,50063,500630908,Luján de Cuyo,MENDOZA,244,319,455,427,882
50,50063,500630904,Luján de Cuyo,MENDOZA,271,350,509,461,970
50,50063,500630309,Luján de Cuyo,MENDOZA,336,312,668,603,1271
50,50063,500630306,Luján de Cuyo,MENDOZA,367,330,693,641,1334
50,50063,500630204,Luján de Cuyo,MENDOZA,239,229,425,342,767
50,50063,500630113,Luján de Cuyo,MENDOZA,305,371,575,545,1120
50,50063,500630312,Luján de Cuyo,MENDOZA,471,631,1053,1040,2093
50,50063,500630213,Luján de Cuyo,MENDOZA,239,263,385,377,762
50,50063,500630802,Luján de Cuyo,MENDOZA,275,287,486,460,946
50,50063,500630801,Luján de Cuyo,MENDOZA,254,274,427,405,832
50,50063,500630112,Luján de Cuyo,MENDOZA,133,371,257,248,505
50,50063,500631111,Luján de Cuyo,MENDOZA,163,227,322,285,607
50,50063,500630601,Luján de Cuyo,MENDOZA,30,24,77,62,139
50,50063,500630217,Luján de Cuyo,MENDOZA,36,40,77,84,161
50,50063,500630502,Luján de Cuyo,MENDOZA,261,580,453,474,927
50,50063,500630501,Luján de Cuyo,MENDOZA,300,331,655,609,1264
50,50063,500630411,Luján de Cuyo,MENDOZA,535,563,1127,1084,2211
50,50063,500630402,Luján de Cuyo,MENDOZA,389,389,798,829,1627
50,50063,500631009,Luján de Cuyo,MENDOZA,176,167,350,365,715
50,50063,500631002,Luján de Cuyo,MENDOZA,169,269,313,277,590
50,50063,500630218,Luján de Cuyo,MENDOZA,275,251,606,566,1172
50,50063,500631114,Luján de Cuyo,MENDOZA,316,314,602,564,1166
50,50063,500631102,Luján de Cuyo,MENDOZA,161,248,276,261,537
50,50063,500631015,Luján de Cuyo,MENDOZA,194,276,347,342,689
50,50063,500630914,Luján de Cuyo,MENDOZA,399,362,813,749,1562
50,50063,500630903,Luján de Cuyo,MENDOZA,193,119,336,372,708
50,50063,500630901,Luján de Cuyo,MENDOZA,284,305,517,521,1038
50,50063,500630304,Luján de Cuyo,MENDOZA,152,211,261,264,525
50,50063,500630206,Luján de Cuyo,MENDOZA,161,162,258,237,495
50,50063,500630812,Luján de Cuyo,MENDOZA,335,387,600,598,1198
50,50063,500630705,Luján de Cuyo,MENDOZA,40,248,85,90,175
50,50063,500631103,Luján de Cuyo,MENDOZA,401,380,921,908,1829
50,50063,500631007,Luján de Cuyo,MENDOZA,206,211,372,385,757
50,50063,500630214,Luján de Cuyo,MENDOZA,260,358,406,297,703
50,50063,500630105,Luján de Cuyo,MENDOZA,187,221,340,332,672
50,50063,500630401,Luján de Cuyo,MENDOZA,249,314,497,587,1084
50,50063,500630301,Luján de Cuyo,MENDOZA,17,59,40,661,701
50,50063,500630310,Luján de Cuyo,MENDOZA,682,683,1376,1367,2743
50,50063,500631106,Luján de Cuyo,MENDOZA,174,155,438,437,875
50,50063,500630913,Luján de Cuyo,MENDOZA,256,245,440,405,845
50,50063,500630905,Luján de Cuyo,MENDOZA,358,324,723,692,1415
50,50063,500630205,Luján de Cuyo,MENDOZA,237,257,423,336,759
50,50063,500630203,Luján de Cuyo,MENDOZA,300,394,500,437,937
50,50063,500630108,Luján de Cuyo,MENDOZA,182,207,318,327,645
50,50063,500630104,Luján de Cuyo,MENDOZA,320,362,607,575,1182
50,50063,500630806,Luján de Cuyo,MENDOZA,137,276,278,250,528
50,50063,500631011,Luján de Cuyo,MENDOZA,330,381,553,521,1074
50,50063,500630701,Luján de Cuyo,MENDOZA,7,18,8,14,22
50,50063,500630405,Luján de Cuyo,MENDOZA,293,309,593,637,1230
50,50063,500630409,Luján de Cuyo,MENDOZA,358,349,687,681,1368
50,50063,500630311,Luján de Cuyo,MENDOZA,287,328,549,530,1079
50,50063,500631108,Luján de Cuyo,MENDOZA,291,279,547,504,1051
50,50063,500631104,Luján de Cuyo,MENDOZA,312,295,628,665,1293
50,50063,500630207,Luján de Cuyo,MENDOZA,173,179,321,256,577
50,50063,500630201,Luján de Cuyo,MENDOZA,235,238,434,369,803
50,50063,500630109,Luján de Cuyo,MENDOZA,349,418,666,616,1282
50,50063,500630810,Luján de Cuyo,MENDOZA,175,188,340,310,650
50,50063,500630804,Luján de Cuyo,MENDOZA,374,355,676,550,1226
50,50063,500631013,Luján de Cuyo,MENDOZA,334,351,618,557,1175
50,50063,500631006,Luján de Cuyo,MENDOZA,250,244,521,473,994
50,50063,500630305,Luján de Cuyo,MENDOZA,350,515,635,668,1303
50,50063,500630408,Luján de Cuyo,MENDOZA,216,272,437,487,924
50,50063,500630410,Luján de Cuyo,MENDOZA,376,387,699,736,1435
50,50063,500631105,Luján de Cuyo,MENDOZA,346,334,789,759,1548
50,50063,500631101,Luján de Cuyo,MENDOZA,376,401,682,616,1298
50,50063,500631016,Luján de Cuyo,MENDOZA,118,91,233,218,451
50,50063,500631005,Luján de Cuyo,MENDOZA,289,357,535,504,1039
50,50063,500630915,Luján de Cuyo,MENDOZA,315,321,634,556,1190
50,50063,500630902,Luján de Cuyo,MENDOZA,0,208,0,0,0
50,50063,500630209,Luján de Cuyo,MENDOZA,191,200,333,289,622
50,50063,500630110,Luján de Cuyo,MENDOZA,170,214,294,281,575
50,50063,500630107,Luján de Cuyo,MENDOZA,364,429,603,602,1205
50,50063,500630813,Luján de Cuyo,MENDOZA,260,305,453,425,878
50,50063,500630809,Luján de Cuyo,MENDOZA,346,358,691,673,1364
50,50063,500630706,Luján de Cuyo,MENDOZA,25,150,34,35,69
50,50063,500630111,Luján de Cuyo,MENDOZA,151,180,249,258,507
50,50063,500630702,Luján de Cuyo,MENDOZA,28,226,43,61,104
50,50063,500630307,Luján de Cuyo,MENDOZA,335,461,688,614,1302
50,50063,500630504,Luján de Cuyo,MENDOZA,203,289,392,464,856
50,50063,500630503,Luján de Cuyo,MENDOZA,178,295,352,423,775
50,50063,500630407,Luján de Cuyo,MENDOZA,283,265,525,541,1066
50,50063,500631115,Luján de Cuyo,MENDOZA,212,229,401,358,759
50,50063,500631107,Luján de Cuyo,MENDOZA,122,357,259,278,537
50,50063,500631004,Luján de Cuyo,MENDOZA,188,223,341,335,676
50,50063,500630909,Luján de Cuyo,MENDOZA,302,296,567,537,1104
50,50063,500630907,Luján de Cuyo,MENDOZA,424,368,867,884,1751
50,50063,500630212,Luján de Cuyo,MENDOZA,232,221,388,359,747
50,50063,500630814,Luján de Cuyo,MENDOZA,367,399,670,623,1293
50,50063,500630308,Luján de Cuyo,MENDOZA,220,212,421,418,839
50,50063,500630208,Luján de Cuyo,MENDOZA,242,250,378,320,698
50,50063,500630805,Luján de Cuyo,MENDOZA,260,244,510,431,941
50,50063,500630803,Luján de Cuyo,MENDOZA,297,302,549,462,1011
50,50063,500631112,Luján de Cuyo,MENDOZA,163,226,288,292,580
50,50063,500630602,Luján de Cuyo,MENDOZA,47,41,88,84,172
50,50063,500630303,Luján de Cuyo,MENDOZA,59,99,124,124,248
50,50063,500631113,Luján de Cuyo,MENDOZA,324,324,577,554,1131
50,50063,500630912,Luján de Cuyo,MENDOZA,290,267,540,548,1088
50,50063,500630906,Luján de Cuyo,MENDOZA,360,477,753,637,1390
50,50063,500630216,Luján de Cuyo,MENDOZA,214,225,391,381,772
50,50063,500630211,Luján de Cuyo,MENDOZA,331,312,606,621,1227
50,50063,500630210,Luján de Cuyo,MENDOZA,209,222,357,336,693
50,50063,500630202,Luján de Cuyo,MENDOZA,320,353,553,532,1085
50,50063,500630106,Luján de Cuyo,MENDOZA,171,195,308,297,605
50,50063,500630103,Luján de Cuyo,MENDOZA,382,428,716,719,1435
50,50063,500630102,Luján de Cuyo,MENDOZA,229,247,417,382,799
50,50063,500630811,Luján de Cuyo,MENDOZA,279,310,533,489,1022
50,50063,500630808,Luján de Cuyo,MENDOZA,311,288,524,468,992
50,50063,500630807,Luján de Cuyo,MENDOZA,237,253,417,375,792
50,50063,500630707,Luján de Cuyo,MENDOZA,53,341,92,102,194
50,50063,500630704,Luján de Cuyo,MENDOZA,65,447,83,105,188
50,50063,500631014,Luján de Cuyo,MENDOZA,182,192,330,297,627
50,50063,500631010,Luján de Cuyo,MENDOZA,329,323,556,491,1047
50,50063,500630403,Luján de Cuyo,MENDOZA,308,302,632,617,1249
50,50063,500630404,Luján de Cuyo,MENDOZA,102,139,182,201,383
50,50063,500630302,Luján de Cuyo,MENDOZA,224,287,443,481,924
50,50063,500631109,Luján de Cuyo,MENDOZA,277,295,544,487,1031
50,50063,500631012,Luján de Cuyo,MENDOZA,187,201,349,317,666
50,50063,500631003,Luján de Cuyo,MENDOZA,256,337,467,484,951
50,50063,500630910,Luján de Cuyo,MENDOZA,295,277,581,613,1194
50,50063,500630215,Luján de Cuyo,MENDOZA,272,366,426,358,784
50,50063,500630101,Luján de Cuyo,MENDOZA,284,348,499,476,975
50,50063,500631017,Luján de Cuyo,MENDOZA,377,513,702,694,1396
50,50056,500560602,Lavalle,MENDOZA,251,300,497,523,1020
50,50056,500560403,Lavalle,MENDOZA,366,397,710,738,1448
50,50056,500560404,Lavalle,MENDOZA,388,447,767,853,1620
50,50056,500560604,Lavalle,MENDOZA,397,446,785,763,1548
50,50056,500560501,Lavalle,MENDOZA,293,323,619,655,1274
50,50056,500560603,Lavalle,MENDOZA,361,360,630,578,1208
50,50056,500560405,Lavalle,MENDOZA,191,199,326,336,662
50,50056,500560614,Lavalle,MENDOZA,73,105,149,155,304
50,50056,500560507,Lavalle,MENDOZA,265,278,621,590,1211
50,50056,500560615,Lavalle,MENDOZA,293,359,561,582,1143
50,50056,500560701,Lavalle,MENDOZA,175,202,294,362,656
50,50056,500560616,Lavalle,MENDOZA,184,121,406,425,831
50,50056,500560406,Lavalle,MENDOZA,270,304,525,523,1048
50,50056,500560608,Lavalle,MENDOZA,247,250,466,479,945
50,50056,500560401,Lavalle,MENDOZA,160,178,316,362,678
50,50056,500560611,Lavalle,MENDOZA,305,284,665,640,1305
50,50056,500560606,Lavalle,MENDOZA,384,410,728,682,1410
50,50056,500560201,Lavalle,MENDOZA,300,381,447,532,979
50,50056,500560502,Lavalle,MENDOZA,121,148,228,260,488
50,50056,500560610,Lavalle,MENDOZA,239,270,455,489,944
50,50056,500560503,Lavalle,MENDOZA,220,225,481,492,973
50,50056,500560609,Lavalle,MENDOZA,331,350,680,720,1400
50,50056,500560402,Lavalle,MENDOZA,230,259,424,425,849
50,50056,500560505,Lavalle,MENDOZA,140,245,316,334,650
50,50056,500560601,Lavalle,MENDOZA,121,135,239,251,490
50,50056,500560506,Lavalle,MENDOZA,223,234,483,501,984
50,50056,500560504,Lavalle,MENDOZA,297,327,600,602,1202
50,50056,500560409,Lavalle,MENDOZA,309,335,564,560,1124
50,50056,500560612,Lavalle,MENDOZA,222,238,424,457,881
50,50056,500560613,Lavalle,MENDOZA,236,235,485,496,981
50,50056,500560607,Lavalle,MENDOZA,114,112,241,202,443
50,50056,500560605,Lavalle,MENDOZA,398,406,811,708,1519
50,50056,500560408,Lavalle,MENDOZA,192,194,338,323,661
50,50056,500560301,Lavalle,MENDOZA,226,265,390,469,859
50,50056,500560101,Lavalle,MENDOZA,239,344,479,563,1042
50,50056,500560407,Lavalle,MENDOZA,508,521,978,980,1958
50,50049,500490202,Las Heras,MENDOZA,70,75,118,132,250
50,50049,500490201,Las Heras,MENDOZA,406,466,764,863,1627
50,50049,500491414,Las Heras,MENDOZA,194,216,390,377,767
50,50049,500491008,Las Heras,MENDOZA,187,412,332,344,676
50,50049,500491001,Las Heras,MENDOZA,462,466,918,858,1776
50,50049,500490911,Las Heras,MENDOZA,369,409,652,593,1245
50,50049,500490812,Las Heras,MENDOZA,417,397,880,832,1712
50,50049,500490703,Las Heras,MENDOZA,232,216,483,429,912
50,50049,500490702,Las Heras,MENDOZA,238,233,486,466,952
50,50049,500490413,Las Heras,MENDOZA,146,213,252,241,493
50,50049,500490312,Las Heras,MENDOZA,265,296,437,410,847
50,50049,500490221,Las Heras,MENDOZA,412,392,956,852,1808
50,50049,500490203,Las Heras,MENDOZA,189,185,380,390,770
50,50049,500490217,Las Heras,MENDOZA,235,224,509,510,1019
50,50049,500491303,Las Heras,MENDOZA,267,257,640,582,1222
50,50049,500491302,Las Heras,MENDOZA,461,453,978,1038,2016
50,50049,500491214,Las Heras,MENDOZA,232,255,391,289,680
50,50049,500491212,Las Heras,MENDOZA,341,361,664,600,1264
50,50049,500491312,Las Heras,MENDOZA,438,412,835,768,1603
50,50049,500491205,Las Heras,MENDOZA,310,320,549,510,1059
50,50049,500491118,Las Heras,MENDOZA,210,196,415,406,821
50,50049,500491112,Las Heras,MENDOZA,381,356,643,574,1217
50,50049,500491411,Las Heras,MENDOZA,157,192,318,350,668
50,50049,500491010,Las Heras,MENDOZA,284,306,495,455,950
50,50049,500490918,Las Heras,MENDOZA,218,237,382,323,705
50,50049,500490213,Las Heras,MENDOZA,382,374,761,734,1495
50,50049,500490501,Las Heras,MENDOZA,7,14,3,9,12
50,50049,500490101,Las Heras,MENDOZA,4,7,6,11,17
50,50049,500490601,Las Heras,MENDOZA,0,1,24,138,162
50,50049,500490307,Las Heras,MENDOZA,17,16,38,75,113
50,50049,500490915,Las Heras,MENDOZA,287,309,538,420,958
50,50049,500490810,Las Heras,MENDOZA,304,275,592,531,1123
50,50049,500490803,Las Heras,MENDOZA,220,230,441,384,825
50,50049,500490801,Las Heras,MENDOZA,284,300,557,512,1069
50,50049,500490407,Las Heras,MENDOZA,290,379,521,461,982
50,50049,500490406,Las Heras,MENDOZA,225,243,380,314,694
50,50049,500491408,Las Heras,MENDOZA,316,309,599,546,1145
50,50049,500491407,Las Heras,MENDOZA,313,329,591,503,1094
50,50049,500491406,Las Heras,MENDOZA,372,357,655,589,1244
50,50049,500491308,Las Heras,MENDOZA,365,360,746,736,1482
50,50049,500491306,Las Heras,MENDOZA,196,182,468,488,956
50,50049,500491301,Las Heras,MENDOZA,284,254,559,555,1114
50,50049,500491202,Las Heras,MENDOZA,261,287,492,478,970
50,50049,500491114,Las Heras,MENDOZA,241,202,512,503,1015
50,50049,500491113,Las Heras,MENDOZA,110,95,237,213,450
50,50049,500490313,Las Heras,MENDOZA,472,515,934,1005,1939
50,50049,500491101,Las Heras,MENDOZA,7,8,12,10,22
50,50049,500490502,Las Heras,MENDOZA,147,149,329,355,684
50,50049,500491013,Las Heras,MENDOZA,231,248,381,349,730
50,50049,500491003,Las Heras,MENDOZA,209,205,401,367,768
50,50049,500490816,Las Heras,MENDOZA,189,179,407,356,763
50,50049,500490814,Las Heras,MENDOZA,340,350,578,491,1069
50,50049,500490808,Las Heras,MENDOZA,414,375,815,833,1648
50,50049,500490715,Las Heras,MENDOZA,272,300,465,436,901
50,50049,500490319,Las Heras,MENDOZA,269,241,509,536,1045
50,50049,500490403,Las Heras,MENDOZA,337,369,589,525,1114
50,50049,500490305,Las Heras,MENDOZA,329,332,615,606,1221
50,50049,500490210,Las Heras,MENDOZA,337,335,691,654,1345
50,50049,500490205,Las Heras,MENDOZA,310,306,661,592,1253
50,50049,500491401,Las Heras,MENDOZA,272,329,515,483,998
50,50049,500491404,Las Heras,MENDOZA,145,255,298,245,543
50,50049,500491213,Las Heras,MENDOZA,234,233,450,407,857
50,50049,500490505,Las Heras,MENDOZA,468,534,944,965,1909
50,50049,500490311,Las Heras,MENDOZA,202,202,344,304,648
50,50049,500490603,Las Heras,MENDOZA,52,76,69,93,162
50,50049,500490503,Las Heras,MENDOZA,445,508,931,1023,1954
50,50049,500491011,Las Heras,MENDOZA,249,274,431,378,809
50,50049,500490912,Las Heras,MENDOZA,174,182,290,273,563
50,50049,500490906,Las Heras,MENDOZA,306,335,551,520,1071
50,50049,500490901,Las Heras,MENDOZA,385,390,618,589,1207
50,50049,500490819,Las Heras,MENDOZA,202,200,410,362,772
50,50049,500490817,Las Heras,MENDOZA,337,343,628,572,1200
50,50049,500490905,Las Heras,MENDOZA,339,350,601,532,1133
50,50049,500490807,Las Heras,MENDOZA,332,324,652,635,1287
50,50049,500490712,Las Heras,MENDOZA,261,292,468,436,904
50,50049,500490710,Las Heras,MENDOZA,153,156,270,248,518
50,50049,500490412,Las Heras,MENDOZA,253,268,445,400,845
50,50049,500490411,Las Heras,MENDOZA,344,386,580,516,1096
50,50049,500490410,Las Heras,MENDOZA,274,262,475,428,903
50,50049,500490405,Las Heras,MENDOZA,223,238,392,325,717
50,50049,500490404,Las Heras,MENDOZA,326,361,557,477,1034
50,50049,500490320,Las Heras,MENDOZA,290,284,573,565,1138
50,50049,500490316,Las Heras,MENDOZA,291,258,693,697,1390
50,50049,500490208,Las Heras,MENDOZA,250,240,560,562,1122
50,50049,500491402,Las Heras,MENDOZA,415,414,781,734,1515
50,50049,500491217,Las Heras,MENDOZA,235,246,381,352,733
50,50049,500491211,Las Heras,MENDOZA,169,182,327,264,591
50,50049,500491206,Las Heras,MENDOZA,253,286,446,381,827
50,50049,500491203,Las Heras,MENDOZA,373,343,745,716,1461
50,50049,500490304,Las Heras,MENDOZA,366,352,669,635,1304
50,50049,500491104,Las Heras,MENDOZA,160,218,290,308,598
50,50049,500491102,Las Heras,MENDOZA,26,29,58,53,111
50,50049,500491012,Las Heras,MENDOZA,291,319,564,453,1017
50,50049,500491009,Las Heras,MENDOZA,221,220,392,344,736
50,50049,500491004,Las Heras,MENDOZA,166,146,299,244,543
50,50049,500490908,Las Heras,MENDOZA,207,284,333,334,667
50,50049,500490907,Las Heras,MENDOZA,277,299,477,432,909
50,50049,500490904,Las Heras,MENDOZA,184,196,317,321,638
50,50049,500490708,Las Heras,MENDOZA,218,183,447,387,834
50,50049,500490707,Las Heras,MENDOZA,213,204,426,376,802
50,50049,500490701,Las Heras,MENDOZA,225,219,492,464,956
50,50049,500490408,Las Heras,MENDOZA,212,349,357,299,656
50,50049,500490318,Las Heras,MENDOZA,228,187,446,457,903
50,50049,500490306,Las Heras,MENDOZA,355,356,715,766,1481
50,50049,500490216,Las Heras,MENDOZA,385,337,934,846,1780
50,50049,500490212,Las Heras,MENDOZA,351,338,748,696,1444
50,50049,500490206,Las Heras,MENDOZA,318,296,676,658,1334
50,50049,500491412,Las Heras,MENDOZA,325,296,664,687,1351
50,50049,500491310,Las Heras,MENDOZA,370,363,717,688,1405
50,50049,500491305,Las Heras,MENDOZA,209,205,469,464,933
50,50049,500491304,Las Heras,MENDOZA,335,279,675,641,1316
50,50049,500491204,Las Heras,MENDOZA,204,261,322,347,669
50,50049,500491201,Las Heras,MENDOZA,169,172,361,369,730
50,50049,500491405,Las Heras,MENDOZA,341,340,650,604,1254
50,50049,500491110,Las Heras,MENDOZA,387,367,678,585,1263
50,50049,500490310,Las Heras,MENDOZA,188,194,347,283,630
50,50049,500490602,Las Heras,MENDOZA,46,68,63,65,128
50,50049,500490506,Las Heras,MENDOZA,154,354,226,252,478
50,50049,500491111,Las Heras,MENDOZA,270,238,478,425,903
50,50049,500491109,Las Heras,MENDOZA,196,300,326,342,668
50,50049,500491108,Las Heras,MENDOZA,174,211,326,301,627
50,50049,500491107,Las Heras,MENDOZA,120,276,221,200,421
50,50049,500491106,Las Heras,MENDOZA,199,228,378,345,723
50,50049,500491119,Las Heras,MENDOZA,303,254,530,537,1067
50,50049,500491103,Las Heras,MENDOZA,356,330,699,704,1403
50,50049,500491006,Las Heras,MENDOZA,188,185,381,323,704
50,50049,500490917,Las Heras,MENDOZA,232,243,391,374,765
50,50049,500490910,Las Heras,MENDOZA,274,274,472,438,910
50,50049,500490903,Las Heras,MENDOZA,209,196,386,378,764
50,50049,500490820,Las Heras,MENDOZA,240,244,436,401,837
50,50049,500490818,Las Heras,MENDOZA,250,255,494,489,983
50,50049,500490815,Las Heras,MENDOZA,345,359,687,654,1341
50,50049,500490809,Las Heras,MENDOZA,332,299,738,685,1423
50,50049,500490709,Las Heras,MENDOZA,288,373,527,553,1080
50,50049,500490402,Las Heras,MENDOZA,350,368,616,574,1190
50,50049,500490321,Las Heras,MENDOZA,322,317,650,695,1345
50,50049,500490211,Las Heras,MENDOZA,281,253,588,575,1163
50,50049,500491410,Las Heras,MENDOZA,317,309,656,650,1306
50,50049,500491409,Las Heras,MENDOZA,260,251,463,419,882
50,50049,500491307,Las Heras,MENDOZA,381,376,810,736,1546
50,50049,500491313,Las Heras,MENDOZA,247,234,510,481,991
50,50049,500491116,Las Heras,MENDOZA,290,258,614,567,1181
50,50049,500491115,Las Heras,MENDOZA,175,166,372,338,710
50,50049,500490919,Las Heras,MENDOZA,173,175,280,261,541
50,50049,500491403,Las Heras,MENDOZA,275,278,517,455,972
50,50049,500490813,Las Heras,MENDOZA,152,158,262,230,492
50,50049,500490706,Las Heras,MENDOZA,210,215,390,372,762
50,50049,500490409,Las Heras,MENDOZA,381,387,662,624,1286
50,50049,500490214,Las Heras,MENDOZA,271,231,573,595,1168
50,50049,500490315,Las Heras,MENDOZA,329,364,634,695,1329
50,50049,500490302,Las Heras,MENDOZA,291,330,578,628,1206
50,50049,500491311,Las Heras,MENDOZA,355,355,701,670,1371
50,50049,500491007,Las Heras,MENDOZA,356,320,721,706,1427
50,50049,500491005,Las Heras,MENDOZA,257,277,471,426,897
50,50049,500491002,Las Heras,MENDOZA,335,336,651,567,1218
50,50049,500490916,Las Heras,MENDOZA,309,287,601,553,1154
50,50049,500490909,Las Heras,MENDOZA,299,296,520,481,1001
50,50049,500490902,Las Heras,MENDOZA,220,224,402,400,802
50,50049,500490811,Las Heras,MENDOZA,333,306,739,717,1456
50,50049,500490804,Las Heras,MENDOZA,304,316,603,605,1208
50,50049,500490802,Las Heras,MENDOZA,347,357,633,544,1177
50,50049,500490714,Las Heras,MENDOZA,172,162,281,239,520
50,50049,500490705,Las Heras,MENDOZA,361,343,759,653,1412
50,50049,500490308,Las Heras,MENDOZA,287,262,569,574,1143
50,50049,500490301,Las Heras,MENDOZA,255,237,609,584,1193
50,50049,500490218,Las Heras,MENDOZA,289,272,589,580,1169
50,50049,500490209,Las Heras,MENDOZA,295,276,666,647,1313
50,50049,500491309,Las Heras,MENDOZA,357,344,724,674,1398
50,50049,500491216,Las Heras,MENDOZA,331,333,566,477,1043
50,50049,500491208,Las Heras,MENDOZA,216,241,390,373,763
50,50049,500491207,Las Heras,MENDOZA,339,342,606,547,1153
50,50049,500490317,Las Heras,MENDOZA,306,272,659,638,1297
50,50049,500490303,Las Heras,MENDOZA,322,289,688,653,1341
50,50049,500490314,Las Heras,MENDOZA,427,428,818,904,1722
50,50049,500491105,Las Heras,MENDOZA,153,331,249,264,513
50,50049,500490914,Las Heras,MENDOZA,293,319,503,432,935
50,50049,500490913,Las Heras,MENDOZA,258,241,480,453,933
50,50049,500490805,Las Heras,MENDOZA,386,358,790,825,1615
50,50049,500490713,Las Heras,MENDOZA,268,296,484,406,890
50,50049,500490711,Las Heras,MENDOZA,263,262,500,435,935
50,50049,500490704,Las Heras,MENDOZA,349,330,705,732,1437
50,50049,500490414,Las Heras,MENDOZA,308,391,555,504,1059
50,50049,500490309,Las Heras,MENDOZA,445,454,884,907,1791
50,50049,500490220,Las Heras,MENDOZA,276,269,629,610,1239
50,50049,500490219,Las Heras,MENDOZA,434,416,941,948,1889
50,50049,500490215,Las Heras,MENDOZA,300,188,708,637,1345
50,50049,500490207,Las Heras,MENDOZA,418,390,875,834,1709
50,50049,500490204,Las Heras,MENDOZA,303,291,599,625,1224
50,50049,500491413,Las Heras,MENDOZA,294,292,724,689,1413
50,50049,500491314,Las Heras,MENDOZA,187,186,359,355,714
50,50049,500491210,Las Heras,MENDOZA,222,238,394,394,788
50,50049,500491209,Las Heras,MENDOZA,184,202,329,324,653
50,50049,500491117,Las Heras,MENDOZA,370,293,779,699,1478
50,50049,500491215,Las Heras,MENDOZA,389,396,682,621,1303
50,50049,500490806,Las Heras,MENDOZA,289,261,556,550,1106
50,50049,500490507,Las Heras,MENDOZA,376,510,689,688,1377
50,50049,500490504,Las Heras,MENDOZA,361,451,651,651,1302
50,50049,500490401,Las Heras,MENDOZA,254,247,474,419,893
50,50035,500350501,Junín,MENDOZA,536,550,1001,980,1981
50,50035,500350205,Junín,MENDOZA,324,331,652,582,1234
50,50035,500350301,Junín,MENDOZA,488,535,881,891,1772
50,50035,500350201,Junín,MENDOZA,388,445,679,650,1329
50,50035,500350103,Junín,MENDOZA,271,283,498,513,1011
50,50035,500350207,Junín,MENDOZA,299,299,540,537,1077
50,50035,500350506,Junín,MENDOZA,113,123,211,189,400
50,50035,500350504,Junín,MENDOZA,390,412,740,747,1487
50,50035,500350206,Junín,MENDOZA,187,191,290,250,540
50,50035,500350104,Junín,MENDOZA,221,237,395,393,788
50,50035,500350213,Junín,MENDOZA,260,253,484,457,941
50,50035,500350402,Junín,MENDOZA,135,168,253,284,537
50,50035,500350102,Junín,MENDOZA,230,264,415,434,849
50,50035,500350502,Junín,MENDOZA,144,159,264,312,576
50,50035,500350203,Junín,MENDOZA,477,517,845,798,1643
50,50035,500350214,Junín,MENDOZA,344,372,643,612,1255
50,50035,500350216,Junín,MENDOZA,453,462,815,762,1577
50,50035,500350211,Junín,MENDOZA,248,242,464,443,907
50,50035,500350218,Junín,MENDOZA,277,285,567,499,1066
50,50035,500350303,Junín,MENDOZA,351,359,592,616,1208
50,50035,500350202,Junín,MENDOZA,326,366,624,602,1226
50,50035,500350505,Junín,MENDOZA,112,119,208,242,450
50,50035,500350403,Junín,MENDOZA,390,409,697,715,1412
50,50035,500350507,Junín,MENDOZA,211,231,393,408,801
50,50035,500350302,Junín,MENDOZA,348,376,640,613,1253
50,50035,500350210,Junín,MENDOZA,356,330,596,535,1131
50,50035,500350209,Junín,MENDOZA,415,406,670,585,1255
50,50035,500350208,Junín,MENDOZA,230,236,396,388,784
50,50035,500350204,Junín,MENDOZA,233,238,389,332,721
50,50035,500350503,Junín,MENDOZA,94,112,178,191,369
50,50035,500350401,Junín,MENDOZA,119,124,205,237,442
50,50035,500350212,Junín,MENDOZA,271,283,453,399,852
50,50035,500350101,Junín,MENDOZA,430,418,821,775,1596
50,50035,500350404,Junín,MENDOZA,155,178,294,289,583
50,50035,500350215,Junín,MENDOZA,249,246,445,395,840
50,50035,500350217,Junín,MENDOZA,227,229,419,418,837
50,50035,500350105,Junín,MENDOZA,276,285,540,589,1129
50,50028,500281712,Guaymallén,MENDOZA,541,559,1079,1069,2148
50,50028,500280412,Guaymallén,MENDOZA,268,258,599,579,1178
50,50028,500281105,Guaymallén,MENDOZA,347,272,659,685,1344
50,50028,500281101,Guaymallén,MENDOZA,226,201,501,462,963
50,50028,500280913,Guaymallén,MENDOZA,305,305,552,500,1052
50,50028,500281009,Guaymallén,MENDOZA,246,264,425,373,798
50,50028,500280902,Guaymallén,MENDOZA,243,277,384,308,692
50,50028,500280816,Guaymallén,MENDOZA,235,253,380,355,735
50,50028,500280815,Guaymallén,MENDOZA,324,340,585,505,1090
50,50028,500280807,Guaymallén,MENDOZA,286,306,491,412,903
50,50028,500280705,Guaymallén,MENDOZA,170,187,390,361,751
50,50028,500280609,Guaymallén,MENDOZA,106,98,211,223,434
50,50028,500280703,Guaymallén,MENDOZA,233,244,441,440,881
50,50028,500280314,Guaymallén,MENDOZA,422,383,779,745,1524
50,50028,500280309,Guaymallén,MENDOZA,289,283,492,460,952
50,50028,500280306,Guaymallén,MENDOZA,336,274,740,751,1491
50,50028,500280515,Guaymallén,MENDOZA,212,220,397,391,788
50,50028,500280108,Guaymallén,MENDOZA,265,323,411,365,776
50,50028,500280103,Guaymallén,MENDOZA,234,257,388,345,733
50,50028,500280102,Guaymallén,MENDOZA,208,231,457,354,811
50,50028,500282007,Guaymallén,MENDOZA,322,352,537,463,1000
50,50028,500282004,Guaymallén,MENDOZA,179,176,314,291,605
50,50028,500282001,Guaymallén,MENDOZA,354,427,603,535,1138
50,50028,500281909,Guaymallén,MENDOZA,367,360,688,649,1337
50,50028,500281906,Guaymallén,MENDOZA,334,317,675,645,1320
50,50028,500281901,Guaymallén,MENDOZA,414,404,855,796,1651
50,50028,500281806,Guaymallén,MENDOZA,241,236,472,460,932
50,50028,500281709,Guaymallén,MENDOZA,203,195,367,363,730
50,50028,500281701,Guaymallén,MENDOZA,193,175,397,387,784
50,50028,500281609,Guaymallén,MENDOZA,423,431,701,662,1363
50,50028,500281607,Guaymallén,MENDOZA,180,202,295,261,556
50,50028,500281507,Guaymallén,MENDOZA,315,291,667,647,1314
50,50028,500281502,Guaymallén,MENDOZA,498,550,1007,1030,2037
50,50028,500281413,Guaymallén,MENDOZA,288,316,491,452,943
50,50028,500281216,Guaymallén,MENDOZA,302,320,520,427,947
50,50028,500281415,Guaymallén,MENDOZA,218,239,392,401,793
50,50028,500280809,Guaymallén,MENDOZA,305,285,586,510,1096
50,50028,500280414,Guaymallén,MENDOZA,312,303,659,710,1369
50,50028,500280509,Guaymallén,MENDOZA,345,363,650,661,1311
50,50028,500281107,Guaymallén,MENDOZA,328,261,708,705,1413
50,50028,500281104,Guaymallén,MENDOZA,417,337,896,824,1720
50,50028,500281003,Guaymallén,MENDOZA,210,210,364,332,696
50,50028,500281001,Guaymallén,MENDOZA,314,329,520,470,990
50,50028,500280611,Guaymallén,MENDOZA,255,217,505,458,963
50,50028,500280602,Guaymallén,MENDOZA,195,193,362,353,715
50,50028,500280519,Guaymallén,MENDOZA,284,273,550,612,1162
50,50028,500280415,Guaymallén,MENDOZA,326,321,594,517,1111
50,50028,500280310,Guaymallén,MENDOZA,468,366,845,798,1643
50,50028,500280214,Guaymallén,MENDOZA,185,209,317,298,615
50,50028,500280209,Guaymallén,MENDOZA,292,326,480,406,886
50,50028,500280206,Guaymallén,MENDOZA,342,373,546,474,1020
50,50028,500280112,Guaymallén,MENDOZA,175,212,285,248,533
50,50028,500280111,Guaymallén,MENDOZA,345,391,541,474,1015
50,50028,500282010,Guaymallén,MENDOZA,213,214,362,309,671
50,50028,500282009,Guaymallén,MENDOZA,338,405,535,450,985
50,50028,500281904,Guaymallén,MENDOZA,298,303,671,652,1323
50,50028,500281810,Guaymallén,MENDOZA,286,291,489,484,973
50,50028,500281707,Guaymallén,MENDOZA,405,459,749,785,1534
50,50028,500281610,Guaymallén,MENDOZA,297,341,498,420,918
50,50028,500281602,Guaymallén,MENDOZA,205,233,338,291,629
50,50028,500281404,Guaymallén,MENDOZA,308,354,486,354,840
50,50028,500281312,Guaymallén,MENDOZA,199,228,321,292,613
50,50028,500281311,Guaymallén,MENDOZA,223,235,392,336,728
50,50028,500281310,Guaymallén,MENDOZA,286,347,461,460,921
50,50028,500281305,Guaymallén,MENDOZA,301,332,527,500,1027
50,50028,500281304,Guaymallén,MENDOZA,318,338,545,476,1021
50,50028,500281219,Guaymallén,MENDOZA,377,384,692,605,1297
50,50028,500281212,Guaymallén,MENDOZA,233,232,471,438,909
50,50028,500281715,Guaymallén,MENDOZA,244,254,521,513,1034
50,50028,500280507,Guaymallén,MENDOZA,543,568,961,997,1958
50,50028,500280511,Guaymallén,MENDOZA,435,476,816,827,1643
50,50028,500281206,Guaymallén,MENDOZA,278,281,490,416,906
50,50028,500281118,Guaymallén,MENDOZA,237,206,474,419,893
50,50028,500281111,Guaymallén,MENDOZA,212,227,390,344,734
50,50028,500281106,Guaymallén,MENDOZA,273,249,587,535,1122
50,50028,500281102,Guaymallén,MENDOZA,262,230,485,505,990
50,50028,500281010,Guaymallén,MENDOZA,340,380,535,510,1045
50,50028,500281005,Guaymallén,MENDOZA,207,209,321,300,621
50,50028,500281004,Guaymallén,MENDOZA,335,347,636,589,1225
50,50028,500280914,Guaymallén,MENDOZA,175,191,298,259,557
50,50028,500280910,Guaymallén,MENDOZA,342,379,552,522,1074
50,50028,500281209,Guaymallén,MENDOZA,288,287,523,492,1015
50,50028,500280812,Guaymallén,MENDOZA,308,365,514,450,964
50,50028,500280805,Guaymallén,MENDOZA,305,352,497,430,927
50,50028,500280804,Guaymallén,MENDOZA,205,228,331,281,612
50,50028,500280803,Guaymallén,MENDOZA,200,221,318,280,598
50,50028,500280709,Guaymallén,MENDOZA,325,318,628,558,1186
50,50028,500280606,Guaymallén,MENDOZA,470,406,943,894,1837
50,50028,500280409,Guaymallén,MENDOZA,362,376,720,658,1378
50,50028,500280404,Guaymallén,MENDOZA,244,238,414,424,838
50,50028,500280315,Guaymallén,MENDOZA,492,502,974,893,1867
50,50028,500280313,Guaymallén,MENDOZA,437,410,820,821,1641
50,50028,500280303,Guaymallén,MENDOZA,226,184,516,521,1037
50,50028,500280210,Guaymallén,MENDOZA,207,225,372,308,680
50,50028,500280104,Guaymallén,MENDOZA,177,226,329,254,583
50,50028,500282005,Guaymallén,MENDOZA,252,248,440,376,816
50,50028,500281811,Guaymallén,MENDOZA,259,276,442,492,934
50,50028,500281805,Guaymallén,MENDOZA,387,392,789,732,1521
50,50028,500281706,Guaymallén,MENDOZA,376,395,684,629,1313
50,50028,500281608,Guaymallén,MENDOZA,346,393,529,531,1060
50,50028,500281309,Guaymallén,MENDOZA,204,211,366,325,691
50,50028,500281214,Guaymallén,MENDOZA,250,244,487,439,926
50,50028,500281208,Guaymallén,MENDOZA,180,188,315,312,627
50,50028,500281211,Guaymallén,MENDOZA,234,451,476,482,958
50,50028,500280501,Guaymallén,MENDOZA,163,158,362,364,726
50,50028,500280516,Guaymallén,MENDOZA,487,459,962,985,1947
50,50028,500281201,Guaymallén,MENDOZA,429,451,817,780,1597
50,50028,500281117,Guaymallén,MENDOZA,271,232,510,433,943
50,50028,500280912,Guaymallén,MENDOZA,286,305,454,436,890
50,50028,500280905,Guaymallén,MENDOZA,312,326,560,516,1076
50,50028,500280903,Guaymallén,MENDOZA,303,335,468,374,842
50,50028,500280819,Guaymallén,MENDOZA,156,199,246,251,497
50,50028,500280806,Guaymallén,MENDOZA,289,290,461,425,886
50,50028,500280711,Guaymallén,MENDOZA,271,356,404,446,850
50,50028,500280518,Guaymallén,MENDOZA,159,153,309,319,628
50,50028,500280505,Guaymallén,MENDOZA,175,178,364,420,784
50,50028,500280502,Guaymallén,MENDOZA,348,337,679,705,1384
50,50028,500280413,Guaymallén,MENDOZA,385,371,869,859,1728
50,50028,500280408,Guaymallén,MENDOZA,261,267,620,587,1207
50,50028,500280405,Guaymallén,MENDOZA,247,257,427,402,829
50,50028,500280403,Guaymallén,MENDOZA,445,467,824,811,1635
50,50028,500280308,Guaymallén,MENDOZA,354,309,582,569,1151
50,50028,500280305,Guaymallén,MENDOZA,303,213,642,650,1292
50,50028,500280304,Guaymallén,MENDOZA,365,320,840,856,1696
50,50028,500280211,Guaymallén,MENDOZA,295,336,464,454,918
50,50028,500280207,Guaymallén,MENDOZA,235,279,361,322,683
50,50028,500280204,Guaymallén,MENDOZA,181,190,279,283,562
50,50028,500282006,Guaymallén,MENDOZA,280,315,468,407,875
50,50028,500282002,Guaymallén,MENDOZA,250,263,458,386,844
50,50028,500281907,Guaymallén,MENDOZA,205,193,434,411,845
50,50028,500281903,Guaymallén,MENDOZA,189,210,407,380,787
50,50028,500281801,Guaymallén,MENDOZA,266,277,521,511,1032
50,50028,500281704,Guaymallén,MENDOZA,229,228,423,358,781
50,50028,500281703,Guaymallén,MENDOZA,345,338,620,554,1174
50,50028,500281601,Guaymallén,MENDOZA,278,275,458,378,836
50,50028,500281506,Guaymallén,MENDOZA,395,390,802,852,1654
50,50028,500281409,Guaymallén,MENDOZA,296,315,461,377,838
50,50028,500281406,Guaymallén,MENDOZA,252,267,468,409,877
50,50028,500281403,Guaymallén,MENDOZA,216,272,308,240,548
50,50028,500281401,Guaymallén,MENDOZA,184,226,279,256,535
50,50028,500281802,Guaymallén,MENDOZA,303,320,575,542,1117
50,50028,500280402,Guaymallén,MENDOZA,221,227,420,406,826
50,50028,500280508,Guaymallén,MENDOZA,492,501,997,1025,2022
50,50028,500281204,Guaymallén,MENDOZA,322,286,681,618,1299
50,50028,500281115,Guaymallén,MENDOZA,297,247,617,577,1194
50,50028,500281112,Guaymallén,MENDOZA,294,308,547,460,1007
50,50028,500281110,Guaymallén,MENDOZA,359,345,684,642,1326
50,50028,500281103,Guaymallén,MENDOZA,425,385,815,767,1582
50,50028,500281008,Guaymallén,MENDOZA,395,401,684,603,1287
50,50028,500280911,Guaymallén,MENDOZA,159,202,259,213,472
50,50028,500280909,Guaymallén,MENDOZA,284,300,505,384,889
50,50028,500280907,Guaymallén,MENDOZA,165,239,251,233,484
50,50028,500280820,Guaymallén,MENDOZA,197,231,298,290,588
50,50028,500280808,Guaymallén,MENDOZA,303,293,553,483,1036
50,50028,500280904,Guaymallén,MENDOZA,179,196,292,229,521
50,50028,500280802,Guaymallén,MENDOZA,177,187,294,256,550
50,50028,500280707,Guaymallén,MENDOZA,276,303,534,447,981
50,50028,500280613,Guaymallén,MENDOZA,305,279,544,511,1055
50,50028,500280704,Guaymallén,MENDOZA,306,353,581,575,1156
50,50028,500280607,Guaymallén,MENDOZA,339,296,669,657,1326
50,50028,500280603,Guaymallén,MENDOZA,203,189,338,353,691
50,50028,500280517,Guaymallén,MENDOZA,555,557,1133,1090,2223
50,50028,500280411,Guaymallén,MENDOZA,321,255,739,687,1426
50,50028,500280208,Guaymallén,MENDOZA,205,255,348,295,643
50,50028,500280203,Guaymallén,MENDOZA,256,248,464,389,853
50,50028,500280107,Guaymallén,MENDOZA,242,297,366,300,666
50,50028,500281809,Guaymallén,MENDOZA,303,311,585,543,1128
50,50028,500281808,Guaymallén,MENDOZA,247,273,496,509,1005
50,50028,500281807,Guaymallén,MENDOZA,409,370,792,778,1570
50,50028,500281705,Guaymallén,MENDOZA,238,244,395,367,762
50,50028,500281702,Guaymallén,MENDOZA,284,296,513,461,974
50,50028,500281603,Guaymallén,MENDOZA,229,243,382,340,722
50,50028,500281408,Guaymallén,MENDOZA,304,324,485,465,950
50,50028,500281402,Guaymallén,MENDOZA,212,245,329,269,598
50,50028,500281307,Guaymallén,MENDOZA,180,195,301,287,588
50,50028,500281301,Guaymallén,MENDOZA,318,352,498,464,962
50,50028,500281218,Guaymallén,MENDOZA,268,284,461,380,841
50,50028,500281215,Guaymallén,MENDOZA,229,233,409,366,775
50,50028,500281207,Guaymallén,MENDOZA,232,240,401,362,763
50,50028,500280706,Guaymallén,MENDOZA,310,322,605,561,1166
50,50028,500281803,Guaymallén,MENDOZA,410,370,871,848,1719
50,50028,500281606,Guaymallén,MENDOZA,187,225,340,278,618
50,50028,500280514,Guaymallén,MENDOZA,319,317,615,638,1253
50,50028,500281714,Guaymallén,MENDOZA,226,240,432,422,854
50,50028,500281203,Guaymallén,MENDOZA,300,279,591,519,1110
50,50028,500281113,Guaymallén,MENDOZA,194,210,341,330,671
50,50028,500281108,Guaymallén,MENDOZA,340,284,664,596,1260
50,50028,500281007,Guaymallén,MENDOZA,374,407,660,624,1284
50,50028,500280906,Guaymallén,MENDOZA,363,373,668,565,1233
50,50028,500280901,Guaymallén,MENDOZA,315,340,529,528,1057
50,50028,500280818,Guaymallén,MENDOZA,147,157,265,233,498
50,50028,500280712,Guaymallén,MENDOZA,318,355,563,542,1105
50,50028,500280710,Guaymallén,MENDOZA,213,223,369,329,698
50,50028,500280504,Guaymallén,MENDOZA,248,258,481,503,984
50,50028,500280317,Guaymallén,MENDOZA,301,326,525,495,1020
50,50028,500280212,Guaymallén,MENDOZA,322,375,462,424,886
50,50028,500280105,Guaymallén,MENDOZA,241,299,405,350,755
50,50028,500282011,Guaymallén,MENDOZA,242,262,414,380,794
50,50028,500281905,Guaymallén,MENDOZA,529,500,1079,1069,2148
50,50028,500281902,Guaymallén,MENDOZA,243,244,460,416,876
50,50028,500281812,Guaymallén,MENDOZA,225,241,464,425,889
50,50028,500281710,Guaymallén,MENDOZA,291,267,537,516,1053
50,50028,500281611,Guaymallén,MENDOZA,357,395,577,513,1090
50,50028,500281604,Guaymallén,MENDOZA,296,349,487,424,911
50,50028,500281505,Guaymallén,MENDOZA,427,384,933,863,1796
50,50028,500281414,Guaymallén,MENDOZA,223,291,322,326,648
50,50028,500281411,Guaymallén,MENDOZA,232,251,333,289,622
50,50028,500281302,Guaymallén,MENDOZA,317,346,542,465,1007
50,50028,500281213,Guaymallén,MENDOZA,226,228,401,413,814
50,50028,500282003,Guaymallén,MENDOZA,199,213,346,297,643
50,50028,500281804,Guaymallén,MENDOZA,307,329,624,600,1224
50,50028,500280410,Guaymallén,MENDOZA,249,223,557,578,1135
50,50028,500281713,Guaymallén,MENDOZA,254,281,450,499,949
50,50028,500280513,Guaymallén,MENDOZA,322,351,650,614,1264
50,50028,500280503,Guaymallén,MENDOZA,341,359,686,725,1411
50,50028,500281205,Guaymallén,MENDOZA,270,256,486,390,876
50,50028,500281109,Guaymallén,MENDOZA,314,305,615,549,1164
50,50028,500280908,Guaymallén,MENDOZA,365,397,596,493,1089
50,50028,500280817,Guaymallén,MENDOZA,230,255,379,375,754
50,50028,500280813,Guaymallén,MENDOZA,321,324,595,543,1138
50,50028,500280708,Guaymallén,MENDOZA,264,275,473,426,899
50,50028,500280702,Guaymallén,MENDOZA,223,250,372,381,753
50,50028,500280701,Guaymallén,MENDOZA,214,233,391,381,772
50,50028,500280612,Guaymallén,MENDOZA,102,88,199,190,389
50,50028,500280610,Guaymallén,MENDOZA,321,277,677,665,1342
50,50028,500280605,Guaymallén,MENDOZA,274,378,578,603,1181
50,50028,500280506,Guaymallén,MENDOZA,266,273,524,507,1031
50,50028,500280406,Guaymallén,MENDOZA,276,294,496,490,986
50,50028,500280311,Guaymallén,MENDOZA,334,341,582,515,1097
50,50028,500280307,Guaymallén,MENDOZA,333,303,639,606,1245
50,50028,500280202,Guaymallén,MENDOZA,247,264,384,379,763
50,50028,500280201,Guaymallén,MENDOZA,271,280,424,348,772
50,50028,500280109,Guaymallén,MENDOZA,225,266,372,287,659
50,50028,500281910,Guaymallén,MENDOZA,333,334,648,596,1244
50,50028,500281908,Guaymallén,MENDOZA,326,334,624,570,1194
50,50028,500281508,Guaymallén,MENDOZA,254,301,464,510,974
50,50028,500281504,Guaymallén,MENDOZA,278,293,560,566,1126
50,50028,500281501,Guaymallén,MENDOZA,338,326,678,684,1362
50,50028,500281412,Guaymallén,MENDOZA,329,349,539,457,996
50,50028,500281405,Guaymallén,MENDOZA,313,363,509,411,920
50,50028,500281306,Guaymallén,MENDOZA,204,217,367,316,683
50,50028,500281303,Guaymallén,MENDOZA,363,378,625,552,1177
50,50028,500281503,Guaymallén,MENDOZA,139,141,257,249,506
50,50028,500280604,Guaymallén,MENDOZA,385,377,725,672,1397
50,50028,500281716,Guaymallén,MENDOZA,325,357,664,675,1339
50,50028,500281202,Guaymallén,MENDOZA,287,273,536,452,988
50,50028,500281116,Guaymallén,MENDOZA,214,215,382,389,771
50,50028,500281114,Guaymallén,MENDOZA,229,210,468,461,929
50,50028,500281006,Guaymallén,MENDOZA,321,338,586,521,1107
50,50028,500281002,Guaymallén,MENDOZA,225,226,417,411,828
50,50028,500280814,Guaymallén,MENDOZA,166,184,310,287,597
50,50028,500280811,Guaymallén,MENDOZA,350,351,628,573,1201
50,50028,500280810,Guaymallén,MENDOZA,239,264,427,408,835
50,50028,500280801,Guaymallén,MENDOZA,282,332,727,591,1318
50,50028,500280614,Guaymallén,MENDOZA,350,316,616,571,1187
50,50028,500280608,Guaymallén,MENDOZA,271,254,542,484,1026
50,50028,500280601,Guaymallén,MENDOZA,245,218,487,471,958
50,50028,500280512,Guaymallén,MENDOZA,185,193,322,303,625
50,50028,500280407,Guaymallén,MENDOZA,271,275,533,487,1020
50,50028,500280401,Guaymallén,MENDOZA,213,234,351,380,731
50,50028,500280316,Guaymallén,MENDOZA,254,219,569,576,1145
50,50028,500280312,Guaymallén,MENDOZA,366,348,654,582,1236
50,50028,500280302,Guaymallén,MENDOZA,352,326,703,636,1339
50,50028,500280301,Guaymallén,MENDOZA,351,365,677,699,1376
50,50028,500280213,Guaymallén,MENDOZA,184,199,285,274,559
50,50028,500280205,Guaymallén,MENDOZA,312,308,520,447,967
50,50028,500280110,Guaymallén,MENDOZA,300,322,470,396,866
50,50028,500280106,Guaymallén,MENDOZA,345,402,546,456,1002
50,50028,500280101,Guaymallén,MENDOZA,133,138,237,240,477
50,50028,500282008,Guaymallén,MENDOZA,201,221,332,258,590
50,50028,500281711,Guaymallén,MENDOZA,135,132,259,252,511
50,50028,500281708,Guaymallén,MENDOZA,268,259,434,400,834
50,50028,500281605,Guaymallén,MENDOZA,380,397,617,627,1244
50,50028,500281410,Guaymallén,MENDOZA,260,266,402,340,742
50,50028,500281407,Guaymallén,MENDOZA,280,330,489,490,979
50,50028,500281308,Guaymallén,MENDOZA,293,327,536,455,991
50,50028,500281217,Guaymallén,MENDOZA,286,302,479,422,901
50,50028,500281210,Guaymallén,MENDOZA,354,332,689,670,1359
50,50028,500280520,Guaymallén,MENDOZA,186,221,331,381,712
50,50028,500280510,Guaymallén,MENDOZA,370,397,688,704,1392
50,50014,500140701,General Alvear,MENDOZA,422,360,811,782,1593
50,50014,500140601,General Alvear,MENDOZA,335,374,598,581,1179
50,50014,500140613,General Alvear,MENDOZA,281,315,441,373,814
50,50014,500140712,General Alvear,MENDOZA,276,362,373,285,658
50,50014,500140504,General Alvear,MENDOZA,259,314,415,443,858
50,50014,500140412,General Alvear,MENDOZA,151,193,228,247,475
50,50014,500140305,General Alvear,MENDOZA,66,143,81,125,206
50,50014,500140405,General Alvear,MENDOZA,329,418,496,594,1090
50,50014,500140403,General Alvear,MENDOZA,8,11,8,12,20
50,50014,500140615,General Alvear,MENDOZA,458,508,789,753,1542
50,50014,500140505,General Alvear,MENDOZA,225,262,357,368,725
50,50014,500140611,General Alvear,MENDOZA,373,387,615,534,1149
50,50014,500140609,General Alvear,MENDOZA,312,340,521,480,1001
50,50014,500140602,General Alvear,MENDOZA,241,255,427,398,825
50,50014,500140409,General Alvear,MENDOZA,338,383,555,503,1058
50,50014,500140411,General Alvear,MENDOZA,188,217,292,342,634
50,50014,500140201,General Alvear,MENDOZA,59,93,43,87,130
50,50014,500140715,General Alvear,MENDOZA,301,335,518,501,1019
50,50014,500140502,General Alvear,MENDOZA,236,250,440,424,864
50,50014,500140716,General Alvear,MENDOZA,364,392,653,555,1208
50,50014,500140714,General Alvear,MENDOZA,268,285,431,408,839
50,50014,500140616,General Alvear,MENDOZA,351,402,577,531,1108
50,50014,500140608,General Alvear,MENDOZA,199,239,282,237,519
50,50014,500140304,General Alvear,MENDOZA,278,340,494,447,941
50,50014,500140408,General Alvear,MENDOZA,379,417,571,536,1107
50,50014,500140709,General Alvear,MENDOZA,327,312,490,456,946
50,50014,500140707,General Alvear,MENDOZA,300,331,482,421,903
50,50014,500140606,General Alvear,MENDOZA,251,269,401,328,729
50,50014,500140713,General Alvear,MENDOZA,230,275,338,313,651
50,50014,500140410,General Alvear,MENDOZA,320,350,512,473,985
50,50014,500140303,General Alvear,MENDOZA,82,116,110,140,250
50,50014,500140302,General Alvear,MENDOZA,95,146,155,187,342
50,50014,500140708,General Alvear,MENDOZA,325,320,599,512,1111
50,50014,500140702,General Alvear,MENDOZA,330,340,613,597,1210
50,50014,500140406,General Alvear,MENDOZA,339,364,540,540,1080
50,50014,500140407,General Alvear,MENDOZA,10,10,16,21,37
50,50014,500140404,General Alvear,MENDOZA,281,348,483,453,936
50,50014,500140710,General Alvear,MENDOZA,375,396,562,421,983
50,50014,500140604,General Alvear,MENDOZA,303,384,452,340,792
50,50014,500140501,General Alvear,MENDOZA,335,420,552,558,1110
50,50014,500140301,General Alvear,MENDOZA,35,54,54,68,122
50,50014,500140401,General Alvear,MENDOZA,188,264,293,344,637
50,50014,500140614,General Alvear,MENDOZA,181,178,315,281,596
50,50014,500140607,General Alvear,MENDOZA,245,269,390,362,752
50,50014,500140603,General Alvear,MENDOZA,244,270,359,307,666
50,50014,500140703,General Alvear,MENDOZA,472,523,806,792,1598
50,50014,500140503,General Alvear,MENDOZA,206,228,306,323,629
50,50014,500140506,General Alvear,MENDOZA,180,202,312,348,660
50,50014,500140711,General Alvear,MENDOZA,266,341,427,349,776
50,50014,500140706,General Alvear,MENDOZA,248,272,396,348,744
50,50014,500140705,General Alvear,MENDOZA,379,398,654,583,1237
50,50014,500140704,General Alvear,MENDOZA,156,167,260,245,505
50,50014,500140617,General Alvear,MENDOZA,253,281,381,399,780
50,50014,500140612,General Alvear,MENDOZA,343,377,576,522,1098
50,50014,500140610,General Alvear,MENDOZA,271,326,381,329,710
50,50014,500140605,General Alvear,MENDOZA,248,324,347,277,624
50,50014,500140402,General Alvear,MENDOZA,115,164,177,187,364
50,50014,500140101,General Alvear,MENDOZA,118,181,124,180,304
50,50126,501260315,Tupungato,MENDOZA,187,194,396,387,783
50,50126,501260312,Tupungato,MENDOZA,382,384,723,722,1445
50,50126,501260310,Tupungato,MENDOZA,249,252,473,495,968
50,50126,501260304,Tupungato,MENDOZA,400,437,707,654,1361
50,50126,501260501,Tupungato,MENDOZA,758,736,1433,1537,2970
50,50126,501260318,Tupungato,MENDOZA,77,92,136,154,290
50,50126,501260101,Tupungato,MENDOZA,107,173,200,211,411
50,50126,501260319,Tupungato,MENDOZA,306,296,553,563,1116
50,50126,501260502,Tupungato,MENDOZA,306,325,597,657,1254
50,50126,501260205,Tupungato,MENDOZA,4,8,1,5,6
50,50126,501260102,Tupungato,MENDOZA,8,18,5,17,22
50,50126,501260314,Tupungato,MENDOZA,369,405,731,702,1433
50,50126,501260307,Tupungato,MENDOZA,285,324,497,438,935
50,50126,501260202,Tupungato,MENDOZA,100,117,191,231,422
50,50126,501260313,Tupungato,MENDOZA,234,282,409,451,860
50,50126,501260309,Tupungato,MENDOZA,356,385,682,737,1419
50,50126,501260303,Tupungato,MENDOZA,551,541,1038,1058,2096
50,50126,501260306,Tupungato,MENDOZA,375,363,632,600,1232
50,50126,501260503,Tupungato,MENDOZA,281,320,545,605,1150
50,50126,501260401,Tupungato,MENDOZA,276,137,530,601,1131
50,50126,501260504,Tupungato,MENDOZA,338,375,702,759,1461
50,50126,501260311,Tupungato,MENDOZA,349,328,652,605,1257
50,50126,501260305,Tupungato,MENDOZA,374,407,604,559,1163
50,50126,501260317,Tupungato,MENDOZA,278,303,566,583,1149
50,50126,501260301,Tupungato,MENDOZA,800,841,1543,1670,3213
50,50126,501260302,Tupungato,MENDOZA,182,180,381,369,750
50,50126,501260308,Tupungato,MENDOZA,161,190,268,305,573
50,50126,501260402,Tupungato,MENDOZA,12,28,22,24,46
50,50126,501260204,Tupungato,MENDOZA,105,113,184,208,392
50,50126,501260316,Tupungato,MENDOZA,225,234,417,407,824
50,50126,501260203,Tupungato,MENDOZA,84,107,158,196,354
50,50126,501260201,Tupungato,MENDOZA,11,15,15,23,38
50,50119,501190204,Tunuyán,MENDOZA,424,477,732,848,1580
50,50119,501190201,Tunuyán,MENDOZA,86,320,125,179,304
50,50119,501190608,Tunuyán,MENDOZA,290,364,453,379,832
50,50119,501190604,Tunuyán,MENDOZA,367,389,596,571,1167
50,50119,501190402,Tunuyán,MENDOZA,165,193,292,336,628
50,50119,501190613,Tunuyán,MENDOZA,579,594,1138,1053,2191
50,50119,501190406,Tunuyán,MENDOZA,278,306,531,528,1059
50,50119,501190405,Tunuyán,MENDOZA,146,161,308,319,627
50,50119,501190404,Tunuyán,MENDOZA,123,141,223,308,531
50,50119,501190310,Tunuyán,MENDOZA,334,340,686,640,1326
50,50119,501190101,Tunuyán,MENDOZA,2,5,6,3,9
50,50119,501190401,Tunuyán,MENDOZA,418,423,849,769,1618
50,50119,501190311,Tunuyán,MENDOZA,269,304,526,514,1040
50,50119,501190303,Tunuyán,MENDOZA,428,460,721,714,1435
50,50119,501190205,Tunuyán,MENDOZA,363,458,630,739,1369
50,50119,501190203,Tunuyán,MENDOZA,52,96,99,113,212
50,50119,501190202,Tunuyán,MENDOZA,137,191,272,267,539
50,50119,501190602,Tunuyán,MENDOZA,102,103,211,178,389
50,50119,501190409,Tunuyán,MENDOZA,453,491,802,848,1650
50,50119,501190403,Tunuyán,MENDOZA,442,486,857,831,1688
50,50119,501190611,Tunuyán,MENDOZA,212,216,380,345,725
50,50119,501190609,Tunuyán,MENDOZA,197,225,308,257,565
50,50119,501190312,Tunuyán,MENDOZA,198,210,309,333,642
50,50119,501190501,Tunuyán,MENDOZA,80,145,161,231,392
50,50119,501190206,Tunuyán,MENDOZA,265,282,490,582,1072
50,50119,501190610,Tunuyán,MENDOZA,264,299,451,359,810
50,50119,501190408,Tunuyán,MENDOZA,458,495,851,850,1701
50,50119,501190308,Tunuyán,MENDOZA,574,563,1141,1083,2224
50,50119,501190305,Tunuyán,MENDOZA,420,429,711,655,1366
50,50119,501190304,Tunuyán,MENDOZA,430,467,722,673,1395
50,50119,501190612,Tunuyán,MENDOZA,375,411,708,681,1389
50,50119,501190605,Tunuyán,MENDOZA,257,279,450,337,787
50,50119,501190603,Tunuyán,MENDOZA,385,394,740,659,1399
50,50119,501190607,Tunuyán,MENDOZA,436,389,789,669,1458
50,50119,501190601,Tunuyán,MENDOZA,260,295,490,489,979
50,50119,501190407,Tunuyán,MENDOZA,508,530,955,947,1902
50,50119,501190309,Tunuyán,MENDOZA,509,472,1012,992,2004
50,50119,501190302,Tunuyán,MENDOZA,376,390,670,641,1311
50,50119,501190301,Tunuyán,MENDOZA,450,446,851,804,1655
50,50119,501190614,Tunuyán,MENDOZA,393,382,783,857,1640
50,50119,501190606,Tunuyán,MENDOZA,238,219,532,505,1037
50,50119,501190307,Tunuyán,MENDOZA,353,363,646,587,1233
50,50119,501190306,Tunuyán,MENDOZA,442,436,827,751,1578
50,50105,501051604,San Rafael,MENDOZA,276,291,548,487,1035
50,50105,501051002,San Rafael,MENDOZA,285,355,555,566,1121
50,50105,501051915,San Rafael,MENDOZA,157,152,277,326,603
50,50105,501051911,San Rafael,MENDOZA,145,145,237,219,456
50,50105,501051910,San Rafael,MENDOZA,350,357,727,697,1424
50,50105,501051907,San Rafael,MENDOZA,379,424,651,614,1265
50,50105,501051810,San Rafael,MENDOZA,328,342,515,474,989
50,50105,501051806,San Rafael,MENDOZA,297,325,440,366,806
50,50105,501051801,San Rafael,MENDOZA,348,405,629,562,1191
50,50105,501051713,San Rafael,MENDOZA,250,278,347,281,628
50,50105,501051705,San Rafael,MENDOZA,226,222,413,357,770
50,50105,501051701,San Rafael,MENDOZA,303,301,669,572,1241
50,50105,501051818,San Rafael,MENDOZA,321,307,650,589,1239
50,50105,501051512,San Rafael,MENDOZA,181,194,350,293,643
50,50105,501051505,San Rafael,MENDOZA,300,333,554,478,1032
50,50105,501051409,San Rafael,MENDOZA,182,198,273,241,514
50,50105,501051206,San Rafael,MENDOZA,141,168,256,243,499
50,50105,501050706,San Rafael,MENDOZA,298,329,540,503,1043
50,50105,501050519,San Rafael,MENDOZA,189,193,350,288,638
50,50105,501050514,San Rafael,MENDOZA,301,288,497,445,942
50,50105,501050415,San Rafael,MENDOZA,190,236,293,225,518
50,50105,501050411,San Rafael,MENDOZA,353,369,608,493,1101
50,50105,501050409,San Rafael,MENDOZA,229,236,383,349,732
50,50105,501050503,San Rafael,MENDOZA,186,250,339,276,615
50,50105,501050502,San Rafael,MENDOZA,117,171,159,99,258
50,50105,501051311,San Rafael,MENDOZA,119,194,221,144,365
50,50105,501050512,San Rafael,MENDOZA,192,226,265,202,467
50,50105,501050509,San Rafael,MENDOZA,283,269,464,403,867
50,50105,501050420,San Rafael,MENDOZA,197,211,341,286,627
50,50105,501050105,San Rafael,MENDOZA,255,311,451,443,894
50,50105,501051601,San Rafael,MENDOZA,388,419,662,685,1347
50,50105,501051005,San Rafael,MENDOZA,47,68,70,126,196
50,50105,501051208,San Rafael,MENDOZA,252,297,447,484,931
50,50105,501051008,San Rafael,MENDOZA,386,376,718,723,1441
50,50105,501050602,San Rafael,MENDOZA,298,354,507,486,993
50,50105,501050202,San Rafael,MENDOZA,399,474,742,729,1471
50,50105,501050607,San Rafael,MENDOZA,297,351,507,450,957
50,50105,501051906,San Rafael,MENDOZA,432,449,824,864,1688
50,50105,501051904,San Rafael,MENDOZA,241,249,427,412,839
50,50105,501051714,San Rafael,MENDOZA,175,189,231,232,463
50,50105,501051712,San Rafael,MENDOZA,357,397,562,449,1011
50,50105,501051702,San Rafael,MENDOZA,260,262,491,451,942
50,50105,501051504,San Rafael,MENDOZA,204,222,314,309,623
50,50105,501051412,San Rafael,MENDOZA,262,310,403,303,706
50,50105,501051401,San Rafael,MENDOZA,312,350,492,442,934
50,50105,501051817,San Rafael,MENDOZA,184,220,297,296,593
50,50105,501050518,San Rafael,MENDOZA,157,206,237,191,428
50,50105,501050513,San Rafael,MENDOZA,326,362,483,344,827
50,50105,501050421,San Rafael,MENDOZA,522,571,967,939,1906
50,50105,501050405,San Rafael,MENDOZA,363,383,656,636,1292
50,50105,501050404,San Rafael,MENDOZA,162,170,327,317,644
50,50105,501050309,San Rafael,MENDOZA,298,271,540,524,1064
50,50105,501050501,San Rafael,MENDOZA,193,279,281,228,509
50,50105,501050204,San Rafael,MENDOZA,408,439,797,794,1591
50,50105,501050508,San Rafael,MENDOZA,198,223,314,270,584
50,50105,501050506,San Rafael,MENDOZA,285,310,424,381,805
50,50105,501051309,San Rafael,MENDOZA,277,409,385,297,682
50,50105,501051912,San Rafael,MENDOZA,302,302,577,560,1137
50,50105,501051608,San Rafael,MENDOZA,66,82,116,116,232
50,50105,501050907,San Rafael,MENDOZA,275,296,457,396,853
50,50105,501050515,San Rafael,MENDOZA,270,275,434,405,839
50,50105,501051012,San Rafael,MENDOZA,255,455,503,409,912
50,50105,501050806,San Rafael,MENDOZA,83,161,80,135,215
50,50105,501050804,San Rafael,MENDOZA,21,29,29,39,68
50,50105,501050603,San Rafael,MENDOZA,50,87,80,86,166
50,50105,501050601,San Rafael,MENDOZA,45,92,45,79,124
50,50105,501050301,San Rafael,MENDOZA,22,21,7,28,35
50,50105,501050103,San Rafael,MENDOZA,282,362,456,525,981
50,50105,501050903,San Rafael,MENDOZA,229,333,420,482,902
50,50105,501050802,San Rafael,MENDOZA,155,218,245,259,504
50,50105,501050801,San Rafael,MENDOZA,243,287,385,439,824
50,50105,501051914,San Rafael,MENDOZA,306,286,635,628,1263
50,50105,501051908,San Rafael,MENDOZA,364,381,656,607,1263
50,50105,501051816,San Rafael,MENDOZA,246,248,409,328,737
50,50105,501051814,San Rafael,MENDOZA,168,180,352,286,638
50,50105,501051808,San Rafael,MENDOZA,200,234,343,332,675
50,50105,501051805,San Rafael,MENDOZA,333,370,508,434,942
50,50105,501051707,San Rafael,MENDOZA,148,170,253,225,478
50,50105,501051518,San Rafael,MENDOZA,382,395,701,670,1371
50,50105,501051515,San Rafael,MENDOZA,171,179,278,247,525
50,50105,501051406,San Rafael,MENDOZA,168,195,239,209,448
50,50105,501051301,San Rafael,MENDOZA,182,213,253,251,504
50,50105,501050705,San Rafael,MENDOZA,310,359,554,524,1078
50,50105,501050520,San Rafael,MENDOZA,201,214,315,290,605
50,50105,501050416,San Rafael,MENDOZA,251,271,413,321,734
50,50105,501050413,San Rafael,MENDOZA,301,333,466,398,864
50,50105,501050408,San Rafael,MENDOZA,342,347,593,540,1133
50,50105,501050407,San Rafael,MENDOZA,425,381,741,747,1488
50,50105,501050403,San Rafael,MENDOZA,241,249,414,361,775
50,50105,501050111,San Rafael,MENDOZA,294,330,485,477,962
50,50105,501050906,San Rafael,MENDOZA,318,405,492,482,974
50,50105,501050605,San Rafael,MENDOZA,194,237,307,273,580
50,50105,501050308,San Rafael,MENDOZA,199,192,396,427,823
50,50105,501051207,San Rafael,MENDOZA,90,120,159,188,347
50,50105,501051102,San Rafael,MENDOZA,273,300,460,458,918
50,50105,501051004,San Rafael,MENDOZA,105,147,154,192,346
50,50105,501050902,San Rafael,MENDOZA,14,31,20,28,48
50,50105,501051607,San Rafael,MENDOZA,185,207,340,369,709
50,50105,501051605,San Rafael,MENDOZA,466,522,1011,1150,2161
50,50105,501051603,San Rafael,MENDOZA,395,442,743,768,1511
50,50105,501050901,San Rafael,MENDOZA,142,189,270,292,562
50,50105,501051011,San Rafael,MENDOZA,220,250,354,376,730
50,50105,501051903,San Rafael,MENDOZA,179,190,331,291,622
50,50105,501051902,San Rafael,MENDOZA,405,490,702,629,1331
50,50105,501051809,San Rafael,MENDOZA,236,252,405,378,783
50,50105,501051410,San Rafael,MENDOZA,212,228,315,246,561
50,50105,501051408,San Rafael,MENDOZA,194,229,307,256,563
50,50105,501051407,San Rafael,MENDOZA,164,214,277,245,522
50,50105,501051403,San Rafael,MENDOZA,202,226,289,233,522
50,50105,501051304,San Rafael,MENDOZA,182,219,278,236,514
50,50105,501050708,San Rafael,MENDOZA,236,255,393,362,755
50,50105,501050417,San Rafael,MENDOZA,302,335,515,416,931
50,50105,501050305,San Rafael,MENDOZA,231,207,420,402,822
50,50105,501050304,San Rafael,MENDOZA,562,548,1023,1033,2056
50,50105,501050108,San Rafael,MENDOZA,358,391,624,551,1175
50,50105,501050510,San Rafael,MENDOZA,292,346,453,337,790
50,50105,501051310,San Rafael,MENDOZA,282,361,428,306,734
50,50105,501050505,San Rafael,MENDOZA,183,214,269,238,507
50,50105,501050808,San Rafael,MENDOZA,116,131,222,197,419
50,50105,501051204,San Rafael,MENDOZA,84,118,122,143,265
50,50105,501051201,San Rafael,MENDOZA,116,149,195,199,394
50,50105,501051009,San Rafael,MENDOZA,226,275,457,452,909
50,50105,501050701,San Rafael,MENDOZA,8,16,5,16,21
50,50105,501050113,San Rafael,MENDOZA,272,277,467,495,962
50,50105,501051606,San Rafael,MENDOZA,29,32,80,96,176
50,50105,501050106,San Rafael,MENDOZA,351,388,648,565,1213
50,50105,501051602,San Rafael,MENDOZA,447,491,752,730,1482
50,50105,501051101,San Rafael,MENDOZA,358,365,627,598,1225
50,50105,501051110,San Rafael,MENDOZA,244,309,412,441,853
50,50105,501051001,San Rafael,MENDOZA,19,146,14,32,46
50,50105,501050807,San Rafael,MENDOZA,177,234,267,360,627
50,50105,501050307,San Rafael,MENDOZA,288,294,507,475,982
50,50105,501050104,San Rafael,MENDOZA,294,315,524,516,1040
50,50105,501051106,San Rafael,MENDOZA,469,532,840,869,1709
50,50105,501051901,San Rafael,MENDOZA,191,214,306,297,603
50,50105,501051815,San Rafael,MENDOZA,300,326,460,393,853
50,50105,501051811,San Rafael,MENDOZA,243,269,403,342,745
50,50105,501051802,San Rafael,MENDOZA,129,131,222,182,404
50,50105,501051711,San Rafael,MENDOZA,286,311,431,355,786
50,50105,501051709,San Rafael,MENDOZA,264,255,450,340,790
50,50105,501051706,San Rafael,MENDOZA,217,211,444,425,869
50,50105,501051704,San Rafael,MENDOZA,263,268,435,395,830
50,50105,501051703,San Rafael,MENDOZA,265,272,444,444,888
50,50105,501051519,San Rafael,MENDOZA,274,290,516,555,1071
50,50105,501051514,San Rafael,MENDOZA,245,246,430,396,826
50,50105,501051501,San Rafael,MENDOZA,378,436,631,532,1163
50,50105,501051312,San Rafael,MENDOZA,211,309,342,240,582
50,50105,501051303,San Rafael,MENDOZA,244,280,358,302,660
50,50105,501050606,San Rafael,MENDOZA,287,334,522,516,1038
50,50105,501051302,San Rafael,MENDOZA,216,228,319,278,597
50,50105,501051203,San Rafael,MENDOZA,106,136,173,171,344
50,50105,501051010,San Rafael,MENDOZA,44,655,69,77,146
50,50105,501051909,San Rafael,MENDOZA,300,315,576,526,1102
50,50105,501051812,San Rafael,MENDOZA,215,220,389,298,687
50,50105,501051804,San Rafael,MENDOZA,411,429,689,563,1252
50,50105,501051803,San Rafael,MENDOZA,232,235,379,352,731
50,50105,501051708,San Rafael,MENDOZA,244,263,402,341,743
50,50105,501051107,San Rafael,MENDOZA,403,482,781,811,1592
50,50105,501051105,San Rafael,MENDOZA,572,631,1035,1077,2112
50,50105,501051109,San Rafael,MENDOZA,135,167,206,233,439
50,50105,501050703,San Rafael,MENDOZA,242,306,443,441,884
50,50105,501050203,San Rafael,MENDOZA,268,326,446,509,955
50,50105,501050110,San Rafael,MENDOZA,223,271,373,402,775
50,50105,501050109,San Rafael,MENDOZA,96,108,182,155,337
50,50105,501051007,San Rafael,MENDOZA,317,389,556,538,1094
50,50105,501050904,San Rafael,MENDOZA,323,345,605,582,1187
50,50105,501050306,San Rafael,MENDOZA,435,500,773,757,1530
50,50105,501051205,San Rafael,MENDOZA,309,343,517,516,1033
50,50105,501051913,San Rafael,MENDOZA,254,256,427,472,899
50,50105,501051813,San Rafael,MENDOZA,219,243,331,270,601
50,50105,501051517,San Rafael,MENDOZA,369,385,621,611,1232
50,50105,501051516,San Rafael,MENDOZA,175,188,342,655,997
50,50105,501051510,San Rafael,MENDOZA,245,265,449,381,830
50,50105,501051506,San Rafael,MENDOZA,249,256,405,385,790
50,50105,501051411,San Rafael,MENDOZA,242,270,347,323,670
50,50105,501051404,San Rafael,MENDOZA,209,283,295,244,539
50,50105,501051402,San Rafael,MENDOZA,131,151,170,163,333
50,50105,501051413,San Rafael,MENDOZA,326,361,467,425,892
50,50105,501050521,San Rafael,MENDOZA,187,195,300,242,542
50,50105,501050419,San Rafael,MENDOZA,411,393,792,748,1540
50,50105,501050410,San Rafael,MENDOZA,217,229,423,402,825
50,50105,501050402,San Rafael,MENDOZA,314,339,568,504,1072
50,50105,501050401,San Rafael,MENDOZA,306,324,564,442,1006
50,50105,501050507,San Rafael,MENDOZA,232,235,391,355,746
50,50105,501051308,San Rafael,MENDOZA,152,198,196,176,372
50,50105,501051006,San Rafael,MENDOZA,317,377,598,568,1166
50,50105,501050517,San Rafael,MENDOZA,213,278,301,249,550
50,50105,501051108,San Rafael,MENDOZA,183,222,329,325,654
50,50105,501051003,San Rafael,MENDOZA,50,85,66,90,156
50,50105,501050805,San Rafael,MENDOZA,8,16,5,12,17
50,50105,501050803,San Rafael,MENDOZA,126,183,221,224,445
50,50105,501050303,San Rafael,MENDOZA,237,249,426,434,860
50,50105,501050302,San Rafael,MENDOZA,222,287,375,380,755
50,50105,501051513,San Rafael,MENDOZA,342,362,624,528,1152
50,50105,501051511,San Rafael,MENDOZA,298,309,493,468,961
50,50105,501051509,San Rafael,MENDOZA,224,254,384,319,703
50,50105,501051502,San Rafael,MENDOZA,184,201,327,299,626
50,50105,501051405,San Rafael,MENDOZA,307,399,434,382,816
50,50105,501050707,San Rafael,MENDOZA,228,244,403,356,759
50,50105,501050608,San Rafael,MENDOZA,98,115,141,115,256
50,50105,501050418,San Rafael,MENDOZA,354,376,649,536,1185
50,50105,501050504,San Rafael,MENDOZA,264,372,506,369,875
50,50105,501051905,San Rafael,MENDOZA,271,254,547,507,1054
50,50105,501051807,San Rafael,MENDOZA,168,188,274,230,504
50,50105,501050516,San Rafael,MENDOZA,308,314,485,412,897
50,50105,501051202,San Rafael,MENDOZA,125,160,207,232,439
50,50105,501050704,San Rafael,MENDOZA,269,310,485,495,980
50,50105,501050107,San Rafael,MENDOZA,332,413,570,561,1131
50,50105,501051609,San Rafael,MENDOZA,211,270,409,436,845
50,50105,501050102,San Rafael,MENDOZA,343,391,669,637,1306
50,50105,501051307,San Rafael,MENDOZA,248,285,391,319,710
50,50105,501051306,San Rafael,MENDOZA,191,227,263,218,481
50,50105,501051710,San Rafael,MENDOZA,237,269,376,325,701
50,50105,501051508,San Rafael,MENDOZA,313,331,535,501,1036
50,50105,501051507,San Rafael,MENDOZA,213,231,384,355,739
50,50105,501051503,San Rafael,MENDOZA,222,247,371,352,723
50,50105,501051103,San Rafael,MENDOZA,263,279,427,412,839
50,50105,501050414,San Rafael,MENDOZA,286,309,488,424,912
50,50105,501050412,San Rafael,MENDOZA,250,288,368,330,698
50,50105,501050406,San Rafael,MENDOZA,293,313,522,470,992
50,50105,501050310,San Rafael,MENDOZA,239,248,410,408,818
50,50105,501050422,San Rafael,MENDOZA,102,112,160,131,291
50,50105,501050511,San Rafael,MENDOZA,264,332,385,299,684
50,50105,501051305,San Rafael,MENDOZA,160,200,242,191,433
50,50105,501051209,San Rafael,MENDOZA,212,227,424,422,846
50,50105,501050905,San Rafael,MENDOZA,201,234,328,323,651
50,50105,501051104,San Rafael,MENDOZA,200,230,334,352,686
50,50105,501050702,San Rafael,MENDOZA,206,271,363,414,777
50,50105,501050604,San Rafael,MENDOZA,2,16,2,2,4
50,50105,501050205,San Rafael,MENDOZA,406,484,698,711,1409
50,50105,501050201,San Rafael,MENDOZA,4,18,4,5,9
50,50105,501050112,San Rafael,MENDOZA,351,396,745,713,1458
50,50105,501050101,San Rafael,MENDOZA,9,16,1,9,10
50,50042,500420406,La Paz,MENDOZA,464,440,832,828,1660
50,50042,500420404,La Paz,MENDOZA,249,275,428,414,842
50,50042,500420301,La Paz,MENDOZA,48,60,40,72,112
50,50042,500420101,La Paz,MENDOZA,178,195,318,323,641
50,50042,500420411,La Paz,MENDOZA,219,214,414,421,835
50,50042,500420409,La Paz,MENDOZA,202,212,401,392,793
50,50042,500420408,La Paz,MENDOZA,288,305,556,489,1045
50,50042,500420412,La Paz,MENDOZA,126,96,265,244,509
50,50042,500420405,La Paz,MENDOZA,177,210,262,233,495
50,50042,500420410,La Paz,MENDOZA,210,229,357,345,702
50,50042,500420302,La Paz,MENDOZA,29,39,29,41,70
50,50042,500420102,La Paz,MENDOZA,78,117,103,138,241
50,50042,500420402,La Paz,MENDOZA,114,136,224,201,425
50,50042,500420407,La Paz,MENDOZA,247,277,418,415,833
50,50042,500420403,La Paz,MENDOZA,123,163,211,226,437
50,50042,500420401,La Paz,MENDOZA,68,76,108,107,215
50,50042,500420201,La Paz,MENDOZA,49,70,64,93,157
50,50021,500211507,Godoy Cruz,MENDOZA,298,367,433,328,761
50,50021,500211406,Godoy Cruz,MENDOZA,330,306,670,617,1287
50,50021,500211405,Godoy Cruz,MENDOZA,315,268,650,600,1250
50,50021,500211403,Godoy Cruz,MENDOZA,347,297,686,687,1373
50,50021,500210804,Godoy Cruz,MENDOZA,111,94,227,240,467
50,50021,500210706,Godoy Cruz,MENDOZA,330,359,504,487,991
50,50021,500210703,Godoy Cruz,MENDOZA,338,352,569,470,1039
50,50021,500210606,Godoy Cruz,MENDOZA,334,357,606,525,1131
50,50021,500210605,Godoy Cruz,MENDOZA,346,365,625,529,1154
50,50021,500210309,Godoy Cruz,MENDOZA,324,338,565,471,1036
50,50021,500210301,Godoy Cruz,MENDOZA,313,390,460,383,843
50,50021,500210202,Godoy Cruz,MENDOZA,240,217,454,391,845
50,50021,500210109,Godoy Cruz,MENDOZA,284,340,451,414,865
50,50021,500210104,Godoy Cruz,MENDOZA,314,328,517,429,946
50,50021,500210101,Godoy Cruz,MENDOZA,208,216,344,305,649
50,50021,500211310,Godoy Cruz,MENDOZA,264,259,436,385,821
50,50021,500211208,Godoy Cruz,MENDOZA,233,212,512,539,1051
50,50021,500211205,Godoy Cruz,MENDOZA,330,322,622,594,1216
50,50021,500211203,Godoy Cruz,MENDOZA,167,171,301,278,579
50,50021,500211111,Godoy Cruz,MENDOZA,180,233,287,266,553
50,50021,500211110,Godoy Cruz,MENDOZA,232,322,321,276,597
50,50021,500211006,Godoy Cruz,MENDOZA,357,369,589,565,1154
50,50021,500210915,Godoy Cruz,MENDOZA,332,404,364,265,629
50,50021,500210907,Godoy Cruz,MENDOZA,250,305,420,354,774
50,50021,500210905,Godoy Cruz,MENDOZA,315,359,494,417,911
50,50021,500210911,Godoy Cruz,MENDOZA,320,357,480,456,936
50,50021,500211603,Godoy Cruz,MENDOZA,234,217,470,425,895
50,50021,500211601,Godoy Cruz,MENDOZA,425,409,916,929,1845
50,50021,500211508,Godoy Cruz,MENDOZA,173,199,242,206,448
50,50021,500211504,Godoy Cruz,MENDOZA,188,224,290,228,518
50,50021,500211605,Godoy Cruz,MENDOZA,289,263,628,570,1198
50,50021,500210802,Godoy Cruz,MENDOZA,233,207,544,521,1065
50,50021,500210613,Godoy Cruz,MENDOZA,365,250,779,707,1486
50,50021,500210601,Godoy Cruz,MENDOZA,374,352,634,519,1153
50,50021,500210508,Godoy Cruz,MENDOZA,413,402,711,653,1364
50,50021,500210413,Godoy Cruz,MENDOZA,239,273,438,374,812
50,50021,500210410,Godoy Cruz,MENDOZA,211,250,314,235,549
50,50021,500210405,Godoy Cruz,MENDOZA,186,218,287,244,531
50,50021,500210305,Godoy Cruz,MENDOZA,179,227,247,234,481
50,50021,500210214,Godoy Cruz,MENDOZA,215,237,385,363,748
50,50021,500210306,Godoy Cruz,MENDOZA,252,320,323,287,610
50,50021,500210209,Godoy Cruz,MENDOZA,295,318,462,392,854
50,50021,500210203,Godoy Cruz,MENDOZA,217,202,451,459,910
50,50021,500210117,Godoy Cruz,MENDOZA,152,162,259,233,492
50,50021,500210116,Godoy Cruz,MENDOZA,306,291,641,630,1271
50,50021,500210107,Godoy Cruz,MENDOZA,656,647,1354,1433,2787
50,50021,500210106,Godoy Cruz,MENDOZA,281,197,576,564,1140
50,50021,500211305,Godoy Cruz,MENDOZA,331,358,527,469,996
50,50021,500211109,Godoy Cruz,MENDOZA,256,328,401,286,687
50,50021,500211108,Godoy Cruz,MENDOZA,203,259,224,203,427
50,50021,500211103,Godoy Cruz,MENDOZA,155,180,227,179,406
50,50021,500211004,Godoy Cruz,MENDOZA,308,342,477,399,876
50,50021,500211001,Godoy Cruz,MENDOZA,260,268,456,372,828
50,50021,500210806,Godoy Cruz,MENDOZA,327,309,708,691,1399
50,50021,500211105,Godoy Cruz,MENDOZA,147,192,197,171,368
50,50021,500210406,Godoy Cruz,MENDOZA,230,229,382,354,736
50,50021,500211408,Godoy Cruz,MENDOZA,242,231,509,475,984
50,50021,500211401,Godoy Cruz,MENDOZA,127,125,311,332,643
50,50021,500210801,Godoy Cruz,MENDOZA,273,253,623,603,1226
50,50021,500210709,Godoy Cruz,MENDOZA,283,241,507,484,991
50,50021,500210707,Godoy Cruz,MENDOZA,231,239,344,309,653
50,50021,500210610,Godoy Cruz,MENDOZA,221,222,350,321,671
50,50021,500210609,Godoy Cruz,MENDOZA,195,213,324,315,639
50,50021,500210608,Godoy Cruz,MENDOZA,400,421,723,655,1378
50,50021,500210607,Godoy Cruz,MENDOZA,318,334,585,458,1043
50,50021,500210603,Godoy Cruz,MENDOZA,275,277,467,479,946
50,50021,500210503,Godoy Cruz,MENDOZA,260,253,472,464,936
50,50021,500210909,Godoy Cruz,MENDOZA,267,285,484,398,882
50,50021,500210411,Godoy Cruz,MENDOZA,359,364,664,600,1264
50,50021,500210403,Godoy Cruz,MENDOZA,297,300,523,457,980
50,50021,500210316,Godoy Cruz,MENDOZA,182,220,240,232,472
50,50021,500210219,Godoy Cruz,MENDOZA,119,121,244,226,470
50,50021,500210218,Godoy Cruz,MENDOZA,66,70,128,128,256
50,50021,500210210,Godoy Cruz,MENDOZA,218,232,338,277,615
50,50021,500210207,Godoy Cruz,MENDOZA,318,324,565,542,1107
50,50021,500210114,Godoy Cruz,MENDOZA,242,247,404,368,772
50,50021,500210113,Godoy Cruz,MENDOZA,300,313,466,436,902
50,50021,500210110,Godoy Cruz,MENDOZA,244,255,395,318,713
50,50021,500210105,Godoy Cruz,MENDOZA,271,277,512,404,916
50,50021,500211309,Godoy Cruz,MENDOZA,314,311,561,500,1061
50,50021,500211211,Godoy Cruz,MENDOZA,279,310,457,398,855
50,50021,500211106,Godoy Cruz,MENDOZA,262,332,373,294,667
50,50021,500211007,Godoy Cruz,MENDOZA,393,393,621,507,1128
50,50021,500210903,Godoy Cruz,MENDOZA,223,377,288,241,529
50,50021,500210913,Godoy Cruz,MENDOZA,246,291,406,356,762
50,50021,500210813,Godoy Cruz,MENDOZA,143,154,217,294,511
50,50021,500211610,Godoy Cruz,MENDOZA,172,155,351,335,686
50,50021,500211607,Godoy Cruz,MENDOZA,348,310,676,675,1351
50,50021,500211502,Godoy Cruz,MENDOZA,301,398,382,341,723
50,50021,500211407,Godoy Cruz,MENDOZA,368,336,787,706,1493
50,50021,500211402,Godoy Cruz,MENDOZA,234,206,499,432,931
50,50021,500210910,Godoy Cruz,MENDOZA,290,314,481,409,890
50,50021,500210710,Godoy Cruz,MENDOZA,161,171,268,239,507
50,50021,500210705,Godoy Cruz,MENDOZA,279,285,424,381,805
50,50021,500210704,Godoy Cruz,MENDOZA,271,275,408,389,797
50,50021,500210701,Godoy Cruz,MENDOZA,268,310,400,357,757
50,50021,500210602,Godoy Cruz,MENDOZA,260,282,456,371,827
50,50021,500210511,Godoy Cruz,MENDOZA,245,251,397,352,749
50,50021,500210510,Godoy Cruz,MENDOZA,271,267,460,395,855
50,50021,500210509,Godoy Cruz,MENDOZA,364,370,613,548,1161
50,50021,500210501,Godoy Cruz,MENDOZA,152,158,257,222,479
50,50021,500210415,Godoy Cruz,MENDOZA,175,160,355,340,695
50,50021,500210119,Godoy Cruz,MENDOZA,128,132,220,249,469
50,50021,500210108,Godoy Cruz,MENDOZA,317,329,556,529,1085
50,50021,500211308,Godoy Cruz,MENDOZA,234,242,422,380,802
50,50021,500211306,Godoy Cruz,MENDOZA,233,245,340,295,635
50,50021,500211302,Godoy Cruz,MENDOZA,176,173,276,269,545
50,50021,500211210,Godoy Cruz,MENDOZA,240,252,401,369,770
50,50021,500211209,Godoy Cruz,MENDOZA,269,293,496,445,941
50,50021,500211206,Godoy Cruz,MENDOZA,239,182,542,519,1061
50,50021,500211101,Godoy Cruz,MENDOZA,203,320,322,245,567
50,50021,500211009,Godoy Cruz,MENDOZA,293,332,480,391,871
50,50021,500210906,Godoy Cruz,MENDOZA,282,315,415,388,803
50,50021,500210809,Godoy Cruz,MENDOZA,201,203,387,323,710
50,50021,500211503,Godoy Cruz,MENDOZA,125,177,259,231,490
50,50021,500211409,Godoy Cruz,MENDOZA,303,210,603,591,1194
50,50021,500211404,Godoy Cruz,MENDOZA,238,203,481,447,928
50,50021,500211314,Godoy Cruz,MENDOZA,230,240,474,409,883
50,50021,500210803,Godoy Cruz,MENDOZA,306,240,723,653,1376
50,50021,500210702,Godoy Cruz,MENDOZA,316,347,510,422,932
50,50021,500210612,Godoy Cruz,MENDOZA,269,276,476,485,961
50,50021,500210419,Godoy Cruz,MENDOZA,127,126,229,233,462
50,50021,500210418,Godoy Cruz,MENDOZA,327,340,613,569,1182
50,50021,500210401,Godoy Cruz,MENDOZA,290,284,601,608,1209
50,50021,500210317,Godoy Cruz,MENDOZA,217,290,322,275,597
50,50021,500210315,Godoy Cruz,MENDOZA,169,184,254,230,484
50,50021,500210308,Godoy Cruz,MENDOZA,361,374,583,515,1098
50,50021,500210206,Godoy Cruz,MENDOZA,259,254,487,444,931
50,50021,500211307,Godoy Cruz,MENDOZA,347,341,639,587,1226
50,50021,500211207,Godoy Cruz,MENDOZA,297,245,748,702,1450
50,50021,500211102,Godoy Cruz,MENDOZA,46,152,65,53,118
50,50021,500211010,Godoy Cruz,MENDOZA,214,206,375,335,710
50,50021,500210904,Godoy Cruz,MENDOZA,263,313,384,324,708
50,50021,500210808,Godoy Cruz,MENDOZA,297,298,590,545,1135
50,50021,500211005,Godoy Cruz,MENDOZA,171,183,279,246,525
50,50021,500210307,Godoy Cruz,MENDOZA,183,227,280,234,514
50,50021,500210115,Godoy Cruz,MENDOZA,372,333,777,857,1634
50,50021,500210917,Godoy Cruz,MENDOZA,179,177,335,255,590
50,50021,500211608,Godoy Cruz,MENDOZA,328,300,666,598,1264
50,50021,500211602,Godoy Cruz,MENDOZA,396,326,889,800,1689
50,50021,500211506,Godoy Cruz,MENDOZA,192,219,304,230,534
50,50021,500211501,Godoy Cruz,MENDOZA,416,501,613,530,1143
50,50021,500211606,Godoy Cruz,MENDOZA,389,342,857,780,1637
50,50021,500211410,Godoy Cruz,MENDOZA,293,306,583,562,1145
50,50021,500211313,Godoy Cruz,MENDOZA,399,431,638,595,1233
50,50021,500210604,Godoy Cruz,MENDOZA,312,340,559,476,1035
50,50021,500210507,Godoy Cruz,MENDOZA,292,303,481,421,902
50,50021,500210505,Godoy Cruz,MENDOZA,257,261,469,443,912
50,50021,500210416,Godoy Cruz,MENDOZA,194,221,302,260,562
50,50021,500210404,Godoy Cruz,MENDOZA,322,367,469,438,907
50,50021,500210313,Godoy Cruz,MENDOZA,203,236,266,213,479
50,50021,500210312,Godoy Cruz,MENDOZA,203,252,279,239,518
50,50021,500210304,Godoy Cruz,MENDOZA,316,360,485,429,914
50,50021,500210302,Godoy Cruz,MENDOZA,162,263,244,174,418
50,50021,500210215,Godoy Cruz,MENDOZA,333,339,552,502,1054
50,50021,500210212,Godoy Cruz,MENDOZA,337,368,541,452,993
50,50021,500210201,Godoy Cruz,MENDOZA,268,262,483,449,932
50,50021,500210111,Godoy Cruz,MENDOZA,379,377,758,660,1418
50,50021,500211311,Godoy Cruz,MENDOZA,334,354,548,460,1008
50,50021,500211202,Godoy Cruz,MENDOZA,317,336,552,459,1011
50,50021,500211201,Godoy Cruz,MENDOZA,148,158,243,210,453
50,50021,500211604,Godoy Cruz,MENDOZA,376,358,784,771,1555
50,50021,500211008,Godoy Cruz,MENDOZA,284,332,398,375,773
50,50021,500210908,Godoy Cruz,MENDOZA,151,155,249,180,429
50,50021,500210901,Godoy Cruz,MENDOZA,186,211,305,284,589
50,50021,500210807,Godoy Cruz,MENDOZA,383,340,845,754,1599
50,50021,500210805,Godoy Cruz,MENDOZA,212,186,447,402,849
50,50021,500211509,Godoy Cruz,MENDOZA,164,184,249,210,459
50,50021,500210611,Godoy Cruz,MENDOZA,270,286,483,470,953
50,50021,500210512,Godoy Cruz,MENDOZA,280,279,487,461,948
50,50021,500210506,Godoy Cruz,MENDOZA,304,305,471,380,851
50,50021,500210502,Godoy Cruz,MENDOZA,221,203,403,390,793
50,50021,500210420,Godoy Cruz,MENDOZA,169,180,304,305,609
50,50021,500210408,Godoy Cruz,MENDOZA,270,267,558,508,1066
50,50021,500210402,Godoy Cruz,MENDOZA,236,250,399,377,776
50,50021,500210314,Godoy Cruz,MENDOZA,234,289,325,261,586
50,50021,500210311,Godoy Cruz,MENDOZA,314,340,470,408,878
50,50021,500210310,Godoy Cruz,MENDOZA,250,299,379,351,730
50,50021,500210217,Godoy Cruz,MENDOZA,315,263,556,583,1139
50,50021,500210213,Godoy Cruz,MENDOZA,269,283,453,484,937
50,50021,500210208,Godoy Cruz,MENDOZA,267,282,447,345,792
50,50021,500210118,Godoy Cruz,MENDOZA,186,187,339,285,624
50,50021,500210112,Godoy Cruz,MENDOZA,205,208,370,331,701
50,50021,500211312,Godoy Cruz,MENDOZA,272,286,472,447,919
50,50021,500211204,Godoy Cruz,MENDOZA,226,213,376,372,748
50,50021,500211112,Godoy Cruz,MENDOZA,208,315,298,244,542
50,50021,500211012,Godoy Cruz,MENDOZA,170,179,270,261,531
50,50021,500211002,Godoy Cruz,MENDOZA,317,344,526,395,921
50,50021,500210916,Godoy Cruz,MENDOZA,202,230,351,292,643
50,50021,500210914,Godoy Cruz,MENDOZA,187,222,285,237,522
50,50021,500210912,Godoy Cruz,MENDOZA,256,291,407,340,747
50,50021,500210812,Godoy Cruz,MENDOZA,203,159,471,428,899
50,50021,500210811,Godoy Cruz,MENDOZA,380,308,778,690,1468
50,50021,500211303,Godoy Cruz,MENDOZA,382,361,610,542,1152
50,50021,500210513,Godoy Cruz,MENDOZA,241,250,408,357,765
50,50021,500211609,Godoy Cruz,MENDOZA,205,183,425,403,828
50,50021,500211505,Godoy Cruz,MENDOZA,193,245,275,225,500
50,50021,500210708,Godoy Cruz,MENDOZA,271,268,515,463,978
50,50021,500210504,Godoy Cruz,MENDOZA,41,44,104,108,212
50,50021,500210417,Godoy Cruz,MENDOZA,234,225,437,407,844
50,50021,500210414,Godoy Cruz,MENDOZA,334,303,742,669,1411
50,50021,500210412,Godoy Cruz,MENDOZA,366,366,593,571,1164
50,50021,500210409,Godoy Cruz,MENDOZA,307,302,525,484,1009
50,50021,500210407,Godoy Cruz,MENDOZA,229,234,498,469,967
50,50021,500210303,Godoy Cruz,MENDOZA,170,219,241,191,432
50,50021,500210216,Godoy Cruz,MENDOZA,346,342,612,662,1274
50,50021,500210211,Godoy Cruz,MENDOZA,244,265,405,311,716
50,50021,500210205,Godoy Cruz,MENDOZA,249,240,543,463,1006
50,50021,500210204,Godoy Cruz,MENDOZA,348,328,762,704,1466
50,50021,500210103,Godoy Cruz,MENDOZA,106,112,229,195,424
50,50021,500210102,Godoy Cruz,MENDOZA,278,289,462,382,844
50,50021,500211304,Godoy Cruz,MENDOZA,319,330,511,462,973
50,50021,500211301,Godoy Cruz,MENDOZA,198,221,332,291,623
50,50021,500211107,Godoy Cruz,MENDOZA,218,246,288,250,538
50,50021,500211104,Godoy Cruz,MENDOZA,200,244,276,244,520
50,50021,500211011,Godoy Cruz,MENDOZA,179,192,291,233,524
50,50021,500211003,Godoy Cruz,MENDOZA,208,218,322,304,626
50,50021,500210902,Godoy Cruz,MENDOZA,300,341,425,379,804
50,50021,500210810,Godoy Cruz,MENDOZA,269,266,481,420,901
50,50021,500211315,Godoy Cruz,MENDOZA,223,229,357,296,653
50,50007,500071110,Capital,MENDOZA,287,327,459,394,853
50,50007,500071101,Capital,MENDOZA,210,250,340,303,643
50,50007,500071017,Capital,MENDOZA,311,337,523,493,1016
50,50007,500070708,Capital,MENDOZA,173,198,254,231,485
50,50007,500070706,Capital,MENDOZA,305,424,413,371,784
50,50007,500070705,Capital,MENDOZA,248,261,373,283,656
50,50007,500070702,Capital,MENDOZA,346,379,564,454,1018
50,50007,500070608,Capital,MENDOZA,349,409,535,414,949
50,50007,500070505,Capital,MENDOZA,201,240,265,246,511
50,50007,500070213,Capital,MENDOZA,311,384,414,394,808
50,50007,500070212,Capital,MENDOZA,157,214,248,222,470
50,50007,500070104,Capital,MENDOZA,245,296,324,195,519
50,50007,500070209,Capital,MENDOZA,304,349,401,405,806
50,50007,500070208,Capital,MENDOZA,209,249,311,274,585
50,50007,500070111,Capital,MENDOZA,152,279,198,151,349
50,50007,500070407,Capital,MENDOZA,177,360,208,108,316
50,50007,500071207,Capital,MENDOZA,135,501,176,114,290
50,50007,500071201,Capital,MENDOZA,152,313,202,138,340
50,50007,500071113,Capital,MENDOZA,179,174,280,220,500
50,50007,500071107,Capital,MENDOZA,257,290,404,366,770
50,50007,500070906,Capital,MENDOZA,269,341,346,326,672
50,50007,500070902,Capital,MENDOZA,190,256,312,252,564
50,50007,500070807,Capital,MENDOZA,212,334,369,225,594
50,50007,500070711,Capital,MENDOZA,354,464,507,417,924
50,50007,500070506,Capital,MENDOZA,299,384,409,361,770
50,50007,500070202,Capital,MENDOZA,250,292,400,363,763
50,50007,500070115,Capital,MENDOZA,192,284,243,168,411
50,50007,500070206,Capital,MENDOZA,354,427,559,494,1053
50,50007,500070205,Capital,MENDOZA,239,260,415,363,778
50,50007,500070408,Capital,MENDOZA,167,283,177,102,279
50,50007,500070501,Capital,MENDOZA,253,286,336,329,665
50,50007,500071309,Capital,MENDOZA,333,322,703,662,1365
50,50007,500071303,Capital,MENDOZA,285,253,653,661,1314
50,50007,500071302,Capital,MENDOZA,297,283,556,568,1124
50,50007,500071209,Capital,MENDOZA,244,531,282,197,479
50,50007,500071208,Capital,MENDOZA,192,528,253,148,401
50,50007,500071205,Capital,MENDOZA,138,317,165,149,314
50,50007,500071111,Capital,MENDOZA,186,225,325,250,575
50,50007,500071105,Capital,MENDOZA,310,331,453,372,825
50,50007,500071018,Capital,MENDOZA,0,0,0,1373,1373
50,50007,500070801,Capital,MENDOZA,164,245,284,278,562
50,50007,500070704,Capital,MENDOZA,233,268,351,318,669
50,50007,500070701,Capital,MENDOZA,212,241,326,317,643
50,50007,500070605,Capital,MENDOZA,189,218,269,235,504
50,50007,500070601,Capital,MENDOZA,212,226,329,283,612
50,50007,500070512,Capital,MENDOZA,123,182,172,147,319
50,50007,500070313,Capital,MENDOZA,166,323,291,294,585
50,50007,500070307,Capital,MENDOZA,96,246,139,79,218
50,50007,500070301,Capital,MENDOZA,258,312,411,346,757
50,50007,500070201,Capital,MENDOZA,365,419,550,515,1065
50,50007,500070107,Capital,MENDOZA,212,335,391,313,704
50,50007,500070102,Capital,MENDOZA,273,302,454,428,882
50,50007,500070207,Capital,MENDOZA,233,296,413,372,785
50,50007,500070405,Capital,MENDOZA,124,265,149,119,268
50,50007,500071202,Capital,MENDOZA,90,201,116,108,224
50,50007,500071307,Capital,MENDOZA,347,351,664,672,1336
50,50007,500071203,Capital,MENDOZA,159,338,214,135,349
50,50007,500071104,Capital,MENDOZA,294,317,426,370,796
50,50007,500071022,Capital,MENDOZA,122,105,250,267,517
50,50007,500071016,Capital,MENDOZA,119,115,234,242,476
50,50007,500070401,Capital,MENDOZA,227,382,476,405,881
50,50007,500071013,Capital,MENDOZA,1,1,3,9,12
50,50007,500070810,Capital,MENDOZA,264,312,351,280,631
50,50007,500070710,Capital,MENDOZA,297,354,435,396,831
50,50007,500070607,Capital,MENDOZA,297,375,410,384,794
50,50007,500070314,Capital,MENDOZA,149,387,182,128,310
50,50007,500070310,Capital,MENDOZA,169,262,242,216,458
50,50007,500070309,Capital,MENDOZA,133,285,171,125,296
50,50007,500070305,Capital,MENDOZA,126,205,137,129,266
50,50007,500070116,Capital,MENDOZA,113,236,246,220,466
50,50007,500070113,Capital,MENDOZA,131,328,232,163,395
50,50007,500070410,Capital,MENDOZA,146,243,159,102,261
50,50007,500070210,Capital,MENDOZA,255,308,424,330,754
50,50007,500070406,Capital,MENDOZA,60,157,68,47,115
50,50007,500071308,Capital,MENDOZA,291,278,571,577,1148
50,50007,500071304,Capital,MENDOZA,325,280,626,589,1215
50,50007,500071210,Capital,MENDOZA,233,468,307,234,541
50,50007,500071206,Capital,MENDOZA,195,440,233,193,426
50,50007,500071112,Capital,MENDOZA,174,203,275,235,510
50,50007,500071109,Capital,MENDOZA,230,280,361,315,676
50,50007,500071108,Capital,MENDOZA,375,438,531,454,985
50,50007,500071010,Capital,MENDOZA,332,261,730,646,1376
50,50007,500071001,Capital,MENDOZA,326,385,587,592,1179
50,50007,500070910,Capital,MENDOZA,263,362,345,311,656
50,50007,500070908,Capital,MENDOZA,221,280,341,340,681
50,50007,500070806,Capital,MENDOZA,251,352,317,254,571
50,50007,500070805,Capital,MENDOZA,173,247,239,233,472
50,50007,500070707,Capital,MENDOZA,234,265,363,303,666
50,50007,500070703,Capital,MENDOZA,254,265,403,311,714
50,50007,500070606,Capital,MENDOZA,422,481,648,607,1255
50,50007,500070604,Capital,MENDOZA,215,249,348,272,620
50,50007,500070603,Capital,MENDOZA,239,281,382,309,691
50,50007,500070510,Capital,MENDOZA,284,414,432,335,767
50,50007,500070509,Capital,MENDOZA,265,339,405,357,762
50,50007,500070507,Capital,MENDOZA,164,241,222,177,399
50,50007,500070504,Capital,MENDOZA,163,191,199,153,352
50,50007,500070316,Capital,MENDOZA,156,244,206,175,381
50,50007,500070311,Capital,MENDOZA,176,247,352,347,699
50,50007,500070303,Capital,MENDOZA,302,410,389,354,743
50,50007,500070214,Capital,MENDOZA,270,323,383,367,750
50,50007,500070203,Capital,MENDOZA,349,385,618,505,1123
50,50007,500070106,Capital,MENDOZA,268,332,361,303,664
50,50007,500071006,Capital,MENDOZA,413,352,839,775,1614
50,50007,500070308,Capital,MENDOZA,124,314,153,129,282
50,50007,500071103,Capital,MENDOZA,265,272,432,332,764
50,50007,500071021,Capital,MENDOZA,249,191,534,492,1026
50,50007,500071020,Capital,MENDOZA,259,318,405,443,848
50,50007,500070402,Capital,MENDOZA,196,484,245,153,398
50,50007,500071011,Capital,MENDOZA,188,131,374,371,745
50,50007,500071009,Capital,MENDOZA,325,334,648,611,1259
50,50007,500071007,Capital,MENDOZA,241,290,333,279,612
50,50007,500071004,Capital,MENDOZA,381,306,800,787,1587
50,50007,500070911,Capital,MENDOZA,217,267,292,291,583
50,50007,500070909,Capital,MENDOZA,82,96,136,128,264
50,50007,500070907,Capital,MENDOZA,256,339,355,292,647
50,50007,500070903,Capital,MENDOZA,199,283,320,247,567
50,50007,500070808,Capital,MENDOZA,147,207,234,167,401
50,50007,500070804,Capital,MENDOZA,108,177,164,113,277
50,50007,500070610,Capital,MENDOZA,343,448,428,418,846
50,50007,500070609,Capital,MENDOZA,198,209,260,238,498
50,50007,500070602,Capital,MENDOZA,225,264,307,274,581
50,50007,500070508,Capital,MENDOZA,265,396,401,333,734
50,50007,500070306,Capital,MENDOZA,114,249,180,125,305
50,50007,500070304,Capital,MENDOZA,230,281,338,299,637
50,50007,500070117,Capital,MENDOZA,162,244,235,192,427
50,50007,500070109,Capital,MENDOZA,202,281,350,284,634
50,50007,500070403,Capital,MENDOZA,121,319,134,96,230
50,50007,500070502,Capital,MENDOZA,260,283,353,319,672
50,50007,500070412,Capital,MENDOZA,226,444,384,326,710
50,50007,500071306,Capital,MENDOZA,242,217,541,498,1039
50,50007,500071301,Capital,MENDOZA,403,375,760,770,1530
50,50007,500071102,Capital,MENDOZA,309,352,465,413,878
50,50007,500070905,Capital,MENDOZA,295,398,363,334,697
50,50007,500070901,Capital,MENDOZA,223,306,317,262,579
50,50007,500070809,Capital,MENDOZA,188,277,284,244,528
50,50007,500070709,Capital,MENDOZA,169,192,249,203,452
50,50007,500070511,Capital,MENDOZA,238,394,326,222,548
50,50007,500070503,Capital,MENDOZA,271,350,421,318,739
50,50007,500070411,Capital,MENDOZA,165,231,192,123,315
50,50007,500070315,Capital,MENDOZA,209,342,257,170,427
50,50007,500070215,Capital,MENDOZA,178,196,285,232,517
50,50007,500070105,Capital,MENDOZA,266,326,338,233,571
50,50007,500070103,Capital,MENDOZA,313,381,413,290,703
50,50007,500070101,Capital,MENDOZA,344,421,511,436,947
50,50007,500070409,Capital,MENDOZA,191,374,236,156,392
50,50007,500070404,Capital,MENDOZA,181,451,208,131,339
50,50007,500071305,Capital,MENDOZA,217,199,400,348,748
50,50007,500071311,Capital,MENDOZA,50,30,69,79,148
50,50007,500071310,Capital,MENDOZA,0,0,1,4,5
50,50007,500071204,Capital,MENDOZA,115,230,144,115,259
50,50007,500071019,Capital,MENDOZA,351,402,628,562,1190
50,50007,500071106,Capital,MENDOZA,362,401,561,458,1019
50,50007,500071015,Capital,MENDOZA,156,138,325,319,644
50,50007,500071014,Capital,MENDOZA,259,210,555,502,1057
50,50007,500071012,Capital,MENDOZA,250,287,349,234,583
50,50007,500071008,Capital,MENDOZA,293,262,600,574,1174
50,50007,500071005,Capital,MENDOZA,335,276,634,610,1244
50,50007,500071002,Capital,MENDOZA,242,303,387,354,741
50,50007,500070912,Capital,MENDOZA,146,179,180,160,340
50,50007,500070904,Capital,MENDOZA,282,401,397,303,700
50,50007,500070811,Capital,MENDOZA,142,240,171,138,309
50,50007,500070802,Capital,MENDOZA,153,210,296,225,521
50,50007,500070611,Capital,MENDOZA,138,188,199,159,358
50,50007,500070317,Capital,MENDOZA,96,237,99,64,163
50,50007,500070312,Capital,MENDOZA,162,206,204,198,402
50,50007,500070302,Capital,MENDOZA,311,383,429,412,841
50,50007,500070114,Capital,MENDOZA,163,244,229,182,411
50,50007,500070112,Capital,MENDOZA,160,262,216,175,391
50,50007,500070110,Capital,MENDOZA,109,160,176,146,322
50,50007,500070108,Capital,MENDOZA,239,294,375,293,668
50,50007,500070211,Capital,MENDOZA,321,383,533,430,963
50,50007,500070204,Capital,MENDOZA,287,311,464,412,876
50,50007,500071003,Capital,MENDOZA,277,309,478,443,921
50,50007,500070803,Capital,MENDOZA,358,413,586,434,1020
50,50112,501120303,Santa Rosa,MENDOZA,117,143,219,211,430
50,50112,501120201,Santa Rosa,MENDOZA,312,358,565,575,1140
50,50112,501120301,Santa Rosa,MENDOZA,94,129,171,161,332
50,50112,501120204,Santa Rosa,MENDOZA,383,410,671,652,1323
50,50112,501120102,Santa Rosa,MENDOZA,554,555,1065,998,2063
50,50112,501120203,Santa Rosa,MENDOZA,114,141,233,200,433
50,50112,501120103,Santa Rosa,MENDOZA,209,280,368,437,805
50,50112,501120305,Santa Rosa,MENDOZA,280,310,495,473,968
50,50112,501120205,Santa Rosa,MENDOZA,344,351,678,635,1313
50,50112,501120101,Santa Rosa,MENDOZA,222,273,424,466,890
50,50112,501120105,Santa Rosa,MENDOZA,158,197,310,310,620
50,50112,501120302,Santa Rosa,MENDOZA,241,283,453,498,951
50,50112,501120304,Santa Rosa,MENDOZA,306,338,556,573,1129
50,50112,501120104,Santa Rosa,MENDOZA,424,445,721,802,1523
50,50112,501120601,Santa Rosa,MENDOZA,147,200,248,268,516
50,50112,501120501,Santa Rosa,MENDOZA,86,134,99,153,252
50,50112,501120401,Santa Rosa,MENDOZA,197,263,329,417,746
50,50112,501120202,Santa Rosa,MENDOZA,250,277,457,483,940
38,38035,380350110,Ledesma,JUJUY,214,236,447,483,930
38,38035,380350105,Ledesma,JUJUY,315,330,656,645,1301
38,38035,380350619,Ledesma,JUJUY,210,206,414,409,823
38,38035,380350617,Ledesma,JUJUY,413,438,854,818,1672
38,38035,380350115,Ledesma,JUJUY,115,122,347,342,689
38,38035,380350616,Ledesma,JUJUY,355,324,773,817,1590
38,38035,380350613,Ledesma,JUJUY,331,320,722,662,1384
38,38035,380350610,Ledesma,JUJUY,351,311,689,760,1449
38,38035,380350606,Ledesma,JUJUY,361,351,720,722,1442
38,38035,380350604,Ledesma,JUJUY,381,352,794,778,1572
38,38035,380350405,Ledesma,JUJUY,0,212,0,0,0
38,38035,380350507,Ledesma,JUJUY,363,357,620,569,1189
38,38035,380350506,Ledesma,JUJUY,232,221,533,493,1026
38,38035,380350501,Ledesma,JUJUY,385,373,698,649,1347
38,38035,380350414,Ledesma,JUJUY,298,236,655,634,1289
38,38035,380350111,Ledesma,JUJUY,248,273,570,607,1177
38,38035,380350511,Ledesma,JUJUY,196,215,345,257,602
38,38035,380350211,Ledesma,JUJUY,378,418,743,795,1538
38,38035,380350217,Ledesma,JUJUY,272,302,560,579,1139
38,38035,380350303,Ledesma,JUJUY,16,16,45,28,73
38,38035,380350301,Ledesma,JUJUY,41,61,28,56,84
38,38035,380350614,Ledesma,JUJUY,348,354,812,797,1609
38,38035,380350608,Ledesma,JUJUY,246,254,481,491,972
38,38035,380350517,Ledesma,JUJUY,212,216,361,304,665
38,38035,380350412,Ledesma,JUJUY,362,343,751,775,1526
38,38035,380350104,Ledesma,JUJUY,10,14,12,17,29
38,38035,380350203,Ledesma,JUJUY,0,1,0,0,0
38,38035,380350102,Ledesma,JUJUY,66,80,148,162,310
38,38035,380350515,Ledesma,JUJUY,387,367,706,723,1429
38,38035,380350210,Ledesma,JUJUY,266,277,553,519,1072
38,38035,380350204,Ledesma,JUJUY,205,211,392,352,744
38,38035,380350107,Ledesma,JUJUY,269,263,593,653,1246
38,38035,380350212,Ledesma,JUJUY,237,256,428,448,876
38,38035,380350114,Ledesma,JUJUY,191,201,455,503,958
38,38035,380350618,Ledesma,JUJUY,345,334,724,712,1436
38,38035,380350207,Ledesma,JUJUY,56,283,62,83,145
38,38035,380350305,Ledesma,JUJUY,14,21,2,27,29
38,38035,380350302,Ledesma,JUJUY,18,19,32,41,73
38,38035,380350615,Ledesma,JUJUY,294,302,698,648,1346
38,38035,380350509,Ledesma,JUJUY,173,209,270,267,537
38,38035,380350406,Ledesma,JUJUY,0,280,0,0,0
38,38035,380350609,Ledesma,JUJUY,209,186,423,473,896
38,38035,380350607,Ledesma,JUJUY,278,249,543,531,1074
38,38035,380350601,Ledesma,JUJUY,342,292,809,769,1578
38,38035,380350112,Ledesma,JUJUY,196,211,378,350,728
38,38035,380350408,Ledesma,JUJUY,394,374,843,892,1735
38,38035,380350508,Ledesma,JUJUY,205,206,371,329,700
38,38035,380350415,Ledesma,JUJUY,202,208,428,403,831
38,38035,380350209,Ledesma,JUJUY,85,241,108,131,239
38,38035,380350106,Ledesma,JUJUY,369,376,767,845,1612
38,38035,380350208,Ledesma,JUJUY,58,206,88,102,190
38,38035,380350206,Ledesma,JUJUY,56,358,71,67,138
38,38035,380350401,Ledesma,JUJUY,128,275,192,232,424
38,38035,380350201,Ledesma,JUJUY,2,2,0,2,2
38,38035,380350101,Ledesma,JUJUY,283,351,539,603,1142
38,38035,380350416,Ledesma,JUJUY,354,428,750,750,1500
38,38035,380350603,Ledesma,JUJUY,337,437,695,714,1409
38,38035,380350510,Ledesma,JUJUY,352,321,563,624,1187
38,38035,380350504,Ledesma,JUJUY,332,304,752,731,1483
38,38035,380350503,Ledesma,JUJUY,296,291,686,633,1319
38,38035,380350513,Ledesma,JUJUY,254,287,435,384,819
38,38035,380350413,Ledesma,JUJUY,295,300,686,716,1402
38,38035,380350409,Ledesma,JUJUY,338,332,650,640,1290
38,38035,380350214,Ledesma,JUJUY,198,226,375,392,767
38,38035,380350404,Ledesma,JUJUY,243,257,524,538,1062
38,38035,380350103,Ledesma,JUJUY,3,6,7,19,26
38,38035,380350403,Ledesma,JUJUY,91,103,163,192,355
38,38035,380350612,Ledesma,JUJUY,282,282,611,624,1235
38,38035,380350611,Ledesma,JUJUY,267,256,567,544,1111
38,38035,380350605,Ledesma,JUJUY,272,269,547,542,1089
38,38035,380350215,Ledesma,JUJUY,206,220,376,335,711
38,38035,380350109,Ledesma,JUJUY,279,326,629,670,1299
38,38035,380350213,Ledesma,JUJUY,183,183,289,307,596
38,38035,380350205,Ledesma,JUJUY,219,220,368,359,727
38,38035,380350304,Ledesma,JUJUY,14,23,16,28,44
38,38035,380350602,Ledesma,JUJUY,354,359,710,681,1391
38,38035,380350516,Ledesma,JUJUY,449,458,932,909,1841
38,38035,380350514,Ledesma,JUJUY,314,311,573,513,1086
38,38035,380350407,Ledesma,JUJUY,266,232,588,590,1178
38,38035,380350505,Ledesma,JUJUY,253,243,509,508,1017
38,38035,380350502,Ledesma,JUJUY,293,282,630,564,1194
38,38035,380350411,Ledesma,JUJUY,254,242,504,473,977
38,38035,380350410,Ledesma,JUJUY,362,294,674,640,1314
38,38035,380350216,Ledesma,JUJUY,165,256,305,300,605
38,38035,380350512,Ledesma,JUJUY,171,155,259,224,483
38,38035,380350108,Ledesma,JUJUY,262,301,516,560,1076
38,38035,380350113,Ledesma,JUJUY,211,213,400,384,784
38,38035,380350306,Ledesma,JUJUY,193,238,418,380,798
38,38035,380350202,Ledesma,JUJUY,2,4,4,4,8
38,38028,380280410,Humahuaca,JUJUY,278,372,633,553,1186
38,38028,380280503,Humahuaca,JUJUY,173,251,252,325,577
38,38028,380280412,Humahuaca,JUJUY,146,222,306,276,582
38,38028,380280401,Humahuaca,JUJUY,153,251,217,176,393
38,38028,380280402,Humahuaca,JUJUY,89,160,132,135,267
38,38028,380280101,Humahuaca,JUJUY,87,214,170,166,336
38,38028,380280408,Humahuaca,JUJUY,173,230,315,227,542
38,38028,380280505,Humahuaca,JUJUY,188,241,367,453,820
38,38028,380280203,Humahuaca,JUJUY,117,265,167,211,378
38,38028,380280406,Humahuaca,JUJUY,213,314,366,309,675
38,38028,380280602,Humahuaca,JUJUY,116,228,197,179,376
38,38028,380280502,Humahuaca,JUJUY,103,204,200,156,356
38,38028,380280301,Humahuaca,JUJUY,151,225,257,298,555
38,38028,380280102,Humahuaca,JUJUY,69,163,130,104,234
38,38028,380280201,Humahuaca,JUJUY,75,181,103,128,231
38,38028,380280303,Humahuaca,JUJUY,134,196,266,242,508
38,38028,380280205,Humahuaca,JUJUY,39,76,61,83,144
38,38028,380280404,Humahuaca,JUJUY,195,346,340,320,660
38,38028,380280202,Humahuaca,JUJUY,58,123,105,122,227
38,38028,380280204,Humahuaca,JUJUY,40,92,70,71,141
38,38028,380280501,Humahuaca,JUJUY,33,71,46,37,83
38,38028,380280403,Humahuaca,JUJUY,221,260,455,413,868
38,38028,380280409,Humahuaca,JUJUY,157,192,363,320,683
38,38028,380280411,Humahuaca,JUJUY,290,366,596,522,1118
38,38028,380280103,Humahuaca,JUJUY,80,170,177,143,320
38,38028,380280415,Humahuaca,JUJUY,215,263,377,356,733
38,38028,380280414,Humahuaca,JUJUY,145,277,256,239,495
38,38028,380280302,Humahuaca,JUJUY,100,230,92,116,208
38,38028,380280407,Humahuaca,JUJUY,246,317,541,465,1006
38,38028,380280405,Humahuaca,JUJUY,190,227,359,333,692
38,38028,380280413,Humahuaca,JUJUY,252,305,539,477,1016
38,38028,380280504,Humahuaca,JUJUY,176,249,421,446,867
38,38028,380280601,Humahuaca,JUJUY,40,63,48,41,89
38,38014,380140618,El Carmen,JUJUY,273,207,663,653,1316
38,38014,380140617,El Carmen,JUJUY,241,203,623,625,1248
38,38014,380140716,El Carmen,JUJUY,358,395,788,782,1570
38,38014,380140715,El Carmen,JUJUY,211,216,461,417,878
38,38014,380140709,El Carmen,JUJUY,308,278,698,661,1359
38,38014,380140611,El Carmen,JUJUY,311,226,771,753,1524
38,38014,380140609,El Carmen,JUJUY,457,438,1044,975,2019
38,38014,380140606,El Carmen,JUJUY,312,225,560,514,1074
38,38014,380140603,El Carmen,JUJUY,295,324,473,437,910
38,38014,380140407,El Carmen,JUJUY,377,321,749,725,1474
38,38014,380140115,El Carmen,JUJUY,12,16,20,25,45
38,38014,380140102,El Carmen,JUJUY,81,92,150,175,325
38,38014,380140506,El Carmen,JUJUY,142,226,252,301,553
38,38014,380140305,El Carmen,JUJUY,368,324,853,879,1732
38,38014,380140714,El Carmen,JUJUY,216,263,461,443,904
38,38014,380140707,El Carmen,JUJUY,261,290,529,509,1038
38,38014,380140601,El Carmen,JUJUY,305,304,570,469,1039
38,38014,380140704,El Carmen,JUJUY,59,277,103,111,214
38,38014,380140104,El Carmen,JUJUY,127,107,203,256,459
38,38014,380140502,El Carmen,JUJUY,190,185,309,373,682
38,38014,380140105,El Carmen,JUJUY,328,326,660,765,1425
38,38014,380140303,El Carmen,JUJUY,142,287,239,289,528
38,38014,380140401,El Carmen,JUJUY,427,578,787,895,1682
38,38014,380140106,El Carmen,JUJUY,83,92,154,157,311
38,38014,380140411,El Carmen,JUJUY,342,304,662,678,1340
38,38014,380140410,El Carmen,JUJUY,307,241,616,635,1251
38,38014,380140513,El Carmen,JUJUY,281,270,589,550,1139
38,38014,380140710,El Carmen,JUJUY,377,371,882,866,1748
38,38014,380140703,El Carmen,JUJUY,57,227,111,107,218
38,38014,380140607,El Carmen,JUJUY,307,204,535,561,1096
38,38014,380140605,El Carmen,JUJUY,319,264,629,623,1252
38,38014,380140508,El Carmen,JUJUY,426,440,751,675,1426
38,38014,380140406,El Carmen,JUJUY,396,333,886,878,1764
38,38014,380140501,El Carmen,JUJUY,214,309,409,436,845
38,38014,380140516,El Carmen,JUJUY,241,252,452,429,881
38,38014,380140412,El Carmen,JUJUY,162,164,405,422,827
38,38014,380140701,El Carmen,JUJUY,180,187,407,431,838
38,38014,380140711,El Carmen,JUJUY,459,395,1225,1223,2448
38,38014,380140708,El Carmen,JUJUY,322,311,703,717,1420
38,38014,380140706,El Carmen,JUJUY,205,226,445,467,912
38,38014,380140705,El Carmen,JUJUY,193,182,481,426,907
38,38014,380140616,El Carmen,JUJUY,288,277,542,537,1079
38,38014,380140503,El Carmen,JUJUY,340,531,647,632,1279
38,38014,380140202,El Carmen,JUJUY,19,40,32,32,64
38,38014,380140206,El Carmen,JUJUY,93,102,248,249,497
38,38014,380140201,El Carmen,JUJUY,253,237,461,544,1005
38,38014,380140515,El Carmen,JUJUY,335,284,778,798,1576
38,38014,380140511,El Carmen,JUJUY,351,354,667,618,1285
38,38014,380140205,El Carmen,JUJUY,266,218,541,556,1097
38,38014,380140702,El Carmen,JUJUY,77,240,152,147,299
38,38014,380140615,El Carmen,JUJUY,397,302,834,872,1706
38,38014,380140614,El Carmen,JUJUY,260,208,547,537,1084
38,38014,380140613,El Carmen,JUJUY,251,212,557,586,1143
38,38014,380140608,El Carmen,JUJUY,288,208,538,543,1081
38,38014,380140510,El Carmen,JUJUY,274,301,491,415,906
38,38014,380140408,El Carmen,JUJUY,311,211,681,633,1314
38,38014,380140717,El Carmen,JUJUY,169,196,367,402,769
38,38014,380140402,El Carmen,JUJUY,258,334,462,523,985
38,38014,380140301,El Carmen,JUJUY,132,214,190,245,435
38,38014,380140103,El Carmen,JUJUY,143,128,326,365,691
38,38014,380140405,El Carmen,JUJUY,303,510,600,633,1233
38,38014,380140514,El Carmen,JUJUY,320,253,773,725,1498
38,38014,380140512,El Carmen,JUJUY,269,230,572,513,1085
38,38014,380140712,El Carmen,JUJUY,448,381,1100,1118,2218
38,38014,380140602,El Carmen,JUJUY,312,283,648,598,1246
38,38014,380140507,El Carmen,JUJUY,349,327,651,663,1314
38,38014,380140116,El Carmen,JUJUY,153,129,338,362,700
38,38014,380140505,El Carmen,JUJUY,32,77,41,47,88
38,38014,380140404,El Carmen,JUJUY,369,437,625,788,1413
38,38014,380140101,El Carmen,JUJUY,53,64,82,89,171
38,38014,380140204,El Carmen,JUJUY,221,259,387,465,852
38,38014,380140203,El Carmen,JUJUY,324,410,628,733,1361
38,38014,380140304,El Carmen,JUJUY,547,547,1324,1303,2627
38,38014,380140713,El Carmen,JUJUY,381,318,804,776,1580
38,38014,380140610,El Carmen,JUJUY,221,212,486,435,921
38,38014,380140604,El Carmen,JUJUY,394,327,739,686,1425
38,38014,380140517,El Carmen,JUJUY,117,218,256,241,497
38,38014,380140117,El Carmen,JUJUY,189,213,426,438,864
38,38014,380140108,El Carmen,JUJUY,101,163,194,211,405
38,38014,380140403,El Carmen,JUJUY,301,402,445,545,990
38,38014,380140302,El Carmen,JUJUY,275,362,513,577,1090
38,38014,380140409,El Carmen,JUJUY,431,342,938,906,1844
38,38014,380140414,El Carmen,JUJUY,264,331,663,658,1321
38,38014,380140413,El Carmen,JUJUY,321,280,722,699,1421
38,38014,380140619,El Carmen,JUJUY,266,218,603,633,1236
38,38014,380140718,El Carmen,JUJUY,105,94,274,278,552
38,38014,380140612,El Carmen,JUJUY,276,249,628,607,1235
38,38014,380140509,El Carmen,JUJUY,315,289,632,632,1264
38,38014,380140504,El Carmen,JUJUY,78,157,70,113,183
38,38014,380140109,El Carmen,JUJUY,182,266,319,384,703
38,38014,380140107,El Carmen,JUJUY,230,405,348,438,786
38,38021,380210509,Dr. Manuel Belgrano,JUJUY,254,224,552,504,1056
38,38021,380210412,Dr. Manuel Belgrano,JUJUY,307,367,566,559,1125
38,38021,380210408,Dr. Manuel Belgrano,JUJUY,92,104,168,176,344
38,38021,380210913,Dr. Manuel Belgrano,JUJUY,357,340,670,538,1208
38,38021,380210618,Dr. Manuel Belgrano,JUJUY,273,273,712,660,1372
38,38021,380211303,Dr. Manuel Belgrano,JUJUY,43,169,154,88,242
38,38021,380211519,Dr. Manuel Belgrano,JUJUY,185,422,212,248,460
38,38021,380211517,Dr. Manuel Belgrano,JUJUY,185,385,289,283,572
38,38021,380211502,Dr. Manuel Belgrano,JUJUY,182,418,323,321,644
38,38021,380211419,Dr. Manuel Belgrano,JUJUY,285,300,702,658,1360
38,38021,380211418,Dr. Manuel Belgrano,JUJUY,315,323,734,704,1438
38,38021,380211414,Dr. Manuel Belgrano,JUJUY,415,407,926,896,1822
38,38021,380211411,Dr. Manuel Belgrano,JUJUY,240,248,535,512,1047
38,38021,380211408,Dr. Manuel Belgrano,JUJUY,404,277,910,919,1829
38,38021,380211211,Dr. Manuel Belgrano,JUJUY,275,266,500,494,994
38,38021,380211204,Dr. Manuel Belgrano,JUJUY,294,274,591,574,1165
38,38021,380211115,Dr. Manuel Belgrano,JUJUY,232,212,430,375,805
38,38021,380211107,Dr. Manuel Belgrano,JUJUY,261,260,526,470,996
38,38021,380211102,Dr. Manuel Belgrano,JUJUY,284,306,569,500,1069
38,38021,380210902,Dr. Manuel Belgrano,JUJUY,219,250,340,326,666
38,38021,380210811,Dr. Manuel Belgrano,JUJUY,254,256,445,428,873
38,38021,380210707,Dr. Manuel Belgrano,JUJUY,347,408,577,424,1001
38,38021,380210706,Dr. Manuel Belgrano,JUJUY,176,265,272,185,457
38,38021,380210720,Dr. Manuel Belgrano,JUJUY,245,249,413,372,785
38,38021,380210613,Dr. Manuel Belgrano,JUJUY,208,254,370,294,664
38,38021,380210526,Dr. Manuel Belgrano,JUJUY,169,161,386,333,719
38,38021,380210904,Dr. Manuel Belgrano,JUJUY,140,102,248,204,452
38,38021,380210606,Dr. Manuel Belgrano,JUJUY,66,106,93,87,180
38,38021,380210516,Dr. Manuel Belgrano,JUJUY,291,350,546,508,1054
38,38021,380210515,Dr. Manuel Belgrano,JUJUY,247,233,506,500,1006
38,38021,380210514,Dr. Manuel Belgrano,JUJUY,414,323,777,741,1518
38,38021,380210504,Dr. Manuel Belgrano,JUJUY,445,426,819,765,1584
38,38021,380210415,Dr. Manuel Belgrano,JUJUY,288,334,574,504,1078
38,38021,380210906,Dr. Manuel Belgrano,JUJUY,311,264,452,899,1351
38,38021,380210813,Dr. Manuel Belgrano,JUJUY,229,221,415,361,776
38,38021,380211212,Dr. Manuel Belgrano,JUJUY,279,280,552,498,1050
38,38021,380210107,Dr. Manuel Belgrano,JUJUY,179,237,353,309,662
38,38021,380210406,Dr. Manuel Belgrano,JUJUY,217,329,394,397,791
38,38021,380210823,Dr. Manuel Belgrano,JUJUY,251,248,473,454,927
38,38021,380211511,Dr. Manuel Belgrano,JUJUY,383,471,725,618,1343
38,38021,380211510,Dr. Manuel Belgrano,JUJUY,312,350,625,566,1191
38,38021,380211503,Dr. Manuel Belgrano,JUJUY,82,222,172,152,324
38,38021,380211501,Dr. Manuel Belgrano,JUJUY,387,403,779,733,1512
38,38021,380211417,Dr. Manuel Belgrano,JUJUY,461,460,1053,967,2020
38,38021,380211404,Dr. Manuel Belgrano,JUJUY,315,325,716,684,1400
38,38021,380211322,Dr. Manuel Belgrano,JUJUY,276,267,603,550,1153
38,38021,380211315,Dr. Manuel Belgrano,JUJUY,321,334,672,623,1295
38,38021,380211313,Dr. Manuel Belgrano,JUJUY,383,392,803,705,1508
38,38021,380211219,Dr. Manuel Belgrano,JUJUY,349,407,655,594,1249
38,38021,380211216,Dr. Manuel Belgrano,JUJUY,208,222,411,366,777
38,38021,380211213,Dr. Manuel Belgrano,JUJUY,213,194,398,401,799
38,38021,380211201,Dr. Manuel Belgrano,JUJUY,283,296,544,531,1075
38,38021,380211008,Dr. Manuel Belgrano,JUJUY,324,361,516,508,1024
38,38021,380211001,Dr. Manuel Belgrano,JUJUY,350,368,577,555,1132
38,38021,380210901,Dr. Manuel Belgrano,JUJUY,405,372,608,571,1179
38,38021,380210810,Dr. Manuel Belgrano,JUJUY,234,244,473,428,901
38,38021,380210721,Dr. Manuel Belgrano,JUJUY,190,220,304,273,577
38,38021,380210712,Dr. Manuel Belgrano,JUJUY,273,281,409,365,774
38,38021,380210711,Dr. Manuel Belgrano,JUJUY,262,224,562,516,1078
38,38021,380210704,Dr. Manuel Belgrano,JUJUY,267,220,523,499,1022
38,38021,380210818,Dr. Manuel Belgrano,JUJUY,308,261,650,593,1243
38,38021,380210615,Dr. Manuel Belgrano,JUJUY,252,323,409,279,688
38,38021,380210610,Dr. Manuel Belgrano,JUJUY,257,393,360,225,585
38,38021,380210602,Dr. Manuel Belgrano,JUJUY,219,210,506,433,939
38,38021,380210523,Dr. Manuel Belgrano,JUJUY,286,284,651,572,1223
38,38021,380210603,Dr. Manuel Belgrano,JUJUY,386,421,757,730,1487
38,38021,380210517,Dr. Manuel Belgrano,JUJUY,276,294,465,443,908
38,38021,380210513,Dr. Manuel Belgrano,JUJUY,374,303,689,662,1351
38,38021,380210501,Dr. Manuel Belgrano,JUJUY,282,344,495,463,958
38,38021,380210419,Dr. Manuel Belgrano,JUJUY,91,135,165,166,331
38,38021,380210410,Dr. Manuel Belgrano,JUJUY,246,248,493,482,975
38,38021,380210709,Dr. Manuel Belgrano,JUJUY,235,358,509,368,877
38,38021,380210110,Dr. Manuel Belgrano,JUJUY,166,195,329,301,630
38,38021,380210608,Dr. Manuel Belgrano,JUJUY,243,228,515,514,1029
38,38021,380211301,Dr. Manuel Belgrano,JUJUY,385,445,729,709,1438
38,38021,380210619,Dr. Manuel Belgrano,JUJUY,259,242,565,553,1118
38,38021,380210616,Dr. Manuel Belgrano,JUJUY,253,371,428,365,793
38,38021,380210601,Dr. Manuel Belgrano,JUJUY,275,200,446,393,839
38,38021,380211402,Dr. Manuel Belgrano,JUJUY,326,329,763,684,1447
38,38021,380211311,Dr. Manuel Belgrano,JUJUY,319,277,750,747,1497
38,38021,380210302,Dr. Manuel Belgrano,JUJUY,18,33,19,30,49
38,38021,380210301,Dr. Manuel Belgrano,JUJUY,14,17,18,27,45
38,38021,380211509,Dr. Manuel Belgrano,JUJUY,193,339,392,388,780
38,38021,380211412,Dr. Manuel Belgrano,JUJUY,316,325,687,605,1292
38,38021,380211403,Dr. Manuel Belgrano,JUJUY,324,338,700,608,1308
38,38021,380211320,Dr. Manuel Belgrano,JUJUY,225,227,487,439,926
38,38021,380211215,Dr. Manuel Belgrano,JUJUY,293,329,572,506,1078
38,38021,380211209,Dr. Manuel Belgrano,JUJUY,311,309,653,510,1163
38,38021,380211205,Dr. Manuel Belgrano,JUJUY,247,221,584,528,1112
38,38021,380211117,Dr. Manuel Belgrano,JUJUY,297,316,580,524,1104
38,38021,380211012,Dr. Manuel Belgrano,JUJUY,270,261,491,439,930
38,38021,380211004,Dr. Manuel Belgrano,JUJUY,243,255,464,454,918
38,38021,380211002,Dr. Manuel Belgrano,JUJUY,348,352,751,620,1371
38,38021,380210919,Dr. Manuel Belgrano,JUJUY,164,172,295,269,564
38,38021,380210916,Dr. Manuel Belgrano,JUJUY,408,373,889,893,1782
38,38021,380210912,Dr. Manuel Belgrano,JUJUY,421,365,744,754,1498
38,38021,380210910,Dr. Manuel Belgrano,JUJUY,387,294,631,577,1208
38,38021,380210717,Dr. Manuel Belgrano,JUJUY,365,379,673,576,1249
38,38021,380210701,Dr. Manuel Belgrano,JUJUY,330,397,637,576,1213
38,38021,380210816,Dr. Manuel Belgrano,JUJUY,416,335,883,746,1629
38,38021,380210518,Dr. Manuel Belgrano,JUJUY,212,215,424,399,823
38,38021,380210510,Dr. Manuel Belgrano,JUJUY,439,431,970,892,1862
38,38021,380210506,Dr. Manuel Belgrano,JUJUY,195,208,324,321,645
38,38021,380210814,Dr. Manuel Belgrano,JUJUY,304,289,479,480,959
38,38021,380210108,Dr. Manuel Belgrano,JUJUY,327,509,650,681,1331
38,38021,380210109,Dr. Manuel Belgrano,JUJUY,72,175,116,100,216
38,38021,380210815,Dr. Manuel Belgrano,JUJUY,217,196,458,400,858
38,38021,380211305,Dr. Manuel Belgrano,JUJUY,305,326,634,579,1213
38,38021,380210306,Dr. Manuel Belgrano,JUJUY,12,15,17,20,37
38,38021,380210405,Dr. Manuel Belgrano,JUJUY,253,340,495,540,1035
38,38021,380210404,Dr. Manuel Belgrano,JUJUY,73,105,110,119,229
38,38021,380211514,Dr. Manuel Belgrano,JUJUY,285,295,589,534,1123
38,38021,380211512,Dr. Manuel Belgrano,JUJUY,289,294,626,585,1211
38,38021,380211504,Dr. Manuel Belgrano,JUJUY,136,328,261,239,500
38,38021,380211410,Dr. Manuel Belgrano,JUJUY,215,201,478,492,970
38,38021,380211407,Dr. Manuel Belgrano,JUJUY,430,412,957,930,1887
38,38021,380211319,Dr. Manuel Belgrano,JUJUY,283,284,666,612,1278
38,38021,380211309,Dr. Manuel Belgrano,JUJUY,310,285,704,687,1391
38,38021,380211314,Dr. Manuel Belgrano,JUJUY,232,213,499,486,985
38,38021,380211220,Dr. Manuel Belgrano,JUJUY,341,330,835,735,1570
38,38021,380211118,Dr. Manuel Belgrano,JUJUY,140,146,266,253,519
38,38021,380211110,Dr. Manuel Belgrano,JUJUY,392,358,622,568,1190
38,38021,380211109,Dr. Manuel Belgrano,JUJUY,155,176,342,329,671
38,38021,380211104,Dr. Manuel Belgrano,JUJUY,273,221,495,479,974
38,38021,380211013,Dr. Manuel Belgrano,JUJUY,292,308,502,461,963
38,38021,380210911,Dr. Manuel Belgrano,JUJUY,482,372,823,753,1576
38,38021,380210903,Dr. Manuel Belgrano,JUJUY,198,205,341,268,609
38,38021,380210824,Dr. Manuel Belgrano,JUJUY,238,234,420,444,864
38,38021,380210806,Dr. Manuel Belgrano,JUJUY,364,347,747,598,1345
38,38021,380210803,Dr. Manuel Belgrano,JUJUY,169,176,260,222,482
38,38021,380210819,Dr. Manuel Belgrano,JUJUY,293,227,569,568,1137
38,38021,380210621,Dr. Manuel Belgrano,JUJUY,243,240,434,432,866
38,38021,380210604,Dr. Manuel Belgrano,JUJUY,330,284,751,741,1492
38,38021,380210203,Dr. Manuel Belgrano,JUJUY,4,6,0,11,11
38,38021,380210102,Dr. Manuel Belgrano,JUJUY,32,36,34,46,80
38,38021,380211518,Dr. Manuel Belgrano,JUJUY,429,470,803,716,1519
38,38021,380211507,Dr. Manuel Belgrano,JUJUY,257,307,523,496,1019
38,38021,380211406,Dr. Manuel Belgrano,JUJUY,360,226,836,788,1624
38,38021,380211317,Dr. Manuel Belgrano,JUJUY,294,299,634,553,1187
38,38021,380211306,Dr. Manuel Belgrano,JUJUY,237,270,413,447,860
38,38021,380211221,Dr. Manuel Belgrano,JUJUY,348,416,690,648,1338
38,38021,380211218,Dr. Manuel Belgrano,JUJUY,240,234,517,513,1030
38,38021,380211108,Dr. Manuel Belgrano,JUJUY,434,413,814,757,1571
38,38021,380211106,Dr. Manuel Belgrano,JUJUY,239,229,473,428,901
38,38021,380211101,Dr. Manuel Belgrano,JUJUY,320,292,719,616,1335
38,38021,380211014,Dr. Manuel Belgrano,JUJUY,347,329,728,712,1440
38,38021,380211010,Dr. Manuel Belgrano,JUJUY,312,310,584,466,1050
38,38021,380211005,Dr. Manuel Belgrano,JUJUY,359,344,736,715,1451
38,38021,380211003,Dr. Manuel Belgrano,JUJUY,287,259,599,496,1095
38,38021,380210921,Dr. Manuel Belgrano,JUJUY,216,193,449,406,855
38,38021,380210920,Dr. Manuel Belgrano,JUJUY,286,300,531,446,977
38,38021,380210827,Dr. Manuel Belgrano,JUJUY,233,273,354,288,642
38,38021,380210825,Dr. Manuel Belgrano,JUJUY,236,234,396,345,741
38,38021,380210702,Dr. Manuel Belgrano,JUJUY,204,213,388,323,711
38,38021,380210524,Dr. Manuel Belgrano,JUJUY,398,420,700,648,1348
38,38021,380210521,Dr. Manuel Belgrano,JUJUY,337,400,617,586,1203
38,38021,380210520,Dr. Manuel Belgrano,JUJUY,354,431,666,592,1258
38,38021,380210605,Dr. Manuel Belgrano,JUJUY,166,283,311,229,540
38,38021,380210511,Dr. Manuel Belgrano,JUJUY,248,241,470,400,870
38,38021,380210502,Dr. Manuel Belgrano,JUJUY,299,294,548,479,1027
38,38021,380210407,Dr. Manuel Belgrano,JUJUY,45,45,76,89,165
38,38021,380210802,Dr. Manuel Belgrano,JUJUY,317,316,521,477,998
38,38021,380210705,Dr. Manuel Belgrano,JUJUY,376,390,614,573,1187
38,38021,380210620,Dr. Manuel Belgrano,JUJUY,178,175,365,362,727
38,38021,380210617,Dr. Manuel Belgrano,JUJUY,240,215,564,534,1098
38,38021,380210609,Dr. Manuel Belgrano,JUJUY,183,245,288,206,494
38,38021,380210503,Dr. Manuel Belgrano,JUJUY,390,410,660,635,1295
38,38021,380210416,Dr. Manuel Belgrano,JUJUY,140,160,273,245,518
38,38021,380211505,Dr. Manuel Belgrano,JUJUY,193,298,394,353,747
38,38021,380210403,Dr. Manuel Belgrano,JUJUY,12,19,17,16,33
38,38021,380210401,Dr. Manuel Belgrano,JUJUY,4,19,4,4,8
38,38021,380210103,Dr. Manuel Belgrano,JUJUY,131,254,210,218,428
38,38021,380211515,Dr. Manuel Belgrano,JUJUY,236,273,419,377,796
38,38021,380211416,Dr. Manuel Belgrano,JUJUY,255,254,579,578,1157
38,38021,380211405,Dr. Manuel Belgrano,JUJUY,347,346,855,947,1802
38,38021,380211312,Dr. Manuel Belgrano,JUJUY,323,319,678,635,1313
38,38021,380211307,Dr. Manuel Belgrano,JUJUY,408,477,810,805,1615
38,38021,380211210,Dr. Manuel Belgrano,JUJUY,310,299,598,587,1185
38,38021,380211203,Dr. Manuel Belgrano,JUJUY,403,370,905,802,1707
38,38021,380211202,Dr. Manuel Belgrano,JUJUY,359,383,621,576,1197
38,38021,380211111,Dr. Manuel Belgrano,JUJUY,294,282,607,569,1176
38,38021,380211006,Dr. Manuel Belgrano,JUJUY,284,278,557,540,1097
38,38021,380210915,Dr. Manuel Belgrano,JUJUY,320,315,715,672,1387
38,38021,380210914,Dr. Manuel Belgrano,JUJUY,271,236,515,473,988
38,38021,380210821,Dr. Manuel Belgrano,JUJUY,261,223,531,485,1016
38,38021,380210808,Dr. Manuel Belgrano,JUJUY,431,415,784,739,1523
38,38021,380210801,Dr. Manuel Belgrano,JUJUY,219,254,352,317,669
38,38021,380210713,Dr. Manuel Belgrano,JUJUY,220,252,366,290,656
38,38021,380210703,Dr. Manuel Belgrano,JUJUY,67,48,127,161,288
38,38021,380210607,Dr. Manuel Belgrano,JUJUY,256,401,363,264,627
38,38021,380210812,Dr. Manuel Belgrano,JUJUY,397,403,697,594,1291
38,38021,380210512,Dr. Manuel Belgrano,JUJUY,326,309,546,503,1049
38,38021,380210417,Dr. Manuel Belgrano,JUJUY,292,317,593,542,1135
38,38021,380210708,Dr. Manuel Belgrano,JUJUY,186,227,308,296,604
38,38021,380210922,Dr. Manuel Belgrano,JUJUY,285,269,505,485,990
38,38021,380210612,Dr. Manuel Belgrano,JUJUY,160,262,288,270,558
38,38021,380211520,Dr. Manuel Belgrano,JUJUY,40,41,51,54,105
38,38021,380210304,Dr. Manuel Belgrano,JUJUY,25,32,28,47,75
38,38021,380210305,Dr. Manuel Belgrano,JUJUY,39,57,48,76,124
38,38021,380211513,Dr. Manuel Belgrano,JUJUY,215,253,430,371,801
38,38021,380211506,Dr. Manuel Belgrano,JUJUY,226,276,473,437,910
38,38021,380211413,Dr. Manuel Belgrano,JUJUY,220,203,563,499,1062
38,38021,380211401,Dr. Manuel Belgrano,JUJUY,285,291,579,538,1117
38,38021,380211321,Dr. Manuel Belgrano,JUJUY,196,204,424,382,806
38,38021,380211316,Dr. Manuel Belgrano,JUJUY,283,299,591,524,1115
38,38021,380211310,Dr. Manuel Belgrano,JUJUY,279,277,632,587,1219
38,38021,380211308,Dr. Manuel Belgrano,JUJUY,366,370,848,780,1628
38,38021,380211214,Dr. Manuel Belgrano,JUJUY,418,428,829,768,1597
38,38021,380211208,Dr. Manuel Belgrano,JUJUY,209,228,422,332,754
38,38021,380211207,Dr. Manuel Belgrano,JUJUY,367,340,759,710,1469
38,38021,380211116,Dr. Manuel Belgrano,JUJUY,289,272,504,430,934
38,38021,380211114,Dr. Manuel Belgrano,JUJUY,272,231,465,426,891
38,38021,380211112,Dr. Manuel Belgrano,JUJUY,237,252,422,349,771
38,38021,380211105,Dr. Manuel Belgrano,JUJUY,349,355,695,610,1305
38,38021,380210923,Dr. Manuel Belgrano,JUJUY,127,163,236,231,467
38,38021,380211113,Dr. Manuel Belgrano,JUJUY,294,307,511,463,974
38,38021,380210907,Dr. Manuel Belgrano,JUJUY,342,257,577,511,1088
38,38021,380210822,Dr. Manuel Belgrano,JUJUY,285,240,602,544,1146
38,38021,380210809,Dr. Manuel Belgrano,JUJUY,297,293,522,524,1046
38,38021,380210714,Dr. Manuel Belgrano,JUJUY,300,291,462,390,852
38,38021,380210614,Dr. Manuel Belgrano,JUJUY,254,263,545,545,1090
38,38021,380210527,Dr. Manuel Belgrano,JUJUY,200,266,363,378,741
38,38021,380210525,Dr. Manuel Belgrano,JUJUY,215,244,327,290,617
38,38021,380210507,Dr. Manuel Belgrano,JUJUY,305,274,565,526,1091
38,38021,380210505,Dr. Manuel Belgrano,JUJUY,276,250,542,475,1017
38,38021,380210418,Dr. Manuel Belgrano,JUJUY,128,160,218,218,436
38,38021,380210718,Dr. Manuel Belgrano,JUJUY,215,220,406,315,721
38,38021,380210411,Dr. Manuel Belgrano,JUJUY,282,325,545,554,1099
38,38021,380210409,Dr. Manuel Belgrano,JUJUY,424,430,830,757,1587
38,38021,380210905,Dr. Manuel Belgrano,JUJUY,375,355,646,588,1234
38,38021,380210307,Dr. Manuel Belgrano,JUJUY,295,336,604,624,1228
38,38021,380210715,Dr. Manuel Belgrano,JUJUY,399,427,635,497,1132
38,38021,380210519,Dr. Manuel Belgrano,JUJUY,229,210,510,515,1025
38,38021,380211304,Dr. Manuel Belgrano,JUJUY,224,229,507,460,967
38,38021,380210303,Dr. Manuel Belgrano,JUJUY,64,64,101,108,209
38,38021,380210104,Dr. Manuel Belgrano,JUJUY,9,20,12,13,25
38,38021,380210101,Dr. Manuel Belgrano,JUJUY,21,34,23,22,45
38,38021,380211302,Dr. Manuel Belgrano,JUJUY,14,20,13,33,46
38,38021,380210105,Dr. Manuel Belgrano,JUJUY,135,176,218,230,448
38,38021,380210201,Dr. Manuel Belgrano,JUJUY,47,59,96,91,187
38,38021,380211516,Dr. Manuel Belgrano,JUJUY,90,469,158,145,303
38,38021,380211508,Dr. Manuel Belgrano,JUJUY,284,320,582,527,1109
38,38021,380211415,Dr. Manuel Belgrano,JUJUY,375,350,872,787,1659
38,38021,380211409,Dr. Manuel Belgrano,JUJUY,377,369,832,811,1643
38,38021,380211318,Dr. Manuel Belgrano,JUJUY,204,212,421,374,795
38,38021,380211217,Dr. Manuel Belgrano,JUJUY,254,272,508,452,960
38,38021,380211206,Dr. Manuel Belgrano,JUJUY,354,336,749,707,1456
38,38021,380211103,Dr. Manuel Belgrano,JUJUY,316,315,635,629,1264
38,38021,380211011,Dr. Manuel Belgrano,JUJUY,223,248,384,296,680
38,38021,380211009,Dr. Manuel Belgrano,JUJUY,402,406,654,560,1214
38,38021,380211007,Dr. Manuel Belgrano,JUJUY,352,331,669,669,1338
38,38021,380210918,Dr. Manuel Belgrano,JUJUY,417,419,726,656,1382
38,38021,380210917,Dr. Manuel Belgrano,JUJUY,328,292,660,602,1262
38,38021,380210909,Dr. Manuel Belgrano,JUJUY,245,265,404,355,759
38,38021,380210908,Dr. Manuel Belgrano,JUJUY,303,263,491,469,960
38,38021,380210826,Dr. Manuel Belgrano,JUJUY,261,218,479,412,891
38,38021,380210820,Dr. Manuel Belgrano,JUJUY,143,136,302,288,590
38,38021,380210807,Dr. Manuel Belgrano,JUJUY,394,360,728,691,1419
38,38021,380210805,Dr. Manuel Belgrano,JUJUY,292,237,505,480,985
38,38021,380210804,Dr. Manuel Belgrano,JUJUY,209,223,408,379,787
38,38021,380210716,Dr. Manuel Belgrano,JUJUY,439,439,726,631,1357
38,38021,380210611,Dr. Manuel Belgrano,JUJUY,256,266,502,477,979
38,38021,380210817,Dr. Manuel Belgrano,JUJUY,283,250,528,468,996
38,38021,380210719,Dr. Manuel Belgrano,JUJUY,294,258,580,532,1112
38,38021,380210710,Dr. Manuel Belgrano,JUJUY,250,341,467,287,754
38,38021,380210414,Dr. Manuel Belgrano,JUJUY,222,276,411,377,788
38,38021,380210413,Dr. Manuel Belgrano,JUJUY,300,301,621,642,1263
38,38021,380210522,Dr. Manuel Belgrano,JUJUY,276,255,596,538,1134
38,38021,380210508,Dr. Manuel Belgrano,JUJUY,250,218,480,482,962
38,38021,380210106,Dr. Manuel Belgrano,JUJUY,180,258,352,313,665
38,38021,380210204,Dr. Manuel Belgrano,JUJUY,5,5,6,9,15
38,38021,380210202,Dr. Manuel Belgrano,JUJUY,54,78,51,54,105
38,38021,380210402,Dr. Manuel Belgrano,JUJUY,100,127,188,206,394
38,38112,381120304,Yavi,JUJUY,54,111,90,121,211
38,38112,381120206,Yavi,JUJUY,51,125,104,83,187
38,38112,381120116,Yavi,JUJUY,228,227,404,350,754
38,38112,381120115,Yavi,JUJUY,231,249,508,404,912
38,38112,381120602,Yavi,JUJUY,51,68,89,68,157
38,38112,381120501,Yavi,JUJUY,68,175,102,85,187
38,38112,381120203,Yavi,JUJUY,48,103,81,81,162
38,38112,381120402,Yavi,JUJUY,49,142,86,74,160
38,38112,381120111,Yavi,JUJUY,264,278,566,500,1066
38,38112,381120109,Yavi,JUJUY,281,315,583,485,1068
38,38112,381120108,Yavi,JUJUY,268,291,575,491,1066
38,38112,381120103,Yavi,JUJUY,260,260,492,440,932
38,38112,381120503,Yavi,JUJUY,51,116,94,87,181
38,38112,381120302,Yavi,JUJUY,147,256,255,225,480
38,38112,381120114,Yavi,JUJUY,221,274,365,327,692
38,38112,381120110,Yavi,JUJUY,316,280,623,603,1226
38,38112,381120112,Yavi,JUJUY,261,270,509,458,967
38,38112,381120301,Yavi,JUJUY,40,104,54,51,105
38,38112,381120205,Yavi,JUJUY,259,345,573,536,1109
38,38112,381120204,Yavi,JUJUY,52,98,96,82,178
38,38112,381120101,Yavi,JUJUY,92,118,166,155,321
38,38112,381120202,Yavi,JUJUY,133,251,256,246,502
38,38112,381120113,Yavi,JUJUY,265,266,583,553,1136
38,38112,381120603,Yavi,JUJUY,27,57,34,38,72
38,38112,381120601,Yavi,JUJUY,41,65,63,44,107
38,38112,381120401,Yavi,JUJUY,19,64,25,24,49
38,38112,381120502,Yavi,JUJUY,114,313,208,194,402
38,38112,381120303,Yavi,JUJUY,116,269,202,155,357
38,38112,381120604,Yavi,JUJUY,61,131,125,108,233
38,38112,381120105,Yavi,JUJUY,218,311,421,344,765
38,38112,381120107,Yavi,JUJUY,239,275,495,424,919
38,38112,381120106,Yavi,JUJUY,242,256,462,422,884
38,38112,381120102,Yavi,JUJUY,238,277,460,376,836
38,38112,381120104,Yavi,JUJUY,310,304,592,521,1113
38,38112,381120117,Yavi,JUJUY,252,353,582,542,1124
38,38112,381120201,Yavi,JUJUY,58,108,109,77,186
38,38077,380770103,Santa Catalina,JUJUY,81,180,151,154,305
38,38077,380770202,Santa Catalina,JUJUY,82,138,173,174,347
38,38077,380770102,Santa Catalina,JUJUY,52,113,96,77,173
38,38077,380770201,Santa Catalina,JUJUY,54,106,64,73,137
38,38077,380770101,Santa Catalina,JUJUY,76,139,154,133,287
38,38077,380770303,Santa Catalina,JUJUY,80,126,119,100,219
38,38077,380770301,Santa Catalina,JUJUY,142,252,213,235,448
38,38077,380770304,Santa Catalina,JUJUY,64,130,134,109,243
38,38077,380770203,Santa Catalina,JUJUY,65,103,98,94,192
38,38077,380770302,Santa Catalina,JUJUY,72,150,85,78,163
38,38077,380770204,Santa Catalina,JUJUY,78,116,134,152,286
38,38063,380630111,San Pedro,JUJUY,211,210,461,501,962
38,38063,380630519,San Pedro,JUJUY,236,257,458,393,851
38,38063,380630407,San Pedro,JUJUY,358,341,658,586,1244
38,38063,380630616,San Pedro,JUJUY,294,279,626,581,1207
38,38063,380630109,San Pedro,JUJUY,169,284,356,402,758
38,38063,380630106,San Pedro,JUJUY,265,289,529,637,1166
38,38063,380630513,San Pedro,JUJUY,198,213,314,290,604
38,38063,380630614,San Pedro,JUJUY,279,294,561,539,1100
38,38063,380630611,San Pedro,JUJUY,228,234,431,415,846
38,38063,380630610,San Pedro,JUJUY,97,110,197,179,376
38,38063,380630606,San Pedro,JUJUY,97,227,164,128,292
38,38063,380630605,San Pedro,JUJUY,171,321,253,236,489
38,38063,380630518,San Pedro,JUJUY,211,212,432,422,854
38,38063,380630515,San Pedro,JUJUY,315,315,556,571,1127
38,38063,380630507,San Pedro,JUJUY,275,295,431,368,799
38,38063,380630501,San Pedro,JUJUY,316,338,657,645,1302
38,38063,380630617,San Pedro,JUJUY,244,223,527,491,1018
38,38063,380630204,San Pedro,JUJUY,106,122,205,241,446
38,38063,380630107,San Pedro,JUJUY,168,168,401,454,855
38,38063,380630612,San Pedro,JUJUY,210,244,368,342,710
38,38063,380630520,San Pedro,JUJUY,206,215,455,467,922
38,38063,380630411,San Pedro,JUJUY,225,243,407,365,772
38,38063,380630402,San Pedro,JUJUY,243,249,452,442,894
38,38063,380630409,San Pedro,JUJUY,290,293,528,504,1032
38,38063,380630112,San Pedro,JUJUY,24,31,55,54,109
38,38063,380630602,San Pedro,JUJUY,304,322,561,545,1106
38,38063,380630517,San Pedro,JUJUY,209,209,405,379,784
38,38063,380630403,San Pedro,JUJUY,268,291,503,427,930
38,38063,380630401,San Pedro,JUJUY,339,358,673,667,1340
38,38063,380630208,San Pedro,JUJUY,236,248,491,475,966
38,38063,380630206,San Pedro,JUJUY,365,382,649,666,1315
38,38063,380630421,San Pedro,JUJUY,264,276,545,479,1024
38,38063,380630124,San Pedro,JUJUY,449,403,817,729,1546
38,38063,380630509,San Pedro,JUJUY,251,260,586,562,1148
38,38063,380630103,San Pedro,JUJUY,288,348,529,576,1105
38,38063,380630101,San Pedro,JUJUY,23,28,20,30,50
38,38063,380630613,San Pedro,JUJUY,368,314,744,702,1446
38,38063,380630603,San Pedro,JUJUY,0,175,0,2,2
38,38063,380630514,San Pedro,JUJUY,285,285,487,411,898
38,38063,380630417,San Pedro,JUJUY,241,290,365,337,702
38,38063,380630416,San Pedro,JUJUY,232,283,376,329,705
38,38063,380630404,San Pedro,JUJUY,357,370,708,645,1353
38,38063,380630410,San Pedro,JUJUY,263,266,486,476,962
38,38063,380630203,San Pedro,JUJUY,156,198,303,288,591
38,38063,380630608,San Pedro,JUJUY,0,261,0,0,0
38,38063,380630607,San Pedro,JUJUY,335,344,705,636,1341
38,38063,380630604,San Pedro,JUJUY,25,331,29,45,74
38,38063,380630516,San Pedro,JUJUY,313,317,560,529,1089
38,38063,380630512,San Pedro,JUJUY,251,285,470,376,846
38,38063,380630508,San Pedro,JUJUY,300,300,587,526,1113
38,38063,380630502,San Pedro,JUJUY,349,378,735,751,1486
38,38063,380630413,San Pedro,JUJUY,376,359,738,720,1458
38,38063,380630412,San Pedro,JUJUY,233,231,463,434,897
38,38063,380630418,San Pedro,JUJUY,279,272,557,575,1132
38,38063,380630209,San Pedro,JUJUY,96,96,196,220,416
38,38063,380630104,San Pedro,JUJUY,292,404,559,628,1187
38,38063,380630303,San Pedro,JUJUY,174,224,254,384,638
38,38063,380630301,San Pedro,JUJUY,126,147,267,278,545
38,38063,380630609,San Pedro,JUJUY,151,230,283,275,558
38,38063,380630601,San Pedro,JUJUY,287,301,610,557,1167
38,38063,380630510,San Pedro,JUJUY,270,280,555,559,1114
38,38063,380630506,San Pedro,JUJUY,167,173,279,219,498
38,38063,380630419,San Pedro,JUJUY,264,270,471,450,921
38,38063,380630408,San Pedro,JUJUY,196,191,365,374,739
38,38063,380630119,San Pedro,JUJUY,336,214,845,871,1716
38,38063,380630110,San Pedro,JUJUY,253,260,536,517,1053
38,38063,380630202,San Pedro,JUJUY,100,189,145,188,333
38,38063,380630102,San Pedro,JUJUY,105,147,144,122,266
38,38063,380630201,San Pedro,JUJUY,40,47,57,69,126
38,38063,380630615,San Pedro,JUJUY,318,332,697,607,1304
38,38063,380630511,San Pedro,JUJUY,400,418,912,956,1868
38,38063,380630505,San Pedro,JUJUY,267,322,408,319,727
38,38063,380630504,San Pedro,JUJUY,250,332,381,333,714
38,38063,380630503,San Pedro,JUJUY,262,274,552,527,1079
38,38063,380630414,San Pedro,JUJUY,327,302,703,677,1380
38,38063,380630205,San Pedro,JUJUY,43,84,77,104,181
38,38063,380630406,San Pedro,JUJUY,316,316,716,724,1440
38,38063,380630405,San Pedro,JUJUY,371,355,688,671,1359
38,38063,380630207,San Pedro,JUJUY,359,380,652,702,1354
38,38063,380630420,San Pedro,JUJUY,315,331,640,653,1293
38,38063,380630618,San Pedro,JUJUY,226,242,501,442,943
38,38063,380630415,San Pedro,JUJUY,402,430,824,733,1557
38,38063,380630108,San Pedro,JUJUY,49,47,93,97,190
38,38063,380630302,San Pedro,JUJUY,59,70,99,128,227
38,38042,380420208,Palpalá,JUJUY,334,372,764,720,1484
38,38042,380420207,Palpalá,JUJUY,124,147,269,258,527
38,38042,380420612,Palpalá,JUJUY,210,191,465,422,887
38,38042,380420501,Palpalá,JUJUY,350,331,737,715,1452
38,38042,380420409,Palpalá,JUJUY,263,269,573,550,1123
38,38042,380420607,Palpalá,JUJUY,373,358,808,794,1602
38,38042,380420302,Palpalá,JUJUY,39,35,98,98,196
38,38042,380420204,Palpalá,JUJUY,73,100,109,149,258
38,38042,380420603,Palpalá,JUJUY,273,279,534,480,1014
38,38042,380420408,Palpalá,JUJUY,344,357,644,634,1278
38,38042,380420503,Palpalá,JUJUY,296,299,638,631,1269
38,38042,380420202,Palpalá,JUJUY,45,55,99,95,194
38,38042,380420103,Palpalá,JUJUY,14,23,19,26,45
38,38042,380420606,Palpalá,JUJUY,234,260,408,343,751
38,38042,380420601,Palpalá,JUJUY,236,245,501,435,936
38,38042,380420513,Palpalá,JUJUY,253,280,505,491,996
38,38042,380420508,Palpalá,JUJUY,239,224,468,434,902
38,38042,380420403,Palpalá,JUJUY,325,328,640,628,1268
38,38042,380420407,Palpalá,JUJUY,386,359,739,735,1474
38,38042,380420406,Palpalá,JUJUY,236,252,463,416,879
38,38042,380420104,Palpalá,JUJUY,162,353,277,306,583
38,38042,380420512,Palpalá,JUJUY,374,367,743,691,1434
38,38042,380420411,Palpalá,JUJUY,314,340,683,600,1283
38,38042,380420205,Palpalá,JUJUY,238,242,510,516,1026
38,38042,380420201,Palpalá,JUJUY,66,68,107,122,229
38,38042,380420101,Palpalá,JUJUY,63,82,68,100,168
38,38042,380420507,Palpalá,JUJUY,265,234,495,438,933
38,38042,380420414,Palpalá,JUJUY,374,413,816,811,1627
38,38042,380420402,Palpalá,JUJUY,346,365,651,644,1295
38,38042,380420412,Palpalá,JUJUY,142,289,277,269,546
38,38042,380420206,Palpalá,JUJUY,127,136,258,274,532
38,38042,380420405,Palpalá,JUJUY,243,240,560,471,1031
38,38042,380420605,Palpalá,JUJUY,233,250,422,382,804
38,38042,380420413,Palpalá,JUJUY,235,291,509,495,1004
38,38042,380420609,Palpalá,JUJUY,404,357,865,859,1724
38,38042,380420105,Palpalá,JUJUY,110,115,208,194,402
38,38042,380420611,Palpalá,JUJUY,231,203,485,455,940
38,38042,380420604,Palpalá,JUJUY,311,336,600,568,1168
38,38042,380420511,Palpalá,JUJUY,230,235,458,447,905
38,38042,380420509,Palpalá,JUJUY,354,341,642,617,1259
38,38042,380420505,Palpalá,JUJUY,263,273,574,599,1173
38,38042,380420504,Palpalá,JUJUY,271,265,529,539,1068
38,38042,380420502,Palpalá,JUJUY,287,283,607,604,1211
38,38042,380420410,Palpalá,JUJUY,261,280,592,523,1115
38,38042,380420404,Palpalá,JUJUY,354,360,726,745,1471
38,38042,380420608,Palpalá,JUJUY,267,287,523,476,999
38,38042,380420301,Palpalá,JUJUY,100,151,189,211,400
38,38042,380420203,Palpalá,JUJUY,3,5,1,4,5
38,38042,380420102,Palpalá,JUJUY,10,15,12,16,28
38,38042,380420613,Palpalá,JUJUY,296,286,616,619,1235
38,38042,380420610,Palpalá,JUJUY,353,313,816,777,1593
38,38042,380420602,Palpalá,JUJUY,322,317,506,511,1017
38,38042,380420510,Palpalá,JUJUY,266,266,462,462,924
38,38042,380420506,Palpalá,JUJUY,315,320,674,663,1337
38,38042,380420401,Palpalá,JUJUY,388,398,775,852,1627
38,38007,380070203,Cochinoca,JUJUY,44,122,51,48,99
38,38007,380070504,Cochinoca,JUJUY,79,169,109,108,217
38,38007,380070303,Cochinoca,JUJUY,92,193,159,141,300
38,38007,380070402,Cochinoca,JUJUY,73,147,149,125,274
38,38007,380070108,Cochinoca,JUJUY,325,370,657,587,1244
38,38007,380070107,Cochinoca,JUJUY,259,341,422,430,852
38,38007,380070405,Cochinoca,JUJUY,42,74,96,82,178
38,38007,380070105,Cochinoca,JUJUY,239,320,502,462,964
38,38007,380070401,Cochinoca,JUJUY,22,67,33,28,61
38,38007,380070503,Cochinoca,JUJUY,129,158,215,197,412
38,38007,380070111,Cochinoca,JUJUY,183,229,432,381,813
38,38007,380070301,Cochinoca,JUJUY,60,89,62,56,118
38,38007,380070403,Cochinoca,JUJUY,152,263,302,325,627
38,38007,380070101,Cochinoca,JUJUY,165,245,363,276,639
38,38007,380070204,Cochinoca,JUJUY,274,372,647,557,1204
38,38007,380070102,Cochinoca,JUJUY,39,147,65,58,123
38,38007,380070106,Cochinoca,JUJUY,196,259,371,377,748
38,38007,380070104,Cochinoca,JUJUY,57,131,137,118,255
38,38007,380070502,Cochinoca,JUJUY,36,79,70,54,124
38,38007,380070109,Cochinoca,JUJUY,284,323,654,569,1223
38,38007,380070404,Cochinoca,JUJUY,62,99,111,87,198
38,38007,380070202,Cochinoca,JUJUY,41,79,68,56,124
38,38007,380070302,Cochinoca,JUJUY,48,126,71,58,129
38,38007,380070110,Cochinoca,JUJUY,173,186,316,293,609
38,38007,380070205,Cochinoca,JUJUY,137,257,310,266,576
38,38007,380070103,Cochinoca,JUJUY,19,38,35,32,67
38,38007,380070501,Cochinoca,JUJUY,79,102,151,120,271
38,38007,380070201,Cochinoca,JUJUY,64,120,104,103,207
38,38105,381050302,Valle Grande,JUJUY,24,51,30,44,74
38,38105,381050402,Valle Grande,JUJUY,62,136,128,129,257
38,38105,381050102,Valle Grande,JUJUY,77,181,138,119,257
38,38105,381050205,Valle Grande,JUJUY,179,270,263,275,538
38,38105,381050203,Valle Grande,JUJUY,12,29,7,12,19
38,38105,381050301,Valle Grande,JUJUY,65,162,77,92,169
38,38105,381050101,Valle Grande,JUJUY,13,63,13,13,26
38,38105,381050303,Valle Grande,JUJUY,20,37,22,33,55
38,38105,381050201,Valle Grande,JUJUY,30,47,19,31,50
38,38105,381050103,Valle Grande,JUJUY,115,217,216,200,416
38,38105,381050202,Valle Grande,JUJUY,79,160,116,142,258
38,38105,381050204,Valle Grande,JUJUY,84,148,134,129,263
38,38105,381050401,Valle Grande,JUJUY,17,100,34,35,69
30,30035,300350111,Federal,ENTRE RÍOS,140,159,251,243,494
30,30035,300350112,Federal,ENTRE RÍOS,294,324,545,487,1032
30,30035,300350113,Federal,ENTRE RÍOS,275,327,383,341,724
30,30035,300350114,Federal,ENTRE RÍOS,189,213,329,333,662
30,30035,300350115,Federal,ENTRE RÍOS,216,218,426,356,782
30,30035,300350116,Federal,ENTRE RÍOS,318,363,572,553,1125
30,30035,300350117,Federal,ENTRE RÍOS,309,367,522,474,996
30,30035,300350118,Federal,ENTRE RÍOS,236,266,442,421,863
30,30035,300350119,Federal,ENTRE RÍOS,225,242,480,484,964
30,30035,300350201,Federal,ENTRE RÍOS,29,31,61,68,129
30,30035,300350202,Federal,ENTRE RÍOS,44,54,83,80,163
30,30035,300350203,Federal,ENTRE RÍOS,56,65,98,94,192
30,30035,300350204,Federal,ENTRE RÍOS,174,204,346,344,690
30,30035,300350205,Federal,ENTRE RÍOS,36,38,80,74,154
30,30035,300350206,Federal,ENTRE RÍOS,80,85,164,166,330
30,30035,300350301,Federal,ENTRE RÍOS,4,6,11,9,20
30,30035,300350302,Federal,ENTRE RÍOS,5,11,84,99,183
30,30035,300350303,Federal,ENTRE RÍOS,9,14,14,15,29
30,30035,300350304,Federal,ENTRE RÍOS,12,21,17,24,41
30,30035,300350305,Federal,ENTRE RÍOS,5,17,4,5,9
30,30035,300350401,Federal,ENTRE RÍOS,25,37,26,48,74
30,30035,300350402,Federal,ENTRE RÍOS,8,10,4,15,19
30,30035,300350403,Federal,ENTRE RÍOS,36,42,70,66,136
30,30035,300350404,Federal,ENTRE RÍOS,4,4,2,3,5
30,30035,300350405,Federal,ENTRE RÍOS,21,26,30,44,74
30,30035,300350406,Federal,ENTRE RÍOS,15,22,18,33,51
30,30035,300350407,Federal,ENTRE RÍOS,26,37,44,36,80
30,30035,300350408,Federal,ENTRE RÍOS,34,57,37,62,99
30,30035,300350409,Federal,ENTRE RÍOS,45,56,50,65,115
30,30035,300350410,Federal,ENTRE RÍOS,8,12,9,15,24
30,30035,300350411,Federal,ENTRE RÍOS,12,12,23,22,45
30,30035,300350412,Federal,ENTRE RÍOS,6,21,8,8,16
30,30035,300350413,Federal,ENTRE RÍOS,3,5,0,3,3
30,30035,300350414,Federal,ENTRE RÍOS,97,117,179,200,379
30,30035,300350101,Federal,ENTRE RÍOS,203,230,430,414,844
30,30035,300350102,Federal,ENTRE RÍOS,213,241,411,381,792
30,30035,300350103,Federal,ENTRE RÍOS,162,184,281,248,529
30,30035,300350104,Federal,ENTRE RÍOS,389,412,731,732,1463
30,30035,300350105,Federal,ENTRE RÍOS,297,336,554,550,1104
30,30035,300350106,Federal,ENTRE RÍOS,244,272,505,480,985
30,30035,300350107,Federal,ENTRE RÍOS,272,306,439,398,837
30,30035,300350108,Federal,ENTRE RÍOS,191,225,328,286,614
30,30035,300350109,Federal,ENTRE RÍOS,134,155,220,215,435
30,30035,300350110,Federal,ENTRE RÍOS,219,242,454,376,830
30,30035,300350501,Federal,ENTRE RÍOS,26,28,24,46,70
30,30035,300350502,Federal,ENTRE RÍOS,16,20,29,33,62
30,30035,300350503,Federal,ENTRE RÍOS,4,8,4,7,11
30,30035,300350504,Federal,ENTRE RÍOS,33,44,39,53,92
30,30035,300350505,Federal,ENTRE RÍOS,13,28,15,21,36
30,30035,300350506,Federal,ENTRE RÍOS,14,34,21,29,50
30,30035,300350507,Federal,ENTRE RÍOS,66,76,105,106,211
30,30035,300350601,Federal,ENTRE RÍOS,5,7,4,8,12
30,30035,300350602,Federal,ENTRE RÍOS,7,10,8,14,22
30,30035,300350603,Federal,ENTRE RÍOS,20,23,37,33,70
30,30035,300350604,Federal,ENTRE RÍOS,9,11,16,14,30
30,30035,300350605,Federal,ENTRE RÍOS,25,31,22,40,62
30,30035,300350606,Federal,ENTRE RÍOS,17,24,16,32,48
30,30035,300350701,Federal,ENTRE RÍOS,53,64,96,103,199
30,30035,300350702,Federal,ENTRE RÍOS,30,47,33,62,95
30,30035,300350703,Federal,ENTRE RÍOS,19,27,16,42,58
30,30035,300350704,Federal,ENTRE RÍOS,22,32,24,36,60
30,30035,300350705,Federal,ENTRE RÍOS,24,31,21,31,52
30,30035,300350706,Federal,ENTRE RÍOS,37,57,44,69,113
30,30035,300350801,Federal,ENTRE RÍOS,26,29,19,48,67
30,30035,300350802,Federal,ENTRE RÍOS,39,29,76,73,149
30,30035,300350803,Federal,ENTRE RÍOS,28,34,35,43,78
30,30035,300350804,Federal,ENTRE RÍOS,41,48,69,91,160
30,30035,300350805,Federal,ENTRE RÍOS,27,35,42,51,93
30,30035,300350901,Federal,ENTRE RÍOS,24,35,24,43,67
30,30035,300350902,Federal,ENTRE RÍOS,34,40,37,53,90
30,30035,300350903,Federal,ENTRE RÍOS,10,23,12,14,26
30,30035,300350904,Federal,ENTRE RÍOS,5,6,3,12,15
30,30035,300350905,Federal,ENTRE RÍOS,29,37,40,43,83
30,30035,300350906,Federal,ENTRE RÍOS,10,15,13,23,36
30,30035,300350907,Federal,ENTRE RÍOS,8,12,14,18,32
30,30035,300351001,Federal,ENTRE RÍOS,1,3,3,1,4
30,30035,300351002,Federal,ENTRE RÍOS,4,7,7,6,13
30,30035,300351003,Federal,ENTRE RÍOS,28,36,38,47,85
30,30035,300351004,Federal,ENTRE RÍOS,13,18,21,19,40
30,30035,300351005,Federal,ENTRE RÍOS,86,103,162,152,314
30,30035,300351006,Federal,ENTRE RÍOS,92,105,160,166,326
30,30035,300351007,Federal,ENTRE RÍOS,200,243,351,348,699
30,30035,300351101,Federal,ENTRE RÍOS,18,18,14,25,39
30,30035,300351102,Federal,ENTRE RÍOS,37,63,64,50,114
30,30035,300351103,Federal,ENTRE RÍOS,352,401,577,593,1170
30,30035,300351104,Federal,ENTRE RÍOS,195,233,318,267,585
30,30035,300351105,Federal,ENTRE RÍOS,207,228,350,331,681
30,30035,300351106,Federal,ENTRE RÍOS,134,148,210,199,409
30,30063,300630104,Islas del Ibicuy,ENTRE RÍOS,43,81,53,64,117
30,30063,300630105,Islas del Ibicuy,ENTRE RÍOS,33,52,61,49,110
30,30063,300630106,Islas del Ibicuy,ENTRE RÍOS,11,18,15,15,30
30,30063,300630107,Islas del Ibicuy,ENTRE RÍOS,50,122,83,85,168
30,30063,300630108,Islas del Ibicuy,ENTRE RÍOS,41,104,45,74,119
30,30063,300630109,Islas del Ibicuy,ENTRE RÍOS,6,20,9,14,23
30,30063,300630110,Islas del Ibicuy,ENTRE RÍOS,265,313,466,498,964
30,30063,300630111,Islas del Ibicuy,ENTRE RÍOS,243,283,455,521,976
30,30063,300630201,Islas del Ibicuy,ENTRE RÍOS,37,53,49,64,113
30,30063,300630202,Islas del Ibicuy,ENTRE RÍOS,17,32,26,23,49
30,30063,300630203,Islas del Ibicuy,ENTRE RÍOS,66,89,106,129,235
30,30063,300630204,Islas del Ibicuy,ENTRE RÍOS,274,305,530,520,1050
30,30063,300630205,Islas del Ibicuy,ENTRE RÍOS,327,363,643,599,1242
30,30063,300630206,Islas del Ibicuy,ENTRE RÍOS,293,343,484,490,974
30,30063,300630207,Islas del Ibicuy,ENTRE RÍOS,274,333,564,532,1096
30,30063,300630301,Islas del Ibicuy,ENTRE RÍOS,43,71,14,56,70
30,30063,300630302,Islas del Ibicuy,ENTRE RÍOS,17,33,29,28,57
30,30063,300630303,Islas del Ibicuy,ENTRE RÍOS,28,30,31,52,83
30,30063,300630304,Islas del Ibicuy,ENTRE RÍOS,179,243,274,300,574
30,30063,300630401,Islas del Ibicuy,ENTRE RÍOS,3,4,0,3,3
30,30063,300630402,Islas del Ibicuy,ENTRE RÍOS,1,4,0,1,1
30,30063,300630403,Islas del Ibicuy,ENTRE RÍOS,6,8,3,8,11
30,30063,300630404,Islas del Ibicuy,ENTRE RÍOS,5,21,9,10,19
30,30063,300630405,Islas del Ibicuy,ENTRE RÍOS,14,19,18,25,43
30,30063,300630406,Islas del Ibicuy,ENTRE RÍOS,50,55,89,92,181
30,30063,300630407,Islas del Ibicuy,ENTRE RÍOS,14,18,17,26,43
30,30063,300630408,Islas del Ibicuy,ENTRE RÍOS,16,19,20,25,45
30,30063,300630409,Islas del Ibicuy,ENTRE RÍOS,14,19,18,23,41
30,30063,300630410,Islas del Ibicuy,ENTRE RÍOS,1,2,0,1,1
30,30063,300630411,Islas del Ibicuy,ENTRE RÍOS,3,9,0,3,3
30,30063,300630412,Islas del Ibicuy,ENTRE RÍOS,181,210,373,346,719
30,30063,300630413,Islas del Ibicuy,ENTRE RÍOS,259,340,501,510,1011
30,30063,300630501,Islas del Ibicuy,ENTRE RÍOS,23,36,20,37,57
30,30063,300630502,Islas del Ibicuy,ENTRE RÍOS,39,48,65,65,130
30,30063,300630101,Islas del Ibicuy,ENTRE RÍOS,30,76,31,58,89
30,30063,300630102,Islas del Ibicuy,ENTRE RÍOS,23,25,23,31,54
30,30063,300630103,Islas del Ibicuy,ENTRE RÍOS,100,142,137,188,325
30,30063,300630503,Islas del Ibicuy,ENTRE RÍOS,8,11,10,17,27
30,30063,300630504,Islas del Ibicuy,ENTRE RÍOS,33,51,60,59,119
30,30063,300630505,Islas del Ibicuy,ENTRE RÍOS,76,109,99,118,217
30,30063,300630506,Islas del Ibicuy,ENTRE RÍOS,7,12,10,13,23
30,30063,300630507,Islas del Ibicuy,ENTRE RÍOS,31,47,58,60,118
30,30063,300630508,Islas del Ibicuy,ENTRE RÍOS,128,194,175,204,379
30,30063,300630509,Islas del Ibicuy,ENTRE RÍOS,53,155,75,78,153
30,30063,300630510,Islas del Ibicuy,ENTRE RÍOS,10,17,16,15,31
30,30063,300630511,Islas del Ibicuy,ENTRE RÍOS,14,31,13,24,37
30,30063,300630512,Islas del Ibicuy,ENTRE RÍOS,51,81,50,83,133
30,30063,300630513,Islas del Ibicuy,ENTRE RÍOS,4,32,3,6,9
30,30063,300630514,Islas del Ibicuy,ENTRE RÍOS,1,12,3,2,5
30,30084,300840616,Paraná,ENTRE RÍOS,303,316,457,364,821
30,30084,300840617,Paraná,ENTRE RÍOS,281,338,450,311,761
30,30084,300840618,Paraná,ENTRE RÍOS,254,367,357,276,633
30,30084,300840619,Paraná,ENTRE RÍOS,281,327,400,362,762
30,30084,300840620,Paraná,ENTRE RÍOS,343,393,446,428,874
30,30084,300840621,Paraná,ENTRE RÍOS,309,305,474,379,853
30,30084,300840622,Paraná,ENTRE RÍOS,219,233,359,308,667
30,30084,300840623,Paraná,ENTRE RÍOS,272,306,400,355,755
30,30084,300840701,Paraná,ENTRE RÍOS,292,332,474,392,866
30,30084,300840702,Paraná,ENTRE RÍOS,273,299,431,282,713
30,30084,300840703,Paraná,ENTRE RÍOS,120,160,156,100,256
30,30084,300840704,Paraná,ENTRE RÍOS,109,131,136,62,198
30,30084,300840705,Paraná,ENTRE RÍOS,154,212,203,135,338
30,30084,300840706,Paraná,ENTRE RÍOS,210,254,312,231,543
30,30084,300840707,Paraná,ENTRE RÍOS,154,198,280,174,454
30,30084,300840708,Paraná,ENTRE RÍOS,325,392,435,350,785
30,30084,300840709,Paraná,ENTRE RÍOS,380,400,537,463,1000
30,30084,300840710,Paraná,ENTRE RÍOS,339,381,470,382,852
30,30084,300840711,Paraná,ENTRE RÍOS,356,435,499,360,859
30,30084,300840712,Paraná,ENTRE RÍOS,326,381,514,381,895
30,30084,300840713,Paraná,ENTRE RÍOS,330,308,714,668,1382
30,30084,300840714,Paraná,ENTRE RÍOS,390,363,684,646,1330
30,30084,300840715,Paraná,ENTRE RÍOS,311,350,524,447,971
30,30084,300840801,Paraná,ENTRE RÍOS,203,206,360,326,686
30,30084,300840802,Paraná,ENTRE RÍOS,300,315,536,513,1049
30,30084,300840803,Paraná,ENTRE RÍOS,240,201,452,382,834
30,30084,300840804,Paraná,ENTRE RÍOS,351,342,626,570,1196
30,30084,300840805,Paraná,ENTRE RÍOS,385,402,672,590,1262
30,30084,300840806,Paraná,ENTRE RÍOS,300,316,551,533,1084
30,30084,300840807,Paraná,ENTRE RÍOS,332,353,540,465,1005
30,30084,300840808,Paraná,ENTRE RÍOS,185,204,293,275,568
30,30084,300840809,Paraná,ENTRE RÍOS,236,251,390,372,762
30,30084,300840810,Paraná,ENTRE RÍOS,305,299,573,517,1090
30,30084,300840811,Paraná,ENTRE RÍOS,298,313,463,408,871
30,30084,300840101,Paraná,ENTRE RÍOS,273,290,485,489,974
30,30084,300840102,Paraná,ENTRE RÍOS,246,250,492,489,981
30,30084,300840103,Paraná,ENTRE RÍOS,105,136,183,188,371
30,30084,300840104,Paraná,ENTRE RÍOS,294,299,570,562,1132
30,30084,300840105,Paraná,ENTRE RÍOS,276,309,538,514,1052
30,30084,300840106,Paraná,ENTRE RÍOS,194,193,401,376,777
30,30084,300840107,Paraná,ENTRE RÍOS,180,196,337,333,670
30,30084,300840108,Paraná,ENTRE RÍOS,373,395,789,764,1553
30,30084,300840109,Paraná,ENTRE RÍOS,116,126,218,215,433
30,30084,300840110,Paraná,ENTRE RÍOS,200,187,394,382,776
30,30084,300840111,Paraná,ENTRE RÍOS,351,354,778,779,1557
30,30084,300840112,Paraná,ENTRE RÍOS,324,323,642,629,1271
30,30084,300840113,Paraná,ENTRE RÍOS,354,340,693,625,1318
30,30084,300840114,Paraná,ENTRE RÍOS,401,412,797,788,1585
30,30084,300840201,Paraná,ENTRE RÍOS,223,230,411,429,840
30,30084,300840202,Paraná,ENTRE RÍOS,170,227,256,207,463
30,30084,300840203,Paraná,ENTRE RÍOS,235,280,327,264,591
30,30084,300840204,Paraná,ENTRE RÍOS,196,271,272,217,489
30,30084,300840205,Paraná,ENTRE RÍOS,326,436,461,374,835
30,30084,300840206,Paraná,ENTRE RÍOS,187,238,252,204,456
30,30084,300840207,Paraná,ENTRE RÍOS,174,201,242,242,484
30,30084,300840208,Paraná,ENTRE RÍOS,305,284,649,624,1273
30,30084,300840209,Paraná,ENTRE RÍOS,232,287,326,268,594
30,30084,300840210,Paraná,ENTRE RÍOS,128,185,163,153,316
30,30084,300840211,Paraná,ENTRE RÍOS,197,240,312,216,528
30,30084,300840212,Paraná,ENTRE RÍOS,250,414,312,253,565
30,30084,300840213,Paraná,ENTRE RÍOS,254,413,343,260,603
30,30084,300840214,Paraná,ENTRE RÍOS,158,191,240,219,459
30,30084,300840215,Paraná,ENTRE RÍOS,251,289,391,310,701
30,30084,300840216,Paraná,ENTRE RÍOS,326,318,594,517,1111
30,30084,300840217,Paraná,ENTRE RÍOS,272,309,396,347,743
30,30084,300840218,Paraná,ENTRE RÍOS,247,291,351,274,625
30,30084,300840219,Paraná,ENTRE RÍOS,223,272,320,266,586
30,30084,300840220,Paraná,ENTRE RÍOS,206,289,298,188,486
30,30084,300840221,Paraná,ENTRE RÍOS,208,301,261,208,469
30,30084,300840222,Paraná,ENTRE RÍOS,168,293,223,150,373
30,30084,300840223,Paraná,ENTRE RÍOS,167,279,177,128,305
30,30084,300840224,Paraná,ENTRE RÍOS,157,290,204,121,325
30,30084,300840301,Paraná,ENTRE RÍOS,335,379,436,383,819
30,30084,300840302,Paraná,ENTRE RÍOS,298,302,574,552,1126
30,30084,300840303,Paraná,ENTRE RÍOS,246,264,434,406,840
30,30084,300840304,Paraná,ENTRE RÍOS,238,256,379,316,695
30,30084,300840305,Paraná,ENTRE RÍOS,414,423,868,804,1672
30,30084,300840306,Paraná,ENTRE RÍOS,266,331,368,303,671
30,30084,300840307,Paraná,ENTRE RÍOS,209,282,269,205,474
30,30084,300840308,Paraná,ENTRE RÍOS,218,279,320,223,543
30,30084,300840309,Paraná,ENTRE RÍOS,268,370,357,260,617
30,30084,300840310,Paraná,ENTRE RÍOS,305,352,497,393,890
30,30084,300840311,Paraná,ENTRE RÍOS,264,309,382,321,703
30,30084,300840312,Paraná,ENTRE RÍOS,219,248,284,239,523
30,30084,300840313,Paraná,ENTRE RÍOS,181,234,205,136,341
30,30084,300840314,Paraná,ENTRE RÍOS,319,400,465,337,802
30,30084,300840315,Paraná,ENTRE RÍOS,143,180,378,225,603
30,30084,300840316,Paraná,ENTRE RÍOS,194,231,266,239,505
30,30084,300840317,Paraná,ENTRE RÍOS,233,270,321,242,563
30,30084,300840318,Paraná,ENTRE RÍOS,426,544,566,426,992
30,30084,300840319,Paraná,ENTRE RÍOS,116,169,133,98,231
30,30084,300840320,Paraná,ENTRE RÍOS,221,303,296,202,498
30,30084,300840321,Paraná,ENTRE RÍOS,175,267,197,172,369
30,30084,300840322,Paraná,ENTRE RÍOS,110,191,146,98,244
30,30084,300840323,Paraná,ENTRE RÍOS,170,265,206,148,354
30,30084,300840401,Paraná,ENTRE RÍOS,328,317,616,601,1217
30,30084,300840402,Paraná,ENTRE RÍOS,249,260,558,542,1100
30,30084,300840403,Paraná,ENTRE RÍOS,112,145,166,174,340
30,30084,300840404,Paraná,ENTRE RÍOS,370,374,616,536,1152
30,30084,300840405,Paraná,ENTRE RÍOS,281,290,464,412,876
30,30084,300840406,Paraná,ENTRE RÍOS,237,222,427,363,790
30,30084,300840407,Paraná,ENTRE RÍOS,197,184,307,268,575
30,30084,300840408,Paraná,ENTRE RÍOS,242,243,416,382,798
30,30084,300840409,Paraná,ENTRE RÍOS,345,352,638,572,1210
30,30084,300840410,Paraná,ENTRE RÍOS,244,247,469,470,939
30,30084,300840411,Paraná,ENTRE RÍOS,396,379,725,690,1415
30,30084,300840412,Paraná,ENTRE RÍOS,289,315,548,658,1206
30,30084,300840413,Paraná,ENTRE RÍOS,231,248,403,365,768
30,30084,300840414,Paraná,ENTRE RÍOS,288,293,491,416,907
30,30084,300840415,Paraná,ENTRE RÍOS,400,399,741,733,1474
30,30084,300840416,Paraná,ENTRE RÍOS,390,363,704,577,1281
30,30084,300840417,Paraná,ENTRE RÍOS,345,372,557,483,1040
30,30084,300840418,Paraná,ENTRE RÍOS,307,285,555,544,1099
30,30084,300840419,Paraná,ENTRE RÍOS,151,150,280,272,552
30,30084,300840420,Paraná,ENTRE RÍOS,231,224,388,376,764
30,30084,300840421,Paraná,ENTRE RÍOS,240,266,411,338,749
30,30084,300840501,Paraná,ENTRE RÍOS,392,388,603,484,1087
30,30084,300840502,Paraná,ENTRE RÍOS,242,271,405,335,740
30,30084,300840503,Paraná,ENTRE RÍOS,257,243,462,412,874
30,30084,300840504,Paraná,ENTRE RÍOS,339,347,528,500,1028
30,30084,300840505,Paraná,ENTRE RÍOS,508,522,916,798,1714
30,30084,300840506,Paraná,ENTRE RÍOS,224,210,411,368,779
30,30084,300840507,Paraná,ENTRE RÍOS,233,235,396,375,771
30,30084,300840508,Paraná,ENTRE RÍOS,306,312,558,535,1093
30,30084,300840509,Paraná,ENTRE RÍOS,184,206,347,320,667
30,30084,300840510,Paraná,ENTRE RÍOS,237,244,383,360,743
30,30084,300840511,Paraná,ENTRE RÍOS,174,190,321,307,628
30,30084,300840512,Paraná,ENTRE RÍOS,330,336,589,551,1140
30,30084,300840513,Paraná,ENTRE RÍOS,227,218,434,387,821
30,30084,300840514,Paraná,ENTRE RÍOS,370,378,688,631,1319
30,30084,300840515,Paraná,ENTRE RÍOS,211,205,361,343,704
30,30084,300840516,Paraná,ENTRE RÍOS,373,384,601,555,1156
30,30084,300840517,Paraná,ENTRE RÍOS,271,293,461,431,892
30,30084,300840518,Paraná,ENTRE RÍOS,235,250,376,314,690
30,30084,300840519,Paraná,ENTRE RÍOS,220,234,360,303,663
30,30084,300840520,Paraná,ENTRE RÍOS,279,279,465,383,848
30,30084,300840521,Paraná,ENTRE RÍOS,214,237,296,265,561
30,30084,300840522,Paraná,ENTRE RÍOS,350,382,510,408,918
30,30084,300840523,Paraná,ENTRE RÍOS,370,394,574,479,1053
30,30084,300840524,Paraná,ENTRE RÍOS,347,374,555,425,980
30,30084,300840601,Paraná,ENTRE RÍOS,332,395,411,267,678
30,30084,300840602,Paraná,ENTRE RÍOS,104,148,118,83,201
30,30084,300840603,Paraná,ENTRE RÍOS,186,233,252,204,456
30,30084,300840604,Paraná,ENTRE RÍOS,309,361,448,352,800
30,30084,300840605,Paraná,ENTRE RÍOS,211,309,244,166,410
30,30084,300840606,Paraná,ENTRE RÍOS,191,267,259,197,456
30,30084,300840607,Paraná,ENTRE RÍOS,186,253,227,171,398
30,30084,300840608,Paraná,ENTRE RÍOS,335,385,481,388,869
30,30084,300840609,Paraná,ENTRE RÍOS,134,172,185,151,336
30,30084,300840610,Paraná,ENTRE RÍOS,81,113,85,57,142
30,30084,300840611,Paraná,ENTRE RÍOS,125,129,173,132,305
30,30084,300840612,Paraná,ENTRE RÍOS,245,305,434,300,734
30,30084,300840613,Paraná,ENTRE RÍOS,164,195,197,184,381
30,30084,300840614,Paraná,ENTRE RÍOS,177,214,231,181,412
30,30084,300840615,Paraná,ENTRE RÍOS,264,315,414,292,706
30,30084,300840812,Paraná,ENTRE RÍOS,252,246,458,464,922
30,30084,300840813,Paraná,ENTRE RÍOS,44,8,33,51,84
30,30084,300840814,Paraná,ENTRE RÍOS,338,334,535,487,1022
30,30084,300840815,Paraná,ENTRE RÍOS,293,308,500,482,982
30,30084,300840816,Paraná,ENTRE RÍOS,317,280,590,607,1197
30,30084,300840817,Paraná,ENTRE RÍOS,278,282,517,468,985
30,30084,300840818,Paraná,ENTRE RÍOS,348,368,608,564,1172
30,30084,300840819,Paraná,ENTRE RÍOS,364,389,642,584,1226
30,30084,300840820,Paraná,ENTRE RÍOS,317,325,526,471,997
30,30084,300840821,Paraná,ENTRE RÍOS,383,410,657,629,1286
30,30084,300840822,Paraná,ENTRE RÍOS,348,381,615,576,1191
30,30084,300840823,Paraná,ENTRE RÍOS,184,203,311,287,598
30,30084,300840901,Paraná,ENTRE RÍOS,313,380,450,368,818
30,30084,300840902,Paraná,ENTRE RÍOS,286,309,419,367,786
30,30084,300840903,Paraná,ENTRE RÍOS,137,153,194,180,374
30,30084,300840904,Paraná,ENTRE RÍOS,303,330,484,358,842
30,30084,300840905,Paraná,ENTRE RÍOS,155,170,277,209,486
30,30084,300840906,Paraná,ENTRE RÍOS,237,263,379,325,704
30,30084,300840907,Paraná,ENTRE RÍOS,435,455,736,638,1374
30,30084,300840908,Paraná,ENTRE RÍOS,131,138,208,509,717
30,30084,300840909,Paraná,ENTRE RÍOS,328,342,517,486,1003
30,30084,300840910,Paraná,ENTRE RÍOS,246,255,392,308,700
30,30084,300840911,Paraná,ENTRE RÍOS,332,345,586,476,1062
30,30084,300840912,Paraná,ENTRE RÍOS,270,275,433,420,853
30,30084,300840913,Paraná,ENTRE RÍOS,366,379,605,537,1142
30,30084,300840914,Paraná,ENTRE RÍOS,303,325,519,472,991
30,30084,300840915,Paraná,ENTRE RÍOS,134,141,221,216,437
30,30084,300840916,Paraná,ENTRE RÍOS,270,275,496,482,978
30,30084,300840917,Paraná,ENTRE RÍOS,361,392,596,570,1166
30,30084,300841001,Paraná,ENTRE RÍOS,280,304,435,364,799
30,30084,300841002,Paraná,ENTRE RÍOS,267,262,480,475,955
30,30084,300841003,Paraná,ENTRE RÍOS,263,281,456,411,867
30,30084,300841004,Paraná,ENTRE RÍOS,181,196,278,224,502
30,30084,300841005,Paraná,ENTRE RÍOS,212,224,314,285,599
30,30084,300841006,Paraná,ENTRE RÍOS,216,282,299,304,603
30,30084,300841007,Paraná,ENTRE RÍOS,258,266,384,349,733
30,30084,300841008,Paraná,ENTRE RÍOS,304,329,487,424,911
30,30084,300841009,Paraná,ENTRE RÍOS,321,330,549,528,1077
30,30084,300841010,Paraná,ENTRE RÍOS,222,232,344,291,635
30,30084,300841011,Paraná,ENTRE RÍOS,297,310,449,412,861
30,30084,300841012,Paraná,ENTRE RÍOS,239,253,399,361,760
30,30084,300841013,Paraná,ENTRE RÍOS,243,242,433,380,813
30,30084,300841014,Paraná,ENTRE RÍOS,351,382,625,598,1223
30,30084,300841015,Paraná,ENTRE RÍOS,319,335,632,526,1158
30,30084,300841016,Paraná,ENTRE RÍOS,207,217,338,256,594
30,30084,300841017,Paraná,ENTRE RÍOS,325,359,533,532,1065
30,30084,300841018,Paraná,ENTRE RÍOS,313,278,644,575,1219
30,30084,300841019,Paraná,ENTRE RÍOS,160,184,240,267,507
30,30084,300841020,Paraná,ENTRE RÍOS,352,349,650,624,1274
30,30084,300841021,Paraná,ENTRE RÍOS,292,307,490,467,957
30,30084,300841101,Paraná,ENTRE RÍOS,108,116,167,140,307
30,30084,300841102,Paraná,ENTRE RÍOS,241,258,446,392,838
30,30084,300841103,Paraná,ENTRE RÍOS,315,341,668,600,1268
30,30084,300841104,Paraná,ENTRE RÍOS,244,250,567,515,1082
30,30084,300841105,Paraná,ENTRE RÍOS,121,132,235,195,430
30,30084,300841106,Paraná,ENTRE RÍOS,320,298,657,633,1290
30,30084,300841107,Paraná,ENTRE RÍOS,376,348,628,561,1189
30,30084,300841108,Paraná,ENTRE RÍOS,247,248,390,393,783
30,30084,300841109,Paraná,ENTRE RÍOS,71,72,120,102,222
30,30084,300841110,Paraná,ENTRE RÍOS,407,399,794,738,1532
30,30084,300841111,Paraná,ENTRE RÍOS,273,299,520,460,980
30,30084,300841112,Paraná,ENTRE RÍOS,249,207,423,406,829
30,30084,300841113,Paraná,ENTRE RÍOS,183,173,343,313,656
30,30084,300841114,Paraná,ENTRE RÍOS,314,348,597,574,1171
30,30084,300841201,Paraná,ENTRE RÍOS,79,121,141,142,283
30,30084,300841202,Paraná,ENTRE RÍOS,185,215,297,304,601
30,30084,300841203,Paraná,ENTRE RÍOS,50,68,79,92,171
30,30084,300841204,Paraná,ENTRE RÍOS,53,80,77,83,160
30,30084,300841205,Paraná,ENTRE RÍOS,239,249,440,427,867
30,30084,300841206,Paraná,ENTRE RÍOS,71,98,112,118,230
30,30084,300841207,Paraná,ENTRE RÍOS,290,281,438,332,770
30,30084,300841208,Paraná,ENTRE RÍOS,56,89,95,105,200
30,30084,300841209,Paraná,ENTRE RÍOS,56,77,70,88,158
30,30084,300841210,Paraná,ENTRE RÍOS,137,150,266,270,536
30,30084,300841211,Paraná,ENTRE RÍOS,168,186,296,336,632
30,30084,300841212,Paraná,ENTRE RÍOS,7,18,20,14,34
30,30084,300841301,Paraná,ENTRE RÍOS,295,299,620,607,1227
30,30084,300841302,Paraná,ENTRE RÍOS,190,216,327,344,671
30,30084,300841303,Paraná,ENTRE RÍOS,46,50,77,87,164
30,30084,300841304,Paraná,ENTRE RÍOS,188,199,320,341,661
30,30084,300841305,Paraná,ENTRE RÍOS,42,44,87,111,198
30,30084,300841306,Paraná,ENTRE RÍOS,161,185,338,318,656
30,30084,300841307,Paraná,ENTRE RÍOS,184,182,308,327,635
30,30084,300841401,Paraná,ENTRE RÍOS,290,279,541,464,1005
30,30084,300841402,Paraná,ENTRE RÍOS,369,397,652,563,1215
30,30084,300841403,Paraná,ENTRE RÍOS,298,324,537,486,1023
30,30084,300841404,Paraná,ENTRE RÍOS,341,358,611,572,1183
30,30084,300841405,Paraná,ENTRE RÍOS,306,322,622,629,1251
30,30084,300841406,Paraná,ENTRE RÍOS,402,408,733,692,1425
30,30084,300841407,Paraná,ENTRE RÍOS,382,428,650,577,1227
30,30084,300841408,Paraná,ENTRE RÍOS,237,273,373,342,715
30,30084,300841409,Paraná,ENTRE RÍOS,305,306,526,493,1019
30,30084,300841410,Paraná,ENTRE RÍOS,273,303,566,488,1054
30,30084,300841411,Paraná,ENTRE RÍOS,302,331,549,505,1054
30,30084,300841412,Paraná,ENTRE RÍOS,349,372,640,635,1275
30,30084,300841413,Paraná,ENTRE RÍOS,159,166,286,287,573
30,30084,300841414,Paraná,ENTRE RÍOS,344,363,617,572,1189
30,30084,300841415,Paraná,ENTRE RÍOS,124,131,217,197,414
30,30084,300841416,Paraná,ENTRE RÍOS,295,313,516,506,1022
30,30084,300841417,Paraná,ENTRE RÍOS,342,361,631,632,1263
30,30084,300841501,Paraná,ENTRE RÍOS,276,284,490,448,938
30,30084,300841502,Paraná,ENTRE RÍOS,139,155,260,255,515
30,30084,300841503,Paraná,ENTRE RÍOS,404,432,699,665,1364
30,30084,300841504,Paraná,ENTRE RÍOS,281,288,513,470,983
30,30084,300841505,Paraná,ENTRE RÍOS,144,147,267,248,515
30,30084,300841506,Paraná,ENTRE RÍOS,347,304,634,621,1255
30,30084,300841507,Paraná,ENTRE RÍOS,355,349,687,657,1344
30,30084,300841508,Paraná,ENTRE RÍOS,349,371,625,585,1210
30,30084,300841509,Paraná,ENTRE RÍOS,196,306,357,334,691
30,30084,300841510,Paraná,ENTRE RÍOS,277,276,457,498,955
30,30084,300841511,Paraná,ENTRE RÍOS,161,164,275,257,532
30,30084,300841512,Paraná,ENTRE RÍOS,334,339,655,592,1247
30,30084,300841513,Paraná,ENTRE RÍOS,4,5,7,6,13
30,30084,300841601,Paraná,ENTRE RÍOS,311,304,623,622,1245
30,30084,300841602,Paraná,ENTRE RÍOS,242,259,390,363,753
30,30084,300841603,Paraná,ENTRE RÍOS,293,317,489,455,944
30,30084,300841604,Paraná,ENTRE RÍOS,225,237,409,371,780
30,30084,300841605,Paraná,ENTRE RÍOS,200,216,323,294,617
30,30084,300841606,Paraná,ENTRE RÍOS,298,299,491,485,976
30,30084,300841607,Paraná,ENTRE RÍOS,336,336,533,477,1010
30,30084,300841608,Paraná,ENTRE RÍOS,350,363,566,564,1130
30,30084,300841609,Paraná,ENTRE RÍOS,266,263,458,430,888
30,30084,300841610,Paraná,ENTRE RÍOS,284,317,484,471,955
30,30084,300841611,Paraná,ENTRE RÍOS,319,357,570,556,1126
30,30084,300841701,Paraná,ENTRE RÍOS,122,113,224,243,467
30,30084,300841702,Paraná,ENTRE RÍOS,286,266,593,558,1151
30,30084,300841703,Paraná,ENTRE RÍOS,276,265,506,464,970
30,30084,300841704,Paraná,ENTRE RÍOS,273,311,488,440,928
30,30084,300841705,Paraná,ENTRE RÍOS,246,251,427,390,817
30,30084,300841706,Paraná,ENTRE RÍOS,168,163,313,248,561
30,30084,300841707,Paraná,ENTRE RÍOS,387,377,689,628,1317
30,30084,300841708,Paraná,ENTRE RÍOS,283,270,590,533,1123
30,30084,300841709,Paraná,ENTRE RÍOS,281,270,584,534,1118
30,30084,300841710,Paraná,ENTRE RÍOS,327,296,680,637,1317
30,30084,300841711,Paraná,ENTRE RÍOS,260,258,461,449,910
30,30084,300841712,Paraná,ENTRE RÍOS,223,228,422,393,815
30,30084,300841713,Paraná,ENTRE RÍOS,315,294,544,495,1039
30,30084,300841714,Paraná,ENTRE RÍOS,404,400,834,714,1548
30,30084,300841715,Paraná,ENTRE RÍOS,265,244,544,539,1083
30,30084,300841716,Paraná,ENTRE RÍOS,210,207,435,426,861
30,30084,300841717,Paraná,ENTRE RÍOS,204,208,404,424,828
30,30084,300841718,Paraná,ENTRE RÍOS,195,174,401,412,813
30,30084,300841719,Paraná,ENTRE RÍOS,355,361,805,775,1580
30,30084,300841801,Paraná,ENTRE RÍOS,29,38,50,55,105
30,30084,300841802,Paraná,ENTRE RÍOS,276,285,556,513,1069
30,30084,300841803,Paraná,ENTRE RÍOS,128,157,238,203,441
30,30084,300841804,Paraná,ENTRE RÍOS,97,116,168,178,346
30,30084,300841901,Paraná,ENTRE RÍOS,26,38,45,39,84
30,30084,300841902,Paraná,ENTRE RÍOS,10,12,13,17,30
30,30084,300841903,Paraná,ENTRE RÍOS,4,199,4,7,11
30,30084,300841904,Paraná,ENTRE RÍOS,4,209,8,9,17
30,30084,300841905,Paraná,ENTRE RÍOS,155,181,308,287,595
30,30084,300841906,Paraná,ENTRE RÍOS,136,143,237,267,504
30,30084,300841907,Paraná,ENTRE RÍOS,81,97,150,149,299
30,30084,300841908,Paraná,ENTRE RÍOS,17,213,35,37,72
30,30084,300841909,Paraná,ENTRE RÍOS,109,125,191,183,374
30,30084,300841910,Paraná,ENTRE RÍOS,152,166,257,272,529
30,30084,300841911,Paraná,ENTRE RÍOS,132,181,210,220,430
30,30084,300841912,Paraná,ENTRE RÍOS,49,161,69,70,139
30,30084,300842001,Paraná,ENTRE RÍOS,10,16,14,19,33
30,30084,300842002,Paraná,ENTRE RÍOS,72,137,106,123,229
30,30084,300842003,Paraná,ENTRE RÍOS,57,96,95,84,179
30,30084,300842004,Paraná,ENTRE RÍOS,46,65,35,80,115
30,30084,300842005,Paraná,ENTRE RÍOS,24,70,32,41,73
30,30084,300842006,Paraná,ENTRE RÍOS,24,72,24,32,56
30,30084,300842007,Paraná,ENTRE RÍOS,26,77,25,36,61
30,30084,300842101,Paraná,ENTRE RÍOS,318,336,581,615,1196
30,30084,300842102,Paraná,ENTRE RÍOS,119,145,189,206,395
30,30084,300842103,Paraná,ENTRE RÍOS,159,171,310,299,609
30,30084,300842104,Paraná,ENTRE RÍOS,155,171,292,290,582
30,30084,300842105,Paraná,ENTRE RÍOS,112,123,198,222,420
30,30084,300842106,Paraná,ENTRE RÍOS,463,485,861,839,1700
30,30084,300842107,Paraná,ENTRE RÍOS,243,258,413,397,810
30,30084,300842108,Paraná,ENTRE RÍOS,252,274,448,420,868
30,30084,300842201,Paraná,ENTRE RÍOS,157,219,253,282,535
30,30084,300842202,Paraná,ENTRE RÍOS,130,146,214,192,406
30,30084,300842203,Paraná,ENTRE RÍOS,55,70,104,91,195
30,30084,300842204,Paraná,ENTRE RÍOS,94,120,164,169,333
30,30084,300842205,Paraná,ENTRE RÍOS,73,85,138,142,280
30,30084,300842206,Paraná,ENTRE RÍOS,219,229,408,368,776
30,30084,300842207,Paraná,ENTRE RÍOS,38,52,61,78,139
30,30084,300842208,Paraná,ENTRE RÍOS,20,23,45,35,80
30,30084,300842301,Paraná,ENTRE RÍOS,7,8,18,11,29
30,30084,300842302,Paraná,ENTRE RÍOS,67,83,110,117,227
30,30084,300842303,Paraná,ENTRE RÍOS,5,10,6,9,15
30,30084,300842304,Paraná,ENTRE RÍOS,38,57,84,89,173
30,30084,300842305,Paraná,ENTRE RÍOS,212,268,339,319,658
30,30084,300842306,Paraná,ENTRE RÍOS,247,302,302,335,637
30,30084,300842307,Paraná,ENTRE RÍOS,156,220,231,215,446
30,30084,300842308,Paraná,ENTRE RÍOS,319,392,304,380,684
30,30084,300842309,Paraná,ENTRE RÍOS,307,364,305,411,716
30,30084,300842310,Paraná,ENTRE RÍOS,259,373,262,327,589
30,30084,300842311,Paraná,ENTRE RÍOS,54,92,70,89,159
30,30084,300842401,Paraná,ENTRE RÍOS,49,56,79,71,150
30,30084,300842402,Paraná,ENTRE RÍOS,24,40,46,40,86
30,30084,300842403,Paraná,ENTRE RÍOS,68,77,102,93,195
30,30084,300842404,Paraná,ENTRE RÍOS,36,44,58,66,124
30,30084,300842405,Paraná,ENTRE RÍOS,52,67,88,85,173
30,30084,300842406,Paraná,ENTRE RÍOS,31,36,56,60,116
30,30084,300842407,Paraná,ENTRE RÍOS,76,96,128,141,269
30,30084,300842408,Paraná,ENTRE RÍOS,16,21,28,28,56
30,30084,300842409,Paraná,ENTRE RÍOS,243,280,382,391,773
30,30084,300842501,Paraná,ENTRE RÍOS,6,9,11,14,25
30,30084,300842502,Paraná,ENTRE RÍOS,7,9,10,12,22
30,30084,300842503,Paraná,ENTRE RÍOS,39,53,61,62,123
30,30084,300842504,Paraná,ENTRE RÍOS,37,44,52,64,116
30,30084,300842505,Paraná,ENTRE RÍOS,32,47,45,66,111
30,30084,300842506,Paraná,ENTRE RÍOS,211,214,433,460,893
30,30084,300842507,Paraná,ENTRE RÍOS,248,283,401,458,859
30,30084,300842508,Paraná,ENTRE RÍOS,333,363,562,559,1121
30,30084,300842509,Paraná,ENTRE RÍOS,274,296,472,461,933
30,30084,300842510,Paraná,ENTRE RÍOS,219,257,297,280,577
30,30084,300842511,Paraná,ENTRE RÍOS,233,292,372,343,715
30,30084,300842512,Paraná,ENTRE RÍOS,83,96,140,135,275
30,30084,300842601,Paraná,ENTRE RÍOS,7,11,2,8,10
30,30084,300842602,Paraná,ENTRE RÍOS,6,11,5,8,13
30,30084,300842603,Paraná,ENTRE RÍOS,6,11,6,11,17
30,30084,300842604,Paraná,ENTRE RÍOS,11,16,17,21,38
30,30084,300842605,Paraná,ENTRE RÍOS,14,19,25,40,65
30,30084,300842606,Paraná,ENTRE RÍOS,11,18,24,16,40
30,30084,300842607,Paraná,ENTRE RÍOS,27,38,29,59,88
30,30084,300842608,Paraná,ENTRE RÍOS,14,19,17,30,47
30,30084,300842609,Paraná,ENTRE RÍOS,53,65,72,93,165
30,30084,300842610,Paraná,ENTRE RÍOS,31,40,56,69,125
30,30084,300842611,Paraná,ENTRE RÍOS,18,29,33,37,70
30,30084,300842612,Paraná,ENTRE RÍOS,20,27,39,33,72
30,30084,300842613,Paraná,ENTRE RÍOS,34,40,73,75,148
30,30084,300842614,Paraná,ENTRE RÍOS,9,21,18,24,42
30,30084,300842615,Paraná,ENTRE RÍOS,108,169,196,235,431
30,30084,300842616,Paraná,ENTRE RÍOS,105,140,197,174,371
30,30084,300842701,Paraná,ENTRE RÍOS,19,23,24,36,60
30,30084,300842702,Paraná,ENTRE RÍOS,22,35,28,32,60
30,30084,300842703,Paraná,ENTRE RÍOS,204,238,394,325,719
30,30084,300842704,Paraná,ENTRE RÍOS,284,321,445,404,849
30,30084,300842705,Paraná,ENTRE RÍOS,275,311,432,348,780
30,30084,300842706,Paraná,ENTRE RÍOS,112,120,197,217,414
30,30084,300842707,Paraná,ENTRE RÍOS,323,347,557,528,1085
30,30084,300842708,Paraná,ENTRE RÍOS,230,239,469,489,958
30,30084,300842801,Paraná,ENTRE RÍOS,96,96,151,177,328
30,30084,300842802,Paraná,ENTRE RÍOS,9,13,12,19,31
30,30084,300842803,Paraná,ENTRE RÍOS,24,35,35,38,73
30,30084,300842804,Paraná,ENTRE RÍOS,6,16,9,12,21
30,30084,300842805,Paraná,ENTRE RÍOS,17,23,32,36,68
30,30084,300842806,Paraná,ENTRE RÍOS,22,27,41,36,77
30,30084,300842807,Paraná,ENTRE RÍOS,10,16,12,20,32
30,30084,300842808,Paraná,ENTRE RÍOS,21,32,23,31,54
30,30084,300842809,Paraná,ENTRE RÍOS,25,26,34,29,63
30,30084,300842810,Paraná,ENTRE RÍOS,18,26,26,28,54
30,30084,300842811,Paraná,ENTRE RÍOS,14,15,20,19,39
30,30084,300842812,Paraná,ENTRE RÍOS,24,29,42,36,78
30,30084,300842813,Paraná,ENTRE RÍOS,19,21,31,32,63
30,30084,300842901,Paraná,ENTRE RÍOS,6,11,9,12,21
30,30084,300842902,Paraná,ENTRE RÍOS,9,15,17,17,34
30,30084,300842903,Paraná,ENTRE RÍOS,12,15,22,24,46
30,30084,300842904,Paraná,ENTRE RÍOS,12,14,16,20,36
30,30084,300842905,Paraná,ENTRE RÍOS,7,13,15,12,27
30,30084,300842906,Paraná,ENTRE RÍOS,11,14,13,16,29
30,30084,300842907,Paraná,ENTRE RÍOS,5,6,7,9,16
30,30084,300842908,Paraná,ENTRE RÍOS,2,6,4,4,8
30,30084,300842909,Paraná,ENTRE RÍOS,12,21,12,17,29
30,30084,300842910,Paraná,ENTRE RÍOS,216,218,368,398,766
30,30084,300843001,Paraná,ENTRE RÍOS,24,31,44,54,98
30,30084,300843002,Paraná,ENTRE RÍOS,53,58,106,115,221
30,30084,300843003,Paraná,ENTRE RÍOS,23,29,34,41,75
30,30084,300843004,Paraná,ENTRE RÍOS,9,12,14,11,25
30,30084,300843005,Paraná,ENTRE RÍOS,79,84,155,179,334
30,30084,300843006,Paraná,ENTRE RÍOS,222,230,348,347,695
30,30084,300843007,Paraná,ENTRE RÍOS,199,223,350,350,700
30,30084,300843008,Paraná,ENTRE RÍOS,146,194,253,253,506
30,30084,300843009,Paraná,ENTRE RÍOS,141,157,226,210,436
30,30084,300843010,Paraná,ENTRE RÍOS,123,143,205,188,393
30,30084,300843011,Paraná,ENTRE RÍOS,150,180,267,226,493
30,30084,300843012,Paraná,ENTRE RÍOS,273,316,419,346,765
30,30084,300843013,Paraná,ENTRE RÍOS,225,254,410,411,821
30,30084,300843014,Paraná,ENTRE RÍOS,57,69,81,86,167
30,30084,300843101,Paraná,ENTRE RÍOS,21,25,41,44,85
30,30084,300843102,Paraná,ENTRE RÍOS,36,49,65,70,135
30,30084,300843103,Paraná,ENTRE RÍOS,12,18,12,24,36
30,30084,300843104,Paraná,ENTRE RÍOS,5,5,6,16,22
30,30084,300843105,Paraná,ENTRE RÍOS,17,23,26,37,63
30,30084,300843106,Paraná,ENTRE RÍOS,13,21,19,25,44
30,30084,300843107,Paraná,ENTRE RÍOS,56,78,74,98,172
30,30084,300843108,Paraná,ENTRE RÍOS,14,20,21,30,51
30,30084,300843109,Paraná,ENTRE RÍOS,30,51,46,47,93
30,30084,300843110,Paraná,ENTRE RÍOS,30,38,38,47,85
30,30084,300843111,Paraná,ENTRE RÍOS,17,20,23,37,60
30,30084,300843112,Paraná,ENTRE RÍOS,35,42,53,62,115
30,30084,300843113,Paraná,ENTRE RÍOS,28,45,32,44,76
30,30084,300843114,Paraná,ENTRE RÍOS,17,24,30,23,53
30,30084,300843115,Paraná,ENTRE RÍOS,99,185,142,154,296
30,30084,300843116,Paraná,ENTRE RÍOS,108,133,152,150,302
30,30084,300843201,Paraná,ENTRE RÍOS,22,29,47,47,94
30,30084,300843202,Paraná,ENTRE RÍOS,63,82,89,95,184
30,30084,300843203,Paraná,ENTRE RÍOS,43,53,61,63,124
30,30084,300843204,Paraná,ENTRE RÍOS,46,62,61,64,125
30,30084,300843205,Paraná,ENTRE RÍOS,109,134,168,186,354
30,30084,300843206,Paraná,ENTRE RÍOS,92,122,146,184,330
30,30084,300843207,Paraná,ENTRE RÍOS,70,96,95,126,221
30,30084,300843208,Paraná,ENTRE RÍOS,36,46,74,51,125
30,30084,300843209,Paraná,ENTRE RÍOS,159,188,270,233,503
30,30084,300843210,Paraná,ENTRE RÍOS,31,42,54,47,101
30,30084,300843211,Paraná,ENTRE RÍOS,43,173,49,57,106
30,30084,300843212,Paraná,ENTRE RÍOS,98,264,151,155,306
30,30084,300843213,Paraná,ENTRE RÍOS,82,176,114,135,249
30,30084,300843301,Paraná,ENTRE RÍOS,10,12,15,18,33
30,30084,300843302,Paraná,ENTRE RÍOS,27,33,39,43,82
30,30084,300843303,Paraná,ENTRE RÍOS,16,23,27,28,55
30,30084,300843304,Paraná,ENTRE RÍOS,7,121,17,14,31
30,30084,300843305,Paraná,ENTRE RÍOS,89,109,120,139,259
30,30084,300843306,Paraná,ENTRE RÍOS,308,339,518,486,1004
30,30084,300843307,Paraná,ENTRE RÍOS,346,373,594,503,1097
30,30084,300843308,Paraná,ENTRE RÍOS,383,466,569,517,1086
30,30084,300843309,Paraná,ENTRE RÍOS,217,244,382,355,737
30,30084,300843310,Paraná,ENTRE RÍOS,103,122,177,213,390
30,30084,300843311,Paraná,ENTRE RÍOS,126,145,241,236,477
30,30084,300843312,Paraná,ENTRE RÍOS,220,245,341,275,616
30,30084,300843313,Paraná,ENTRE RÍOS,219,256,384,374,758
30,30084,300843314,Paraná,ENTRE RÍOS,318,371,571,531,1102
30,30084,300843401,Paraná,ENTRE RÍOS,4,6,0,4,4
30,30084,300843402,Paraná,ENTRE RÍOS,16,24,15,31,46
30,30084,300843403,Paraná,ENTRE RÍOS,8,16,9,9,18
30,30084,300843404,Paraná,ENTRE RÍOS,12,22,17,16,33
30,30084,300843405,Paraná,ENTRE RÍOS,11,21,20,26,46
30,30084,300843406,Paraná,ENTRE RÍOS,0,2,0,0,0
30,30084,300843407,Paraná,ENTRE RÍOS,49,65,71,75,146
30,30084,300843408,Paraná,ENTRE RÍOS,49,68,78,93,171
30,30084,300843409,Paraná,ENTRE RÍOS,17,27,23,35,58
30,30084,300843410,Paraná,ENTRE RÍOS,17,31,28,38,66
30,30084,300843411,Paraná,ENTRE RÍOS,14,19,14,25,39
30,30084,300843412,Paraná,ENTRE RÍOS,48,54,71,80,151
30,30084,300843413,Paraná,ENTRE RÍOS,22,32,39,41,80
30,30084,300843414,Paraná,ENTRE RÍOS,32,46,45,56,101
30,30084,300843415,Paraná,ENTRE RÍOS,75,80,119,122,241
30,30084,300843416,Paraná,ENTRE RÍOS,147,187,247,248,495
30,30084,300843501,Paraná,ENTRE RÍOS,12,17,22,21,43
30,30084,300843502,Paraná,ENTRE RÍOS,13,17,17,22,39
30,30084,300843503,Paraná,ENTRE RÍOS,19,18,29,33,62
30,30084,300843504,Paraná,ENTRE RÍOS,8,15,14,16,30
30,30084,300843505,Paraná,ENTRE RÍOS,16,36,23,23,46
30,30084,300843506,Paraná,ENTRE RÍOS,133,137,256,242,498
30,30084,300843507,Paraná,ENTRE RÍOS,118,129,196,186,382
30,30084,300843508,Paraná,ENTRE RÍOS,139,158,230,212,442
30,30084,300843601,Paraná,ENTRE RÍOS,17,27,20,39,59
30,30084,300843602,Paraná,ENTRE RÍOS,20,23,38,30,68
30,30084,300843603,Paraná,ENTRE RÍOS,26,32,25,37,62
30,30084,300843604,Paraná,ENTRE RÍOS,20,21,31,38,69
30,30084,300843701,Paraná,ENTRE RÍOS,192,203,331,321,652
30,30084,300843702,Paraná,ENTRE RÍOS,155,176,289,289,578
30,30084,300843703,Paraná,ENTRE RÍOS,115,133,183,211,394
30,30084,300843704,Paraná,ENTRE RÍOS,370,386,594,553,1147
30,30084,300843705,Paraná,ENTRE RÍOS,189,206,295,242,537
30,30084,300843706,Paraná,ENTRE RÍOS,235,231,386,360,746
30,30084,300843707,Paraná,ENTRE RÍOS,186,209,312,268,580
30,30084,300843708,Paraná,ENTRE RÍOS,134,152,209,216,425
30,30084,300843709,Paraná,ENTRE RÍOS,145,149,277,275,552
30,30084,300843710,Paraná,ENTRE RÍOS,207,214,361,336,697
30,30084,300843711,Paraná,ENTRE RÍOS,257,278,420,345,765
30,30084,300843712,Paraná,ENTRE RÍOS,178,178,376,370,746
30,30084,300843713,Paraná,ENTRE RÍOS,146,194,321,329,650
30,30084,300843714,Paraná,ENTRE RÍOS,265,276,411,424,835
30,30084,300843715,Paraná,ENTRE RÍOS,22,27,42,37,79
30,30084,300843801,Paraná,ENTRE RÍOS,4,8,6,9,15
30,30084,300843802,Paraná,ENTRE RÍOS,14,25,17,23,40
30,30084,300843803,Paraná,ENTRE RÍOS,15,14,24,27,51
30,30084,300843804,Paraná,ENTRE RÍOS,18,17,24,30,54
30,30084,300843805,Paraná,ENTRE RÍOS,34,45,46,51,97
30,30084,300843806,Paraná,ENTRE RÍOS,12,17,18,18,36
30,30084,300843807,Paraná,ENTRE RÍOS,25,31,41,50,91
30,30084,300843808,Paraná,ENTRE RÍOS,26,35,37,46,83
30,30084,300843809,Paraná,ENTRE RÍOS,16,24,29,25,54
30,30084,300843901,Paraná,ENTRE RÍOS,41,68,111,75,186
30,30084,300843902,Paraná,ENTRE RÍOS,26,45,38,53,91
30,30084,300843903,Paraná,ENTRE RÍOS,51,66,69,76,145
30,30084,300843904,Paraná,ENTRE RÍOS,38,51,65,63,128
30,30084,300843905,Paraná,ENTRE RÍOS,9,11,13,10,23
30,30084,300843906,Paraná,ENTRE RÍOS,7,18,15,12,27
30,30084,300843907,Paraná,ENTRE RÍOS,14,30,27,26,53
30,30084,300843908,Paraná,ENTRE RÍOS,30,39,49,51,100
30,30084,300843909,Paraná,ENTRE RÍOS,26,32,48,53,101
30,30084,300844001,Paraná,ENTRE RÍOS,48,49,76,87,163
30,30084,300844002,Paraná,ENTRE RÍOS,22,40,33,42,75
30,30084,300844003,Paraná,ENTRE RÍOS,24,28,31,40,71
30,30084,300844004,Paraná,ENTRE RÍOS,63,66,105,106,211
30,30084,300844005,Paraná,ENTRE RÍOS,24,33,43,39,82
30,30084,300844006,Paraná,ENTRE RÍOS,13,17,19,26,45
30,30084,300844007,Paraná,ENTRE RÍOS,27,29,53,59,112
30,30084,300844008,Paraná,ENTRE RÍOS,42,49,62,91,153
30,30084,300844009,Paraná,ENTRE RÍOS,41,43,65,73,138
30,30084,300844101,Paraná,ENTRE RÍOS,7,14,11,11,22
30,30084,300844102,Paraná,ENTRE RÍOS,15,25,14,24,38
30,30084,300844103,Paraná,ENTRE RÍOS,19,25,30,38,68
30,30084,300844104,Paraná,ENTRE RÍOS,19,26,27,35,62
30,30084,300844105,Paraná,ENTRE RÍOS,293,311,441,388,829
30,30084,300844106,Paraná,ENTRE RÍOS,272,300,446,414,860
30,30084,300844107,Paraná,ENTRE RÍOS,2,5,2,4,6
30,30084,300844108,Paraná,ENTRE RÍOS,325,365,501,458,959
30,30084,300844109,Paraná,ENTRE RÍOS,206,233,306,262,568
30,30084,300844110,Paraná,ENTRE RÍOS,155,185,244,229,473
30,30084,300844201,Paraná,ENTRE RÍOS,8,13,14,15,29
30,30084,300844202,Paraná,ENTRE RÍOS,47,62,71,85,156
30,30084,300844203,Paraná,ENTRE RÍOS,18,25,26,34,60
30,30084,300844204,Paraná,ENTRE RÍOS,50,71,73,84,157
30,30084,300844205,Paraná,ENTRE RÍOS,14,14,17,26,43
30,30084,300844206,Paraná,ENTRE RÍOS,10,15,11,18,29
30,30084,300844207,Paraná,ENTRE RÍOS,22,33,36,37,73
30,30084,300844208,Paraná,ENTRE RÍOS,20,20,32,48,80
30,30084,300844209,Paraná,ENTRE RÍOS,41,45,65,60,125
30,30084,300844301,Paraná,ENTRE RÍOS,343,362,600,548,1148
30,30084,300844302,Paraná,ENTRE RÍOS,192,206,312,299,611
30,30084,300844303,Paraná,ENTRE RÍOS,252,281,368,349,717
30,30084,300844304,Paraná,ENTRE RÍOS,205,237,322,263,585
30,30084,300844305,Paraná,ENTRE RÍOS,260,301,373,351,724
30,30084,300844306,Paraná,ENTRE RÍOS,273,292,407,340,747
30,30084,300844307,Paraná,ENTRE RÍOS,279,293,462,449,911
30,30084,300844308,Paraná,ENTRE RÍOS,207,228,297,302,599
30,30084,300844309,Paraná,ENTRE RÍOS,368,408,561,499,1060
30,30084,300844310,Paraná,ENTRE RÍOS,149,171,247,216,463
30,30084,300844311,Paraná,ENTRE RÍOS,193,200,369,358,727
30,30084,300844312,Paraná,ENTRE RÍOS,205,208,331,373,704
30,30084,300844313,Paraná,ENTRE RÍOS,199,193,367,378,745
30,30084,300844401,Paraná,ENTRE RÍOS,293,312,441,377,818
30,30084,300844402,Paraná,ENTRE RÍOS,88,102,151,123,274
30,30084,300844403,Paraná,ENTRE RÍOS,368,388,566,506,1072
30,30084,300844404,Paraná,ENTRE RÍOS,359,374,574,555,1129
30,30084,300844405,Paraná,ENTRE RÍOS,146,156,229,203,432
30,30084,300844406,Paraná,ENTRE RÍOS,196,217,292,250,542
30,30084,300844407,Paraná,ENTRE RÍOS,296,334,432,406,838
30,30084,300844408,Paraná,ENTRE RÍOS,289,331,469,466,935
30,30084,300844409,Paraná,ENTRE RÍOS,144,214,248,264,512
30,30084,300844410,Paraná,ENTRE RÍOS,275,287,455,459,914
30,30084,300844411,Paraná,ENTRE RÍOS,215,223,362,332,694
30,30084,300844501,Paraná,ENTRE RÍOS,35,39,66,62,128
30,30084,300844502,Paraná,ENTRE RÍOS,30,35,57,51,108
30,30084,300844503,Paraná,ENTRE RÍOS,40,48,55,65,120
30,30084,300844504,Paraná,ENTRE RÍOS,51,55,82,96,178
30,30084,300844505,Paraná,ENTRE RÍOS,50,54,80,82,162
30,30084,300844506,Paraná,ENTRE RÍOS,36,38,59,63,122
30,30084,300844507,Paraná,ENTRE RÍOS,142,170,208,222,430
30,30084,300844508,Paraná,ENTRE RÍOS,126,148,205,189,394
30,30084,300844509,Paraná,ENTRE RÍOS,60,70,106,103,209
30,30084,300844510,Paraná,ENTRE RÍOS,120,132,219,215,434
30,30084,300844511,Paraná,ENTRE RÍOS,33,48,46,42,88
30,30084,300844601,Paraná,ENTRE RÍOS,17,28,2,26,28
18,18168,181680107,Santo Tomé,CORRIENTES,308,314,657,633,1290
18,18168,181680108,Santo Tomé,CORRIENTES,317,314,599,511,1110
18,18168,181680109,Santo Tomé,CORRIENTES,346,315,636,584,1220
18,18168,181680110,Santo Tomé,CORRIENTES,271,270,506,458,964
18,18168,181680201,Santo Tomé,CORRIENTES,91,104,185,183,368
18,18168,181680202,Santo Tomé,CORRIENTES,60,97,109,125,234
18,18168,181680301,Santo Tomé,CORRIENTES,30,52,43,67,110
18,18168,181680302,Santo Tomé,CORRIENTES,27,45,29,53,82
18,18168,181680303,Santo Tomé,CORRIENTES,15,25,13,33,46
18,18168,181680401,Santo Tomé,CORRIENTES,10,17,22,26,48
18,18168,181680402,Santo Tomé,CORRIENTES,15,24,9,27,36
18,18168,181680403,Santo Tomé,CORRIENTES,14,28,16,29,45
18,18168,181680501,Santo Tomé,CORRIENTES,66,42,74,100,174
18,18168,181680502,Santo Tomé,CORRIENTES,9,9,11,23,34
18,18168,181680601,Santo Tomé,CORRIENTES,7,11,11,17,28
18,18168,181680602,Santo Tomé,CORRIENTES,11,23,9,16,25
18,18168,181680603,Santo Tomé,CORRIENTES,77,134,81,144,225
18,18168,181680604,Santo Tomé,CORRIENTES,24,28,4,23,27
18,18168,181680701,Santo Tomé,CORRIENTES,265,288,566,588,1154
18,18168,181680702,Santo Tomé,CORRIENTES,460,456,893,893,1786
18,18168,181680703,Santo Tomé,CORRIENTES,442,450,805,822,1627
18,18168,181680704,Santo Tomé,CORRIENTES,254,303,450,457,907
18,18168,181680705,Santo Tomé,CORRIENTES,595,611,1305,1348,2653
18,18168,181680706,Santo Tomé,CORRIENTES,389,380,802,852,1654
18,18168,181680707,Santo Tomé,CORRIENTES,204,238,445,453,898
18,18168,181680708,Santo Tomé,CORRIENTES,1,3,0,1,1
18,18168,181680709,Santo Tomé,CORRIENTES,0,2,0,0,0
18,18168,181680710,Santo Tomé,CORRIENTES,9,14,12,14,26
18,18168,181680711,Santo Tomé,CORRIENTES,148,156,345,335,680
18,18168,181680712,Santo Tomé,CORRIENTES,401,402,844,816,1660
18,18168,181680713,Santo Tomé,CORRIENTES,325,330,528,552,1080
18,18168,181680714,Santo Tomé,CORRIENTES,204,196,327,332,659
18,18168,181680715,Santo Tomé,CORRIENTES,250,274,471,465,936
18,18168,181680716,Santo Tomé,CORRIENTES,264,270,492,465,957
18,18168,181680101,Santo Tomé,CORRIENTES,57,57,92,101,193
18,18168,181680102,Santo Tomé,CORRIENTES,270,273,466,434,900
18,18168,181680103,Santo Tomé,CORRIENTES,272,304,448,391,839
18,18168,181680104,Santo Tomé,CORRIENTES,315,333,479,428,907
18,18168,181680105,Santo Tomé,CORRIENTES,228,276,344,316,660
18,18168,181680106,Santo Tomé,CORRIENTES,291,307,592,556,1148
18,18168,181680717,Santo Tomé,CORRIENTES,230,228,468,455,923
18,18168,181680718,Santo Tomé,CORRIENTES,401,417,746,793,1539
18,18168,181680719,Santo Tomé,CORRIENTES,360,314,698,643,1341
18,18168,181680720,Santo Tomé,CORRIENTES,292,296,609,603,1212
18,18168,181680721,Santo Tomé,CORRIENTES,242,272,460,439,899
18,18168,181680722,Santo Tomé,CORRIENTES,440,462,865,860,1725
18,18168,181680723,Santo Tomé,CORRIENTES,227,251,387,348,735
18,18168,181680724,Santo Tomé,CORRIENTES,225,251,401,380,781
18,18168,181680725,Santo Tomé,CORRIENTES,440,465,947,963,1910
18,18168,181680726,Santo Tomé,CORRIENTES,3,4,6,9,15
18,18168,181680727,Santo Tomé,CORRIENTES,253,297,539,554,1093
18,18168,181680801,Santo Tomé,CORRIENTES,54,61,82,90,172
18,18168,181680802,Santo Tomé,CORRIENTES,20,18,5,33,38
18,18168,181680803,Santo Tomé,CORRIENTES,2,6,1,3,4
18,18168,181680804,Santo Tomé,CORRIENTES,15,17,17,32,49
18,18168,181680901,Santo Tomé,CORRIENTES,7,9,4,16,20
18,18168,181680902,Santo Tomé,CORRIENTES,2,2,1,5,6
18,18168,181680903,Santo Tomé,CORRIENTES,8,14,0,18,18
18,18168,181680904,Santo Tomé,CORRIENTES,5,9,7,9,16
18,18168,181681001,Santo Tomé,CORRIENTES,2,5,1,5,6
18,18168,181681002,Santo Tomé,CORRIENTES,57,79,100,113,213
18,18168,181681003,Santo Tomé,CORRIENTES,27,33,39,47,86
18,18168,181681101,Santo Tomé,CORRIENTES,5,12,0,8,8
18,18168,181681102,Santo Tomé,CORRIENTES,5,17,4,7,11
18,18168,181681103,Santo Tomé,CORRIENTES,78,106,131,160,291
18,18168,181681201,Santo Tomé,CORRIENTES,110,106,179,196,375
18,18168,181681202,Santo Tomé,CORRIENTES,5,30,6,9,15
18,18168,181681203,Santo Tomé,CORRIENTES,16,15,26,24,50
18,18168,181681204,Santo Tomé,CORRIENTES,9,8,9,25,34
18,18168,181681301,Santo Tomé,CORRIENTES,10,12,11,26,37
18,18168,181681302,Santo Tomé,CORRIENTES,41,51,59,58,117
18,18168,181681303,Santo Tomé,CORRIENTES,161,192,286,321,607
18,18168,181681304,Santo Tomé,CORRIENTES,9,11,15,8,23
18,18168,181681305,Santo Tomé,CORRIENTES,73,106,83,177,260
18,18168,181681306,Santo Tomé,CORRIENTES,161,186,322,341,663
18,18168,181681307,Santo Tomé,CORRIENTES,477,479,1119,1029,2148
18,18168,181681401,Santo Tomé,CORRIENTES,201,228,401,380,781
18,18168,181681402,Santo Tomé,CORRIENTES,58,89,92,109,201
18,18168,181681403,Santo Tomé,CORRIENTES,22,35,31,33,64
18,18168,181681404,Santo Tomé,CORRIENTES,64,61,110,110,220
18,18168,181681501,Santo Tomé,CORRIENTES,53,62,102,139,241
18,18168,181681502,Santo Tomé,CORRIENTES,6,6,1,9,10
18,18168,181681601,Santo Tomé,CORRIENTES,181,216,307,352,659
18,18168,181681602,Santo Tomé,CORRIENTES,109,113,42,138,180
18,18168,181681603,Santo Tomé,CORRIENTES,32,26,20,65,85
18,18168,181681604,Santo Tomé,CORRIENTES,8,9,3,15,18
18,18168,181681701,Santo Tomé,CORRIENTES,344,371,670,666,1336
18,18168,181681702,Santo Tomé,CORRIENTES,311,331,437,318,755
18,18168,181681703,Santo Tomé,CORRIENTES,337,393,455,461,916
18,18168,181681704,Santo Tomé,CORRIENTES,253,264,420,423,843
18,18168,181681705,Santo Tomé,CORRIENTES,216,236,299,311,610
18,18168,181681706,Santo Tomé,CORRIENTES,259,332,309,213,522
18,18168,181681707,Santo Tomé,CORRIENTES,335,360,545,463,1008
18,18168,181681708,Santo Tomé,CORRIENTES,384,416,687,665,1352
18,18168,181681709,Santo Tomé,CORRIENTES,299,329,603,567,1170
18,18168,181681710,Santo Tomé,CORRIENTES,342,371,748,701,1449
18,18168,181681711,Santo Tomé,CORRIENTES,176,195,403,361,764
18,18168,181681712,Santo Tomé,CORRIENTES,325,290,710,637,1347
18,18168,181681713,Santo Tomé,CORRIENTES,279,292,465,421,886
18,18168,181681714,Santo Tomé,CORRIENTES,256,276,562,487,1049
14,14126,141260702,San Alberto,CORDOBA,223,345,393,357,750
14,14126,141260701,San Alberto,CORDOBA,157,300,284,235,519
14,14126,141260609,San Alberto,CORDOBA,160,351,291,285,576
14,14126,141260611,San Alberto,CORDOBA,36,87,66,67,133
14,14126,141260610,San Alberto,CORDOBA,181,364,288,303,591
14,14126,141260514,San Alberto,CORDOBA,203,229,393,439,832
14,14126,141260513,San Alberto,CORDOBA,147,161,298,305,603
14,14126,141260512,San Alberto,CORDOBA,370,388,628,610,1238
14,14126,141260507,San Alberto,CORDOBA,112,143,240,231,471
14,14126,141260515,San Alberto,CORDOBA,122,131,221,210,431
14,14126,141260312,San Alberto,CORDOBA,245,443,395,382,777
14,14126,141260309,San Alberto,CORDOBA,165,290,296,292,588
14,14126,141260311,San Alberto,CORDOBA,260,391,417,387,804
14,14126,141260310,San Alberto,CORDOBA,125,259,202,209,411
14,14126,141260313,San Alberto,CORDOBA,220,290,418,441,859
14,14126,141260518,San Alberto,CORDOBA,123,141,230,253,483
14,14126,141260517,San Alberto,CORDOBA,170,165,335,307,642
14,14126,141260516,San Alberto,CORDOBA,206,223,440,413,853
14,14126,141260109,San Alberto,CORDOBA,119,189,197,189,386
14,14126,141260604,San Alberto,CORDOBA,110,180,198,197,395
14,14126,141260304,San Alberto,CORDOBA,267,323,522,552,1074
14,14126,141260302,San Alberto,CORDOBA,3,6,2,3,5
14,14126,141260103,San Alberto,CORDOBA,47,82,69,98,167
14,14126,141260607,San Alberto,CORDOBA,135,202,206,244,450
14,14126,141260303,San Alberto,CORDOBA,115,205,237,223,460
14,14126,141260206,San Alberto,CORDOBA,223,246,370,438,808
14,14126,141260713,San Alberto,CORDOBA,89,176,141,141,282
14,14126,141260711,San Alberto,CORDOBA,202,266,379,353,732
14,14126,141260710,San Alberto,CORDOBA,141,209,258,257,515
14,14126,141260709,San Alberto,CORDOBA,200,317,322,298,620
14,14126,141260708,San Alberto,CORDOBA,267,370,444,432,876
14,14126,141260707,San Alberto,CORDOBA,199,274,342,312,654
14,14126,141260706,San Alberto,CORDOBA,216,367,363,270,633
14,14126,141260705,San Alberto,CORDOBA,254,411,408,360,768
14,14126,141260704,San Alberto,CORDOBA,202,275,386,376,762
14,14126,141260703,San Alberto,CORDOBA,159,276,283,229,512
14,14126,141260712,San Alberto,CORDOBA,258,330,445,419,864
14,14126,141260608,San Alberto,CORDOBA,186,321,333,289,622
14,14126,141260511,San Alberto,CORDOBA,248,263,476,418,894
14,14126,141260510,San Alberto,CORDOBA,223,245,428,405,833
14,14126,141260509,San Alberto,CORDOBA,321,347,665,665,1330
14,14126,141260508,San Alberto,CORDOBA,233,276,487,425,912
14,14126,141260406,San Alberto,CORDOBA,140,257,260,285,545
14,14126,141260314,San Alberto,CORDOBA,301,347,602,558,1160
14,14126,141260308,San Alberto,CORDOBA,251,349,483,458,941
14,14126,141260307,San Alberto,CORDOBA,191,295,410,401,811
14,14126,141260208,San Alberto,CORDOBA,165,126,336,322,658
14,14126,141260605,San Alberto,CORDOBA,125,238,229,237,466
14,14126,141260603,San Alberto,CORDOBA,116,195,221,197,418
14,14126,141260601,San Alberto,CORDOBA,68,98,95,118,213
14,14126,141260506,San Alberto,CORDOBA,63,78,142,121,263
14,14126,141260505,San Alberto,CORDOBA,94,116,174,189,363
14,14126,141260503,San Alberto,CORDOBA,6,17,5,8,13
14,14126,141260502,San Alberto,CORDOBA,98,122,162,194,356
14,14126,141260504,San Alberto,CORDOBA,106,127,228,207,435
14,14126,141260405,San Alberto,CORDOBA,42,83,71,66,137
14,14126,141260404,San Alberto,CORDOBA,103,144,180,205,385
14,14126,141260306,San Alberto,CORDOBA,40,83,58,72,130
14,14126,141260305,San Alberto,CORDOBA,46,90,71,82,153
14,14126,141260301,San Alberto,CORDOBA,16,22,25,31,56
14,14126,141260205,San Alberto,CORDOBA,24,27,34,41,75
14,14126,141260204,San Alberto,CORDOBA,60,70,117,122,239
14,14126,141260203,San Alberto,CORDOBA,33,32,50,64,114
14,14126,141260202,San Alberto,CORDOBA,9,12,12,14,26
14,14126,141260106,San Alberto,CORDOBA,32,46,43,60,103
14,14126,141260201,San Alberto,CORDOBA,47,52,82,84,166
14,14126,141260108,San Alberto,CORDOBA,53,69,105,89,194
14,14126,141260101,San Alberto,CORDOBA,44,65,65,68,133
14,14126,141260606,San Alberto,CORDOBA,7,10,42,48,90
14,14126,141260602,San Alberto,CORDOBA,27,42,29,59,88
14,14126,141260501,San Alberto,CORDOBA,17,37,15,20,35
14,14126,141260403,San Alberto,CORDOBA,34,62,51,54,105
14,14126,141260402,San Alberto,CORDOBA,35,48,53,64,117
14,14126,141260401,San Alberto,CORDOBA,96,156,140,161,301
14,14126,141260207,San Alberto,CORDOBA,34,49,51,62,113
14,14126,141260107,San Alberto,CORDOBA,44,64,50,67,117
14,14126,141260105,San Alberto,CORDOBA,12,19,19,20,39
14,14126,141260104,San Alberto,CORDOBA,52,63,86,93,179
14,14126,141260102,San Alberto,CORDOBA,47,82,73,79,152
14,14133,141330601,San Javier,CORDOBA,291,327,446,360,806
14,14133,141330517,San Javier,CORDOBA,234,238,427,408,835
14,14133,141330516,San Javier,CORDOBA,263,270,457,391,848
14,14133,141330408,San Javier,CORDOBA,129,171,190,217,407
14,14133,141330405,San Javier,CORDOBA,130,188,203,204,407
14,14133,141330305,San Javier,CORDOBA,119,167,204,227,431
14,14133,141330204,San Javier,CORDOBA,275,318,450,477,927
14,14133,141330108,San Javier,CORDOBA,218,253,444,426,870
14,14133,141330201,San Javier,CORDOBA,165,249,267,332,599
14,14133,141330505,San Javier,CORDOBA,238,265,545,515,1060
14,14133,141330504,San Javier,CORDOBA,238,223,446,430,876
14,14133,141330308,San Javier,CORDOBA,124,233,255,249,504
14,14133,141330307,San Javier,CORDOBA,355,527,638,572,1210
14,14133,141330503,San Javier,CORDOBA,223,270,370,319,689
14,14133,141330501,San Javier,CORDOBA,317,340,592,518,1110
14,14133,141330411,San Javier,CORDOBA,175,277,266,269,535
14,14133,141330515,San Javier,CORDOBA,379,389,742,707,1449
14,14133,141330514,San Javier,CORDOBA,129,144,217,205,422
14,14133,141330512,San Javier,CORDOBA,336,352,642,865,1507
14,14133,141330309,San Javier,CORDOBA,215,285,383,344,727
14,14133,141330216,San Javier,CORDOBA,195,234,315,321,636
14,14133,141330215,San Javier,CORDOBA,57,95,97,87,184
14,14133,141330214,San Javier,CORDOBA,241,288,394,368,762
14,14133,141330213,San Javier,CORDOBA,348,469,525,518,1043
14,14133,141330614,San Javier,CORDOBA,325,349,601,573,1174
14,14133,141330212,San Javier,CORDOBA,172,250,248,258,506
14,14133,141330211,San Javier,CORDOBA,179,273,295,264,559
14,14133,141330210,San Javier,CORDOBA,70,113,131,102,233
14,14133,141330209,San Javier,CORDOBA,113,242,154,145,299
14,14133,141330208,San Javier,CORDOBA,202,345,313,308,621
14,14133,141330613,San Javier,CORDOBA,347,357,652,551,1203
14,14133,141330112,San Javier,CORDOBA,261,275,525,511,1036
14,14133,141330110,San Javier,CORDOBA,271,298,497,470,967
14,14133,141330511,San Javier,CORDOBA,287,292,495,438,933
14,14133,141330612,San Javier,CORDOBA,177,192,294,269,563
14,14133,141330617,San Javier,CORDOBA,195,261,345,304,649
14,14133,141330616,San Javier,CORDOBA,239,267,424,372,796
14,14133,141330615,San Javier,CORDOBA,231,279,434,364,798
14,14133,141330611,San Javier,CORDOBA,202,204,356,309,665
14,14133,141330610,San Javier,CORDOBA,287,369,453,344,797
14,14133,141330609,San Javier,CORDOBA,261,304,392,294,686
14,14133,141330608,San Javier,CORDOBA,237,285,387,393,780
14,14133,141330607,San Javier,CORDOBA,289,289,555,615,1170
14,14133,141330606,San Javier,CORDOBA,177,259,284,274,558
14,14133,141330605,San Javier,CORDOBA,275,277,492,471,963
14,14133,141330604,San Javier,CORDOBA,241,288,421,371,792
14,14133,141330603,San Javier,CORDOBA,285,326,468,410,878
14,14133,141330602,San Javier,CORDOBA,406,437,626,571,1197
14,14133,141330510,San Javier,CORDOBA,355,408,571,459,1030
14,14133,141330509,San Javier,CORDOBA,236,283,361,261,622
14,14133,141330409,San Javier,CORDOBA,369,489,601,588,1189
14,14133,141330508,San Javier,CORDOBA,250,314,422,324,746
14,14133,141330507,San Javier,CORDOBA,273,306,408,327,735
14,14133,141330506,San Javier,CORDOBA,316,358,576,485,1061
14,14133,141330513,San Javier,CORDOBA,241,269,479,403,882
14,14133,141330502,San Javier,CORDOBA,210,271,327,247,574
14,14133,141330410,San Javier,CORDOBA,134,231,212,206,418
14,14133,141330207,San Javier,CORDOBA,126,163,206,192,398
14,14133,141330111,San Javier,CORDOBA,315,341,627,620,1247
14,14133,141330406,San Javier,CORDOBA,55,83,91,87,178
14,14133,141330404,San Javier,CORDOBA,62,99,100,109,209
14,14133,141330402,San Javier,CORDOBA,44,64,82,99,181
14,14133,141330401,San Javier,CORDOBA,24,40,31,41,72
14,14133,141330304,San Javier,CORDOBA,147,164,208,285,493
14,14133,141330403,San Javier,CORDOBA,49,88,93,85,178
14,14133,141330302,San Javier,CORDOBA,125,160,205,207,412
14,14133,141330203,San Javier,CORDOBA,63,97,119,111,230
14,14133,141330206,San Javier,CORDOBA,74,98,135,152,287
14,14133,141330202,San Javier,CORDOBA,76,100,114,124,238
14,14133,141330205,San Javier,CORDOBA,86,79,156,154,310
14,14133,141330107,San Javier,CORDOBA,40,59,65,58,123
14,14133,141330103,San Javier,CORDOBA,132,140,257,251,508
14,14133,141330102,San Javier,CORDOBA,99,114,178,181,359
14,14133,141330101,San Javier,CORDOBA,21,39,34,39,73
14,14133,141330407,San Javier,CORDOBA,72,103,131,133,264
14,14133,141330306,San Javier,CORDOBA,92,147,160,207,367
14,14133,141330303,San Javier,CORDOBA,66,81,131,121,252
14,14133,141330301,San Javier,CORDOBA,79,128,139,155,294
14,14133,141330109,San Javier,CORDOBA,90,93,169,226,395
14,14133,141330106,San Javier,CORDOBA,23,41,34,40,74
14,14133,141330105,San Javier,CORDOBA,268,310,523,491,1014
14,14133,141330104,San Javier,CORDOBA,120,138,212,228,440
14,14140,141400406,San Justo,CORDOBA,245,308,386,320,706
14,14140,141401705,San Justo,CORDOBA,84,122,138,175,313
14,14140,141401007,San Justo,CORDOBA,129,110,219,258,477
14,14140,141401006,San Justo,CORDOBA,127,150,188,245,433
14,14140,141401002,San Justo,CORDOBA,69,106,123,164,287
14,14140,141401001,San Justo,CORDOBA,83,145,128,171,299
14,14140,141400804,San Justo,CORDOBA,177,197,331,407,738
14,14140,141400801,San Justo,CORDOBA,161,208,298,368,666
14,14140,141400204,San Justo,CORDOBA,95,117,155,176,331
14,14140,141400202,San Justo,CORDOBA,99,124,145,168,313
14,14140,141400904,San Justo,CORDOBA,138,185,240,272,512
14,14140,141401902,San Justo,CORDOBA,224,257,334,261,595
14,14140,141400520,San Justo,CORDOBA,383,428,600,587,1187
14,14140,141401908,San Justo,CORDOBA,209,220,283,269,552
14,14140,141401907,San Justo,CORDOBA,203,232,320,273,593
14,14140,141401906,San Justo,CORDOBA,221,266,329,268,597
14,14140,141401905,San Justo,CORDOBA,137,153,245,236,481
14,14140,141401904,San Justo,CORDOBA,189,221,255,217,472
14,14140,141401903,San Justo,CORDOBA,165,199,222,183,405
14,14140,141401901,San Justo,CORDOBA,366,427,568,561,1129
14,14140,141401812,San Justo,CORDOBA,239,244,357,352,709
14,14140,141401811,San Justo,CORDOBA,254,280,366,322,688
14,14140,141401810,San Justo,CORDOBA,213,253,272,225,497
14,14140,141401806,San Justo,CORDOBA,273,278,483,455,938
14,14140,141401805,San Justo,CORDOBA,227,250,384,391,775
14,14140,141401804,San Justo,CORDOBA,221,231,376,346,722
14,14140,141401803,San Justo,CORDOBA,231,255,345,325,670
14,14140,141401802,San Justo,CORDOBA,254,272,417,442,859
14,14140,141401801,San Justo,CORDOBA,218,237,334,311,645
14,14140,141401720,San Justo,CORDOBA,202,226,274,261,535
14,14140,141401719,San Justo,CORDOBA,258,277,385,400,785
14,14140,141401718,San Justo,CORDOBA,68,67,136,155,291
14,14140,141401717,San Justo,CORDOBA,266,268,392,417,809
14,14140,141401716,San Justo,CORDOBA,210,223,323,323,646
14,14140,141401715,San Justo,CORDOBA,285,302,511,538,1049
14,14140,141401714,San Justo,CORDOBA,367,423,549,475,1024
14,14140,141401713,San Justo,CORDOBA,174,203,238,208,446
14,14140,141401712,San Justo,CORDOBA,202,219,313,285,598
14,14140,141401613,San Justo,CORDOBA,191,208,281,264,545
14,14140,141401612,San Justo,CORDOBA,231,248,358,319,677
14,14140,141401611,San Justo,CORDOBA,349,381,488,458,946
14,14140,141401807,San Justo,CORDOBA,208,243,317,281,598
14,14140,141401610,San Justo,CORDOBA,357,391,564,573,1137
14,14140,141401609,San Justo,CORDOBA,244,273,373,377,750
14,14140,141401608,San Justo,CORDOBA,362,418,582,544,1126
14,14140,141401607,San Justo,CORDOBA,214,230,328,292,620
14,14140,141401513,San Justo,CORDOBA,441,490,722,701,1423
14,14140,141401512,San Justo,CORDOBA,331,370,468,467,935
14,14140,141401511,San Justo,CORDOBA,285,308,423,369,792
14,14140,141401510,San Justo,CORDOBA,308,331,478,435,913
14,14140,141401509,San Justo,CORDOBA,248,277,356,325,681
14,14140,141401508,San Justo,CORDOBA,177,193,276,287,563
14,14140,141401507,San Justo,CORDOBA,228,253,387,363,750
14,14140,141401423,San Justo,CORDOBA,260,278,432,435,867
14,14140,141401422,San Justo,CORDOBA,194,194,326,299,625
14,14140,141401421,San Justo,CORDOBA,224,252,343,346,689
14,14140,141401420,San Justo,CORDOBA,202,217,320,291,611
14,14140,141401419,San Justo,CORDOBA,276,277,509,529,1038
14,14140,141401418,San Justo,CORDOBA,302,327,484,392,876
14,14140,141401417,San Justo,CORDOBA,261,283,384,330,714
14,14140,141401416,San Justo,CORDOBA,315,337,477,437,914
14,14140,141401415,San Justo,CORDOBA,316,316,495,458,953
14,14140,141401414,San Justo,CORDOBA,389,404,725,629,1354
14,14140,141401413,San Justo,CORDOBA,381,423,607,569,1176
14,14140,141401412,San Justo,CORDOBA,315,315,494,463,957
14,14140,141401410,San Justo,CORDOBA,178,216,259,220,479
14,14140,141401409,San Justo,CORDOBA,179,197,245,213,458
14,14140,141401408,San Justo,CORDOBA,150,178,252,212,464
14,14140,141401407,San Justo,CORDOBA,233,317,282,243,525
14,14140,141401406,San Justo,CORDOBA,194,229,253,237,490
14,14140,141401405,San Justo,CORDOBA,283,327,395,330,725
14,14140,141401404,San Justo,CORDOBA,267,326,342,291,633
14,14140,141401403,San Justo,CORDOBA,241,255,334,359,693
14,14140,141401402,San Justo,CORDOBA,263,287,384,410,794
14,14140,141401401,San Justo,CORDOBA,320,388,541,805,1346
14,14140,141401808,San Justo,CORDOBA,294,335,436,378,814
14,14140,141401318,San Justo,CORDOBA,233,257,406,388,794
14,14140,141401317,San Justo,CORDOBA,324,359,635,636,1271
14,14140,141401316,San Justo,CORDOBA,266,295,437,395,832
14,14140,141401315,San Justo,CORDOBA,342,334,601,629,1230
14,14140,141401314,San Justo,CORDOBA,202,244,294,257,551
14,14140,141401313,San Justo,CORDOBA,283,309,392,375,767
14,14140,141401312,San Justo,CORDOBA,226,265,313,305,618
14,14140,141401311,San Justo,CORDOBA,242,280,331,271,602
14,14140,141401310,San Justo,CORDOBA,226,264,329,284,613
14,14140,141401309,San Justo,CORDOBA,245,258,305,286,591
14,14140,141401308,San Justo,CORDOBA,181,229,262,227,489
14,14140,141401307,San Justo,CORDOBA,192,227,273,271,544
14,14140,141401306,San Justo,CORDOBA,240,284,345,305,650
14,14140,141401305,San Justo,CORDOBA,275,305,418,353,771
14,14140,141401304,San Justo,CORDOBA,254,291,354,339,693
14,14140,141401303,San Justo,CORDOBA,204,269,272,249,521
14,14140,141401302,San Justo,CORDOBA,221,284,286,274,560
14,14140,141401301,San Justo,CORDOBA,212,313,383,316,699
14,14140,141401219,San Justo,CORDOBA,226,254,345,363,708
14,14140,141401218,San Justo,CORDOBA,189,245,281,216,497
14,14140,141401217,San Justo,CORDOBA,271,411,343,246,589
14,14140,141401216,San Justo,CORDOBA,208,281,331,255,586
14,14140,141401215,San Justo,CORDOBA,221,305,307,260,567
14,14140,141401214,San Justo,CORDOBA,213,255,295,261,556
14,14140,141401213,San Justo,CORDOBA,262,275,401,348,749
14,14140,141401206,San Justo,CORDOBA,353,353,728,728,1456
14,14140,141401205,San Justo,CORDOBA,346,352,664,643,1307
14,14140,141401204,San Justo,CORDOBA,236,249,371,392,763
14,14140,141401203,San Justo,CORDOBA,243,251,458,493,951
14,14140,141401202,San Justo,CORDOBA,174,229,258,246,504
14,14140,141401201,San Justo,CORDOBA,199,274,334,325,659
14,14140,141401121,San Justo,CORDOBA,335,394,493,470,963
14,14140,141401120,San Justo,CORDOBA,350,414,512,461,973
14,14140,141401119,San Justo,CORDOBA,306,368,417,368,785
14,14140,141401118,San Justo,CORDOBA,323,430,422,341,763
14,14140,141401117,San Justo,CORDOBA,184,257,269,214,483
14,14140,141401116,San Justo,CORDOBA,216,257,270,217,487
14,14140,141401115,San Justo,CORDOBA,196,260,273,235,508
14,14140,141401114,San Justo,CORDOBA,282,307,389,311,700
14,14140,141401113,San Justo,CORDOBA,289,331,386,359,745
14,14140,141401112,San Justo,CORDOBA,219,239,299,220,519
14,14140,141401111,San Justo,CORDOBA,237,275,337,279,616
14,14140,141401110,San Justo,CORDOBA,291,335,439,394,833
14,14140,141401109,San Justo,CORDOBA,242,258,398,400,798
14,14140,141401108,San Justo,CORDOBA,455,483,788,740,1528
14,14140,141401107,San Justo,CORDOBA,211,243,279,253,532
14,14140,141401106,San Justo,CORDOBA,192,219,280,260,540
14,14140,141401105,San Justo,CORDOBA,299,327,408,368,776
14,14140,141401104,San Justo,CORDOBA,220,236,325,261,586
14,14140,141401103,San Justo,CORDOBA,361,390,520,499,1019
14,14140,141401102,San Justo,CORDOBA,219,293,326,358,684
14,14140,141401101,San Justo,CORDOBA,136,263,213,240,453
14,14140,141401016,San Justo,CORDOBA,348,387,525,448,973
14,14140,141401015,San Justo,CORDOBA,284,309,418,388,806
14,14140,141401014,San Justo,CORDOBA,215,222,327,298,625
14,14140,141401013,San Justo,CORDOBA,161,184,219,189,408
14,14140,141401012,San Justo,CORDOBA,364,396,557,485,1042
14,14140,141401011,San Justo,CORDOBA,272,287,460,424,884
14,14140,141401010,San Justo,CORDOBA,274,294,432,413,845
14,14140,141401009,San Justo,CORDOBA,219,241,337,302,639
14,14140,141401008,San Justo,CORDOBA,182,202,259,255,514
14,14140,141400915,San Justo,CORDOBA,374,408,565,470,1035
14,14140,141400914,San Justo,CORDOBA,302,314,501,522,1023
14,14140,141400913,San Justo,CORDOBA,272,325,390,340,730
14,14140,141400912,San Justo,CORDOBA,210,235,293,268,561
14,14140,141400911,San Justo,CORDOBA,353,402,521,526,1047
14,14140,141400910,San Justo,CORDOBA,259,271,477,464,941
14,14140,141400821,San Justo,CORDOBA,179,199,268,454,722
14,14140,141400820,San Justo,CORDOBA,355,393,516,516,1032
14,14140,141400819,San Justo,CORDOBA,266,298,479,436,915
14,14140,141400818,San Justo,CORDOBA,307,322,551,540,1091
14,14140,141400817,San Justo,CORDOBA,279,318,467,388,855
14,14140,141400815,San Justo,CORDOBA,249,258,407,356,763
14,14140,141400809,San Justo,CORDOBA,294,320,473,474,947
14,14140,141401017,San Justo,CORDOBA,306,309,530,507,1037
14,14140,141400720,San Justo,CORDOBA,279,351,519,503,1022
14,14140,141400719,San Justo,CORDOBA,292,311,484,448,932
14,14140,141400718,San Justo,CORDOBA,347,372,514,444,958
14,14140,141400717,San Justo,CORDOBA,116,137,198,194,392
14,14140,141400716,San Justo,CORDOBA,317,361,423,348,771
14,14140,141400715,San Justo,CORDOBA,284,295,441,414,855
14,14140,141400714,San Justo,CORDOBA,285,293,535,508,1043
14,14140,141400713,San Justo,CORDOBA,347,350,507,500,1007
14,14140,141400712,San Justo,CORDOBA,217,282,279,237,516
14,14140,141400711,San Justo,CORDOBA,331,373,446,463,909
14,14140,141400710,San Justo,CORDOBA,368,410,684,691,1375
14,14140,141400709,San Justo,CORDOBA,233,248,400,360,760
14,14140,141400708,San Justo,CORDOBA,178,218,222,183,405
14,14140,141400707,San Justo,CORDOBA,198,210,261,221,482
14,14140,141400706,San Justo,CORDOBA,390,406,636,609,1245
14,14140,141400705,San Justo,CORDOBA,389,416,681,666,1347
14,14140,141400704,San Justo,CORDOBA,198,220,265,261,526
14,14140,141400703,San Justo,CORDOBA,243,272,338,322,660
14,14140,141400702,San Justo,CORDOBA,344,381,480,406,886
14,14140,141400619,San Justo,CORDOBA,328,354,527,481,1008
14,14140,141400618,San Justo,CORDOBA,184,214,242,200,442
14,14140,141400616,San Justo,CORDOBA,378,418,614,586,1200
14,14140,141400615,San Justo,CORDOBA,147,166,287,279,566
14,14140,141400614,San Justo,CORDOBA,251,290,378,367,745
14,14140,141400613,San Justo,CORDOBA,115,156,220,223,443
14,14140,141400612,San Justo,CORDOBA,197,234,338,322,660
14,14140,141400611,San Justo,CORDOBA,243,272,378,323,701
14,14140,141400610,San Justo,CORDOBA,374,422,625,577,1202
14,14140,141400617,San Justo,CORDOBA,189,218,266,238,504
14,14140,141400516,San Justo,CORDOBA,279,319,411,421,832
14,14140,141400515,San Justo,CORDOBA,265,299,449,414,863
14,14140,141400514,San Justo,CORDOBA,292,317,445,375,820
14,14140,141400513,San Justo,CORDOBA,202,224,298,281,579
14,14140,141400405,San Justo,CORDOBA,213,287,326,270,596
14,14140,141400404,San Justo,CORDOBA,208,249,301,231,532
14,14140,141400213,San Justo,CORDOBA,99,119,152,145,297
14,14140,141400212,San Justo,CORDOBA,234,268,373,372,745
14,14140,141400211,San Justo,CORDOBA,176,199,275,237,512
14,14140,141400407,San Justo,CORDOBA,333,370,544,475,1019
14,14140,141400510,San Justo,CORDOBA,103,112,165,151,316
14,14140,141400408,San Justo,CORDOBA,346,356,654,618,1272
14,14140,141400512,San Justo,CORDOBA,222,250,370,341,711
14,14140,141400511,San Justo,CORDOBA,327,351,549,534,1083
14,14140,141400508,San Justo,CORDOBA,311,434,466,387,853
14,14140,141400413,San Justo,CORDOBA,376,309,691,687,1378
14,14140,141400412,San Justo,CORDOBA,342,363,522,530,1052
14,14140,141400411,San Justo,CORDOBA,188,231,301,317,618
14,14140,141400410,San Justo,CORDOBA,242,248,389,393,782
14,14140,141400409,San Justo,CORDOBA,356,377,628,599,1227
14,14140,141400403,San Justo,CORDOBA,186,232,259,258,517
14,14140,141400402,San Justo,CORDOBA,236,247,351,324,675
14,14140,141400401,San Justo,CORDOBA,219,260,327,279,606
14,14140,141400313,San Justo,CORDOBA,131,151,213,166,379
14,14140,141400312,San Justo,CORDOBA,250,273,422,400,822
14,14140,141400311,San Justo,CORDOBA,232,267,369,293,662
14,14140,141400310,San Justo,CORDOBA,273,311,411,363,774
14,14140,141400309,San Justo,CORDOBA,213,222,343,343,686
14,14140,141400308,San Justo,CORDOBA,335,365,573,532,1105
14,14140,141400307,San Justo,CORDOBA,296,299,456,457,913
14,14140,141400306,San Justo,CORDOBA,278,307,413,399,812
14,14140,141400305,San Justo,CORDOBA,311,341,516,521,1037
14,14140,141400304,San Justo,CORDOBA,217,233,355,347,702
14,14140,141400303,San Justo,CORDOBA,215,242,310,302,612
14,14140,141400302,San Justo,CORDOBA,396,432,667,640,1307
14,14140,141400301,San Justo,CORDOBA,350,362,645,711,1356
14,14140,141400112,San Justo,CORDOBA,246,275,384,370,754
14,14140,141400111,San Justo,CORDOBA,239,269,368,386,754
14,14140,141400110,San Justo,CORDOBA,183,218,298,274,572
14,14140,141400109,San Justo,CORDOBA,293,315,408,398,806
14,14140,141401809,San Justo,CORDOBA,275,317,398,323,721
14,14140,141401212,San Justo,CORDOBA,303,329,550,480,1030
14,14140,141401211,San Justo,CORDOBA,374,395,625,628,1253
14,14140,141401210,San Justo,CORDOBA,334,362,584,576,1160
14,14140,141401209,San Justo,CORDOBA,261,285,364,337,701
14,14140,141401208,San Justo,CORDOBA,271,326,399,381,780
14,14140,141401911,San Justo,CORDOBA,228,239,348,319,667
14,14140,141401910,San Justo,CORDOBA,404,460,636,599,1235
14,14140,141401909,San Justo,CORDOBA,268,313,435,441,876
14,14140,141401711,San Justo,CORDOBA,365,392,653,638,1291
14,14140,141401615,San Justo,CORDOBA,206,216,342,345,687
14,14140,141401614,San Justo,CORDOBA,267,278,486,475,961
14,14140,141401515,San Justo,CORDOBA,101,117,158,156,314
14,14140,141401514,San Justo,CORDOBA,111,137,174,190,364
14,14140,141401411,San Justo,CORDOBA,240,272,323,309,632
14,14140,141400916,San Justo,CORDOBA,193,194,300,282,582
14,14140,141400909,San Justo,CORDOBA,299,331,446,427,873
14,14140,141400908,San Justo,CORDOBA,283,300,437,408,845
14,14140,141400816,San Justo,CORDOBA,247,276,337,284,621
14,14140,141400814,San Justo,CORDOBA,213,233,424,399,823
14,14140,141400813,San Justo,CORDOBA,281,298,416,372,788
14,14140,141400812,San Justo,CORDOBA,351,372,576,528,1104
14,14140,141400811,San Justo,CORDOBA,215,220,360,374,734
14,14140,141400810,San Justo,CORDOBA,259,246,590,574,1164
14,14140,141400701,San Justo,CORDOBA,245,255,386,413,799
14,14140,141400519,San Justo,CORDOBA,204,237,320,284,604
14,14140,141400518,San Justo,CORDOBA,203,218,307,285,592
14,14140,141400517,San Justo,CORDOBA,207,220,336,289,625
14,14140,141400509,San Justo,CORDOBA,290,419,464,390,854
14,14140,141400113,San Justo,CORDOBA,64,86,123,104,227
14,14140,141401207,San Justo,CORDOBA,290,325,427,407,834
14,14140,141401703,San Justo,CORDOBA,38,52,60,72,132
14,14140,141401702,San Justo,CORDOBA,66,84,126,153,279
14,14140,141401701,San Justo,CORDOBA,59,85,94,123,217
14,14140,141401606,San Justo,CORDOBA,77,117,136,171,307
14,14140,141401605,San Justo,CORDOBA,86,128,151,176,327
14,14140,141401604,San Justo,CORDOBA,11,35,18,19,37
14,14140,141401603,San Justo,CORDOBA,51,148,72,100,172
14,14140,141401602,San Justo,CORDOBA,59,114,96,114,210
14,14140,141401506,San Justo,CORDOBA,49,73,79,93,172
14,14140,141401505,San Justo,CORDOBA,84,119,139,180,319
14,14140,141401504,San Justo,CORDOBA,79,117,153,196,349
14,14140,141401503,San Justo,CORDOBA,67,118,108,118,226
14,14140,141401502,San Justo,CORDOBA,56,75,80,115,195
14,14140,141401501,San Justo,CORDOBA,74,99,116,145,261
14,14140,141401601,San Justo,CORDOBA,40,93,54,82,136
14,14140,141401005,San Justo,CORDOBA,39,67,74,88,162
14,14140,141401004,San Justo,CORDOBA,47,87,73,94,167
14,14140,141401003,San Justo,CORDOBA,71,110,133,176,309
14,14140,141400907,San Justo,CORDOBA,38,71,58,82,140
14,14140,141400906,San Justo,CORDOBA,84,141,169,194,363
14,14140,141400905,San Justo,CORDOBA,59,66,99,126,225
14,14140,141400903,San Justo,CORDOBA,75,107,127,153,280
14,14140,141400902,San Justo,CORDOBA,29,44,54,67,121
14,14140,141400901,San Justo,CORDOBA,64,69,122,147,269
14,14140,141400808,San Justo,CORDOBA,80,114,137,171,308
14,14140,141400807,San Justo,CORDOBA,81,85,157,189,346
14,14140,141400806,San Justo,CORDOBA,38,52,69,76,145
14,14140,141400805,San Justo,CORDOBA,73,73,151,183,334
14,14140,141400803,San Justo,CORDOBA,144,200,297,341,638
14,14140,141400802,San Justo,CORDOBA,98,183,191,231,422
14,14140,141400608,San Justo,CORDOBA,46,75,67,90,157
14,14140,141400607,San Justo,CORDOBA,44,82,85,83,168
14,14140,141400606,San Justo,CORDOBA,47,80,83,84,167
14,14140,141400605,San Justo,CORDOBA,68,103,131,143,274
14,14140,141400604,San Justo,CORDOBA,89,111,139,180,319
14,14140,141400603,San Justo,CORDOBA,20,33,25,37,62
14,14140,141400602,San Justo,CORDOBA,28,55,46,60,106
14,14140,141400601,San Justo,CORDOBA,16,21,20,25,45
14,14140,141400507,San Justo,CORDOBA,10,19,13,28,41
14,14140,141400506,San Justo,CORDOBA,51,92,85,123,208
14,14140,141400505,San Justo,CORDOBA,60,77,109,145,254
14,14140,141400504,San Justo,CORDOBA,43,91,54,102,156
14,14140,141400503,San Justo,CORDOBA,35,48,53,65,118
14,14140,141400502,San Justo,CORDOBA,89,113,144,171,315
14,14140,141400209,San Justo,CORDOBA,48,55,70,123,193
14,14140,141400208,San Justo,CORDOBA,60,79,99,134,233
14,14140,141400207,San Justo,CORDOBA,24,35,40,56,96
14,14140,141400206,San Justo,CORDOBA,84,118,144,180,324
14,14140,141400205,San Justo,CORDOBA,30,37,61,68,129
14,14140,141400203,San Justo,CORDOBA,55,74,98,120,218
14,14140,141400108,San Justo,CORDOBA,47,59,62,101,163
14,14140,141400107,San Justo,CORDOBA,28,32,39,52,91
14,14140,141400106,San Justo,CORDOBA,17,27,33,36,69
14,14140,141400105,San Justo,CORDOBA,29,42,41,50,91
14,14140,141400104,San Justo,CORDOBA,39,44,52,66,118
14,14140,141400201,San Justo,CORDOBA,46,63,56,90,146
14,14140,141400103,San Justo,CORDOBA,115,137,178,211,389
14,14140,141400102,San Justo,CORDOBA,40,60,79,80,159
14,14140,141400101,San Justo,CORDOBA,41,46,74,104,178
14,14140,141400210,San Justo,CORDOBA,25,40,47,60,107
14,14140,141400609,San Justo,CORDOBA,26,44,52,61,113
14,14140,141400501,San Justo,CORDOBA,70,135,109,111,220
14,14140,141401710,San Justo,CORDOBA,73,110,103,144,247
14,14140,141401709,San Justo,CORDOBA,107,119,181,181,362
14,14140,141401708,San Justo,CORDOBA,73,134,110,178,288
14,14140,141401707,San Justo,CORDOBA,21,31,30,42,72
14,14140,141401706,San Justo,CORDOBA,49,91,86,98,184
14,14140,141401704,San Justo,CORDOBA,23,73,34,47,81
14,14119,141190917,Río Segundo,CORDOBA,349,390,527,491,1018
14,14119,141190913,Río Segundo,CORDOBA,184,222,260,215,475
14,14119,141190912,Río Segundo,CORDOBA,374,415,585,538,1123
14,14119,141190911,Río Segundo,CORDOBA,295,321,457,418,875
14,14119,141190910,Río Segundo,CORDOBA,178,209,270,189,459
14,14119,141190909,Río Segundo,CORDOBA,273,295,421,351,772
14,14119,141190908,Río Segundo,CORDOBA,241,264,356,295,651
14,14119,141190907,Río Segundo,CORDOBA,209,218,320,296,616
14,14119,141190906,Río Segundo,CORDOBA,226,250,353,308,661
14,14119,141190905,Río Segundo,CORDOBA,256,271,396,361,757
14,14119,141190904,Río Segundo,CORDOBA,244,280,391,360,751
14,14119,141190903,Río Segundo,CORDOBA,181,187,277,260,537
14,14119,141190902,Río Segundo,CORDOBA,287,309,464,463,927
14,14119,141190501,Río Segundo,CORDOBA,82,127,115,133,248
14,14119,141190301,Río Segundo,CORDOBA,110,141,183,196,379
14,14119,141190506,Río Segundo,CORDOBA,34,64,54,64,118
14,14119,141190901,Río Segundo,CORDOBA,248,265,436,405,841
14,14119,141190816,Río Segundo,CORDOBA,244,269,384,348,732
14,14119,141190815,Río Segundo,CORDOBA,402,420,685,594,1279
14,14119,141190814,Río Segundo,CORDOBA,298,339,468,428,896
14,14119,141190813,Río Segundo,CORDOBA,298,366,438,447,885
14,14119,141190812,Río Segundo,CORDOBA,326,371,549,555,1104
14,14119,141190811,Río Segundo,CORDOBA,302,362,450,409,859
14,14119,141190810,Río Segundo,CORDOBA,331,386,528,438,966
14,14119,141190809,Río Segundo,CORDOBA,331,396,505,475,980
14,14119,141190807,Río Segundo,CORDOBA,228,247,425,404,829
14,14119,141190806,Río Segundo,CORDOBA,215,226,356,384,740
14,14119,141190805,Río Segundo,CORDOBA,237,282,390,348,738
14,14119,141190804,Río Segundo,CORDOBA,241,288,359,320,679
14,14119,141190803,Río Segundo,CORDOBA,193,258,322,304,626
14,14119,141190802,Río Segundo,CORDOBA,212,237,386,408,794
14,14119,141190801,Río Segundo,CORDOBA,287,297,572,610,1182
14,14119,141190714,Río Segundo,CORDOBA,215,247,374,355,729
14,14119,141190713,Río Segundo,CORDOBA,271,287,498,493,991
14,14119,141190712,Río Segundo,CORDOBA,260,275,485,408,893
14,14119,141190711,Río Segundo,CORDOBA,228,281,392,361,753
14,14119,141190710,Río Segundo,CORDOBA,353,386,545,470,1015
14,14119,141190709,Río Segundo,CORDOBA,295,344,543,546,1089
14,14119,141190708,Río Segundo,CORDOBA,318,331,588,569,1157
14,14119,141190707,Río Segundo,CORDOBA,306,349,477,404,881
14,14119,141190705,Río Segundo,CORDOBA,342,358,597,532,1129
14,14119,141190704,Río Segundo,CORDOBA,363,423,635,591,1226
14,14119,141190703,Río Segundo,CORDOBA,444,520,804,739,1543
14,14119,141190702,Río Segundo,CORDOBA,303,342,531,524,1055
14,14119,141190701,Río Segundo,CORDOBA,304,324,581,560,1141
14,14119,141190621,Río Segundo,CORDOBA,289,299,556,557,1113
14,14119,141190620,Río Segundo,CORDOBA,287,302,547,536,1083
14,14119,141190619,Río Segundo,CORDOBA,295,305,548,547,1095
14,14119,141190618,Río Segundo,CORDOBA,254,294,430,437,867
14,14119,141190610,Río Segundo,CORDOBA,248,263,484,428,912
14,14119,141190609,Río Segundo,CORDOBA,255,307,416,360,776
14,14119,141190608,Río Segundo,CORDOBA,225,281,351,296,647
14,14119,141190607,Río Segundo,CORDOBA,308,353,455,442,897
14,14119,141190606,Río Segundo,CORDOBA,377,405,722,697,1419
14,14119,141190605,Río Segundo,CORDOBA,384,417,665,689,1354
14,14119,141190604,Río Segundo,CORDOBA,248,279,390,342,732
14,14119,141190603,Río Segundo,CORDOBA,296,354,520,474,994
14,14119,141190602,Río Segundo,CORDOBA,342,364,593,552,1145
14,14119,141190601,Río Segundo,CORDOBA,350,362,678,650,1328
14,14119,141190515,Río Segundo,CORDOBA,238,265,379,380,759
14,14119,141190514,Río Segundo,CORDOBA,299,303,459,500,959
14,14119,141190513,Río Segundo,CORDOBA,221,237,345,294,639
14,14119,141190512,Río Segundo,CORDOBA,272,308,442,403,845
14,14119,141190511,Río Segundo,CORDOBA,272,308,460,443,903
14,14119,141190617,Río Segundo,CORDOBA,218,233,389,381,770
14,14119,141190616,Río Segundo,CORDOBA,235,258,439,423,862
14,14119,141190615,Río Segundo,CORDOBA,220,221,369,336,705
14,14119,141190614,Río Segundo,CORDOBA,159,184,246,206,452
14,14119,141190420,Río Segundo,CORDOBA,271,282,447,471,918
14,14119,141190419,Río Segundo,CORDOBA,280,311,396,337,733
14,14119,141190418,Río Segundo,CORDOBA,389,442,553,515,1068
14,14119,141190417,Río Segundo,CORDOBA,212,237,356,328,684
14,14119,141190416,Río Segundo,CORDOBA,207,228,360,347,707
14,14119,141190415,Río Segundo,CORDOBA,233,274,348,311,659
14,14119,141190414,Río Segundo,CORDOBA,293,321,475,436,911
14,14119,141190413,Río Segundo,CORDOBA,349,405,507,514,1021
14,14119,141190412,Río Segundo,CORDOBA,251,285,376,366,742
14,14119,141190411,Río Segundo,CORDOBA,392,396,618,605,1223
14,14119,141190612,Río Segundo,CORDOBA,283,316,503,469,972
14,14119,141190316,Río Segundo,CORDOBA,337,377,605,536,1141
14,14119,141190215,Río Segundo,CORDOBA,213,244,347,314,661
14,14119,141190214,Río Segundo,CORDOBA,242,260,403,416,819
14,14119,141190213,Río Segundo,CORDOBA,317,355,485,487,972
14,14119,141190310,Río Segundo,CORDOBA,240,257,362,395,757
14,14119,141190315,Río Segundo,CORDOBA,318,352,491,440,931
14,14119,141190115,Río Segundo,CORDOBA,317,353,479,482,961
14,14119,141190114,Río Segundo,CORDOBA,282,294,532,511,1043
14,14119,141190112,Río Segundo,CORDOBA,324,374,491,488,979
14,14119,141190111,Río Segundo,CORDOBA,255,306,413,356,769
14,14119,141190110,Río Segundo,CORDOBA,154,179,245,200,445
14,14119,141190109,Río Segundo,CORDOBA,376,418,619,600,1219
14,14119,141190108,Río Segundo,CORDOBA,329,353,562,496,1058
14,14119,141190107,Río Segundo,CORDOBA,190,223,342,288,630
14,14119,141190106,Río Segundo,CORDOBA,205,243,312,275,587
14,14119,141190309,Río Segundo,CORDOBA,96,120,161,167,328
14,14119,141190308,Río Segundo,CORDOBA,285,334,461,442,903
14,14119,141190306,Río Segundo,CORDOBA,291,324,471,446,917
14,14119,141190314,Río Segundo,CORDOBA,403,431,646,580,1226
14,14119,141190313,Río Segundo,CORDOBA,212,220,367,383,750
14,14119,141190312,Río Segundo,CORDOBA,199,219,331,349,680
14,14119,141190311,Río Segundo,CORDOBA,228,244,385,383,768
14,14119,141190916,Río Segundo,CORDOBA,308,336,522,534,1056
14,14119,141190915,Río Segundo,CORDOBA,231,263,377,333,710
14,14119,141190914,Río Segundo,CORDOBA,319,347,510,441,951
14,14119,141190808,Río Segundo,CORDOBA,347,373,612,540,1152
14,14119,141190706,Río Segundo,CORDOBA,361,428,581,552,1133
14,14119,141190410,Río Segundo,CORDOBA,374,382,609,603,1212
14,14119,141190307,Río Segundo,CORDOBA,284,328,515,444,959
14,14119,141190212,Río Segundo,CORDOBA,148,157,243,274,517
14,14119,141190113,Río Segundo,CORDOBA,250,267,361,346,707
14,14119,141190817,Río Segundo,CORDOBA,241,252,449,423,872
14,14119,141190613,Río Segundo,CORDOBA,233,263,341,276,617
14,14119,141190611,Río Segundo,CORDOBA,283,312,506,467,973
14,14119,141190510,Río Segundo,CORDOBA,16,30,27,34,61
14,14119,141190509,Río Segundo,CORDOBA,16,54,17,30,47
14,14119,141190508,Río Segundo,CORDOBA,37,41,49,72,121
14,14119,141190507,Río Segundo,CORDOBA,11,30,9,16,25
14,14119,141190505,Río Segundo,CORDOBA,38,53,52,62,114
14,14119,141190504,Río Segundo,CORDOBA,71,144,101,111,212
14,14119,141190503,Río Segundo,CORDOBA,65,111,106,113,219
14,14119,141190502,Río Segundo,CORDOBA,15,29,26,27,53
14,14119,141190409,Río Segundo,CORDOBA,120,144,186,262,448
14,14119,141190408,Río Segundo,CORDOBA,55,106,104,111,215
14,14119,141190407,Río Segundo,CORDOBA,62,94,101,122,223
14,14119,141190406,Río Segundo,CORDOBA,39,81,77,74,151
14,14119,141190405,Río Segundo,CORDOBA,20,53,24,40,64
14,14119,141190404,Río Segundo,CORDOBA,29,74,41,58,99
14,14119,141190403,Río Segundo,CORDOBA,18,54,17,32,49
14,14119,141190402,Río Segundo,CORDOBA,30,47,44,52,96
14,14119,141190401,Río Segundo,CORDOBA,13,27,19,29,48
14,14119,141190304,Río Segundo,CORDOBA,40,56,62,76,138
14,14119,141190303,Río Segundo,CORDOBA,71,117,118,133,251
14,14119,141190302,Río Segundo,CORDOBA,89,139,142,186,328
14,14119,141190305,Río Segundo,CORDOBA,32,64,63,64,127
14,14119,141190211,Río Segundo,CORDOBA,27,62,47,49,96
14,14119,141190210,Río Segundo,CORDOBA,15,47,23,24,47
14,14119,141190209,Río Segundo,CORDOBA,23,69,38,48,86
14,14119,141190208,Río Segundo,CORDOBA,4,6,8,8,16
14,14119,141190207,Río Segundo,CORDOBA,4,8,2,4,6
14,14119,141190205,Río Segundo,CORDOBA,55,69,63,96,159
14,14119,141190204,Río Segundo,CORDOBA,16,23,16,22,38
14,14119,141190203,Río Segundo,CORDOBA,14,38,12,22,34
14,14119,141190202,Río Segundo,CORDOBA,21,49,35,46,81
14,14119,141190201,Río Segundo,CORDOBA,14,22,20,22,42
14,14119,141190105,Río Segundo,CORDOBA,26,41,41,51,92
14,14119,141190104,Río Segundo,CORDOBA,17,36,24,33,57
14,14119,141190103,Río Segundo,CORDOBA,52,82,90,88,178
14,14119,141190101,Río Segundo,CORDOBA,272,337,489,544,1033
14,14119,141190102,Río Segundo,CORDOBA,73,139,112,134,246
14,14119,141190206,Río Segundo,CORDOBA,8,20,10,12,22
46,46035,460350202,Chamical,LA RIOJA,181,272,249,309,558
46,46035,460350203,Chamical,LA RIOJA,48,94,78,87,165
46,46035,460350201,Chamical,LA RIOJA,365,522,660,708,1368
46,46035,460350107,Chamical,LA RIOJA,378,447,600,580,1180
46,46035,460350109,Chamical,LA RIOJA,379,426,690,681,1371
46,46035,460350108,Chamical,LA RIOJA,429,490,859,838,1697
46,46035,460350104,Chamical,LA RIOJA,529,574,1007,1018,2025
46,46035,460350101,Chamical,LA RIOJA,374,414,642,593,1235
46,46035,460350106,Chamical,LA RIOJA,322,354,568,552,1120
46,46035,460350103,Chamical,LA RIOJA,528,596,978,920,1898
46,46035,460350102,Chamical,LA RIOJA,293,341,436,405,841
46,46035,460350105,Chamical,LA RIOJA,232,259,357,345,702
46,46014,460140103,Capital,LA RIOJA,487,731,795,852,1647
46,46014,460141113,Capital,LA RIOJA,370,498,577,552,1129
46,46014,460141107,Capital,LA RIOJA,308,377,557,500,1057
46,46014,460141016,Capital,LA RIOJA,334,279,740,688,1428
46,46014,460141009,Capital,LA RIOJA,228,230,440,443,883
46,46014,460141007,Capital,LA RIOJA,242,226,460,434,894
46,46014,460140908,Capital,LA RIOJA,408,461,765,684,1449
46,46014,460140901,Capital,LA RIOJA,330,394,605,648,1253
46,46014,460140806,Capital,LA RIOJA,445,433,725,741,1466
46,46014,460140716,Capital,LA RIOJA,258,381,433,466,899
46,46014,460140709,Capital,LA RIOJA,275,361,519,539,1058
46,46014,460140803,Capital,LA RIOJA,421,464,704,620,1324
46,46014,460140611,Capital,LA RIOJA,282,420,472,395,867
46,46014,460140601,Capital,LA RIOJA,387,394,706,593,1299
46,46014,460140418,Capital,LA RIOJA,230,245,401,372,773
46,46014,460140409,Capital,LA RIOJA,278,309,555,483,1038
46,46014,460140106,Capital,LA RIOJA,363,426,692,715,1407
46,46014,460140812,Capital,LA RIOJA,302,323,575,566,1141
46,46014,460141013,Capital,LA RIOJA,410,422,871,890,1761
46,46014,460140920,Capital,LA RIOJA,357,483,674,648,1322
46,46014,460140917,Capital,LA RIOJA,444,460,994,885,1879
46,46014,460140909,Capital,LA RIOJA,355,391,679,664,1343
46,46014,460140904,Capital,LA RIOJA,234,279,458,392,850
46,46014,460140902,Capital,LA RIOJA,320,400,492,421,913
46,46014,460140801,Capital,LA RIOJA,373,402,600,543,1143
46,46014,460140707,Capital,LA RIOJA,268,292,557,520,1077
46,46014,460140706,Capital,LA RIOJA,273,279,621,569,1190
46,46014,460140702,Capital,LA RIOJA,487,512,980,973,1953
46,46014,460140515,Capital,LA RIOJA,363,367,796,786,1582
46,46014,460140507,Capital,LA RIOJA,397,412,835,819,1654
46,46014,460140504,Capital,LA RIOJA,431,528,916,852,1768
46,46014,460140414,Capital,LA RIOJA,221,248,412,382,794
46,46014,460140413,Capital,LA RIOJA,341,360,656,625,1281
46,46014,460140412,Capital,LA RIOJA,286,315,516,493,1009
46,46014,460140111,Capital,LA RIOJA,369,469,651,615,1266
46,46014,460140906,Capital,LA RIOJA,431,526,842,806,1648
46,46014,460140201,Capital,LA RIOJA,28,44,28,47,75
46,46014,460141106,Capital,LA RIOJA,384,328,712,712,1424
46,46014,460141101,Capital,LA RIOJA,390,441,789,820,1609
46,46014,460141005,Capital,LA RIOJA,444,530,947,899,1846
46,46014,460141006,Capital,LA RIOJA,394,433,863,864,1727
46,46014,460140905,Capital,LA RIOJA,220,251,424,379,803
46,46014,460140809,Capital,LA RIOJA,376,404,693,645,1338
46,46014,460140711,Capital,LA RIOJA,280,296,510,508,1018
46,46014,460140605,Capital,LA RIOJA,308,555,417,355,772
46,46014,460140514,Capital,LA RIOJA,354,347,762,742,1504
46,46014,460140513,Capital,LA RIOJA,302,332,681,682,1363
46,46014,460140503,Capital,LA RIOJA,259,305,514,487,1001
46,46014,460140501,Capital,LA RIOJA,239,251,431,399,830
46,46014,460140415,Capital,LA RIOJA,235,255,425,397,822
46,46014,460140408,Capital,LA RIOJA,373,389,661,570,1231
46,46014,460140402,Capital,LA RIOJA,275,306,500,429,929
46,46014,460140105,Capital,LA RIOJA,239,302,488,480,968
46,46014,460141115,Capital,LA RIOJA,482,638,752,739,1491
46,46014,460140302,Capital,LA RIOJA,83,104,133,179,312
46,46014,460140102,Capital,LA RIOJA,28,33,33,50,83
46,46014,460141111,Capital,LA RIOJA,428,467,815,740,1555
46,46014,460141110,Capital,LA RIOJA,477,474,945,971,1916
46,46014,460141108,Capital,LA RIOJA,403,463,747,720,1467
46,46014,460141015,Capital,LA RIOJA,241,236,529,480,1009
46,46014,460141010,Capital,LA RIOJA,276,271,545,486,1031
46,46014,460140916,Capital,LA RIOJA,352,373,719,708,1427
46,46014,460140907,Capital,LA RIOJA,374,413,746,620,1366
46,46014,460140814,Capital,LA RIOJA,444,515,769,724,1493
46,46014,460140802,Capital,LA RIOJA,314,334,547,501,1048
46,46014,460140610,Capital,LA RIOJA,327,430,497,385,882
46,46014,460140609,Capital,LA RIOJA,241,305,360,313,673
46,46014,460140608,Capital,LA RIOJA,239,327,331,282,613
46,46014,460140604,Capital,LA RIOJA,272,315,451,376,827
46,46014,460140603,Capital,LA RIOJA,209,273,294,264,558
46,46014,460140517,Capital,LA RIOJA,423,435,812,815,1627
46,46014,460140516,Capital,LA RIOJA,361,335,791,758,1549
46,46014,460140512,Capital,LA RIOJA,278,256,638,634,1272
46,46014,460140511,Capital,LA RIOJA,271,278,585,599,1184
46,46014,460140509,Capital,LA RIOJA,417,460,876,793,1669
46,46014,460140505,Capital,LA RIOJA,332,331,628,645,1273
46,46014,460140502,Capital,LA RIOJA,255,276,481,435,916
46,46014,460140403,Capital,LA RIOJA,247,274,441,383,824
46,46014,460140108,Capital,LA RIOJA,237,280,426,467,893
46,46014,460141114,Capital,LA RIOJA,422,494,676,687,1363
46,46014,460141004,Capital,LA RIOJA,208,263,403,440,843
46,46014,460141003,Capital,LA RIOJA,285,293,530,515,1045
46,46014,460140922,Capital,LA RIOJA,345,589,678,649,1327
46,46014,460140915,Capital,LA RIOJA,424,441,857,896,1753
46,46014,460140914,Capital,LA RIOJA,430,483,880,706,1586
46,46014,460140913,Capital,LA RIOJA,278,349,462,429,891
46,46014,460140804,Capital,LA RIOJA,436,520,628,568,1196
46,46014,460140708,Capital,LA RIOJA,333,378,691,652,1343
46,46014,460140705,Capital,LA RIOJA,432,468,801,784,1585
46,46014,460140701,Capital,LA RIOJA,99,205,180,196,376
46,46014,460140417,Capital,LA RIOJA,231,259,445,391,836
46,46014,460140407,Capital,LA RIOJA,250,263,496,443,939
46,46014,460140401,Capital,LA RIOJA,287,325,513,521,1034
46,46014,460140606,Capital,LA RIOJA,269,401,402,317,719
46,46014,460140109,Capital,LA RIOJA,510,592,975,1008,1983
46,46014,460140202,Capital,LA RIOJA,103,158,159,165,324
46,46014,460141011,Capital,LA RIOJA,251,253,508,510,1018
46,46014,460140911,Capital,LA RIOJA,55,136,64,98,162
46,46014,460140910,Capital,LA RIOJA,553,592,1174,1045,2219
46,46014,460140810,Capital,LA RIOJA,453,494,800,663,1463
46,46014,460140807,Capital,LA RIOJA,380,352,790,723,1513
46,46014,460140718,Capital,LA RIOJA,177,265,313,331,644
46,46014,460140717,Capital,LA RIOJA,113,233,198,192,390
46,46014,460140703,Capital,LA RIOJA,471,541,848,878,1726
46,46014,460140518,Capital,LA RIOJA,389,383,699,673,1372
46,46014,460140104,Capital,LA RIOJA,209,260,365,342,707
46,46014,460140107,Capital,LA RIOJA,348,392,780,836,1616
46,46014,460140811,Capital,LA RIOJA,417,418,779,719,1498
46,46014,460140607,Capital,LA RIOJA,276,405,394,323,717
46,46014,460141112,Capital,LA RIOJA,371,412,642,551,1193
46,46014,460141109,Capital,LA RIOJA,415,468,735,630,1365
46,46014,460141103,Capital,LA RIOJA,218,222,462,468,930
46,46014,460141018,Capital,LA RIOJA,295,356,549,542,1091
46,46014,460141105,Capital,LA RIOJA,496,490,1039,1001,2040
46,46014,460141017,Capital,LA RIOJA,606,651,1321,1581,2902
46,46014,460141001,Capital,LA RIOJA,327,333,612,564,1176
46,46014,460140918,Capital,LA RIOJA,338,470,758,687,1445
46,46014,460140903,Capital,LA RIOJA,218,271,375,364,739
46,46014,460140813,Capital,LA RIOJA,334,423,472,399,871
46,46014,460140808,Capital,LA RIOJA,262,248,445,438,883
46,46014,460140715,Capital,LA RIOJA,283,298,575,559,1134
46,46014,460140704,Capital,LA RIOJA,389,427,745,741,1486
46,46014,460140519,Capital,LA RIOJA,316,346,522,527,1049
46,46014,460140508,Capital,LA RIOJA,427,450,904,827,1731
46,46014,460140506,Capital,LA RIOJA,206,206,457,463,920
46,46014,460140416,Capital,LA RIOJA,280,310,491,483,974
46,46014,460140411,Capital,LA RIOJA,434,466,801,789,1590
46,46014,460140406,Capital,LA RIOJA,300,301,559,565,1124
46,46014,460140713,Capital,LA RIOJA,362,381,799,813,1612
46,46014,460140712,Capital,LA RIOJA,329,361,673,671,1344
46,46014,460140410,Capital,LA RIOJA,258,317,399,321,720
46,46014,460140101,Capital,LA RIOJA,180,359,280,339,619
46,46014,460141104,Capital,LA RIOJA,353,382,744,727,1471
46,46014,460141102,Capital,LA RIOJA,388,390,779,710,1489
46,46014,460141014,Capital,LA RIOJA,394,371,793,772,1565
46,46014,460141012,Capital,LA RIOJA,603,604,1343,1265,2608
46,46014,460141008,Capital,LA RIOJA,387,409,754,690,1444
46,46014,460141002,Capital,LA RIOJA,168,156,301,335,636
46,46014,460140921,Capital,LA RIOJA,326,436,565,579,1144
46,46014,460140919,Capital,LA RIOJA,421,453,799,762,1561
46,46014,460140912,Capital,LA RIOJA,412,498,703,711,1414
46,46014,460140805,Capital,LA RIOJA,340,320,552,504,1056
46,46014,460140714,Capital,LA RIOJA,425,423,855,837,1692
46,46014,460140710,Capital,LA RIOJA,352,417,642,580,1222
46,46014,460140602,Capital,LA RIOJA,286,354,446,405,851
46,46014,460140510,Capital,LA RIOJA,346,359,698,683,1381
46,46014,460140405,Capital,LA RIOJA,257,270,513,496,1009
46,46014,460140404,Capital,LA RIOJA,394,422,726,666,1392
46,46014,460140110,Capital,LA RIOJA,522,623,1061,1082,2143
46,46014,460140301,Capital,LA RIOJA,45,62,49,79,128
46,46042,460420203,Chilecito,LA RIOJA,216,290,439,416,855
46,46042,460420121,Chilecito,LA RIOJA,360,393,635,625,1260
46,46042,460420118,Chilecito,LA RIOJA,339,319,716,672,1388
46,46042,460420114,Chilecito,LA RIOJA,380,438,670,592,1262
46,46042,460420110,Chilecito,LA RIOJA,467,512,828,778,1606
46,46042,460420109,Chilecito,LA RIOJA,401,412,785,699,1484
46,46042,460420101,Chilecito,LA RIOJA,534,597,949,942,1891
46,46042,460420403,Chilecito,LA RIOJA,127,244,155,249,404
46,46042,460420401,Chilecito,LA RIOJA,366,418,639,728,1367
46,46042,460420201,Chilecito,LA RIOJA,392,465,843,825,1668
46,46042,460420119,Chilecito,LA RIOJA,236,277,405,402,807
46,46042,460420303,Chilecito,LA RIOJA,247,322,452,421,873
46,46042,460420301,Chilecito,LA RIOJA,562,612,1102,1153,2255
46,46042,460420105,Chilecito,LA RIOJA,224,329,333,257,590
46,46042,460420102,Chilecito,LA RIOJA,217,276,332,340,672
46,46042,460420305,Chilecito,LA RIOJA,205,328,310,395,705
46,46042,460420202,Chilecito,LA RIOJA,439,508,820,968,1788
46,46042,460420117,Chilecito,LA RIOJA,283,308,491,500,991
46,46042,460420302,Chilecito,LA RIOJA,582,636,1179,1195,2374
46,46042,460420205,Chilecito,LA RIOJA,193,231,402,409,811
46,46042,460420112,Chilecito,LA RIOJA,326,346,713,683,1396
46,46042,460420111,Chilecito,LA RIOJA,296,336,567,494,1061
46,46042,460420104,Chilecito,LA RIOJA,266,327,432,399,831
46,46042,460420107,Chilecito,LA RIOJA,287,357,402,391,793
46,46042,460420304,Chilecito,LA RIOJA,249,312,454,478,932
46,46042,460420204,Chilecito,LA RIOJA,370,438,731,745,1476
46,46042,460420116,Chilecito,LA RIOJA,357,407,708,725,1433
46,46042,460420122,Chilecito,LA RIOJA,276,434,615,551,1166
46,46042,460420103,Chilecito,LA RIOJA,277,316,461,425,886
46,46042,460420306,Chilecito,LA RIOJA,553,615,1169,1139,2308
46,46042,460420123,Chilecito,LA RIOJA,366,409,700,627,1327
46,46042,460420108,Chilecito,LA RIOJA,301,346,504,498,1002
46,46042,460420206,Chilecito,LA RIOJA,197,267,324,405,729
46,46042,460420402,Chilecito,LA RIOJA,382,512,806,833,1639
46,46042,460420120,Chilecito,LA RIOJA,600,705,1134,1083,2217
46,46042,460420115,Chilecito,LA RIOJA,315,362,563,510,1073
46,46042,460420113,Chilecito,LA RIOJA,655,683,1396,1308,2704
46,46042,460420106,Chilecito,LA RIOJA,457,550,756,652,1408
46,46119,461190102,San Blas de los Sauces,LA RIOJA,307,435,572,555,1127
46,46119,461190101,San Blas de los Sauces,LA RIOJA,177,297,313,334,647
46,46119,461190104,San Blas de los Sauces,LA RIOJA,121,202,230,209,439
46,46119,461190201,San Blas de los Sauces,LA RIOJA,134,267,230,244,474
46,46119,461190103,San Blas de los Sauces,LA RIOJA,348,490,648,592,1240
46,46112,461120109,Rosario Vera Peñaloza,LA RIOJA,339,391,765,656,1421
46,46112,461120302,Rosario Vera Peñaloza,LA RIOJA,131,172,214,271,485
46,46112,461120301,Rosario Vera Peñaloza,LA RIOJA,182,213,275,339,614
46,46112,461120105,Rosario Vera Peñaloza,LA RIOJA,277,321,503,467,970
46,46112,461120103,Rosario Vera Peñaloza,LA RIOJA,292,341,526,472,998
46,46112,461120203,Rosario Vera Peñaloza,LA RIOJA,45,74,69,84,153
46,46112,461120108,Rosario Vera Peñaloza,LA RIOJA,374,432,730,700,1430
46,46112,461120104,Rosario Vera Peñaloza,LA RIOJA,402,460,701,681,1382
46,46112,461120107,Rosario Vera Peñaloza,LA RIOJA,314,383,516,481,997
46,46112,461120106,Rosario Vera Peñaloza,LA RIOJA,356,436,663,653,1316
46,46112,461120202,Rosario Vera Peñaloza,LA RIOJA,299,413,479,551,1030
46,46112,461120101,Rosario Vera Peñaloza,LA RIOJA,423,507,713,697,1410
46,46112,461120201,Rosario Vera Peñaloza,LA RIOJA,200,238,370,363,733
46,46112,461120102,Rosario Vera Peñaloza,LA RIOJA,290,333,540,575,1115
46,46091,460910201,General San Martín,LA RIOJA,375,451,758,685,1443
46,46091,460910101,General San Martín,LA RIOJA,68,95,72,119,191
46,46091,460910202,General San Martín,LA RIOJA,168,239,260,298,558
46,46091,460910204,General San Martín,LA RIOJA,431,500,886,876,1762
46,46091,460910203,General San Martín,LA RIOJA,132,155,228,277,505
46,46091,460910102,General San Martín,LA RIOJA,123,193,244,241,485
46,46084,460840202,General Ocampo,LA RIOJA,210,259,359,355,714
46,46084,460840201,General Ocampo,LA RIOJA,256,325,428,440,868
46,46084,460840204,General Ocampo,LA RIOJA,69,113,78,123,201
46,46084,460840102,General Ocampo,LA RIOJA,198,279,315,397,712
46,46084,460840104,General Ocampo,LA RIOJA,227,266,411,432,843
46,46084,460840206,General Ocampo,LA RIOJA,338,388,611,578,1189
46,46084,460840205,General Ocampo,LA RIOJA,233,280,372,351,723
46,46084,460840101,General Ocampo,LA RIOJA,253,318,442,410,852
46,46084,460840103,General Ocampo,LA RIOJA,245,346,383,457,840
46,46084,460840203,General Ocampo,LA RIOJA,67,91,81,122,203
46,46063,460630101,General Belgrano,LA RIOJA,304,383,544,499,1043
46,46063,460630103,General Belgrano,LA RIOJA,324,414,578,556,1134
46,46063,460630202,General Belgrano,LA RIOJA,26,38,35,37,72
46,46063,460630102,General Belgrano,LA RIOJA,423,476,796,730,1526
46,46063,460630201,General Belgrano,LA RIOJA,258,331,447,456,903
46,46063,460630105,General Belgrano,LA RIOJA,196,254,357,374,731
46,46063,460630104,General Belgrano,LA RIOJA,270,312,432,412,844
46,46063,460630106,General Belgrano,LA RIOJA,258,385,355,459,814
46,46063,460630203,General Belgrano,LA RIOJA,90,130,140,163,303
46,46049,460490203,Famatina,LA RIOJA,58,107,109,112,221
46,46049,460490102,Famatina,LA RIOJA,303,417,537,526,1063
46,46049,460490201,Famatina,LA RIOJA,244,409,427,422,849
46,46049,460490204,Famatina,LA RIOJA,154,268,204,238,442
46,46049,460490104,Famatina,LA RIOJA,38,80,48,56,104
46,46049,460490205,Famatina,LA RIOJA,77,120,144,128,272
46,46049,460490101,Famatina,LA RIOJA,393,541,678,725,1403
46,46049,460490103,Famatina,LA RIOJA,189,296,286,331,617
46,46049,460490202,Famatina,LA RIOJA,255,367,441,451,892
46,46028,460280103,Coronel Felipe Varela,LA RIOJA,287,361,524,489,1013
46,46028,460280202,Coronel Felipe Varela,LA RIOJA,338,436,656,690,1346
46,46028,460280201,Coronel Felipe Varela,LA RIOJA,110,125,176,187,363
46,46028,460280204,Coronel Felipe Varela,LA RIOJA,193,261,373,414,787
46,46028,460280108,Coronel Felipe Varela,LA RIOJA,200,249,357,342,699
46,46028,460280106,Coronel Felipe Varela,LA RIOJA,144,240,282,291,573
46,46028,460280105,Coronel Felipe Varela,LA RIOJA,254,373,416,445,861
46,46028,460280107,Coronel Felipe Varela,LA RIOJA,185,211,377,380,757
46,46028,460280203,Coronel Felipe Varela,LA RIOJA,165,252,295,343,638
46,46028,460280101,Coronel Felipe Varela,LA RIOJA,155,185,271,245,516
46,46028,460280102,Coronel Felipe Varela,LA RIOJA,298,378,526,516,1042
46,46028,460280109,Coronel Felipe Varela,LA RIOJA,134,236,262,279,541
46,46028,460280104,Coronel Felipe Varela,LA RIOJA,154,226,256,256,512
46,46098,460980105,Vinchina,LA RIOJA,15,23,19,42,61
46,46098,460980103,Vinchina,LA RIOJA,11,15,15,24,39
46,46098,460980104,Vinchina,LA RIOJA,78,132,104,126,230
46,46098,460980102,Vinchina,LA RIOJA,283,378,497,514,1011
46,46098,460980101,Vinchina,LA RIOJA,379,546,665,725,1390
46,46007,460070203,Arauco,LA RIOJA,16,39,17,18,35
46,46007,460070109,Arauco,LA RIOJA,222,279,411,441,852
46,46007,460070108,Arauco,LA RIOJA,345,340,637,638,1275
46,46007,460070201,Arauco,LA RIOJA,317,409,526,564,1090
46,46007,460070106,Arauco,LA RIOJA,97,128,165,178,343
46,46007,460070107,Arauco,LA RIOJA,259,303,468,493,961
46,46007,460070105,Arauco,LA RIOJA,317,335,595,524,1119
46,46007,460070104,Arauco,LA RIOJA,306,336,653,631,1284
46,46007,460070101,Arauco,LA RIOJA,315,347,582,612,1194
46,46007,460070204,Arauco,LA RIOJA,183,227,384,401,785
46,46007,460070111,Arauco,LA RIOJA,363,401,739,734,1473
46,46007,460070102,Arauco,LA RIOJA,258,330,469,432,901
46,46007,460070112,Arauco,LA RIOJA,424,532,814,819,1633
46,46007,460070103,Arauco,LA RIOJA,386,433,664,680,1344
46,46007,460070202,Arauco,LA RIOJA,111,155,205,202,407
46,46007,460070110,Arauco,LA RIOJA,190,212,358,364,722
46,46126,461260101,Sanagasta,LA RIOJA,294,579,625,605,1230
46,46126,461260103,Sanagasta,LA RIOJA,299,559,517,528,1045
46,46126,461260102,Sanagasta,LA RIOJA,29,96,26,44,70
46,46105,461050102,Independencia,LA RIOJA,207,251,458,404,862
46,46105,461050103,Independencia,LA RIOJA,132,202,208,252,460
46,46105,461050101,Independencia,LA RIOJA,248,337,466,480,946
46,46105,461050104,Independencia,LA RIOJA,56,78,60,99,159
46,46070,460700103,General Juan F. Quiroga,LA RIOJA,103,142,170,226,396
46,46070,460700102,General Juan F. Quiroga,LA RIOJA,283,378,465,540,1005
46,46070,460700101,General Juan F. Quiroga,LA RIOJA,359,408,653,682,1335
46,46070,460700203,General Juan F. Quiroga,LA RIOJA,86,120,121,150,271
46,46070,460700201,General Juan F. Quiroga,LA RIOJA,265,365,504,513,1017
46,46070,460700202,General Juan F. Quiroga,LA RIOJA,27,43,38,46,84
46,46056,460560103,General Angel V. Peñaloza,LA RIOJA,96,137,124,188,312
46,46056,460560104,General Angel V. Peñaloza,LA RIOJA,185,248,317,339,656
46,46056,460560101,General Angel V. Peñaloza,LA RIOJA,326,403,574,590,1164
46,46056,460560102,General Angel V. Peñaloza,LA RIOJA,260,373,433,508,941
46,46077,460770103,General Lamadrid,LA RIOJA,13,19,9,17,26
46,46077,460770102,General Lamadrid,LA RIOJA,5,12,4,7,11
46,46077,460770101,General Lamadrid,LA RIOJA,214,302,399,402,801
46,46077,460770104,General Lamadrid,LA RIOJA,252,324,457,439,896
46,46021,460210105,Castro Barros,LA RIOJA,131,236,200,224,424
46,46021,460210106,Castro Barros,LA RIOJA,126,238,175,179,354
46,46021,460210202,Castro Barros,LA RIOJA,141,282,193,193,386
46,46021,460210101,Castro Barros,LA RIOJA,223,358,398,435,833
46,46021,460210104,Castro Barros,LA RIOJA,161,241,209,209,418
46,46021,460210201,Castro Barros,LA RIOJA,128,262,191,199,390
46,46021,460210103,Castro Barros,LA RIOJA,95,166,126,118,244
46,46021,460210102,Castro Barros,LA RIOJA,323,436,617,602,1219
42,42112,421120312,Puelén,LA PAMPA,296,412,416,503,919
42,42112,421120310,Puelén,LA PAMPA,45,115,54,100,154
42,42112,421120309,Puelén,LA PAMPA,181,251,367,379,746
42,42112,421120303,Puelén,LA PAMPA,272,310,391,413,804
42,42112,421120319,Puelén,LA PAMPA,5,6,2,6,8
42,42112,421120316,Puelén,LA PAMPA,9,12,10,20,30
42,42112,421120201,Puelén,LA PAMPA,25,30,13,31,44
42,42112,421120308,Puelén,LA PAMPA,286,293,592,611,1203
42,42112,421120318,Puelén,LA PAMPA,3,3,4,4,8
42,42112,421120317,Puelén,LA PAMPA,1,3,0,1,1
42,42112,421120306,Puelén,LA PAMPA,321,342,652,647,1299
42,42112,421120311,Puelén,LA PAMPA,10,17,15,22,37
42,42112,421120321,Puelén,LA PAMPA,4,6,2,9,11
42,42112,421120320,Puelén,LA PAMPA,5,7,2,6,8
42,42112,421120313,Puelén,LA PAMPA,16,27,4,25,29
42,42112,421120305,Puelén,LA PAMPA,310,331,480,509,989
42,42112,421120302,Puelén,LA PAMPA,185,204,286,269,555
42,42112,421120301,Puelén,LA PAMPA,220,243,352,396,748
42,42112,421120315,Puelén,LA PAMPA,18,32,27,42,69
42,42112,421120101,Puelén,LA PAMPA,108,125,179,178,357
42,42112,421120322,Puelén,LA PAMPA,4,5,4,6,10
42,42112,421120102,Puelén,LA PAMPA,149,214,205,250,455
42,42112,421120314,Puelén,LA PAMPA,9,10,2,21,23
42,42112,421120307,Puelén,LA PAMPA,243,256,390,386,776
42,42112,421120304,Puelén,LA PAMPA,65,85,92,93,185
42,42056,420560506,Chapaleufú,LA PAMPA,124,198,154,189,343
42,42056,420560516,Chapaleufú,LA PAMPA,245,251,486,445,931
42,42056,420560507,Chapaleufú,LA PAMPA,25,32,22,36,58
42,42056,420560503,Chapaleufú,LA PAMPA,197,209,288,254,542
42,42056,420560402,Chapaleufú,LA PAMPA,33,98,38,67,105
42,42056,420560302,Chapaleufú,LA PAMPA,58,128,45,84,129
42,42056,420560102,Chapaleufú,LA PAMPA,36,52,28,60,88
42,42056,420560511,Chapaleufú,LA PAMPA,225,238,406,360,766
42,42056,420560501,Chapaleufú,LA PAMPA,301,353,362,329,691
42,42056,420560401,Chapaleufú,LA PAMPA,102,127,158,165,323
42,42056,420560304,Chapaleufú,LA PAMPA,106,135,129,143,272
42,42056,420560303,Chapaleufú,LA PAMPA,295,319,435,445,880
42,42056,420560508,Chapaleufú,LA PAMPA,14,26,8,21,29
42,42056,420560505,Chapaleufú,LA PAMPA,27,57,25,41,66
42,42056,420560517,Chapaleufú,LA PAMPA,168,189,256,313,569
42,42056,420560514,Chapaleufú,LA PAMPA,200,229,255,268,523
42,42056,420560510,Chapaleufú,LA PAMPA,27,35,28,44,72
42,42056,420560515,Chapaleufú,LA PAMPA,326,335,533,541,1074
42,42056,420560513,Chapaleufú,LA PAMPA,132,146,242,225,467
42,42056,420560101,Chapaleufú,LA PAMPA,241,292,352,324,676
42,42056,420560509,Chapaleufú,LA PAMPA,17,39,26,23,49
42,42056,420560202,Chapaleufú,LA PAMPA,16,55,17,24,41
42,42056,420560502,Chapaleufú,LA PAMPA,301,368,399,332,731
42,42056,420560301,Chapaleufú,LA PAMPA,131,167,178,169,347
42,42056,420560504,Chapaleufú,LA PAMPA,187,216,249,230,479
42,42056,420560601,Chapaleufú,LA PAMPA,243,282,330,358,688
42,42056,420560512,Chapaleufú,LA PAMPA,133,197,198,225,423
42,42056,420560602,Chapaleufú,LA PAMPA,21,56,20,34,54
42,42056,420560201,Chapaleufú,LA PAMPA,53,70,106,98,204
42,42049,420490103,Chalileo,LA PAMPA,161,235,213,242,455
42,42049,420490102,Chalileo,LA PAMPA,264,318,475,415,890
42,42049,420490106,Chalileo,LA PAMPA,38,65,24,87,111
42,42049,420490101,Chalileo,LA PAMPA,170,190,282,283,565
42,42049,420490104,Chalileo,LA PAMPA,11,15,3,16,19
42,42049,420490108,Chalileo,LA PAMPA,91,122,169,169,338
42,42049,420490107,Chalileo,LA PAMPA,158,176,213,236,449
42,42049,420490105,Chalileo,LA PAMPA,54,70,64,94,158
42,42154,421540601,Utracán,LA PAMPA,115,146,131,158,289
42,42154,421540517,Utracán,LA PAMPA,241,258,561,464,1025
42,42154,421540504,Utracán,LA PAMPA,212,275,318,306,624
42,42154,421540511,Utracán,LA PAMPA,224,280,320,298,618
42,42154,421540102,Utracán,LA PAMPA,39,75,38,56,94
42,42154,421540513,Utracán,LA PAMPA,294,406,581,524,1105
42,42154,421540301,Utracán,LA PAMPA,242,307,377,330,707
42,42154,421540201,Utracán,LA PAMPA,148,179,200,222,422
42,42154,421540401,Utracán,LA PAMPA,38,62,28,58,86
42,42154,421540503,Utracán,LA PAMPA,236,315,312,303,615
42,42154,421540202,Utracán,LA PAMPA,88,136,55,119,174
42,42154,421540602,Utracán,LA PAMPA,13,32,7,21,28
42,42154,421540403,Utracán,LA PAMPA,56,128,66,75,141
42,42154,421540515,Utracán,LA PAMPA,264,286,411,370,781
42,42154,421540514,Utracán,LA PAMPA,215,245,351,331,682
42,42154,421540508,Utracán,LA PAMPA,213,253,345,315,660
42,42154,421540506,Utracán,LA PAMPA,207,287,273,210,483
42,42154,421540701,Utracán,LA PAMPA,28,49,32,37,69
42,42154,421540404,Utracán,LA PAMPA,29,67,15,54,69
42,42154,421540101,Utracán,LA PAMPA,70,86,101,125,226
42,42154,421540512,Utracán,LA PAMPA,295,357,502,521,1023
42,42154,421540510,Utracán,LA PAMPA,201,237,284,245,529
42,42154,421540509,Utracán,LA PAMPA,233,266,417,369,786
42,42154,421540302,Utracán,LA PAMPA,53,97,42,76,118
42,42154,421540516,Utracán,LA PAMPA,261,265,486,466,952
42,42154,421540507,Utracán,LA PAMPA,235,310,296,270,566
42,42154,421540505,Utracán,LA PAMPA,286,361,372,358,730
42,42154,421540702,Utracán,LA PAMPA,36,74,32,52,84
42,42154,421540402,Utracán,LA PAMPA,24,67,39,54,93
42,42154,421540103,Utracán,LA PAMPA,46,100,12,67,79
42,42154,421540502,Utracán,LA PAMPA,273,353,347,338,685
42,42154,421540501,Utracán,LA PAMPA,90,131,153,143,296
42,42028,420280102,Catriló,LA PAMPA,20,41,21,25,46
42,42028,420280302,Catriló,LA PAMPA,215,236,333,325,658
42,42028,420280101,Catriló,LA PAMPA,148,193,250,241,491
42,42028,420280305,Catriló,LA PAMPA,221,236,329,336,665
42,42028,420280202,Catriló,LA PAMPA,101,129,137,172,309
42,42028,420280103,Catriló,LA PAMPA,54,123,41,79,120
42,42028,420280402,Catriló,LA PAMPA,28,66,24,41,65
42,42028,420280301,Catriló,LA PAMPA,275,305,433,431,864
42,42028,420280201,Catriló,LA PAMPA,337,358,483,458,941
42,42028,420280401,Catriló,LA PAMPA,36,74,31,62,93
42,42028,420280105,Catriló,LA PAMPA,151,179,232,241,473
42,42028,420280304,Catriló,LA PAMPA,249,314,387,394,781
42,42028,420280303,Catriló,LA PAMPA,333,422,611,625,1236
42,42028,420280203,Catriló,LA PAMPA,193,241,252,238,490
42,42028,420280104,Catriló,LA PAMPA,28,58,23,38,61
42,42147,421470109,Trenel,LA PAMPA,196,236,314,283,597
42,42147,421470108,Trenel,LA PAMPA,15,30,21,29,50
42,42147,421470210,Trenel,LA PAMPA,32,64,45,50,95
42,42147,421470104,Trenel,LA PAMPA,11,47,13,21,34
42,42147,421470106,Trenel,LA PAMPA,16,43,22,18,40
42,42147,421470105,Trenel,LA PAMPA,7,31,5,8,13
42,42147,421470103,Trenel,LA PAMPA,3,7,2,3,5
42,42147,421470216,Trenel,LA PAMPA,215,239,295,273,568
42,42147,421470203,Trenel,LA PAMPA,14,28,22,29,51
42,42147,421470211,Trenel,LA PAMPA,9,46,7,15,22
42,42147,421470207,Trenel,LA PAMPA,7,40,6,8,14
42,42147,421470205,Trenel,LA PAMPA,7,13,6,11,17
42,42147,421470215,Trenel,LA PAMPA,291,353,440,443,883
42,42147,421470101,Trenel,LA PAMPA,166,190,206,223,429
42,42147,421470301,Trenel,LA PAMPA,162,206,220,263,483
42,42147,421470302,Trenel,LA PAMPA,8,27,11,15,26
42,42147,421470102,Trenel,LA PAMPA,2,13,1,5,6
42,42147,421470214,Trenel,LA PAMPA,233,256,347,350,697
42,42147,421470212,Trenel,LA PAMPA,6,19,9,8,17
42,42147,421470209,Trenel,LA PAMPA,16,32,20,30,50
42,42147,421470213,Trenel,LA PAMPA,3,18,2,5,7
42,42147,421470208,Trenel,LA PAMPA,9,17,3,10,13
42,42147,421470204,Trenel,LA PAMPA,1,10,2,2,4
42,42147,421470107,Trenel,LA PAMPA,14,58,17,21,38
42,42147,421470202,Trenel,LA PAMPA,173,226,213,217,430
42,42147,421470201,Trenel,LA PAMPA,224,249,396,413,809
42,42147,421470206,Trenel,LA PAMPA,12,28,8,20,28
42,42140,421400216,Toay,LA PAMPA,166,247,209,247,456
42,42140,421400215,Toay,LA PAMPA,140,243,195,219,414
42,42140,421400209,Toay,LA PAMPA,203,240,343,313,656
42,42140,421400205,Toay,LA PAMPA,174,188,271,275,546
42,42140,421400203,Toay,LA PAMPA,178,197,354,313,667
42,42140,421400202,Toay,LA PAMPA,199,259,356,370,726
42,42140,421400223,Toay,LA PAMPA,58,110,70,78,148
42,42140,421400204,Toay,LA PAMPA,234,254,456,407,863
42,42140,421400302,Toay,LA PAMPA,54,122,52,95,147
42,42140,421400303,Toay,LA PAMPA,4,8,3,6,9
42,42140,421400214,Toay,LA PAMPA,56,74,117,195,312
42,42140,421400212,Toay,LA PAMPA,195,247,330,295,625
42,42140,421400210,Toay,LA PAMPA,243,288,374,311,685
42,42140,421400207,Toay,LA PAMPA,182,214,343,358,701
42,42140,421400221,Toay,LA PAMPA,35,63,34,40,74
42,42140,421400101,Toay,LA PAMPA,13,25,8,18,26
42,42140,421400301,Toay,LA PAMPA,1,4,1,2,3
42,42140,421400219,Toay,LA PAMPA,139,224,188,233,421
42,42140,421400217,Toay,LA PAMPA,153,248,251,231,482
42,42140,421400102,Toay,LA PAMPA,33,55,15,46,61
42,42140,421400213,Toay,LA PAMPA,54,112,102,109,211
42,42140,421400206,Toay,LA PAMPA,212,242,360,332,692
42,42140,421400211,Toay,LA PAMPA,312,342,548,569,1117
42,42140,421400103,Toay,LA PAMPA,17,34,7,20,27
42,42140,421400222,Toay,LA PAMPA,175,256,301,315,616
42,42140,421400208,Toay,LA PAMPA,184,217,245,251,496
42,42140,421400104,Toay,LA PAMPA,2,5,0,2,2
42,42140,421400218,Toay,LA PAMPA,144,219,205,214,419
42,42140,421400201,Toay,LA PAMPA,196,248,330,313,643
42,42140,421400220,Toay,LA PAMPA,80,136,46,118,164
42,42133,421330508,Realicó,LA PAMPA,283,316,447,381,828
42,42133,421330503,Realicó,LA PAMPA,205,269,279,279,558
42,42133,421330211,Realicó,LA PAMPA,180,210,310,317,627
42,42133,421330212,Realicó,LA PAMPA,115,128,207,204,411
42,42133,421330507,Realicó,LA PAMPA,24,54,28,35,63
42,42133,421330206,Realicó,LA PAMPA,19,35,19,39,58
42,42133,421330103,Realicó,LA PAMPA,13,48,10,21,31
42,42133,421330210,Realicó,LA PAMPA,1,5,0,1,1
42,42133,421330703,Realicó,LA PAMPA,15,21,33,37,70
42,42133,421330601,Realicó,LA PAMPA,185,188,301,301,602
42,42133,421330505,Realicó,LA PAMPA,181,209,273,307,580
42,42133,421330214,Realicó,LA PAMPA,200,239,268,244,512
42,42133,421330102,Realicó,LA PAMPA,8,39,7,10,17
42,42133,421330207,Realicó,LA PAMPA,334,424,637,659,1296
42,42133,421330502,Realicó,LA PAMPA,189,233,244,219,463
42,42133,421330705,Realicó,LA PAMPA,11,28,15,17,32
42,42133,421330605,Realicó,LA PAMPA,8,22,3,13,16
42,42133,421330603,Realicó,LA PAMPA,6,25,5,7,12
42,42133,421330701,Realicó,LA PAMPA,244,281,327,358,685
42,42133,421330501,Realicó,LA PAMPA,175,199,267,250,517
42,42133,421330401,Realicó,LA PAMPA,57,72,93,84,177
42,42133,421330205,Realicó,LA PAMPA,269,343,345,283,628
42,42133,421330203,Realicó,LA PAMPA,242,270,349,332,681
42,42133,421330213,Realicó,LA PAMPA,111,118,193,190,383
42,42133,421330704,Realicó,LA PAMPA,39,73,61,67,128
42,42133,421330201,Realicó,LA PAMPA,279,330,419,406,825
42,42133,421330101,Realicó,LA PAMPA,102,146,152,148,300
42,42133,421330707,Realicó,LA PAMPA,5,22,6,18,24
42,42133,421330402,Realicó,LA PAMPA,18,26,22,28,50
42,42133,421330702,Realicó,LA PAMPA,221,267,291,299,590
42,42133,421330602,Realicó,LA PAMPA,242,274,314,321,635
42,42133,421330510,Realicó,LA PAMPA,196,231,378,335,713
42,42133,421330509,Realicó,LA PAMPA,148,180,220,249,469
42,42133,421330504,Realicó,LA PAMPA,181,209,264,267,531
42,42133,421330706,Realicó,LA PAMPA,7,32,7,13,20
42,42133,421330302,Realicó,LA PAMPA,13,35,15,22,37
42,42133,421330204,Realicó,LA PAMPA,199,244,251,240,491
42,42133,421330202,Realicó,LA PAMPA,152,194,214,161,375
42,42133,421330301,Realicó,LA PAMPA,98,115,132,140,272
42,42133,421330506,Realicó,LA PAMPA,9,34,3,11,14
42,42133,421330403,Realicó,LA PAMPA,11,22,15,21,36
42,42133,421330208,Realicó,LA PAMPA,0,11,0,0,0
42,42133,421330604,Realicó,LA PAMPA,49,81,73,93,166
42,42133,421330216,Realicó,LA PAMPA,214,234,345,380,725
42,42133,421330215,Realicó,LA PAMPA,212,246,294,282,576
42,42133,421330209,Realicó,LA PAMPA,2,14,0,2,2
42,42126,421260207,Rancul,LA PAMPA,85,90,144,145,289
42,42126,421260102,Rancul,LA PAMPA,241,329,361,326,687
42,42126,421260303,Rancul,LA PAMPA,8,26,7,13,20
42,42126,421260205,Rancul,LA PAMPA,109,154,179,187,366
42,42126,421260502,Rancul,LA PAMPA,70,87,118,110,228
42,42126,421260201,Rancul,LA PAMPA,273,286,421,431,852
42,42126,421260111,Rancul,LA PAMPA,197,220,351,353,704
42,42126,421260404,Rancul,LA PAMPA,14,19,8,19,27
42,42126,421260208,Rancul,LA PAMPA,150,185,213,197,410
42,42126,421260206,Rancul,LA PAMPA,8,33,7,10,17
42,42126,421260109,Rancul,LA PAMPA,17,23,22,28,50
42,42126,421260107,Rancul,LA PAMPA,20,29,26,40,66
42,42126,421260104,Rancul,LA PAMPA,8,10,13,13,26
42,42126,421260405,Rancul,LA PAMPA,32,53,40,64,104
42,42126,421260112,Rancul,LA PAMPA,135,130,228,215,443
42,42126,421260403,Rancul,LA PAMPA,12,20,10,20,30
42,42126,421260505,Rancul,LA PAMPA,8,27,4,16,20
42,42126,421260509,Rancul,LA PAMPA,181,210,249,231,480
42,42126,421260406,Rancul,LA PAMPA,16,29,14,23,37
42,42126,421260504,Rancul,LA PAMPA,11,21,7,19,26
42,42126,421260511,Rancul,LA PAMPA,140,173,190,177,367
42,42126,421260402,Rancul,LA PAMPA,12,16,31,21,52
42,42126,421260101,Rancul,LA PAMPA,234,275,380,352,732
42,42126,421260203,Rancul,LA PAMPA,134,164,200,192,392
42,42126,421260507,Rancul,LA PAMPA,4,22,4,6,10
42,42126,421260301,Rancul,LA PAMPA,8,34,14,13,27
42,42126,421260204,Rancul,LA PAMPA,6,31,9,10,19
42,42126,421260110,Rancul,LA PAMPA,23,36,13,37,50
42,42126,421260108,Rancul,LA PAMPA,47,72,52,68,120
42,42126,421260510,Rancul,LA PAMPA,227,259,366,353,719
42,42126,421260103,Rancul,LA PAMPA,252,302,368,347,715
42,42126,421260508,Rancul,LA PAMPA,4,15,3,6,9
42,42126,421260106,Rancul,LA PAMPA,10,17,7,13,20
42,42126,421260501,Rancul,LA PAMPA,159,216,225,223,448
42,42126,421260407,Rancul,LA PAMPA,170,233,316,289,605
42,42126,421260401,Rancul,LA PAMPA,165,199,244,277,521
42,42126,421260202,Rancul,LA PAMPA,156,201,242,237,479
42,42126,421260506,Rancul,LA PAMPA,72,113,116,145,261
42,42126,421260503,Rancul,LA PAMPA,35,106,31,46,77
42,42126,421260304,Rancul,LA PAMPA,7,28,3,9,12
42,42126,421260302,Rancul,LA PAMPA,20,45,36,57,93
42,42126,421260105,Rancul,LA PAMPA,17,27,26,32,58
42,42119,421190101,Quemú Quemú,LA PAMPA,212,243,268,278,546
42,42119,421190309,Quemú Quemú,LA PAMPA,1,3,0,2,2
42,42119,421190303,Quemú Quemú,LA PAMPA,15,33,13,19,32
42,42119,421190204,Quemú Quemú,LA PAMPA,246,283,356,376,732
42,42119,421190310,Quemú Quemú,LA PAMPA,3,12,5,4,9
42,42119,421190208,Quemú Quemú,LA PAMPA,12,54,15,16,31
42,42119,421190206,Quemú Quemú,LA PAMPA,18,35,20,25,45
42,42119,421190302,Quemú Quemú,LA PAMPA,290,351,384,329,713
42,42119,421190203,Quemú Quemú,LA PAMPA,295,350,375,352,727
42,42119,421190211,Quemú Quemú,LA PAMPA,180,198,264,268,532
42,42119,421190304,Quemú Quemú,LA PAMPA,3,6,2,4,6
42,42119,421190207,Quemú Quemú,LA PAMPA,5,16,4,8,12
42,42119,421190104,Quemú Quemú,LA PAMPA,14,36,20,23,43
42,42119,421190210,Quemú Quemú,LA PAMPA,10,20,9,14,23
42,42119,421190401,Quemú Quemú,LA PAMPA,283,331,380,423,803
42,42119,421190202,Quemú Quemú,LA PAMPA,113,151,170,191,361
42,42119,421190405,Quemú Quemú,LA PAMPA,13,25,9,20,29
42,42119,421190402,Quemú Quemú,LA PAMPA,35,40,56,64,120
42,42119,421190311,Quemú Quemú,LA PAMPA,276,335,380,361,741
42,42119,421190305,Quemú Quemú,LA PAMPA,16,41,15,20,35
42,42119,421190209,Quemú Quemú,LA PAMPA,10,23,12,22,34
42,42119,421190205,Quemú Quemú,LA PAMPA,23,39,31,31,62
42,42119,421190312,Quemú Quemú,LA PAMPA,256,296,335,329,664
42,42119,421190301,Quemú Quemú,LA PAMPA,254,320,367,319,686
42,42119,421190201,Quemú Quemú,LA PAMPA,159,179,170,173,343
42,42119,421190212,Quemú Quemú,LA PAMPA,287,330,524,495,1019
42,42119,421190308,Quemú Quemú,LA PAMPA,24,44,23,39,62
42,42119,421190404,Quemú Quemú,LA PAMPA,15,51,16,20,36
42,42119,421190307,Quemú Quemú,LA PAMPA,20,55,28,35,63
42,42119,421190102,Quemú Quemú,LA PAMPA,3,7,4,4,8
42,42119,421190403,Quemú Quemú,LA PAMPA,23,54,39,36,75
42,42119,421190306,Quemú Quemú,LA PAMPA,16,34,19,23,42
42,42119,421190103,Quemú Quemú,LA PAMPA,9,22,10,17,27
42,42105,421050808,Maracó,LA PAMPA,229,268,313,341,654
42,42105,421050805,Maracó,LA PAMPA,316,318,532,530,1062
42,42105,421050801,Maracó,LA PAMPA,428,445,870,805,1675
42,42105,421050713,Maracó,LA PAMPA,280,273,477,475,952
42,42105,421050416,Maracó,LA PAMPA,154,233,196,161,357
42,42105,421050414,Maracó,LA PAMPA,235,333,293,256,549
42,42105,421050412,Maracó,LA PAMPA,199,229,263,244,507
42,42105,421050411,Maracó,LA PAMPA,212,243,258,251,509
42,42105,421050501,Maracó,LA PAMPA,131,167,190,187,377
42,42105,421051005,Maracó,LA PAMPA,309,336,452,434,886
42,42105,421050203,Maracó,LA PAMPA,51,101,52,81,133
42,42105,421051012,Maracó,LA PAMPA,348,429,530,555,1085
42,42105,421051011,Maracó,LA PAMPA,254,293,427,352,779
42,42105,421051010,Maracó,LA PAMPA,242,312,275,288,563
42,42105,421051007,Maracó,LA PAMPA,181,191,359,346,705
42,42105,421050711,Maracó,LA PAMPA,284,295,358,343,701
42,42105,421050418,Maracó,LA PAMPA,190,232,230,202,432
42,42105,421050307,Maracó,LA PAMPA,155,202,178,171,349
42,42105,421050101,Maracó,LA PAMPA,116,148,182,185,367
42,42105,421050602,Maracó,LA PAMPA,35,68,40,55,95
42,42105,421050503,Maracó,LA PAMPA,50,73,59,94,153
42,42105,421050304,Maracó,LA PAMPA,234,278,285,271,556
42,42105,421051008,Maracó,LA PAMPA,206,253,292,279,571
42,42105,421050901,Maracó,LA PAMPA,239,271,434,455,889
42,42105,421050804,Maracó,LA PAMPA,366,373,691,666,1357
42,42105,421050709,Maracó,LA PAMPA,301,319,412,411,823
42,42105,421050419,Maracó,LA PAMPA,187,215,276,336,612
42,42105,421050314,Maracó,LA PAMPA,156,215,213,139,352
42,42105,421050313,Maracó,LA PAMPA,192,231,251,191,442
42,42105,421050311,Maracó,LA PAMPA,212,243,295,287,582
42,42105,421051001,Maracó,LA PAMPA,298,333,466,460,926
42,42105,421050717,Maracó,LA PAMPA,332,384,488,464,952
42,42105,421050204,Maracó,LA PAMPA,13,29,10,45,55
42,42105,421050202,Maracó,LA PAMPA,29,58,27,40,67
42,42105,421050410,Maracó,LA PAMPA,207,259,253,192,445
42,42105,421050905,Maracó,LA PAMPA,249,263,522,493,1015
42,42105,421050904,Maracó,LA PAMPA,226,249,552,474,1026
42,42105,421050708,Maracó,LA PAMPA,208,215,394,401,795
42,42105,421050408,Maracó,LA PAMPA,222,255,303,279,582
42,42105,421050403,Maracó,LA PAMPA,282,290,573,556,1129
42,42105,421050402,Maracó,LA PAMPA,319,330,619,612,1231
42,42105,421050312,Maracó,LA PAMPA,243,295,267,258,525
42,42105,421050310,Maracó,LA PAMPA,232,283,227,247,474
42,42105,421051002,Maracó,LA PAMPA,302,318,466,449,915
42,42105,421050502,Maracó,LA PAMPA,11,19,5,16,21
42,42105,421051006,Maracó,LA PAMPA,226,262,289,267,556
42,42105,421050803,Maracó,LA PAMPA,229,238,467,401,868
42,42105,421050707,Maracó,LA PAMPA,108,124,160,163,323
42,42105,421050703,Maracó,LA PAMPA,289,337,361,366,727
42,42105,421050417,Maracó,LA PAMPA,192,231,237,175,412
42,42105,421050415,Maracó,LA PAMPA,185,283,260,211,471
42,42105,421050413,Maracó,LA PAMPA,208,258,245,229,474
42,42105,421050407,Maracó,LA PAMPA,32,36,67,57,124
42,42105,421050308,Maracó,LA PAMPA,215,269,275,207,482
42,42105,421050303,Maracó,LA PAMPA,225,257,295,344,639
42,42105,421050302,Maracó,LA PAMPA,194,210,267,257,524
42,42105,421050207,Maracó,LA PAMPA,177,266,264,265,529
42,42105,421051003,Maracó,LA PAMPA,333,426,362,366,728
42,42105,421050103,Maracó,LA PAMPA,41,50,30,49,79
42,42105,421050206,Maracó,LA PAMPA,207,707,290,360,650
42,42105,421051009,Maracó,LA PAMPA,168,206,229,214,443
42,42105,421050903,Maracó,LA PAMPA,103,99,265,235,500
42,42105,421050706,Maracó,LA PAMPA,276,300,498,481,979
42,42105,421050701,Maracó,LA PAMPA,290,310,420,425,845
42,42105,421050404,Maracó,LA PAMPA,349,370,681,678,1359
42,42105,421050401,Maracó,LA PAMPA,318,375,501,469,970
42,42105,421050301,Maracó,LA PAMPA,265,331,420,389,809
42,42105,421050715,Maracó,LA PAMPA,225,251,370,379,749
42,42105,421050716,Maracó,LA PAMPA,232,268,342,335,677
42,42105,421050205,Maracó,LA PAMPA,9,37,7,13,20
42,42105,421050906,Maracó,LA PAMPA,238,245,507,446,953
42,42105,421050806,Maracó,LA PAMPA,244,339,551,545,1096
42,42105,421050714,Maracó,LA PAMPA,268,281,459,457,916
42,42105,421050710,Maracó,LA PAMPA,255,283,328,290,618
42,42105,421050705,Maracó,LA PAMPA,321,358,433,382,815
42,42105,421050409,Maracó,LA PAMPA,260,308,324,270,594
42,42105,421050405,Maracó,LA PAMPA,306,322,457,444,901
42,42105,421050306,Maracó,LA PAMPA,203,250,243,191,434
42,42105,421050305,Maracó,LA PAMPA,224,259,280,279,559
42,42105,421050718,Maracó,LA PAMPA,216,233,459,424,883
42,42105,421050201,Maracó,LA PAMPA,15,19,19,27,46
42,42105,421050504,Maracó,LA PAMPA,15,16,18,27,45
42,42105,421050102,Maracó,LA PAMPA,2,9,2,4,6
42,42105,421050902,Maracó,LA PAMPA,114,127,235,230,465
42,42105,421050807,Maracó,LA PAMPA,388,442,673,642,1315
42,42105,421050802,Maracó,LA PAMPA,178,199,332,305,637
42,42105,421050712,Maracó,LA PAMPA,320,315,473,439,912
42,42105,421050704,Maracó,LA PAMPA,249,293,316,263,579
42,42105,421050702,Maracó,LA PAMPA,205,224,276,273,549
42,42105,421050601,Maracó,LA PAMPA,99,118,133,151,284
42,42105,421050406,Maracó,LA PAMPA,395,424,588,569,1157
42,42105,421050309,Maracó,LA PAMPA,210,240,259,216,475
42,42105,421051004,Maracó,LA PAMPA,217,229,323,293,616
42,42098,420980401,Loventué,LA PAMPA,95,129,140,161,301
42,42098,420980106,Loventué,LA PAMPA,135,155,170,181,351
42,42098,420980110,Loventué,LA PAMPA,190,227,274,294,568
42,42098,420980108,Loventué,LA PAMPA,151,206,210,208,418
42,42098,420980201,Loventué,LA PAMPA,217,287,346,343,689
42,42098,420980112,Loventué,LA PAMPA,24,35,51,60,111
42,42098,420980103,Loventué,LA PAMPA,172,187,314,287,601
42,42098,420980101,Loventué,LA PAMPA,193,235,304,310,614
42,42098,420980111,Loventué,LA PAMPA,190,233,310,297,607
42,42098,420980105,Loventué,LA PAMPA,159,187,278,255,533
42,42098,420980104,Loventué,LA PAMPA,143,190,285,247,532
42,42098,420980302,Loventué,LA PAMPA,67,135,63,147,210
42,42098,420980113,Loventué,LA PAMPA,39,77,29,48,77
42,42098,420980107,Loventué,LA PAMPA,166,208,231,221,452
42,42098,420980109,Loventué,LA PAMPA,216,259,321,265,586
42,42098,420980402,Loventué,LA PAMPA,98,183,56,131,187
42,42098,420980102,Loventué,LA PAMPA,130,214,216,225,441
42,42098,420980114,Loventué,LA PAMPA,20,41,15,25,40
42,42098,420980303,Loventué,LA PAMPA,203,253,317,293,610
42,42098,420980301,Loventué,LA PAMPA,190,248,319,311,630
42,42098,420980202,Loventué,LA PAMPA,26,50,28,33,61
42,42070,420700201,Guatraché,LA PAMPA,354,408,434,501,935
42,42070,420700507,Guatraché,LA PAMPA,282,354,405,379,784
42,42070,420700402,Guatraché,LA PAMPA,51,104,63,88,151
42,42070,420700103,Guatraché,LA PAMPA,89,196,100,144,244
42,42070,420700505,Guatraché,LA PAMPA,147,218,196,204,400
42,42070,420700508,Guatraché,LA PAMPA,214,233,291,259,550
42,42070,420700503,Guatraché,LA PAMPA,230,253,270,246,516
42,42070,420700203,Guatraché,LA PAMPA,1,9,2,2,4
42,42070,420700104,Guatraché,LA PAMPA,148,202,190,171,361
42,42070,420700506,Guatraché,LA PAMPA,37,38,54,39,93
42,42070,420700302,Guatraché,LA PAMPA,28,55,16,44,60
42,42070,420700106,Guatraché,LA PAMPA,175,212,238,202,440
42,42070,420700101,Guatraché,LA PAMPA,186,229,222,219,441
42,42070,420700105,Guatraché,LA PAMPA,183,201,273,244,517
42,42070,420700504,Guatraché,LA PAMPA,208,231,547,600,1147
42,42070,420700202,Guatraché,LA PAMPA,47,107,46,81,127
42,42070,420700401,Guatraché,LA PAMPA,179,216,231,235,466
42,42070,420700102,Guatraché,LA PAMPA,7,10,1,8,9
42,42070,420700502,Guatraché,LA PAMPA,283,334,344,311,655
42,42070,420700501,Guatraché,LA PAMPA,343,382,432,460,892
42,42070,420700301,Guatraché,LA PAMPA,10,16,19,20,39
42,42035,420350701,Conhelo,LA PAMPA,113,153,153,138,291
42,42035,420350411,Conhelo,LA PAMPA,141,170,202,201,403
42,42035,420350407,Conhelo,LA PAMPA,215,242,246,237,483
42,42035,420350202,Conhelo,LA PAMPA,78,142,73,138,211
42,42035,420350501,Conhelo,LA PAMPA,75,117,103,97,200
42,42035,420350413,Conhelo,LA PAMPA,237,289,343,337,680
42,42035,420350403,Conhelo,LA PAMPA,263,320,380,343,723
42,42035,420350401,Conhelo,LA PAMPA,178,210,261,302,563
42,42035,420350503,Conhelo,LA PAMPA,18,27,11,24,35
42,42035,420350307,Conhelo,LA PAMPA,8,14,8,13,21
42,42035,420350601,Conhelo,LA PAMPA,217,279,315,311,626
42,42035,420350412,Conhelo,LA PAMPA,263,303,352,323,675
42,42035,420350201,Conhelo,LA PAMPA,143,169,228,236,464
42,42035,420350304,Conhelo,LA PAMPA,5,23,1,6,7
42,42035,420350106,Conhelo,LA PAMPA,9,25,10,10,20
42,42035,420350406,Conhelo,LA PAMPA,180,217,204,206,410
42,42035,420350603,Conhelo,LA PAMPA,14,30,9,21,30
42,42035,420350608,Conhelo,LA PAMPA,60,92,71,86,157
42,42035,420350605,Conhelo,LA PAMPA,23,35,26,38,64
42,42035,420350502,Conhelo,LA PAMPA,26,67,29,40,69
42,42035,420350306,Conhelo,LA PAMPA,189,271,305,323,628
42,42035,420350602,Conhelo,LA PAMPA,207,239,266,264,530
42,42035,420350702,Conhelo,LA PAMPA,8,21,8,11,19
42,42035,420350301,Conhelo,LA PAMPA,3,15,3,4,7
42,42035,420350303,Conhelo,LA PAMPA,8,9,9,11,20
42,42035,420350103,Conhelo,LA PAMPA,8,12,8,8,16
42,42035,420350102,Conhelo,LA PAMPA,1,1,1,3,4
42,42035,420350504,Conhelo,LA PAMPA,16,33,16,26,42
42,42035,420350607,Conhelo,LA PAMPA,13,26,17,19,36
42,42035,420350609,Conhelo,LA PAMPA,217,266,322,322,644
42,42035,420350409,Conhelo,LA PAMPA,182,210,280,235,515
42,42035,420350404,Conhelo,LA PAMPA,194,222,333,269,602
42,42035,420350310,Conhelo,LA PAMPA,317,352,556,522,1078
42,42035,420350703,Conhelo,LA PAMPA,7,20,7,11,18
42,42035,420350410,Conhelo,LA PAMPA,160,180,200,202,402
42,42035,420350405,Conhelo,LA PAMPA,259,306,348,326,674
42,42035,420350402,Conhelo,LA PAMPA,172,199,260,270,530
42,42035,420350309,Conhelo,LA PAMPA,149,153,250,229,479
42,42035,420350101,Conhelo,LA PAMPA,78,90,96,123,219
42,42035,420350302,Conhelo,LA PAMPA,10,28,8,18,26
42,42035,420350705,Conhelo,LA PAMPA,16,35,20,26,46
42,42035,420350606,Conhelo,LA PAMPA,15,26,19,31,50
42,42035,420350604,Conhelo,LA PAMPA,20,41,24,22,46
42,42035,420350308,Conhelo,LA PAMPA,22,53,24,36,60
42,42035,420350610,Conhelo,LA PAMPA,164,200,217,205,422
42,42035,420350408,Conhelo,LA PAMPA,156,188,238,183,421
42,42035,420350505,Conhelo,LA PAMPA,89,112,137,133,270
42,42035,420350305,Conhelo,LA PAMPA,3,10,4,9,13
42,42035,420350105,Conhelo,LA PAMPA,17,30,18,29,47
42,42035,420350104,Conhelo,LA PAMPA,13,30,9,26,35
42,42035,420350704,Conhelo,LA PAMPA,17,31,20,26,46
42,42021,420210907,Capital,LA PAMPA,331,355,482,451,933
42,42021,420210902,Capital,LA PAMPA,301,375,381,327,708
42,42021,420210823,Capital,LA PAMPA,149,169,237,222,459
42,42021,420210821,Capital,LA PAMPA,299,311,560,483,1043
42,42021,420210811,Capital,LA PAMPA,201,234,252,233,485
42,42021,420210807,Capital,LA PAMPA,259,284,302,295,597
42,42021,420210723,Capital,LA PAMPA,254,286,402,416,818
42,42021,420210717,Capital,LA PAMPA,218,248,289,237,526
42,42021,420210601,Capital,LA PAMPA,209,231,341,351,692
42,42021,420210509,Capital,LA PAMPA,210,227,295,274,569
42,42021,420210408,Capital,LA PAMPA,263,301,375,358,733
42,42021,420210402,Capital,LA PAMPA,225,242,344,359,703
42,42021,420210310,Capital,LA PAMPA,292,331,426,438,864
42,42021,420210303,Capital,LA PAMPA,275,361,420,449,869
42,42021,420210117,Capital,LA PAMPA,119,142,229,244,473
42,42021,420210112,Capital,LA PAMPA,276,274,676,624,1300
42,42021,420210111,Capital,LA PAMPA,272,262,531,463,994
42,42021,420210610,Capital,LA PAMPA,2,2,64,10,74
42,42021,420210818,Capital,LA PAMPA,209,216,379,345,724
42,42021,420210817,Capital,LA PAMPA,212,218,362,344,706
42,42021,420211006,Capital,LA PAMPA,272,282,512,492,1004
42,42021,420210614,Capital,LA PAMPA,296,400,355,279,634
42,42021,420210612,Capital,LA PAMPA,191,310,213,160,373
42,42021,420210208,Capital,LA PAMPA,14,32,11,21,32
42,42021,420210207,Capital,LA PAMPA,12,20,15,20,35
42,42021,420210107,Capital,LA PAMPA,28,47,36,35,71
42,42021,420210504,Capital,LA PAMPA,257,288,358,343,701
42,42021,420211002,Capital,LA PAMPA,337,344,624,616,1240
42,42021,420210912,Capital,LA PAMPA,367,415,608,607,1215
42,42021,420210904,Capital,LA PAMPA,336,384,449,411,860
42,42021,420210901,Capital,LA PAMPA,138,192,144,87,231
42,42021,420210808,Capital,LA PAMPA,339,406,444,384,828
42,42021,420210802,Capital,LA PAMPA,193,271,226,174,400
42,42021,420210715,Capital,LA PAMPA,319,331,430,422,852
42,42021,420210507,Capital,LA PAMPA,372,440,504,458,962
42,42021,420210502,Capital,LA PAMPA,366,360,658,653,1311
42,42021,420210405,Capital,LA PAMPA,210,197,331,295,626
42,42021,420210609,Capital,LA PAMPA,163,226,179,103,282
42,42021,420211003,Capital,LA PAMPA,196,212,367,367,734
42,42021,420210705,Capital,LA PAMPA,301,466,425,310,735
42,42021,420210203,Capital,LA PAMPA,3,10,3,4,7
42,42021,420210108,Capital,LA PAMPA,19,34,13,35,48
42,42021,420210101,Capital,LA PAMPA,46,92,38,72,110
42,42021,420211001,Capital,LA PAMPA,329,342,633,599,1232
42,42021,420210913,Capital,LA PAMPA,263,333,332,354,686
42,42021,420210819,Capital,LA PAMPA,208,221,394,360,754
42,42021,420210814,Capital,LA PAMPA,261,322,341,278,619
42,42021,420210724,Capital,LA PAMPA,185,255,283,304,587
42,42021,420210815,Capital,LA PAMPA,277,296,389,426,815
42,42021,420210721,Capital,LA PAMPA,277,298,471,483,954
42,42021,420210719,Capital,LA PAMPA,298,332,480,459,939
42,42021,420210718,Capital,LA PAMPA,183,204,278,260,538
42,42021,420210716,Capital,LA PAMPA,187,208,254,244,498
42,42021,420210714,Capital,LA PAMPA,291,338,389,339,728
42,42021,420210605,Capital,LA PAMPA,186,229,217,188,405
42,42021,420210515,Capital,LA PAMPA,339,419,439,377,816
42,42021,420210506,Capital,LA PAMPA,392,437,533,488,1021
42,42021,420210414,Capital,LA PAMPA,314,361,399,348,747
42,42021,420210409,Capital,LA PAMPA,16,14,24,397,421
42,42021,420210404,Capital,LA PAMPA,235,239,380,359,739
42,42021,420210403,Capital,LA PAMPA,200,218,338,291,629
42,42021,420210311,Capital,LA PAMPA,349,361,758,670,1428
42,42021,420210209,Capital,LA PAMPA,236,280,403,380,783
42,42021,420210201,Capital,LA PAMPA,124,156,188,204,392
42,42021,420210704,Capital,LA PAMPA,275,355,308,229,537
42,42021,420210202,Capital,LA PAMPA,19,29,22,32,54
42,42021,420210909,Capital,LA PAMPA,197,247,248,240,488
42,42021,420210914,Capital,LA PAMPA,175,204,269,224,493
42,42021,420210803,Capital,LA PAMPA,193,297,207,127,334
42,42021,420210801,Capital,LA PAMPA,170,267,215,161,376
42,42021,420210510,Capital,LA PAMPA,294,318,463,473,936
42,42021,420210420,Capital,LA PAMPA,257,332,418,431,849
42,42021,420210410,Capital,LA PAMPA,141,159,189,156,345
42,42021,420210407,Capital,LA PAMPA,378,422,506,443,949
42,42021,420210306,Capital,LA PAMPA,288,300,636,647,1283
42,42021,420210816,Capital,LA PAMPA,301,315,465,463,928
42,42021,420211005,Capital,LA PAMPA,290,299,557,497,1054
42,42021,420210702,Capital,LA PAMPA,162,216,198,169,367
42,42021,420210616,Capital,LA PAMPA,167,252,213,145,358
42,42021,420210707,Capital,LA PAMPA,244,320,338,248,586
42,42021,420210106,Capital,LA PAMPA,33,48,46,54,100
42,42021,420210105,Capital,LA PAMPA,113,130,226,214,440
42,42021,420210917,Capital,LA PAMPA,199,305,387,389,776
42,42021,420210911,Capital,LA PAMPA,240,279,326,316,642
42,42021,420210910,Capital,LA PAMPA,207,271,270,242,512
42,42021,420210820,Capital,LA PAMPA,206,211,394,357,751
42,42021,420210813,Capital,LA PAMPA,205,263,230,189,419
42,42021,420210809,Capital,LA PAMPA,254,296,329,308,637
42,42021,420210804,Capital,LA PAMPA,241,294,306,233,539
42,42021,420210713,Capital,LA PAMPA,241,260,378,300,678
42,42021,420210602,Capital,LA PAMPA,215,248,357,335,692
42,42021,420210516,Capital,LA PAMPA,434,535,556,518,1074
42,42021,420210421,Capital,LA PAMPA,166,266,267,267,534
42,42021,420210419,Capital,LA PAMPA,188,226,304,279,583
42,42021,420210417,Capital,LA PAMPA,217,277,271,268,539
42,42021,420210415,Capital,LA PAMPA,209,237,294,236,530
42,42021,420210406,Capital,LA PAMPA,255,294,398,345,743
42,42021,420210312,Capital,LA PAMPA,362,378,716,660,1376
42,42021,420210309,Capital,LA PAMPA,241,270,364,377,741
42,42021,420210307,Capital,LA PAMPA,251,273,487,468,955
42,42021,420210305,Capital,LA PAMPA,265,280,403,443,846
42,42021,420210709,Capital,LA PAMPA,199,240,257,222,479
42,42021,420210703,Capital,LA PAMPA,278,383,322,234,556
42,42021,420210205,Capital,LA PAMPA,18,37,24,31,55
42,42021,420210103,Capital,LA PAMPA,21,34,20,30,50
42,42021,420210204,Capital,LA PAMPA,14,27,22,21,43
42,42021,420210109,Capital,LA PAMPA,11,21,6,13,19
42,42021,420210102,Capital,LA PAMPA,13,21,8,16,24
42,42021,420210615,Capital,LA PAMPA,193,305,204,131,335
42,42021,420210908,Capital,LA PAMPA,386,409,599,540,1139
42,42021,420210805,Capital,LA PAMPA,303,376,339,276,615
42,42021,420210418,Capital,LA PAMPA,204,249,296,293,589
42,42021,420210412,Capital,LA PAMPA,203,247,231,179,410
42,42021,420210413,Capital,LA PAMPA,284,368,321,268,589
42,42021,420210308,Capital,LA PAMPA,256,272,456,455,911
42,42021,420210304,Capital,LA PAMPA,258,327,451,453,904
42,42021,420210210,Capital,LA PAMPA,155,189,273,257,530
42,42021,420210118,Capital,LA PAMPA,201,310,299,355,654
42,42021,420210611,Capital,LA PAMPA,206,323,255,165,420
42,42021,420210608,Capital,LA PAMPA,149,218,180,141,321
42,42021,420210505,Capital,LA PAMPA,300,297,491,497,988
42,42021,420210722,Capital,LA PAMPA,296,313,501,508,1009
42,42021,420210706,Capital,LA PAMPA,202,313,260,162,422
42,42021,420210701,Capital,LA PAMPA,190,231,242,190,432
42,42021,420210708,Capital,LA PAMPA,269,289,334,331,665
42,42021,420210206,Capital,LA PAMPA,27,57,26,31,57
42,42021,420210916,Capital,LA PAMPA,322,353,586,555,1141
42,42021,420210915,Capital,LA PAMPA,219,255,350,292,642
42,42021,420210905,Capital,LA PAMPA,322,340,654,633,1287
42,42021,420210824,Capital,LA PAMPA,207,239,291,296,587
42,42021,420210810,Capital,LA PAMPA,295,321,436,403,839
42,42021,420210806,Capital,LA PAMPA,250,311,335,276,611
42,42021,420210725,Capital,LA PAMPA,144,216,211,208,419
42,42021,420210720,Capital,LA PAMPA,265,310,448,465,913
42,42021,420210710,Capital,LA PAMPA,178,205,241,246,487
42,42021,420210603,Capital,LA PAMPA,331,373,421,375,796
42,42021,420210514,Capital,LA PAMPA,207,244,295,285,580
42,42021,420210513,Capital,LA PAMPA,243,278,390,387,777
42,42021,420210511,Capital,LA PAMPA,245,260,456,484,940
42,42021,420210503,Capital,LA PAMPA,349,387,588,563,1151
42,42021,420210416,Capital,LA PAMPA,184,225,250,209,459
42,42021,420210401,Capital,LA PAMPA,223,253,394,363,757
42,42021,420210115,Capital,LA PAMPA,0,329,0,0,0
42,42021,420210110,Capital,LA PAMPA,37,53,48,60,108
42,42021,420210302,Capital,LA PAMPA,253,261,558,559,1117
42,42021,420210113,Capital,LA PAMPA,243,251,600,554,1154
42,42021,420210613,Capital,LA PAMPA,291,437,319,245,564
42,42021,420210104,Capital,LA PAMPA,9,32,9,12,21
42,42021,420210906,Capital,LA PAMPA,136,155,262,381,643
42,42021,420210903,Capital,LA PAMPA,352,408,470,372,842
42,42021,420210822,Capital,LA PAMPA,184,191,336,293,629
42,42021,420210812,Capital,LA PAMPA,189,228,241,223,464
42,42021,420210712,Capital,LA PAMPA,213,216,336,301,637
42,42021,420210711,Capital,LA PAMPA,152,188,222,214,436
42,42021,420210606,Capital,LA PAMPA,178,241,184,151,335
42,42021,420210604,Capital,LA PAMPA,325,430,421,316,737
42,42021,420210512,Capital,LA PAMPA,273,276,613,612,1225
42,42021,420210508,Capital,LA PAMPA,2,2,10,27,37
42,42021,420210501,Capital,LA PAMPA,231,259,483,435,918
42,42021,420210411,Capital,LA PAMPA,169,218,197,170,367
42,42021,420210301,Capital,LA PAMPA,240,259,571,500,1071
42,42021,420210116,Capital,LA PAMPA,0,376,0,0,0
42,42021,420210114,Capital,LA PAMPA,177,222,267,256,523
42,42021,420210607,Capital,LA PAMPA,236,292,304,222,526
42,42021,420211004,Capital,LA PAMPA,294,302,549,471,1020
42,42007,420070403,Atreucó,LA PAMPA,177,208,215,190,405
42,42007,420070505,Atreucó,LA PAMPA,15,36,20,19,39
42,42007,420070408,Atreucó,LA PAMPA,9,21,5,14,19
42,42007,420070407,Atreucó,LA PAMPA,17,33,15,25,40
42,42007,420070402,Atreucó,LA PAMPA,269,293,311,327,638
42,42007,420070201,Atreucó,LA PAMPA,134,156,201,204,405
42,42007,420070104,Atreucó,LA PAMPA,20,34,10,32,42
42,42007,420070109,Atreucó,LA PAMPA,16,34,18,24,42
42,42007,420070401,Atreucó,LA PAMPA,272,299,359,372,731
42,42007,420070410,Atreucó,LA PAMPA,4,9,4,6,10
42,42007,420070103,Atreucó,LA PAMPA,8,14,4,15,19
42,42007,420070506,Atreucó,LA PAMPA,2,9,4,9,13
42,42007,420070502,Atreucó,LA PAMPA,5,7,6,9,15
42,42007,420070411,Atreucó,LA PAMPA,10,31,11,12,23
42,42007,420070406,Atreucó,LA PAMPA,247,299,338,351,689
42,42007,420070301,Atreucó,LA PAMPA,100,120,154,153,307
42,42007,420070207,Atreucó,LA PAMPA,218,266,347,333,680
42,42007,420070412,Atreucó,LA PAMPA,0,6,0,0,0
42,42007,420070504,Atreucó,LA PAMPA,7,7,9,10,19
42,42007,420070203,Atreucó,LA PAMPA,22,18,23,37,60
42,42007,420070106,Atreucó,LA PAMPA,13,14,8,17,25
42,42007,420070105,Atreucó,LA PAMPA,7,17,4,10,14
42,42007,420070413,Atreucó,LA PAMPA,183,204,308,293,601
42,42007,420070208,Atreucó,LA PAMPA,176,193,282,259,541
42,42007,420070110,Atreucó,LA PAMPA,188,236,288,273,561
42,42007,420070101,Atreucó,LA PAMPA,215,239,313,296,609
42,42007,420070503,Atreucó,LA PAMPA,2,11,3,3,6
42,42007,420070303,Atreucó,LA PAMPA,5,17,2,8,10
42,42007,420070302,Atreucó,LA PAMPA,23,49,20,34,54
42,42007,420070108,Atreucó,LA PAMPA,23,45,29,39,68
42,42007,420070501,Atreucó,LA PAMPA,134,158,195,209,404
42,42007,420070202,Atreucó,LA PAMPA,161,190,206,202,408
42,42007,420070404,Atreucó,LA PAMPA,171,208,234,213,447
42,42007,420070102,Atreucó,LA PAMPA,146,179,198,218,416
42,42007,420070206,Atreucó,LA PAMPA,6,17,9,13,22
42,42007,420070205,Atreucó,LA PAMPA,8,23,5,11,16
42,42007,420070204,Atreucó,LA PAMPA,37,65,47,59,106
42,42007,420070508,Atreucó,LA PAMPA,100,118,132,142,274
42,42007,420070107,Atreucó,LA PAMPA,8,26,8,10,18
42,42007,420070409,Atreucó,LA PAMPA,251,320,433,430,863
42,42007,420070405,Atreucó,LA PAMPA,173,208,255,229,484
42,42007,420070507,Atreucó,LA PAMPA,4,11,4,6,10
42,42077,420770301,Hucal,LA PAMPA,241,329,310,287,597
42,42077,420770204,Hucal,LA PAMPA,17,57,15,24,39
42,42077,420770107,Hucal,LA PAMPA,21,40,11,30,41
42,42077,420770105,Hucal,LA PAMPA,10,19,12,12,24
42,42077,420770102,Hucal,LA PAMPA,3,13,0,3,3
42,42077,420770302,Hucal,LA PAMPA,169,221,193,207,400
42,42077,420770406,Hucal,LA PAMPA,13,33,21,23,44
42,42077,420770104,Hucal,LA PAMPA,5,13,5,8,13
42,42077,420770209,Hucal,LA PAMPA,5,25,3,6,9
42,42077,420770203,Hucal,LA PAMPA,146,165,185,193,378
42,42077,420770202,Hucal,LA PAMPA,184,211,239,251,490
42,42077,420770404,Hucal,LA PAMPA,11,30,7,19,26
42,42077,420770410,Hucal,LA PAMPA,191,223,252,232,484
42,42077,420770407,Hucal,LA PAMPA,3,5,2,5,7
42,42077,420770305,Hucal,LA PAMPA,23,66,16,33,49
42,42077,420770208,Hucal,LA PAMPA,15,34,12,18,30
42,42077,420770201,Hucal,LA PAMPA,198,219,264,267,531
42,42077,420770408,Hucal,LA PAMPA,5,14,6,7,13
42,42077,420770306,Hucal,LA PAMPA,80,94,120,117,237
42,42077,420770210,Hucal,LA PAMPA,163,221,205,198,403
42,42077,420770403,Hucal,LA PAMPA,7,17,6,8,14
42,42077,420770303,Hucal,LA PAMPA,9,30,5,9,14
42,42077,420770409,Hucal,LA PAMPA,208,244,286,280,566
42,42077,420770402,Hucal,LA PAMPA,209,243,310,291,601
42,42077,420770401,Hucal,LA PAMPA,298,351,397,386,783
42,42077,420770211,Hucal,LA PAMPA,154,186,195,189,384
42,42077,420770304,Hucal,LA PAMPA,25,68,31,32,63
42,42077,420770108,Hucal,LA PAMPA,41,107,32,67,99
42,42077,420770106,Hucal,LA PAMPA,8,15,5,8,13
42,42077,420770103,Hucal,LA PAMPA,6,12,5,12,17
42,42077,420770307,Hucal,LA PAMPA,133,152,163,180,343
42,42077,420770101,Hucal,LA PAMPA,109,147,149,163,312
42,42077,420770212,Hucal,LA PAMPA,141,164,195,195,390
42,42077,420770405,Hucal,LA PAMPA,4,8,3,6,9
42,42077,420770205,Hucal,LA PAMPA,11,28,8,12,20
42,42077,420770207,Hucal,LA PAMPA,25,55,15,29,44
42,42077,420770206,Hucal,LA PAMPA,17,33,22,28,50
42,42084,420840207,Lihuel Calel,LA PAMPA,4,8,3,5,8
42,42084,420840202,Lihuel Calel,LA PAMPA,28,44,16,35,51
42,42084,420840101,Lihuel Calel,LA PAMPA,68,106,104,104,208
42,42084,420840206,Lihuel Calel,LA PAMPA,6,7,14,32,46
42,42084,420840203,Lihuel Calel,LA PAMPA,12,33,5,19,24
42,42084,420840204,Lihuel Calel,LA PAMPA,0,3,0,0,0
42,42084,420840201,Lihuel Calel,LA PAMPA,16,27,5,19,24
42,42084,420840205,Lihuel Calel,LA PAMPA,3,4,0,3,3
42,42084,420840102,Lihuel Calel,LA PAMPA,45,146,22,53,75
42,42042,420420305,Curacó,LA PAMPA,1,3,1,2,3
42,42042,420420104,Curacó,LA PAMPA,2,6,0,2,2
42,42042,420420303,Curacó,LA PAMPA,3,4,0,5,5
42,42042,420420106,Curacó,LA PAMPA,2,5,3,5,8
42,42042,420420301,Curacó,LA PAMPA,113,128,178,235,413
42,42042,420420302,Curacó,LA PAMPA,14,36,5,18,23
42,42042,420420105,Curacó,LA PAMPA,0,1,0,0,0
42,42042,420420304,Curacó,LA PAMPA,0,3,0,0,0
42,42042,420420308,Curacó,LA PAMPA,4,5,2,5,7
42,42042,420420307,Curacó,LA PAMPA,3,5,1,3,4
42,42042,420420202,Curacó,LA PAMPA,55,104,37,79,116
42,42042,420420107,Curacó,LA PAMPA,7,8,2,10,12
42,42042,420420102,Curacó,LA PAMPA,1,1,0,1,1
42,42042,420420101,Curacó,LA PAMPA,2,13,0,4,4
42,42042,420420103,Curacó,LA PAMPA,1,2,1,3,4
42,42042,420420201,Curacó,LA PAMPA,143,188,212,208,420
42,42042,420420306,Curacó,LA PAMPA,9,10,8,10,18
42,42091,420910105,Limay Mahuida,LA PAMPA,69,94,107,114,221
42,42091,420910103,Limay Mahuida,LA PAMPA,32,63,12,43,55
42,42091,420910104,Limay Mahuida,LA PAMPA,21,33,18,29,47
42,42091,420910102,Limay Mahuida,LA PAMPA,40,52,36,69,105
42,42091,420910101,Limay Mahuida,LA PAMPA,27,40,34,41,75
42,42014,420140201,Caleu Caleu,LA PAMPA,209,225,351,334,685
42,42014,420140205,Caleu Caleu,LA PAMPA,32,56,39,66,105
42,42014,420140210,Caleu Caleu,LA PAMPA,235,280,355,329,684
42,42014,420140206,Caleu Caleu,LA PAMPA,8,10,7,8,15
42,42014,420140203,Caleu Caleu,LA PAMPA,48,157,25,56,81
42,42014,420140101,Caleu Caleu,LA PAMPA,13,24,9,21,30
42,42014,420140209,Caleu Caleu,LA PAMPA,9,20,7,13,20
42,42014,420140208,Caleu Caleu,LA PAMPA,0,9,0,0,0
42,42014,420140102,Caleu Caleu,LA PAMPA,15,35,11,22,33
42,42014,420140202,Caleu Caleu,LA PAMPA,7,11,29,39,68
42,42014,420140211,Caleu Caleu,LA PAMPA,141,195,269,266,535
42,42014,420140204,Caleu Caleu,LA PAMPA,0,10,0,0,0
42,42014,420140207,Caleu Caleu,LA PAMPA,1,6,4,2,6
42,42014,420140103,Caleu Caleu,LA PAMPA,23,53,19,32,51
42,42063,420630103,Chical Co,LA PAMPA,126,213,165,195,360
42,42063,420630104,Chical Co,LA PAMPA,1,4,1,0,1
42,42063,420630107,Chical Co,LA PAMPA,98,150,109,155,264
42,42063,420630102,Chical Co,LA PAMPA,118,136,217,206,423
42,42063,420630105,Chical Co,LA PAMPA,7,7,6,7,13
42,42063,420630106,Chical Co,LA PAMPA,31,41,49,63,112
42,42063,420630101,Chical Co,LA PAMPA,93,106,161,168,329
38,38098,380980101,Tumbaya,JUJUY,65,123,155,141,296
38,38098,380980501,Tumbaya,JUJUY,64,82,125,117,242
38,38098,380980204,Tumbaya,JUJUY,143,209,315,334,649
38,38098,380980202,Tumbaya,JUJUY,15,24,24,29,53
38,38098,380980201,Tumbaya,JUJUY,11,12,19,17,36
38,38098,380980102,Tumbaya,JUJUY,39,79,50,33,83
38,38098,380980404,Tumbaya,JUJUY,126,209,233,195,428
38,38098,380980401,Tumbaya,JUJUY,30,55,58,63,121
38,38098,380980303,Tumbaya,JUJUY,31,59,30,50,80
38,38098,380980403,Tumbaya,JUJUY,66,107,134,123,257
38,38098,380980302,Tumbaya,JUJUY,31,53,40,36,76
38,38098,380980502,Tumbaya,JUJUY,32,48,55,33,88
38,38098,380980203,Tumbaya,JUJUY,148,217,229,243,472
38,38098,380980405,Tumbaya,JUJUY,303,379,589,532,1121
38,38098,380980205,Tumbaya,JUJUY,62,79,108,134,242
38,38098,380980402,Tumbaya,JUJUY,69,86,127,146,273
38,38098,380980301,Tumbaya,JUJUY,49,61,61,80,141
38,38094,380940102,Tilcara,JUJUY,193,299,295,295,590
38,38094,380940603,Tilcara,JUJUY,16,40,23,33,56
38,38094,380940601,Tilcara,JUJUY,18,20,27,34,61
38,38094,380940103,Tilcara,JUJUY,206,371,348,333,681
38,38094,380940405,Tilcara,JUJUY,315,406,628,614,1242
38,38094,380940505,Tilcara,JUJUY,160,239,329,305,634
38,38094,380940302,Tilcara,JUJUY,41,79,59,51,110
38,38094,380940101,Tilcara,JUJUY,10,30,20,18,38
38,38094,380940408,Tilcara,JUJUY,175,229,352,338,690
38,38094,380940406,Tilcara,JUJUY,227,336,418,372,790
38,38094,380940507,Tilcara,JUJUY,162,268,272,258,530
38,38094,380940104,Tilcara,JUJUY,154,213,328,310,638
38,38094,380940502,Tilcara,JUJUY,42,51,76,82,158
38,38094,380940403,Tilcara,JUJUY,117,186,215,212,427
38,38094,380940202,Tilcara,JUJUY,24,54,29,33,62
38,38094,380940402,Tilcara,JUJUY,255,301,497,498,995
38,38094,380940407,Tilcara,JUJUY,178,218,359,344,703
38,38094,380940602,Tilcara,JUJUY,20,40,23,40,63
38,38094,380940506,Tilcara,JUJUY,180,295,315,329,644
38,38094,380940503,Tilcara,JUJUY,162,213,282,279,561
38,38094,380940203,Tilcara,JUJUY,11,14,15,19,34
38,38094,380940301,Tilcara,JUJUY,25,35,33,38,71
38,38094,380940401,Tilcara,JUJUY,81,121,121,121,242
38,38094,380940504,Tilcara,JUJUY,210,296,421,391,812
38,38094,380940404,Tilcara,JUJUY,187,231,351,345,696
38,38094,380940201,Tilcara,JUJUY,30,60,47,44,91
38,38094,380940501,Tilcara,JUJUY,198,272,371,359,730
38,38084,380840401,Susques,JUJUY,42,83,82,82,164
38,38084,380840102,Susques,JUJUY,52,122,101,83,184
38,38084,380840301,Susques,JUJUY,44,56,95,66,161
38,38084,380840101,Susques,JUJUY,82,122,163,181,344
38,38084,380840501,Susques,JUJUY,14,66,30,23,53
38,38084,380840403,Susques,JUJUY,44,78,86,68,154
38,38084,380840302,Susques,JUJUY,137,207,329,293,622
38,38084,380840502,Susques,JUJUY,79,89,241,186,427
38,38084,380840201,Susques,JUJUY,80,174,120,175,295
38,38084,380840303,Susques,JUJUY,205,247,513,601,1114
38,38084,380840202,Susques,JUJUY,66,128,118,107,225
38,38084,380840402,Susques,JUJUY,9,21,12,36,48
38,38056,380560103,San Antonio,JUJUY,65,138,88,113,201
38,38056,380560201,San Antonio,JUJUY,144,314,236,273,509
38,38056,380560102,San Antonio,JUJUY,153,228,247,307,554
38,38056,380560101,San Antonio,JUJUY,15,28,10,21,31
38,38056,380560304,San Antonio,JUJUY,12,16,11,14,25
38,38056,380560104,San Antonio,JUJUY,203,242,404,351,755
38,38056,380560301,San Antonio,JUJUY,7,9,4,10,14
38,38056,380560202,San Antonio,JUJUY,216,324,350,389,739
38,38056,380560303,San Antonio,JUJUY,24,32,24,35,59
38,38056,380560105,San Antonio,JUJUY,183,210,356,319,675
38,38056,380560203,San Antonio,JUJUY,55,105,83,93,176
38,38056,380560302,San Antonio,JUJUY,6,12,5,10,15
38,38056,380560204,San Antonio,JUJUY,156,137,373,340,713
38,38070,380700205,Santa Bárbara,JUJUY,182,202,392,390,782
38,38070,380700105,Santa Bárbara,JUJUY,315,349,664,693,1357
38,38070,380700505,Santa Bárbara,JUJUY,44,76,100,113,213
38,38070,380700401,Santa Bárbara,JUJUY,23,27,31,50,81
38,38070,380700403,Santa Bárbara,JUJUY,265,283,555,610,1165
38,38070,380700602,Santa Bárbara,JUJUY,22,35,15,58,73
38,38070,380700207,Santa Bárbara,JUJUY,122,173,258,233,491
38,38070,380700106,Santa Bárbara,JUJUY,367,387,769,775,1544
38,38070,380700601,Santa Bárbara,JUJUY,35,56,41,53,94
38,38070,380700203,Santa Bárbara,JUJUY,164,220,252,335,587
38,38070,380700503,Santa Bárbara,JUJUY,18,32,4,26,30
38,38070,380700303,Santa Bárbara,JUJUY,13,19,12,25,37
38,38070,380700102,Santa Bárbara,JUJUY,13,18,5,15,20
38,38070,380700201,Santa Bárbara,JUJUY,45,77,27,78,105
38,38070,380700504,Santa Bárbara,JUJUY,136,150,239,273,512
38,38070,380700206,Santa Bárbara,JUJUY,177,238,368,348,716
38,38070,380700107,Santa Bárbara,JUJUY,119,148,242,232,474
38,38070,380700508,Santa Bárbara,JUJUY,152,153,429,410,839
38,38070,380700204,Santa Bárbara,JUJUY,411,457,882,879,1761
38,38070,380700402,Santa Bárbara,JUJUY,38,41,48,68,116
38,38070,380700301,Santa Bárbara,JUJUY,27,43,7,53,60
38,38070,380700404,Santa Bárbara,JUJUY,307,350,669,687,1356
38,38070,380700506,Santa Bárbara,JUJUY,357,343,712,743,1455
38,38070,380700302,Santa Bárbara,JUJUY,13,18,9,26,35
38,38070,380700101,Santa Bárbara,JUJUY,239,202,315,390,705
38,38070,380700502,Santa Bárbara,JUJUY,96,223,174,191,365
38,38070,380700501,Santa Bárbara,JUJUY,218,241,509,522,1031
38,38070,380700507,Santa Bárbara,JUJUY,282,223,600,616,1216
38,38070,380700202,Santa Bárbara,JUJUY,169,242,224,286,510
38,38049,380490102,Rinconada,JUJUY,58,102,105,76,181
38,38049,380490105,Rinconada,JUJUY,50,73,121,100,221
38,38049,380490202,Rinconada,JUJUY,46,80,38,63,101
38,38049,380490301,Rinconada,JUJUY,66,149,146,126,272
38,38049,380490101,Rinconada,JUJUY,19,38,38,36,74
38,38049,380490303,Rinconada,JUJUY,55,73,143,529,672
38,38049,380490302,Rinconada,JUJUY,91,172,176,155,331
38,38049,380490106,Rinconada,JUJUY,90,166,176,175,351
38,38049,380490104,Rinconada,JUJUY,27,44,57,40,97
38,38049,380490201,Rinconada,JUJUY,38,60,72,68,140
38,38049,380490103,Rinconada,JUJUY,13,23,26,22,48
34,34007,340070101,Bermejo,FORMOSA,83,86,246,256,502
34,34007,340070102,Bermejo,FORMOSA,307,308,801,904,1705
34,34007,340070201,Bermejo,FORMOSA,203,232,424,519,943
34,34007,340070202,Bermejo,FORMOSA,33,41,52,85,137
34,34007,340070203,Bermejo,FORMOSA,192,202,331,430,761
34,34007,340070204,Bermejo,FORMOSA,168,172,348,388,736
34,34007,340070301,Bermejo,FORMOSA,60,45,103,143,246
34,34007,340070401,Bermejo,FORMOSA,59,88,93,129,222
34,34007,340070402,Bermejo,FORMOSA,151,189,264,281,545
34,34007,340070403,Bermejo,FORMOSA,171,186,266,342,608
34,34007,340070404,Bermejo,FORMOSA,138,169,265,247,512
34,34007,340070405,Bermejo,FORMOSA,241,296,442,468,910
34,34007,340070406,Bermejo,FORMOSA,206,278,363,388,751
34,34007,340070407,Bermejo,FORMOSA,135,210,246,242,488
34,34007,340070408,Bermejo,FORMOSA,136,220,234,236,470
34,34007,340070409,Bermejo,FORMOSA,120,157,211,249,460
34,34007,340070501,Bermejo,FORMOSA,197,225,293,366,659
34,34007,340070502,Bermejo,FORMOSA,52,87,87,77,164
34,34007,340070503,Bermejo,FORMOSA,186,154,314,375,689
34,34007,340070504,Bermejo,FORMOSA,50,93,22,74,96
34,34007,340070505,Bermejo,FORMOSA,156,197,254,274,528
34,34007,340070601,Bermejo,FORMOSA,30,37,29,51,80
34,34007,340070602,Bermejo,FORMOSA,97,119,167,204,371
34,34007,340070603,Bermejo,FORMOSA,17,29,16,30,46
34,34007,340070701,Bermejo,FORMOSA,27,46,32,51,83
34,34007,340070702,Bermejo,FORMOSA,145,206,320,326,646
34,34007,340070703,Bermejo,FORMOSA,94,93,159,210,369
34,34007,340070801,Bermejo,FORMOSA,94,102,125,194,319
34,34014,340140101,Formosa,FORMOSA,342,265,636,641,1277
34,34014,340140102,Formosa,FORMOSA,248,220,452,450,902
34,34014,340140103,Formosa,FORMOSA,95,323,141,130,271
34,34014,340140104,Formosa,FORMOSA,255,341,355,281,636
34,34014,340140105,Formosa,FORMOSA,238,262,398,329,727
34,34014,340140106,Formosa,FORMOSA,256,269,509,407,916
34,34014,340140107,Formosa,FORMOSA,202,206,401,340,741
34,34014,340140108,Formosa,FORMOSA,405,418,857,715,1572
34,34014,340140109,Formosa,FORMOSA,301,253,598,577,1175
34,34014,340140110,Formosa,FORMOSA,356,297,705,711,1416
34,34014,340140111,Formosa,FORMOSA,215,216,400,323,723
34,34014,340140112,Formosa,FORMOSA,251,261,503,416,919
34,34014,340140113,Formosa,FORMOSA,300,302,496,404,900
34,34014,340140114,Formosa,FORMOSA,292,288,509,416,925
34,34014,340140115,Formosa,FORMOSA,175,191,289,283,572
34,34014,340140116,Formosa,FORMOSA,284,272,476,398,874
34,34014,340140117,Formosa,FORMOSA,247,237,427,407,834
34,34014,340140118,Formosa,FORMOSA,176,183,314,313,627
34,34014,340140119,Formosa,FORMOSA,167,195,247,224,471
34,34014,340140120,Formosa,FORMOSA,364,368,564,462,1026
34,34014,340140121,Formosa,FORMOSA,170,195,274,210,484
34,34014,340140122,Formosa,FORMOSA,235,247,450,430,880
34,34014,340140123,Formosa,FORMOSA,246,288,442,337,779
34,34014,340140124,Formosa,FORMOSA,218,220,381,364,745
34,34014,340140125,Formosa,FORMOSA,203,223,367,333,700
34,34014,340140126,Formosa,FORMOSA,176,209,293,290,583
34,34014,340140201,Formosa,FORMOSA,361,373,774,774,1548
34,34014,340140202,Formosa,FORMOSA,298,290,565,557,1122
34,34014,340140203,Formosa,FORMOSA,330,384,604,509,1113
34,34014,340140204,Formosa,FORMOSA,186,220,347,315,662
34,34014,340140205,Formosa,FORMOSA,345,352,710,646,1356
34,34014,340140206,Formosa,FORMOSA,299,297,710,649,1359
34,34014,340140207,Formosa,FORMOSA,244,238,417,484,901
34,34014,340140208,Formosa,FORMOSA,258,285,501,437,938
34,34014,340140209,Formosa,FORMOSA,359,369,627,585,1212
34,34014,340140210,Formosa,FORMOSA,238,264,401,341,742
34,34014,340140211,Formosa,FORMOSA,262,272,436,380,816
34,34014,340140212,Formosa,FORMOSA,254,239,433,392,825
34,34014,340140213,Formosa,FORMOSA,188,232,269,244,513
34,34014,340140214,Formosa,FORMOSA,311,358,486,348,834
34,34014,340140215,Formosa,FORMOSA,258,304,410,429,839
34,34014,340140216,Formosa,FORMOSA,227,285,369,272,641
34,34014,340140217,Formosa,FORMOSA,215,253,365,280,645
34,34014,340140218,Formosa,FORMOSA,212,244,363,294,657
34,34014,340140219,Formosa,FORMOSA,185,198,359,313,672
34,34014,340140220,Formosa,FORMOSA,370,343,689,665,1354
34,34014,340140221,Formosa,FORMOSA,193,169,418,397,815
34,34014,340140222,Formosa,FORMOSA,200,185,410,381,791
34,34014,340140223,Formosa,FORMOSA,240,196,517,524,1041
34,34014,340140301,Formosa,FORMOSA,274,314,468,372,840
34,34014,340140302,Formosa,FORMOSA,322,351,534,427,961
34,34014,340140303,Formosa,FORMOSA,264,319,461,359,820
34,34014,340140304,Formosa,FORMOSA,281,372,404,352,756
34,34014,340140305,Formosa,FORMOSA,252,322,391,315,706
34,34014,340140306,Formosa,FORMOSA,248,285,416,372,788
34,34014,340140307,Formosa,FORMOSA,339,356,626,496,1122
34,34014,340140308,Formosa,FORMOSA,319,253,581,514,1095
34,34014,340140309,Formosa,FORMOSA,176,161,405,374,779
34,34014,340140310,Formosa,FORMOSA,353,322,720,662,1382
34,34014,340140311,Formosa,FORMOSA,282,289,630,597,1227
34,34014,340140312,Formosa,FORMOSA,250,313,464,473,937
34,34014,340140313,Formosa,FORMOSA,281,263,598,585,1183
34,34014,340140401,Formosa,FORMOSA,221,224,358,356,714
34,34014,340140402,Formosa,FORMOSA,189,229,307,262,569
34,34014,340140403,Formosa,FORMOSA,382,377,723,666,1389
34,34014,340140404,Formosa,FORMOSA,367,372,612,551,1163
34,34014,340140405,Formosa,FORMOSA,223,207,374,293,667
34,34014,340140406,Formosa,FORMOSA,376,390,709,593,1302
34,34014,340140407,Formosa,FORMOSA,222,231,515,398,913
34,34014,340140408,Formosa,FORMOSA,285,270,469,364,833
34,34014,340140409,Formosa,FORMOSA,350,402,613,517,1130
34,34014,340140410,Formosa,FORMOSA,258,272,419,356,775
34,34014,340140411,Formosa,FORMOSA,212,220,394,340,734
34,34014,340140412,Formosa,FORMOSA,262,260,547,445,992
34,34014,340140413,Formosa,FORMOSA,306,273,582,545,1127
34,34014,340140414,Formosa,FORMOSA,243,237,492,448,940
34,34014,340140415,Formosa,FORMOSA,366,327,769,708,1477
34,34014,340140416,Formosa,FORMOSA,290,279,597,554,1151
34,34014,340140417,Formosa,FORMOSA,290,267,500,493,993
34,34014,340140418,Formosa,FORMOSA,245,244,503,415,918
34,34014,340140419,Formosa,FORMOSA,259,248,502,454,956
34,34014,340140501,Formosa,FORMOSA,17,22,21,26,47
34,34014,340140502,Formosa,FORMOSA,351,349,665,697,1362
34,34014,340140503,Formosa,FORMOSA,14,31,17,24,41
34,34014,340140504,Formosa,FORMOSA,127,140,262,256,518
34,34014,340140505,Formosa,FORMOSA,93,103,182,168,350
34,34014,340140506,Formosa,FORMOSA,167,169,323,381,704
34,34014,340140601,Formosa,FORMOSA,6,10,0,6,6
34,34014,340140602,Formosa,FORMOSA,141,178,242,236,478
34,34014,340140603,Formosa,FORMOSA,115,134,250,237,487
34,34014,340140604,Formosa,FORMOSA,25,27,25,38,63
34,34014,340140605,Formosa,FORMOSA,67,68,131,138,269
34,34014,340140606,Formosa,FORMOSA,64,90,110,110,220
34,34014,340140607,Formosa,FORMOSA,94,112,162,199,361
34,34014,340140608,Formosa,FORMOSA,3,278,0,6,6
34,34014,340140609,Formosa,FORMOSA,0,281,0,0,0
34,34014,340140701,Formosa,FORMOSA,203,244,320,414,734
34,34014,340140702,Formosa,FORMOSA,221,275,418,469,887
34,34014,340140703,Formosa,FORMOSA,196,199,519,442,961
34,34014,340140704,Formosa,FORMOSA,196,205,452,475,927
34,34014,340140705,Formosa,FORMOSA,319,319,735,686,1421
34,34014,340140706,Formosa,FORMOSA,301,281,679,672,1351
34,34014,340140707,Formosa,FORMOSA,223,233,571,496,1067
34,34014,340140708,Formosa,FORMOSA,270,269,675,652,1327
34,34014,340140709,Formosa,FORMOSA,338,319,764,740,1504
34,34014,340140710,Formosa,FORMOSA,262,191,622,618,1240
34,34014,340140711,Formosa,FORMOSA,337,220,783,757,1540
34,34014,340140712,Formosa,FORMOSA,5,297,13,13,26
34,34014,340140713,Formosa,FORMOSA,248,278,576,538,1114
34,34014,340140714,Formosa,FORMOSA,275,284,688,655,1343
34,34014,340140715,Formosa,FORMOSA,323,292,713,712,1425
34,34014,340140716,Formosa,FORMOSA,126,205,190,229,419
34,34014,340140717,Formosa,FORMOSA,190,241,347,365,712
34,34014,340140801,Formosa,FORMOSA,33,59,24,56,80
34,34014,340140802,Formosa,FORMOSA,16,32,9,32,41
34,34014,340140803,Formosa,FORMOSA,46,59,87,93,180
34,34014,340140804,Formosa,FORMOSA,54,89,95,98,193
34,34014,340140901,Formosa,FORMOSA,115,135,219,235,454
34,34014,340140902,Formosa,FORMOSA,32,39,19,67,86
34,34014,340141001,Formosa,FORMOSA,64,78,96,104,200
34,34014,340141002,Formosa,FORMOSA,7,10,10,11,21
34,34014,340141003,Formosa,FORMOSA,5,12,3,7,10
34,34014,340141004,Formosa,FORMOSA,112,127,187,165,352
34,34014,340141005,Formosa,FORMOSA,156,179,280,284,564
34,34014,340141101,Formosa,FORMOSA,39,39,77,60,137
34,34014,340141102,Formosa,FORMOSA,13,18,9,20,29
34,34014,340141103,Formosa,FORMOSA,59,71,84,89,173
34,34014,340141104,Formosa,FORMOSA,109,139,205,205,410
34,34014,340141201,Formosa,FORMOSA,55,68,100,127,227
34,34014,340141301,Formosa,FORMOSA,48,57,43,71,114
34,34014,340141302,Formosa,FORMOSA,7,9,3,9,12
34,34014,340141401,Formosa,FORMOSA,36,54,57,62,119
34,34014,340141402,Formosa,FORMOSA,52,69,53,86,139
34,34014,340141403,Formosa,FORMOSA,162,200,287,301,588
34,34014,340141404,Formosa,FORMOSA,99,111,177,193,370
34,34014,340141501,Formosa,FORMOSA,381,368,742,711,1453
34,34014,340141502,Formosa,FORMOSA,228,230,463,460,923
34,34014,340141503,Formosa,FORMOSA,214,267,376,324,700
34,34014,340141504,Formosa,FORMOSA,389,396,741,586,1327
34,34014,340141505,Formosa,FORMOSA,264,243,526,466,992
34,34014,340141506,Formosa,FORMOSA,286,282,575,516,1091
34,34014,340141507,Formosa,FORMOSA,421,381,759,744,1503
34,34014,340141508,Formosa,FORMOSA,376,373,705,588,1293
34,34014,340141509,Formosa,FORMOSA,298,263,550,542,1092
34,34014,340141510,Formosa,FORMOSA,212,175,441,396,837
34,34014,340141511,Formosa,FORMOSA,129,85,255,186,441
34,34014,340141512,Formosa,FORMOSA,342,318,643,516,1159
34,34014,340141513,Formosa,FORMOSA,317,304,579,511,1090
34,34014,340141514,Formosa,FORMOSA,443,370,810,731,1541
34,34014,340141515,Formosa,FORMOSA,179,191,346,304,650
34,34014,340141516,Formosa,FORMOSA,270,284,541,471,1012
34,34014,340141517,Formosa,FORMOSA,352,381,677,486,1163
34,34014,340141518,Formosa,FORMOSA,283,282,537,437,974
34,34014,340141519,Formosa,FORMOSA,212,212,452,419,871
34,34014,340141520,Formosa,FORMOSA,165,187,266,250,516
34,34014,340141521,Formosa,FORMOSA,215,195,470,434,904
34,34014,340141522,Formosa,FORMOSA,213,225,428,404,832
34,34014,340141523,Formosa,FORMOSA,234,244,492,436,928
34,34014,340141524,Formosa,FORMOSA,213,225,394,343,737
34,34014,340141525,Formosa,FORMOSA,284,324,557,494,1051
34,34014,340141526,Formosa,FORMOSA,189,218,343,306,649
34,34014,340141527,Formosa,FORMOSA,207,237,386,320,706
34,34014,340141528,Formosa,FORMOSA,266,250,540,489,1029
34,34014,340141601,Formosa,FORMOSA,205,219,421,424,845
34,34014,340141602,Formosa,FORMOSA,370,368,737,706,1443
34,34014,340141603,Formosa,FORMOSA,189,183,381,320,701
34,34014,340141604,Formosa,FORMOSA,220,213,445,398,843
34,34014,340141605,Formosa,FORMOSA,336,320,618,670,1288
34,34014,340141606,Formosa,FORMOSA,352,324,661,601,1262
34,34014,340141607,Formosa,FORMOSA,235,216,488,437,925
34,34014,340141608,Formosa,FORMOSA,369,365,735,664,1399
34,34014,340141609,Formosa,FORMOSA,292,257,532,482,1014
34,34014,340141610,Formosa,FORMOSA,303,254,586,512,1098
34,34014,340141611,Formosa,FORMOSA,253,267,472,386,858
34,34014,340141612,Formosa,FORMOSA,228,221,426,394,820
34,34014,340141613,Formosa,FORMOSA,239,252,465,407,872
34,34014,340141614,Formosa,FORMOSA,195,207,326,339,665
34,34014,340141615,Formosa,FORMOSA,236,241,524,439,963
34,34014,340141616,Formosa,FORMOSA,303,292,616,527,1143
34,34014,340141617,Formosa,FORMOSA,271,222,554,474,1028
34,34014,340141618,Formosa,FORMOSA,176,112,387,357,744
34,34014,340141619,Formosa,FORMOSA,215,227,437,388,825
34,34014,340141620,Formosa,FORMOSA,251,251,500,449,949
34,34014,340141621,Formosa,FORMOSA,330,317,692,606,1298
34,34014,340141622,Formosa,FORMOSA,352,335,729,951,1680
34,34014,340141623,Formosa,FORMOSA,276,282,530,475,1005
34,34014,340141624,Formosa,FORMOSA,213,216,447,362,809
34,34014,340141625,Formosa,FORMOSA,212,218,425,392,817
34,34014,340141626,Formosa,FORMOSA,226,228,411,438,849
34,34014,340141627,Formosa,FORMOSA,202,187,420,409,829
34,34014,340141628,Formosa,FORMOSA,206,192,400,365,765
34,34014,340141701,Formosa,FORMOSA,179,172,329,341,670
34,34014,340141702,Formosa,FORMOSA,204,123,372,411,783
34,34014,340141703,Formosa,FORMOSA,240,246,500,484,984
34,34014,340141704,Formosa,FORMOSA,248,227,540,491,1031
34,34014,340141705,Formosa,FORMOSA,379,383,850,828,1678
34,34014,340141706,Formosa,FORMOSA,285,200,649,589,1238
34,34014,340141707,Formosa,FORMOSA,147,129,294,299,593
34,34014,340141708,Formosa,FORMOSA,259,226,577,544,1121
34,34014,340141709,Formosa,FORMOSA,230,203,521,434,955
34,34014,340141710,Formosa,FORMOSA,206,213,478,432,910
34,34014,340141711,Formosa,FORMOSA,247,235,541,518,1059
34,34014,340141712,Formosa,FORMOSA,257,167,514,524,1038
34,34014,340141713,Formosa,FORMOSA,111,111,168,198,366
34,34014,340141714,Formosa,FORMOSA,264,281,543,507,1050
34,34014,340141715,Formosa,FORMOSA,189,192,387,341,728
34,34014,340141716,Formosa,FORMOSA,328,359,719,701,1420
34,34014,340141717,Formosa,FORMOSA,252,259,512,493,1005
34,34014,340141801,Formosa,FORMOSA,9,13,3,20,23
34,34014,340141802,Formosa,FORMOSA,6,8,4,8,12
34,34014,340141901,Formosa,FORMOSA,32,34,29,57,86
34,34014,340141902,Formosa,FORMOSA,4,4,1,10,11
34,34014,340142001,Formosa,FORMOSA,37,46,49,69,118
34,34014,340142002,Formosa,FORMOSA,242,243,577,628,1205
34,34014,340142003,Formosa,FORMOSA,18,21,21,35,56
34,34014,340142004,Formosa,FORMOSA,260,285,477,537,1014
34,34014,340142005,Formosa,FORMOSA,24,20,35,47,82
34,34014,340142006,Formosa,FORMOSA,327,263,630,632,1262
34,34014,340142007,Formosa,FORMOSA,46,54,50,79,129
34,34014,340142008,Formosa,FORMOSA,5,5,7,7,14
34,34014,340142009,Formosa,FORMOSA,17,20,24,30,54
34,34014,340142010,Formosa,FORMOSA,2,5,2,5,7
34,34014,340142011,Formosa,FORMOSA,27,38,38,57,95
34,34014,340142012,Formosa,FORMOSA,121,28,238,219,457
34,34014,340142013,Formosa,FORMOSA,278,316,554,512,1066
34,34014,340142014,Formosa,FORMOSA,218,249,457,427,884
34,34014,340142015,Formosa,FORMOSA,330,354,670,690,1360
34,34014,340142016,Formosa,FORMOSA,253,262,599,584,1183
34,34014,340142017,Formosa,FORMOSA,225,262,437,465,902
34,34014,340142018,Formosa,FORMOSA,184,197,363,402,765
34,34014,340142019,Formosa,FORMOSA,213,200,507,541,1048
34,34014,340142020,Formosa,FORMOSA,182,207,372,369,741
34,34014,340142021,Formosa,FORMOSA,0,168,0,0,0
34,34014,340142022,Formosa,FORMOSA,1,312,0,1,1
34,34014,340142023,Formosa,FORMOSA,322,338,681,690,1371
34,34014,340142024,Formosa,FORMOSA,245,208,440,452,892
34,34014,340142025,Formosa,FORMOSA,309,328,537,507,1044
34,34014,340142026,Formosa,FORMOSA,260,287,546,519,1065
34,34014,340142027,Formosa,FORMOSA,318,333,656,664,1320
34,34014,340142101,Formosa,FORMOSA,184,93,332,386,718
34,34014,340142102,Formosa,FORMOSA,216,195,434,376,810
34,34014,340142103,Formosa,FORMOSA,274,286,487,437,924
34,34014,340142104,Formosa,FORMOSA,332,310,545,525,1070
34,34014,340142105,Formosa,FORMOSA,157,113,265,212,477
34,34014,340142106,Formosa,FORMOSA,201,137,278,215,493
34,34014,340142107,Formosa,FORMOSA,246,305,320,237,557
34,34014,340142108,Formosa,FORMOSA,229,261,328,255,583
34,34014,340142109,Formosa,FORMOSA,223,240,316,269,585
34,34014,340142110,Formosa,FORMOSA,204,221,295,250,545
34,34014,340142111,Formosa,FORMOSA,228,224,419,350,769
34,34014,340142112,Formosa,FORMOSA,164,173,255,202,457
34,34014,340142113,Formosa,FORMOSA,212,165,370,317,687
34,34014,340142114,Formosa,FORMOSA,243,247,413,340,753
34,34014,340142115,Formosa,FORMOSA,406,348,768,763,1531
34,34014,340142116,Formosa,FORMOSA,391,360,779,741,1520
34,34014,340142117,Formosa,FORMOSA,289,282,518,537,1055
34,34014,340142118,Formosa,FORMOSA,225,224,424,395,819
34,34014,340142119,Formosa,FORMOSA,268,261,540,512,1052
34,34014,340142201,Formosa,FORMOSA,219,232,468,410,878
34,34014,340142202,Formosa,FORMOSA,300,329,608,546,1154
34,34014,340142203,Formosa,FORMOSA,177,188,368,340,708
34,34014,340142204,Formosa,FORMOSA,330,357,665,657,1322
34,34014,340142205,Formosa,FORMOSA,380,396,800,754,1554
34,34014,340142206,Formosa,FORMOSA,377,327,779,712,1491
34,34014,340142207,Formosa,FORMOSA,358,347,760,748,1508
34,34014,340142208,Formosa,FORMOSA,369,360,786,806,1592
34,34014,340142209,Formosa,FORMOSA,348,318,742,711,1453
34,34014,340142210,Formosa,FORMOSA,375,374,883,836,1719
34,34014,340142211,Formosa,FORMOSA,323,311,760,741,1501
34,34014,340142212,Formosa,FORMOSA,376,378,803,774,1577
34,34014,340142213,Formosa,FORMOSA,352,354,785,706,1491
34,34014,340142214,Formosa,FORMOSA,363,365,768,763,1531
34,34014,340142215,Formosa,FORMOSA,221,204,495,450,945
34,34014,340142216,Formosa,FORMOSA,319,267,626,608,1234
34,34014,340142217,Formosa,FORMOSA,265,259,588,569,1157
34,34014,340142218,Formosa,FORMOSA,262,253,601,589,1190
34,34014,340142219,Formosa,FORMOSA,353,401,712,714,1426
34,34014,340142220,Formosa,FORMOSA,200,211,408,360,768
34,34014,340142221,Formosa,FORMOSA,182,197,359,387,746
34,34014,340142222,Formosa,FORMOSA,30,37,39,49,88
34,34021,340210101,Laishi,FORMOSA,7,10,8,10,18
34,34021,340210102,Laishi,FORMOSA,26,35,32,55,87
34,34021,340210201,Laishi,FORMOSA,137,179,268,291,559
34,34021,340210202,Laishi,FORMOSA,47,44,91,108,199
34,34021,340210203,Laishi,FORMOSA,9,14,9,15,24
34,34021,340210204,Laishi,FORMOSA,6,10,4,14,18
34,34021,340210205,Laishi,FORMOSA,5,13,6,6,12
34,34021,340210206,Laishi,FORMOSA,50,73,68,83,151
34,34021,340210207,Laishi,FORMOSA,10,17,11,18,29
34,34021,340210208,Laishi,FORMOSA,80,133,156,175,331
34,34021,340210209,Laishi,FORMOSA,34,43,41,48,89
34,34021,340210210,Laishi,FORMOSA,47,63,82,97,179
34,34021,340210211,Laishi,FORMOSA,188,188,316,314,630
34,34021,340210212,Laishi,FORMOSA,203,211,368,380,748
34,34021,340210213,Laishi,FORMOSA,280,295,591,525,1116
34,34021,340210214,Laishi,FORMOSA,302,390,669,663,1332
34,34021,340210215,Laishi,FORMOSA,151,183,272,229,501
34,34021,340210301,Laishi,FORMOSA,72,103,95,132,227
34,34021,340210302,Laishi,FORMOSA,129,189,260,280,540
34,34021,340210303,Laishi,FORMOSA,67,99,101,116,217
34,34021,340210304,Laishi,FORMOSA,185,240,354,349,703
34,34021,340210305,Laishi,FORMOSA,164,196,324,341,665
34,34021,340210306,Laishi,FORMOSA,76,119,135,161,296
34,34021,340210307,Laishi,FORMOSA,196,232,444,437,881
34,34021,340210401,Laishi,FORMOSA,11,21,13,27,40
34,34021,340210402,Laishi,FORMOSA,73,92,109,159,268
34,34021,340210403,Laishi,FORMOSA,258,312,515,541,1056
34,34021,340210501,Laishi,FORMOSA,5,7,5,7,12
34,34021,340210502,Laishi,FORMOSA,127,161,201,232,433
34,34021,340210601,Laishi,FORMOSA,50,67,90,133,223
34,34021,340210602,Laishi,FORMOSA,134,165,209,233,442
34,34021,340210603,Laishi,FORMOSA,205,251,336,349,685
34,34021,340210604,Laishi,FORMOSA,247,275,427,433,860
34,34021,340210701,Laishi,FORMOSA,18,30,19,38,57
34,34021,340210702,Laishi,FORMOSA,14,20,6,21,27
34,34021,340210703,Laishi,FORMOSA,49,53,47,105,152
34,34021,340210704,Laishi,FORMOSA,28,38,19,43,62
34,34021,340210705,Laishi,FORMOSA,7,15,7,11,18
34,34021,340210706,Laishi,FORMOSA,327,341,591,539,1130
34,34021,340210707,Laishi,FORMOSA,236,267,441,479,920
34,34021,340210708,Laishi,FORMOSA,176,197,360,392,752
34,34021,340210709,Laishi,FORMOSA,102,118,191,183,374
34,34028,340280101,Matacos,FORMOSA,167,180,291,363,654
34,34028,340280102,Matacos,FORMOSA,154,209,346,348,694
34,34028,340280103,Matacos,FORMOSA,271,335,591,557,1148
34,34028,340280104,Matacos,FORMOSA,243,279,454,421,875
34,34028,340280105,Matacos,FORMOSA,277,323,547,529,1076
34,34028,340280106,Matacos,FORMOSA,212,263,444,411,855
34,34028,340280107,Matacos,FORMOSA,205,220,522,503,1025
34,34028,340280108,Matacos,FORMOSA,163,194,313,291,604
34,34028,340280109,Matacos,FORMOSA,264,312,632,598,1230
34,34028,340280110,Matacos,FORMOSA,140,190,336,325,661
34,34028,340280111,Matacos,FORMOSA,118,179,256,257,513
34,34028,340280112,Matacos,FORMOSA,169,204,389,333,722
34,34028,340280113,Matacos,FORMOSA,248,333,499,513,1012
34,34028,340280114,Matacos,FORMOSA,191,221,368,345,713
34,34028,340280115,Matacos,FORMOSA,180,190,435,440,875
34,34028,340280201,Matacos,FORMOSA,233,263,580,601,1181
34,34028,340280301,Matacos,FORMOSA,99,107,183,234,417
34,34028,340280302,Matacos,FORMOSA,29,42,51,69,120
34,34035,340350101,Patiño,FORMOSA,247,259,419,458,877
34,34035,340350102,Patiño,FORMOSA,59,71,72,115,187
34,34035,340350103,Patiño,FORMOSA,154,183,277,290,567
34,34035,340350104,Patiño,FORMOSA,29,34,13,47,60
34,34035,340350105,Patiño,FORMOSA,47,61,55,86,141
34,34035,340350106,Patiño,FORMOSA,157,177,336,375,711
34,34035,340350107,Patiño,FORMOSA,6,6,2,18,20
34,34035,340350108,Patiño,FORMOSA,200,211,488,519,1007
34,34035,340350201,Patiño,FORMOSA,179,193,367,423,790
34,34035,340350202,Patiño,FORMOSA,71,86,95,121,216
34,34035,340350203,Patiño,FORMOSA,157,219,201,254,455
34,34035,340350204,Patiño,FORMOSA,91,125,133,166,299
34,34035,340350205,Patiño,FORMOSA,24,41,25,45,70
34,34035,340350206,Patiño,FORMOSA,94,117,102,165,267
34,34035,340350207,Patiño,FORMOSA,5,7,10,10,20
34,34035,340350301,Patiño,FORMOSA,206,228,462,503,965
34,34035,340350302,Patiño,FORMOSA,25,48,29,39,68
34,34035,340350303,Patiño,FORMOSA,110,136,150,215,365
34,34035,340350304,Patiño,FORMOSA,11,14,2,14,16
34,34035,340350401,Patiño,FORMOSA,14,21,13,23,36
34,34035,340350402,Patiño,FORMOSA,269,305,528,614,1142
34,34035,340350403,Patiño,FORMOSA,64,73,61,128,189
34,34035,340350404,Patiño,FORMOSA,26,36,28,63,91
34,34035,340350405,Patiño,FORMOSA,185,211,362,359,721
34,34035,340350406,Patiño,FORMOSA,116,125,206,236,442
34,34035,340350501,Patiño,FORMOSA,455,525,777,880,1657
34,34035,340350502,Patiño,FORMOSA,29,42,28,46,74
34,34035,340350503,Patiño,FORMOSA,2,6,0,2,2
34,34035,340350601,Patiño,FORMOSA,106,134,187,224,411
34,34035,340350602,Patiño,FORMOSA,166,166,281,325,606
34,34035,340350603,Patiño,FORMOSA,155,168,197,275,472
34,34035,340350604,Patiño,FORMOSA,180,209,355,328,683
34,34035,340350605,Patiño,FORMOSA,143,168,261,246,507
34,34035,340350606,Patiño,FORMOSA,165,184,301,299,600
34,34035,340350607,Patiño,FORMOSA,198,227,371,396,767
34,34035,340350608,Patiño,FORMOSA,171,200,287,282,569
34,34035,340350609,Patiño,FORMOSA,142,178,287,307,594
34,34035,340350610,Patiño,FORMOSA,119,187,241,240,481
34,34035,340350611,Patiño,FORMOSA,293,363,537,527,1064
34,34035,340350612,Patiño,FORMOSA,301,344,608,554,1162
34,34035,340350613,Patiño,FORMOSA,217,250,415,368,783
34,34035,340350614,Patiño,FORMOSA,125,149,216,225,441
34,34035,340350615,Patiño,FORMOSA,142,177,309,286,595
34,34035,340350701,Patiño,FORMOSA,111,128,203,287,490
34,34035,340350702,Patiño,FORMOSA,157,201,230,313,543
34,34035,340350703,Patiño,FORMOSA,173,207,233,329,562
34,34035,340350704,Patiño,FORMOSA,316,349,542,504,1046
34,34035,340350705,Patiño,FORMOSA,236,302,401,412,813
34,34035,340350706,Patiño,FORMOSA,155,192,241,238,479
34,34035,340350707,Patiño,FORMOSA,220,254,380,401,781
34,34035,340350801,Patiño,FORMOSA,123,166,245,219,464
34,34035,340350802,Patiño,FORMOSA,231,261,440,376,816
34,34035,340350803,Patiño,FORMOSA,210,266,437,408,845
34,34035,340350804,Patiño,FORMOSA,246,282,399,413,812
34,34035,340350805,Patiño,FORMOSA,281,327,526,486,1012
34,34035,340350806,Patiño,FORMOSA,176,210,290,284,574
34,34035,340350901,Patiño,FORMOSA,168,194,287,279,566
34,34035,340350902,Patiño,FORMOSA,200,232,357,327,684
34,34035,340350903,Patiño,FORMOSA,272,309,437,427,864
34,34035,340350904,Patiño,FORMOSA,234,291,389,336,725
34,34035,340350905,Patiño,FORMOSA,169,198,302,264,566
34,34035,340350906,Patiño,FORMOSA,310,382,546,548,1094
34,34035,340350907,Patiño,FORMOSA,206,245,399,389,788
34,34035,340350908,Patiño,FORMOSA,250,277,401,379,780
34,34035,340350909,Patiño,FORMOSA,293,359,575,527,1102
34,34035,340350910,Patiño,FORMOSA,155,187,282,284,566
34,34035,340350911,Patiño,FORMOSA,180,285,317,367,684
34,34035,340351001,Patiño,FORMOSA,174,197,322,314,636
34,34035,340351002,Patiño,FORMOSA,295,329,576,514,1090
34,34035,340351003,Patiño,FORMOSA,215,266,341,340,681
34,34035,340351004,Patiño,FORMOSA,323,341,606,565,1171
34,34035,340351005,Patiño,FORMOSA,203,246,343,321,664
34,34035,340351006,Patiño,FORMOSA,197,241,339,350,689
34,34035,340351007,Patiño,FORMOSA,156,180,281,241,522
34,34035,340351101,Patiño,FORMOSA,72,28,117,161,278
34,34035,340351102,Patiño,FORMOSA,29,30,47,67,114
34,34035,340351103,Patiño,FORMOSA,223,248,421,506,927
34,34035,340351104,Patiño,FORMOSA,184,211,322,335,657
34,34035,340351105,Patiño,FORMOSA,166,201,278,325,603
34,34035,340351201,Patiño,FORMOSA,309,338,575,563,1138
34,34035,340351202,Patiño,FORMOSA,323,356,582,528,1110
34,34035,340351203,Patiño,FORMOSA,265,287,425,413,838
34,34035,340351204,Patiño,FORMOSA,178,199,330,273,603
34,34035,340351205,Patiño,FORMOSA,278,288,472,427,899
34,34035,340351206,Patiño,FORMOSA,200,217,361,450,811
34,34035,340351207,Patiño,FORMOSA,284,322,632,593,1225
34,34035,340351208,Patiño,FORMOSA,166,177,292,279,571
34,34035,340351209,Patiño,FORMOSA,153,201,305,306,611
34,34035,340351210,Patiño,FORMOSA,97,149,187,180,367
34,34035,340351301,Patiño,FORMOSA,43,43,93,114,207
34,34035,340351302,Patiño,FORMOSA,26,34,20,33,53
34,34035,340351303,Patiño,FORMOSA,24,29,39,48,87
34,34035,340351401,Patiño,FORMOSA,56,76,60,93,153
34,34035,340351402,Patiño,FORMOSA,46,65,65,90,155
34,34035,340351403,Patiño,FORMOSA,33,43,49,62,111
34,34035,340351501,Patiño,FORMOSA,2,2,1,5,6
34,34035,340351502,Patiño,FORMOSA,83,106,153,160,313
34,34035,340351503,Patiño,FORMOSA,104,121,177,196,373
34,34035,340351601,Patiño,FORMOSA,88,112,167,190,357
34,34035,340351701,Patiño,FORMOSA,36,48,25,72,97
34,34035,340351702,Patiño,FORMOSA,19,23,15,44,59
34,34035,340351703,Patiño,FORMOSA,8,13,5,17,22
34,34035,340351704,Patiño,FORMOSA,18,20,10,33,43
34,34035,340351801,Patiño,FORMOSA,134,153,230,314,544
34,34035,340351802,Patiño,FORMOSA,121,129,247,260,507
34,34035,340351803,Patiño,FORMOSA,49,60,83,126,209
34,34035,340351804,Patiño,FORMOSA,49,52,69,95,164
34,34035,340351805,Patiño,FORMOSA,129,160,241,261,502
34,34035,340351806,Patiño,FORMOSA,175,188,304,306,610
34,34035,340351807,Patiño,FORMOSA,155,180,299,264,563
34,34035,340351808,Patiño,FORMOSA,222,232,368,406,774
34,34035,340351809,Patiño,FORMOSA,133,113,328,338,666
34,34035,340351810,Patiño,FORMOSA,134,175,243,257,500
34,34035,340351811,Patiño,FORMOSA,123,126,285,260,545
34,34035,340351812,Patiño,FORMOSA,95,99,175,182,357
34,34035,340351901,Patiño,FORMOSA,42,61,49,83,132
34,34035,340351902,Patiño,FORMOSA,43,55,51,89,140
34,34035,340351903,Patiño,FORMOSA,109,110,148,218,366
34,34035,340351904,Patiño,FORMOSA,179,214,346,350,696
34,34035,340351905,Patiño,FORMOSA,221,250,358,390,748
34,34035,340351906,Patiño,FORMOSA,244,319,444,467,911
34,34035,340351907,Patiño,FORMOSA,121,126,294,281,575
34,34035,340351908,Patiño,FORMOSA,202,205,389,378,767
34,34035,340351909,Patiño,FORMOSA,49,74,99,83,182
34,34035,340352001,Patiño,FORMOSA,64,74,91,117,208
34,34035,340352002,Patiño,FORMOSA,105,126,142,203,345
34,34035,340352003,Patiño,FORMOSA,48,63,81,104,185
34,34035,340352101,Patiño,FORMOSA,35,35,39,67,106
34,34035,340352102,Patiño,FORMOSA,11,19,6,26,32
34,34035,340352103,Patiño,FORMOSA,61,72,59,101,160
34,34042,340420101,Pilagás,FORMOSA,39,39,58,81,139
34,34042,340420102,Pilagás,FORMOSA,168,179,319,345,664
34,34042,340420103,Pilagás,FORMOSA,64,74,111,148,259
34,34042,340420104,Pilagás,FORMOSA,157,194,273,330,603
34,34042,340420105,Pilagás,FORMOSA,191,216,323,431,754
34,34042,340420106,Pilagás,FORMOSA,110,117,242,262,504
34,34042,340420107,Pilagás,FORMOSA,125,190,237,239,476
34,34042,340420108,Pilagás,FORMOSA,143,260,228,240,468
34,34042,340420109,Pilagás,FORMOSA,330,416,667,651,1318
34,34042,340420110,Pilagás,FORMOSA,265,322,518,508,1026
34,34042,340420111,Pilagás,FORMOSA,330,384,598,527,1125
34,34042,340420112,Pilagás,FORMOSA,97,103,183,195,378
34,34042,340420201,Pilagás,FORMOSA,14,16,20,34,54
34,34042,340420202,Pilagás,FORMOSA,80,87,161,177,338
34,34042,340420203,Pilagás,FORMOSA,37,40,55,69,124
34,34042,340420204,Pilagás,FORMOSA,275,357,502,575,1077
34,34042,340420205,Pilagás,FORMOSA,241,281,435,443,878
34,34042,340420301,Pilagás,FORMOSA,92,105,159,194,353
34,34042,340420302,Pilagás,FORMOSA,13,17,13,25,38
34,34042,340420303,Pilagás,FORMOSA,165,193,309,357,666
34,34042,340420304,Pilagás,FORMOSA,25,32,39,43,82
34,34042,340420305,Pilagás,FORMOSA,332,396,596,653,1249
34,34042,340420306,Pilagás,FORMOSA,262,333,492,450,942
34,34042,340420307,Pilagás,FORMOSA,150,225,331,325,656
34,34042,340420401,Pilagás,FORMOSA,144,168,225,342,567
34,34042,340420402,Pilagás,FORMOSA,16,22,15,26,41
34,34042,340420403,Pilagás,FORMOSA,13,15,7,20,27
34,34042,340420501,Pilagás,FORMOSA,167,172,408,432,840
34,34042,340420502,Pilagás,FORMOSA,24,25,33,55,88
34,34042,340420503,Pilagás,FORMOSA,10,16,9,13,22
34,34042,340420504,Pilagás,FORMOSA,245,303,432,477,909
34,34042,340420505,Pilagás,FORMOSA,253,292,480,486,966
34,34042,340420506,Pilagás,FORMOSA,217,253,396,372,768
34,34049,340490101,Pilcomayo,FORMOSA,245,286,532,543,1075
34,34049,340490102,Pilcomayo,FORMOSA,374,389,790,704,1494
34,34049,340490103,Pilcomayo,FORMOSA,276,241,538,492,1030
34,34049,340490104,Pilcomayo,FORMOSA,224,247,399,366,765
34,34049,340490105,Pilcomayo,FORMOSA,180,200,432,402,834
34,34049,340490106,Pilcomayo,FORMOSA,304,331,651,547,1198
34,34049,340490107,Pilcomayo,FORMOSA,229,245,443,392,835
34,34049,340490108,Pilcomayo,FORMOSA,257,236,513,408,921
34,34049,340490109,Pilcomayo,FORMOSA,390,422,791,671,1462
34,34049,340490110,Pilcomayo,FORMOSA,262,246,501,463,964
34,34049,340490111,Pilcomayo,FORMOSA,255,286,481,358,839
34,34049,340490112,Pilcomayo,FORMOSA,199,218,399,315,714
34,34049,340490113,Pilcomayo,FORMOSA,235,247,546,406,952
34,34049,340490114,Pilcomayo,FORMOSA,404,379,898,860,1758
34,34049,340490115,Pilcomayo,FORMOSA,326,319,807,716,1523
34,34049,340490116,Pilcomayo,FORMOSA,249,270,470,469,939
34,34049,340490117,Pilcomayo,FORMOSA,262,270,470,459,929
34,34049,340490118,Pilcomayo,FORMOSA,220,213,442,415,857
34,34049,340490119,Pilcomayo,FORMOSA,328,312,728,608,1336
34,34049,340490120,Pilcomayo,FORMOSA,275,303,575,565,1140
34,34049,340490121,Pilcomayo,FORMOSA,318,341,704,634,1338
34,34049,340490122,Pilcomayo,FORMOSA,323,330,662,615,1277
34,34049,340490123,Pilcomayo,FORMOSA,239,227,493,445,938
34,34049,340490124,Pilcomayo,FORMOSA,307,321,685,706,1391
34,34049,340490125,Pilcomayo,FORMOSA,260,269,556,553,1109
34,34049,340490126,Pilcomayo,FORMOSA,194,195,454,407,861
34,34049,340490127,Pilcomayo,FORMOSA,148,151,311,317,628
34,34049,340490128,Pilcomayo,FORMOSA,237,241,429,364,793
34,34049,340490201,Pilcomayo,FORMOSA,3,4,1,3,4
34,34049,340490301,Pilcomayo,FORMOSA,13,22,5,23,28
34,34049,340490302,Pilcomayo,FORMOSA,148,155,280,318,598
34,34049,340490303,Pilcomayo,FORMOSA,34,40,90,81,171
34,34049,340490304,Pilcomayo,FORMOSA,43,47,90,80,170
34,34049,340490305,Pilcomayo,FORMOSA,43,45,82,90,172
34,34049,340490306,Pilcomayo,FORMOSA,65,65,138,152,290
34,34049,340490401,Pilcomayo,FORMOSA,33,44,42,70,112
34,34049,340490402,Pilcomayo,FORMOSA,31,31,60,60,120
34,34049,340490403,Pilcomayo,FORMOSA,168,177,318,321,639
34,34049,340490501,Pilcomayo,FORMOSA,16,19,18,34,52
34,34049,340490601,Pilcomayo,FORMOSA,101,106,152,204,356
34,34049,340490602,Pilcomayo,FORMOSA,230,257,383,433,816
34,34049,340490603,Pilcomayo,FORMOSA,196,223,307,382,689
34,34049,340490604,Pilcomayo,FORMOSA,104,151,171,185,356
34,34049,340490605,Pilcomayo,FORMOSA,9,12,16,14,30
34,34049,340490606,Pilcomayo,FORMOSA,71,70,135,146,281
34,34049,340490607,Pilcomayo,FORMOSA,16,26,10,33,43
34,34049,340490608,Pilcomayo,FORMOSA,12,13,5,15,20
34,34049,340490609,Pilcomayo,FORMOSA,92,74,168,207,375
34,34049,340490610,Pilcomayo,FORMOSA,303,364,579,564,1143
34,34049,340490611,Pilcomayo,FORMOSA,164,177,248,258,506
34,34049,340490612,Pilcomayo,FORMOSA,254,331,512,493,1005
34,34049,340490613,Pilcomayo,FORMOSA,188,223,331,319,650
34,34049,340490614,Pilcomayo,FORMOSA,212,252,390,356,746
34,34049,340490701,Pilcomayo,FORMOSA,230,252,345,435,780
34,34049,340490702,Pilcomayo,FORMOSA,101,80,154,204,358
34,34049,340490703,Pilcomayo,FORMOSA,414,495,705,757,1462
34,34049,340490704,Pilcomayo,FORMOSA,178,164,319,325,644
34,34049,340490705,Pilcomayo,FORMOSA,39,45,84,77,161
34,34049,340490706,Pilcomayo,FORMOSA,177,161,314,352,666
34,34049,340490707,Pilcomayo,FORMOSA,32,33,46,58,104
34,34049,340490708,Pilcomayo,FORMOSA,163,184,291,332,623
34,34049,340490709,Pilcomayo,FORMOSA,62,109,112,128,240
34,34049,340490710,Pilcomayo,FORMOSA,164,210,308,278,586
34,34049,340490801,Pilcomayo,FORMOSA,236,229,436,456,892
34,34049,340490802,Pilcomayo,FORMOSA,93,102,161,177,338
34,34049,340490803,Pilcomayo,FORMOSA,111,126,189,205,394
34,34049,340490804,Pilcomayo,FORMOSA,569,607,1180,1232,2412
34,34049,340490805,Pilcomayo,FORMOSA,574,638,971,1129,2100
34,34049,340490806,Pilcomayo,FORMOSA,294,337,488,477,965
34,34049,340490807,Pilcomayo,FORMOSA,160,198,298,287,585
34,34049,340490808,Pilcomayo,FORMOSA,175,205,353,322,675
34,34049,340490901,Pilcomayo,FORMOSA,118,132,224,269,493
34,34049,340490902,Pilcomayo,FORMOSA,306,337,572,608,1180
34,34049,340490903,Pilcomayo,FORMOSA,215,252,387,423,810
34,34049,340490904,Pilcomayo,FORMOSA,10,16,13,17,30
34,34049,340491001,Pilcomayo,FORMOSA,6,6,5,12,17
34,34049,340491002,Pilcomayo,FORMOSA,54,47,98,118,216
34,34049,340491003,Pilcomayo,FORMOSA,268,268,548,579,1127
34,34049,340491004,Pilcomayo,FORMOSA,304,326,681,640,1321
34,34049,340491005,Pilcomayo,FORMOSA,336,342,688,626,1314
34,34049,340491006,Pilcomayo,FORMOSA,350,300,742,671,1413
34,34049,340491007,Pilcomayo,FORMOSA,263,272,540,485,1025
34,34049,340491008,Pilcomayo,FORMOSA,240,243,548,451,999
34,34049,340491009,Pilcomayo,FORMOSA,258,271,541,443,984
34,34049,340491010,Pilcomayo,FORMOSA,353,386,752,677,1429
34,34049,340491011,Pilcomayo,FORMOSA,226,212,470,468,938
34,34049,340491012,Pilcomayo,FORMOSA,318,265,664,664,1328
34,34049,340491013,Pilcomayo,FORMOSA,264,269,574,543,1117
34,34049,340491014,Pilcomayo,FORMOSA,261,272,553,563,1116
34,34049,340491015,Pilcomayo,FORMOSA,237,232,496,485,981
34,34049,340491016,Pilcomayo,FORMOSA,341,333,655,560,1215
34,34049,340491017,Pilcomayo,FORMOSA,210,215,430,437,867
34,34049,340491018,Pilcomayo,FORMOSA,280,309,667,616,1283
34,34049,340491019,Pilcomayo,FORMOSA,276,282,616,613,1229
34,34049,340491020,Pilcomayo,FORMOSA,273,280,572,566,1138
34,34049,340491021,Pilcomayo,FORMOSA,261,279,564,546,1110
34,34049,340491022,Pilcomayo,FORMOSA,127,190,235,223,458
34,34049,340491023,Pilcomayo,FORMOSA,1,200,0,1,1
34,34049,340491024,Pilcomayo,FORMOSA,36,275,58,69,127
34,34049,340491101,Pilcomayo,FORMOSA,296,400,537,550,1087
34,34049,340491102,Pilcomayo,FORMOSA,140,183,242,250,492
34,34049,340491103,Pilcomayo,FORMOSA,241,292,377,380,757
34,34049,340491104,Pilcomayo,FORMOSA,239,247,488,464,952
34,34049,340491105,Pilcomayo,FORMOSA,191,224,323,299,622
34,34049,340491106,Pilcomayo,FORMOSA,301,338,570,515,1085
34,34049,340491107,Pilcomayo,FORMOSA,162,266,256,235,491
34,34049,340491108,Pilcomayo,FORMOSA,114,225,189,195,384
34,34049,340491109,Pilcomayo,FORMOSA,215,221,327,304,631
34,34056,340560101,Pirané,FORMOSA,313,361,626,594,1220
34,34056,340560102,Pirané,FORMOSA,127,156,202,226,428
34,34056,340560103,Pirané,FORMOSA,270,308,496,441,937
34,34056,340560104,Pirané,FORMOSA,300,350,482,433,915
34,34056,340560105,Pirané,FORMOSA,221,248,412,425,837
34,34056,340560106,Pirané,FORMOSA,328,361,633,585,1218
34,34056,340560107,Pirané,FORMOSA,260,301,399,332,731
34,34056,340560108,Pirané,FORMOSA,185,218,266,260,526
34,34056,340560109,Pirané,FORMOSA,252,314,449,368,817
34,34056,340560110,Pirané,FORMOSA,239,268,442,425,867
34,34056,340560111,Pirané,FORMOSA,291,311,543,492,1035
34,34056,340560112,Pirané,FORMOSA,313,385,612,630,1242
34,34056,340560113,Pirané,FORMOSA,224,270,448,428,876
34,34056,340560114,Pirané,FORMOSA,70,281,143,133,276
34,34056,340560115,Pirané,FORMOSA,144,196,298,325,623
34,34056,340560116,Pirané,FORMOSA,268,354,493,479,972
34,34056,340560117,Pirané,FORMOSA,197,325,363,345,708
34,34056,340560201,Pirané,FORMOSA,3,5,4,5,9
34,34056,340560202,Pirané,FORMOSA,169,164,292,351,643
34,34056,340560203,Pirané,FORMOSA,4,7,7,7,14
34,34056,340560204,Pirané,FORMOSA,9,10,8,13,21
34,34056,340560205,Pirané,FORMOSA,14,15,10,30,40
34,34056,340560301,Pirané,FORMOSA,76,94,96,121,217
34,34056,340560302,Pirané,FORMOSA,21,23,28,40,68
34,34056,340560303,Pirané,FORMOSA,167,204,280,314,594
34,34056,340560304,Pirané,FORMOSA,3,7,5,5,10
34,34056,340560401,Pirané,FORMOSA,11,14,14,15,29
34,34056,340560402,Pirané,FORMOSA,204,246,364,397,761
34,34056,340560403,Pirané,FORMOSA,70,80,139,157,296
34,34056,340560404,Pirané,FORMOSA,19,23,22,31,53
34,34056,340560405,Pirané,FORMOSA,255,336,429,486,915
34,34056,340560406,Pirané,FORMOSA,223,228,373,328,701
34,34056,340560407,Pirané,FORMOSA,198,258,341,302,643
34,34056,340560408,Pirané,FORMOSA,314,361,551,470,1021
34,34056,340560409,Pirané,FORMOSA,303,359,562,509,1071
34,34056,340560501,Pirané,FORMOSA,187,210,272,330,602
34,34056,340560502,Pirané,FORMOSA,111,128,187,226,413
34,34056,340560503,Pirané,FORMOSA,88,121,146,180,326
34,34056,340560504,Pirané,FORMOSA,192,246,328,333,661
34,34056,340560601,Pirané,FORMOSA,86,87,136,178,314
34,34056,340560602,Pirané,FORMOSA,71,83,105,126,231
34,34056,340560603,Pirané,FORMOSA,76,87,144,157,301
34,34056,340560604,Pirané,FORMOSA,35,42,58,65,123
34,34056,340560605,Pirané,FORMOSA,85,102,144,182,326
34,34056,340560701,Pirané,FORMOSA,213,264,323,394,717
34,34056,340560702,Pirané,FORMOSA,51,66,98,109,207
34,34056,340560703,Pirané,FORMOSA,29,38,43,43,86
34,34056,340560704,Pirané,FORMOSA,27,36,46,48,94
34,34056,340560705,Pirané,FORMOSA,228,266,453,454,907
34,34056,340560706,Pirané,FORMOSA,223,275,428,381,809
34,34056,340560707,Pirané,FORMOSA,280,319,488,453,941
34,34056,340560708,Pirané,FORMOSA,318,405,582,527,1109
34,34056,340560709,Pirané,FORMOSA,185,223,297,309,606
34,34056,340560801,Pirané,FORMOSA,47,63,90,102,192
34,34056,340560802,Pirané,FORMOSA,58,68,111,121,232
34,34056,340560803,Pirané,FORMOSA,15,21,19,30,49
34,34056,340560804,Pirané,FORMOSA,24,28,43,47,90
34,34056,340560805,Pirané,FORMOSA,51,68,88,109,197
34,34056,340560901,Pirané,FORMOSA,67,84,75,97,172
34,34056,340560902,Pirané,FORMOSA,45,47,93,114,207
34,34056,340560903,Pirané,FORMOSA,15,21,23,22,45
34,34056,340561001,Pirané,FORMOSA,117,138,224,263,487
34,34056,340561002,Pirané,FORMOSA,32,44,46,75,121
34,34056,340561003,Pirané,FORMOSA,93,110,166,192,358
34,34056,340561004,Pirané,FORMOSA,52,56,103,95,198
34,34056,340561005,Pirané,FORMOSA,30,33,40,49,89
34,34056,340561101,Pirané,FORMOSA,268,265,527,486,1013
34,34056,340561102,Pirané,FORMOSA,249,275,476,446,922
34,34056,340561103,Pirané,FORMOSA,202,252,341,313,654
34,34056,340561104,Pirané,FORMOSA,208,227,390,447,837
34,34056,340561105,Pirané,FORMOSA,257,287,469,432,901
34,34056,340561106,Pirané,FORMOSA,175,180,328,301,629
34,34056,340561107,Pirané,FORMOSA,198,220,344,329,673
34,34056,340561108,Pirané,FORMOSA,285,320,536,473,1009
34,34056,340561109,Pirané,FORMOSA,232,252,503,504,1007
34,34056,340561110,Pirané,FORMOSA,219,241,424,392,816
34,34056,340561111,Pirané,FORMOSA,201,217,398,324,722
34,34056,340561112,Pirané,FORMOSA,257,273,463,440,903
34,34056,340561113,Pirané,FORMOSA,192,213,349,322,671
34,34056,340561114,Pirané,FORMOSA,159,180,318,290,608
34,34056,340561115,Pirané,FORMOSA,215,253,382,359,741
34,34056,340561116,Pirané,FORMOSA,234,251,525,509,1034
34,34056,340561117,Pirané,FORMOSA,233,273,469,489,958
34,34056,340561118,Pirané,FORMOSA,208,273,389,358,747
34,34056,340561119,Pirané,FORMOSA,275,384,555,527,1082
34,34056,340561120,Pirané,FORMOSA,192,212,294,285,579
34,34056,340561121,Pirané,FORMOSA,219,262,443,451,894
34,34056,340561122,Pirané,FORMOSA,160,263,340,351,691
34,34056,340561123,Pirané,FORMOSA,123,236,275,247,522
34,34056,340561201,Pirané,FORMOSA,12,21,20,22,42
34,34056,340561202,Pirané,FORMOSA,124,124,205,212,417
34,34056,340561203,Pirané,FORMOSA,9,12,12,15,27
34,34056,340561301,Pirané,FORMOSA,56,79,71,110,181
34,34056,340561302,Pirané,FORMOSA,34,34,45,46,91
34,34056,340561401,Pirané,FORMOSA,88,107,152,180,332
34,34056,340561402,Pirané,FORMOSA,188,210,346,361,707
34,34056,340561403,Pirané,FORMOSA,38,45,50,61,111
34,34056,340561404,Pirané,FORMOSA,22,22,32,42,74
34,34056,340561405,Pirané,FORMOSA,34,34,60,61,121
34,34056,340561406,Pirané,FORMOSA,53,57,80,90,170
34,34056,340561407,Pirané,FORMOSA,60,61,83,107,190
34,34056,340561408,Pirané,FORMOSA,196,210,351,460,811
34,34056,340561409,Pirané,FORMOSA,316,340,614,677,1291
34,34056,340561501,Pirané,FORMOSA,159,172,230,297,527
34,34056,340561502,Pirané,FORMOSA,28,41,38,50,88
34,34056,340561503,Pirané,FORMOSA,71,97,122,143,265
34,34056,340561504,Pirané,FORMOSA,27,28,15,34,49
34,34056,340561505,Pirané,FORMOSA,7,7,3,11,14
34,34056,340561506,Pirané,FORMOSA,161,174,292,286,578
34,34056,340561507,Pirané,FORMOSA,184,221,340,342,682
34,34056,340561508,Pirané,FORMOSA,255,284,484,455,939
34,34056,340561509,Pirané,FORMOSA,236,271,442,381,823
34,34056,340561510,Pirané,FORMOSA,254,270,506,494,1000
34,34056,340561511,Pirané,FORMOSA,233,256,414,393,807
34,34056,340561512,Pirané,FORMOSA,266,295,525,519,1044
34,34056,340561513,Pirané,FORMOSA,212,266,390,394,784
34,34056,340561601,Pirané,FORMOSA,62,76,80,118,198
34,34056,340561602,Pirané,FORMOSA,16,23,22,34,56
34,34056,340561603,Pirané,FORMOSA,20,33,14,36,50
34,34056,340561604,Pirané,FORMOSA,64,73,109,127,236
34,34056,340561701,Pirané,FORMOSA,32,39,43,56,99
34,34056,340561702,Pirané,FORMOSA,34,37,29,72,101
34,34056,340561801,Pirané,FORMOSA,72,80,125,146,271
34,34056,340561802,Pirané,FORMOSA,61,65,83,111,194
34,34056,340561803,Pirané,FORMOSA,14,14,12,27,39
34,34063,340630101,Ramón Lista,FORMOSA,373,401,917,976,1893
34,34063,340630102,Ramón Lista,FORMOSA,456,447,1226,1294,2520
34,34063,340630201,Ramón Lista,FORMOSA,276,295,667,719,1386
34,34063,340630202,Ramón Lista,FORMOSA,378,360,854,910,1764
34,34063,340630203,Ramón Lista,FORMOSA,241,257,514,666,1180
34,34063,340630204,Ramón Lista,FORMOSA,358,352,835,818,1653
34,34063,340630205,Ramón Lista,FORMOSA,319,316,750,706,1456
34,34063,340630206,Ramón Lista,FORMOSA,192,248,364,378,742
34,34063,340630207,Ramón Lista,FORMOSA,203,257,610,550,1160
30,30008,300080101,Colón,ENTRE RÍOS,133,181,204,196,400
30,30008,300080102,Colón,ENTRE RÍOS,187,347,269,278,547
30,30008,300080103,Colón,ENTRE RÍOS,184,263,286,270,556
30,30008,300080104,Colón,ENTRE RÍOS,171,232,275,240,515
30,30008,300080105,Colón,ENTRE RÍOS,170,176,293,276,569
30,30008,300080106,Colón,ENTRE RÍOS,192,266,293,265,558
30,30008,300080107,Colón,ENTRE RÍOS,116,214,165,153,318
30,30008,300080108,Colón,ENTRE RÍOS,173,238,258,225,483
30,30008,300080109,Colón,ENTRE RÍOS,209,263,338,272,610
30,30008,300080110,Colón,ENTRE RÍOS,226,283,338,313,651
30,30008,300080111,Colón,ENTRE RÍOS,294,349,449,420,869
30,30008,300080112,Colón,ENTRE RÍOS,219,274,355,274,629
30,30008,300080113,Colón,ENTRE RÍOS,188,213,284,279,563
30,30008,300080114,Colón,ENTRE RÍOS,205,253,298,286,584
30,30008,300080201,Colón,ENTRE RÍOS,150,221,228,196,424
30,30008,300080202,Colón,ENTRE RÍOS,116,161,172,111,283
30,30008,300080203,Colón,ENTRE RÍOS,138,217,260,206,466
30,30008,300080204,Colón,ENTRE RÍOS,204,292,264,236,500
30,30008,300080205,Colón,ENTRE RÍOS,206,260,309,231,540
30,30008,300080206,Colón,ENTRE RÍOS,272,331,410,320,730
30,30008,300080207,Colón,ENTRE RÍOS,334,366,498,500,998
30,30008,300080208,Colón,ENTRE RÍOS,329,347,611,630,1241
30,30008,300080209,Colón,ENTRE RÍOS,164,198,242,212,454
30,30008,300080210,Colón,ENTRE RÍOS,177,224,276,244,520
30,30008,300080211,Colón,ENTRE RÍOS,171,252,259,247,506
30,30008,300080212,Colón,ENTRE RÍOS,74,105,114,96,210
30,30008,300080213,Colón,ENTRE RÍOS,59,101,86,80,166
30,30008,300080214,Colón,ENTRE RÍOS,106,231,157,145,302
30,30008,300080215,Colón,ENTRE RÍOS,181,238,320,283,603
30,30008,300080216,Colón,ENTRE RÍOS,177,223,331,299,630
30,30008,300080301,Colón,ENTRE RÍOS,50,55,74,77,151
30,30008,300080302,Colón,ENTRE RÍOS,77,84,107,130,237
30,30008,300080303,Colón,ENTRE RÍOS,95,107,137,161,298
30,30008,300080304,Colón,ENTRE RÍOS,90,114,150,144,294
30,30008,300080305,Colón,ENTRE RÍOS,193,234,344,356,700
30,30008,300080306,Colón,ENTRE RÍOS,273,293,547,524,1071
30,30008,300080307,Colón,ENTRE RÍOS,181,231,292,298,590
30,30008,300080308,Colón,ENTRE RÍOS,260,236,430,405,835
30,30008,300080309,Colón,ENTRE RÍOS,79,82,141,108,249
30,30008,300080310,Colón,ENTRE RÍOS,218,256,369,351,720
30,30008,300080311,Colón,ENTRE RÍOS,239,305,435,413,848
30,30008,300080312,Colón,ENTRE RÍOS,202,253,356,368,724
30,30008,300080313,Colón,ENTRE RÍOS,185,216,374,392,766
30,30008,300080314,Colón,ENTRE RÍOS,102,128,138,168,306
30,30008,300080315,Colón,ENTRE RÍOS,118,188,157,198,355
30,30008,300080316,Colón,ENTRE RÍOS,28,38,37,41,78
30,30008,300080317,Colón,ENTRE RÍOS,60,74,80,108,188
30,30008,300080318,Colón,ENTRE RÍOS,55,73,78,85,163
30,30008,300080319,Colón,ENTRE RÍOS,54,78,66,89,155
30,30008,300080401,Colón,ENTRE RÍOS,166,171,274,280,554
30,30008,300080402,Colón,ENTRE RÍOS,362,382,602,601,1203
30,30008,300080403,Colón,ENTRE RÍOS,326,345,486,476,962
30,30008,300080404,Colón,ENTRE RÍOS,326,351,512,533,1045
30,30008,300080405,Colón,ENTRE RÍOS,338,406,559,548,1107
30,30008,300080406,Colón,ENTRE RÍOS,382,421,573,576,1149
30,30008,300080407,Colón,ENTRE RÍOS,158,178,262,260,522
30,30008,300080408,Colón,ENTRE RÍOS,247,280,358,358,716
30,30008,300080409,Colón,ENTRE RÍOS,284,328,407,310,717
30,30008,300080410,Colón,ENTRE RÍOS,331,385,488,511,999
30,30008,300080411,Colón,ENTRE RÍOS,273,300,457,408,865
30,30008,300080412,Colón,ENTRE RÍOS,426,453,663,663,1326
30,30008,300080413,Colón,ENTRE RÍOS,176,190,260,242,502
30,30008,300080501,Colón,ENTRE RÍOS,41,52,60,61,121
30,30008,300080502,Colón,ENTRE RÍOS,69,84,92,123,215
30,30008,300080503,Colón,ENTRE RÍOS,75,93,97,131,228
30,30008,300080504,Colón,ENTRE RÍOS,156,158,262,275,537
30,30008,300080505,Colón,ENTRE RÍOS,55,61,98,98,196
30,30008,300080506,Colón,ENTRE RÍOS,352,373,639,657,1296
30,30008,300080507,Colón,ENTRE RÍOS,336,366,614,607,1221
30,30008,300080508,Colón,ENTRE RÍOS,351,403,645,653,1298
30,30008,300080509,Colón,ENTRE RÍOS,175,235,277,296,573
30,30008,300080510,Colón,ENTRE RÍOS,199,164,315,290,605
30,30008,300080511,Colón,ENTRE RÍOS,70,215,109,112,221
30,30008,300080601,Colón,ENTRE RÍOS,292,410,419,447,866
30,30008,300080602,Colón,ENTRE RÍOS,353,394,555,568,1123
30,30008,300080603,Colón,ENTRE RÍOS,186,213,290,293,583
30,30008,300080604,Colón,ENTRE RÍOS,295,334,430,414,844
30,30008,300080605,Colón,ENTRE RÍOS,367,426,557,518,1075
30,30008,300080606,Colón,ENTRE RÍOS,334,386,431,410,841
30,30008,300080607,Colón,ENTRE RÍOS,304,329,435,372,807
30,30008,300080608,Colón,ENTRE RÍOS,369,425,547,530,1077
30,30008,300080609,Colón,ENTRE RÍOS,182,203,249,235,484
30,30008,300080610,Colón,ENTRE RÍOS,225,246,304,325,629
30,30008,300080611,Colón,ENTRE RÍOS,340,367,492,436,928
30,30008,300080612,Colón,ENTRE RÍOS,265,326,389,377,766
30,30008,300080701,Colón,ENTRE RÍOS,7,10,7,14,21
30,30008,300080702,Colón,ENTRE RÍOS,31,45,49,50,99
30,30008,300080703,Colón,ENTRE RÍOS,97,148,141,164,305
30,30008,300080704,Colón,ENTRE RÍOS,10,12,22,18,40
30,30008,300080705,Colón,ENTRE RÍOS,58,71,90,97,187
30,30008,300080706,Colón,ENTRE RÍOS,16,16,25,26,51
30,30008,300080707,Colón,ENTRE RÍOS,36,46,49,50,99
30,30008,300080708,Colón,ENTRE RÍOS,20,32,20,29,49
30,30008,300080709,Colón,ENTRE RÍOS,23,30,31,35,66
30,30008,300080710,Colón,ENTRE RÍOS,22,28,34,45,79
30,30008,300080711,Colón,ENTRE RÍOS,67,117,126,117,243
30,30008,300080801,Colón,ENTRE RÍOS,17,28,24,27,51
30,30008,300080802,Colón,ENTRE RÍOS,12,17,17,24,41
30,30008,300080803,Colón,ENTRE RÍOS,10,18,12,16,28
30,30008,300080804,Colón,ENTRE RÍOS,36,44,58,59,117
30,30008,300080805,Colón,ENTRE RÍOS,24,39,34,46,80
30,30008,300080806,Colón,ENTRE RÍOS,16,24,19,26,45
30,30008,300080807,Colón,ENTRE RÍOS,90,109,141,159,300
30,30008,300080808,Colón,ENTRE RÍOS,47,51,68,92,160
30,30008,300080809,Colón,ENTRE RÍOS,15,25,23,27,50
30,30008,300080810,Colón,ENTRE RÍOS,45,55,64,69,133
30,30008,300080811,Colón,ENTRE RÍOS,37,50,41,59,100
30,30008,300080901,Colón,ENTRE RÍOS,23,31,43,34,77
30,30008,300080902,Colón,ENTRE RÍOS,23,29,26,35,61
30,30008,300080903,Colón,ENTRE RÍOS,20,33,23,38,61
30,30008,300080904,Colón,ENTRE RÍOS,8,13,15,19,34
30,30008,300080905,Colón,ENTRE RÍOS,30,44,46,48,94
30,30008,300080906,Colón,ENTRE RÍOS,70,72,78,98,176
30,30008,300080907,Colón,ENTRE RÍOS,14,17,18,21,39
30,30008,300080908,Colón,ENTRE RÍOS,5,13,4,9,13
30,30008,300080909,Colón,ENTRE RÍOS,31,42,42,58,100
30,30008,300080910,Colón,ENTRE RÍOS,224,369,351,319,670
30,30008,300081001,Colón,ENTRE RÍOS,27,31,33,49,82
30,30008,300081002,Colón,ENTRE RÍOS,23,31,24,37,61
30,30008,300081003,Colón,ENTRE RÍOS,171,207,250,239,489
30,30008,300081004,Colón,ENTRE RÍOS,17,19,26,27,53
30,30008,300081005,Colón,ENTRE RÍOS,35,39,54,70,124
30,30008,300081006,Colón,ENTRE RÍOS,16,23,18,25,43
30,30008,300081007,Colón,ENTRE RÍOS,134,159,212,224,436
30,30008,300081008,Colón,ENTRE RÍOS,22,42,19,37,56
30,30008,300081009,Colón,ENTRE RÍOS,10,17,7,17,24
30,30008,300081101,Colón,ENTRE RÍOS,34,41,38,56,94
30,30008,300081102,Colón,ENTRE RÍOS,23,25,42,47,89
30,30008,300081103,Colón,ENTRE RÍOS,27,37,34,65,99
30,30008,300081104,Colón,ENTRE RÍOS,16,25,18,40,58
30,30008,300081105,Colón,ENTRE RÍOS,39,54,59,62,121
30,30008,300081106,Colón,ENTRE RÍOS,4,8,4,10,14
30,30008,300081107,Colón,ENTRE RÍOS,23,26,26,33,59
30,30008,300081108,Colón,ENTRE RÍOS,224,216,376,404,780
30,30008,300081109,Colón,ENTRE RÍOS,112,112,157,187,344
30,30008,300081110,Colón,ENTRE RÍOS,417,386,724,835,1559
30,30008,300081111,Colón,ENTRE RÍOS,134,146,277,274,551
30,30008,300081201,Colón,ENTRE RÍOS,1,1,0,1,1
30,30015,300150101,Concordia,ENTRE RÍOS,388,401,719,777,1496
30,30015,300150102,Concordia,ENTRE RÍOS,349,329,744,697,1441
30,30015,300150103,Concordia,ENTRE RÍOS,509,474,1181,1184,2365
30,30015,300150104,Concordia,ENTRE RÍOS,458,413,1015,997,2012
30,30015,300150105,Concordia,ENTRE RÍOS,329,304,706,692,1398
30,30015,300150106,Concordia,ENTRE RÍOS,407,394,861,888,1749
30,30015,300150107,Concordia,ENTRE RÍOS,346,330,715,739,1454
30,30015,300150108,Concordia,ENTRE RÍOS,286,269,590,563,1153
30,30015,300150109,Concordia,ENTRE RÍOS,292,288,568,504,1072
30,30015,300150110,Concordia,ENTRE RÍOS,197,172,440,410,850
30,30015,300150111,Concordia,ENTRE RÍOS,485,469,984,991,1975
30,30015,300150112,Concordia,ENTRE RÍOS,346,345,728,735,1463
30,30015,300150113,Concordia,ENTRE RÍOS,425,431,794,847,1641
30,30015,300150201,Concordia,ENTRE RÍOS,411,427,823,760,1583
30,30015,300150202,Concordia,ENTRE RÍOS,271,275,511,482,993
30,30015,300150203,Concordia,ENTRE RÍOS,274,273,543,560,1103
30,30015,300150204,Concordia,ENTRE RÍOS,337,305,708,741,1449
30,30015,300150205,Concordia,ENTRE RÍOS,477,457,975,927,1902
30,30015,300150206,Concordia,ENTRE RÍOS,337,346,586,566,1152
30,30015,300150207,Concordia,ENTRE RÍOS,195,187,316,303,619
30,30015,300150208,Concordia,ENTRE RÍOS,349,359,603,571,1174
30,30015,300150209,Concordia,ENTRE RÍOS,416,404,725,693,1418
30,30015,300150210,Concordia,ENTRE RÍOS,422,421,834,845,1679
30,30015,300150211,Concordia,ENTRE RÍOS,334,324,652,584,1236
30,30015,300150212,Concordia,ENTRE RÍOS,401,401,726,720,1446
30,30015,300150213,Concordia,ENTRE RÍOS,406,428,731,645,1376
30,30015,300150214,Concordia,ENTRE RÍOS,236,269,368,342,710
30,30015,300150301,Concordia,ENTRE RÍOS,281,295,481,437,918
30,30015,300150302,Concordia,ENTRE RÍOS,354,365,556,510,1066
30,30015,300150303,Concordia,ENTRE RÍOS,424,431,732,633,1365
30,30015,300150304,Concordia,ENTRE RÍOS,349,383,584,524,1108
30,30015,300150305,Concordia,ENTRE RÍOS,380,390,776,760,1536
30,30015,300150306,Concordia,ENTRE RÍOS,52,59,85,87,172
30,30015,300150307,Concordia,ENTRE RÍOS,106,119,164,151,315
30,30015,300150308,Concordia,ENTRE RÍOS,388,429,680,670,1350
30,30015,300150309,Concordia,ENTRE RÍOS,332,323,638,690,1328
30,30015,300150310,Concordia,ENTRE RÍOS,228,220,407,406,813
30,30015,300150401,Concordia,ENTRE RÍOS,287,277,466,478,944
30,30015,300150402,Concordia,ENTRE RÍOS,189,198,297,232,529
30,30015,300150403,Concordia,ENTRE RÍOS,334,365,553,461,1014
30,30015,300150404,Concordia,ENTRE RÍOS,309,325,521,455,976
30,30015,300150405,Concordia,ENTRE RÍOS,322,331,594,580,1174
30,30015,300150406,Concordia,ENTRE RÍOS,386,400,659,575,1234
30,30015,300150407,Concordia,ENTRE RÍOS,328,343,575,536,1111
30,30015,300150408,Concordia,ENTRE RÍOS,312,339,599,565,1164
30,30015,300150409,Concordia,ENTRE RÍOS,240,249,460,429,889
30,30015,300150410,Concordia,ENTRE RÍOS,318,242,592,571,1163
30,30015,300150411,Concordia,ENTRE RÍOS,441,425,890,880,1770
30,30015,300150412,Concordia,ENTRE RÍOS,412,393,833,780,1613
30,30015,300150413,Concordia,ENTRE RÍOS,422,437,723,672,1395
30,30015,300150414,Concordia,ENTRE RÍOS,263,308,356,302,658
30,30015,300150415,Concordia,ENTRE RÍOS,119,132,195,170,365
30,30015,300150416,Concordia,ENTRE RÍOS,441,484,612,574,1186
30,30015,300150501,Concordia,ENTRE RÍOS,185,222,266,214,480
30,30015,300150502,Concordia,ENTRE RÍOS,393,424,615,460,1075
30,30015,300150503,Concordia,ENTRE RÍOS,215,233,348,288,636
30,30015,300150504,Concordia,ENTRE RÍOS,206,209,343,274,617
30,30015,300150505,Concordia,ENTRE RÍOS,185,192,359,376,735
30,30015,300150506,Concordia,ENTRE RÍOS,267,275,461,409,870
30,30015,300150507,Concordia,ENTRE RÍOS,256,269,486,479,965
30,30015,300150508,Concordia,ENTRE RÍOS,249,244,459,464,923
30,30015,300150509,Concordia,ENTRE RÍOS,276,281,485,483,968
30,30015,300150510,Concordia,ENTRE RÍOS,188,201,331,269,600
30,30015,300150511,Concordia,ENTRE RÍOS,188,174,308,268,576
30,30015,300150512,Concordia,ENTRE RÍOS,159,174,243,187,430
30,30015,300150513,Concordia,ENTRE RÍOS,166,178,244,199,443
30,30015,300150514,Concordia,ENTRE RÍOS,146,216,218,152,370
30,30015,300150515,Concordia,ENTRE RÍOS,221,254,313,235,548
30,30015,300150516,Concordia,ENTRE RÍOS,185,272,255,216,471
30,30015,300150517,Concordia,ENTRE RÍOS,208,293,290,227,517
30,30015,300150518,Concordia,ENTRE RÍOS,149,178,223,192,415
30,30015,300150519,Concordia,ENTRE RÍOS,197,235,272,216,488
30,30015,300150520,Concordia,ENTRE RÍOS,223,238,376,345,721
30,30015,300150521,Concordia,ENTRE RÍOS,113,120,182,173,355
30,30015,300150522,Concordia,ENTRE RÍOS,384,370,726,690,1416
30,30015,300150601,Concordia,ENTRE RÍOS,352,348,728,756,1484
30,30015,300150602,Concordia,ENTRE RÍOS,206,212,413,387,800
30,30015,300150603,Concordia,ENTRE RÍOS,474,428,1004,922,1926
30,30015,300150604,Concordia,ENTRE RÍOS,418,412,787,692,1479
30,30015,300150605,Concordia,ENTRE RÍOS,150,177,226,218,444
30,30015,300150606,Concordia,ENTRE RÍOS,264,270,463,413,876
30,30015,300150607,Concordia,ENTRE RÍOS,340,366,539,448,987
30,30015,300150608,Concordia,ENTRE RÍOS,245,283,355,294,649
30,30015,300150609,Concordia,ENTRE RÍOS,254,311,379,294,673
30,30015,300150610,Concordia,ENTRE RÍOS,230,296,320,270,590
30,30015,300150611,Concordia,ENTRE RÍOS,171,245,253,175,428
30,30015,300150612,Concordia,ENTRE RÍOS,196,237,294,248,542
30,30015,300150613,Concordia,ENTRE RÍOS,357,348,596,539,1135
30,30015,300150614,Concordia,ENTRE RÍOS,449,449,755,626,1381
30,30015,300150615,Concordia,ENTRE RÍOS,228,240,375,313,688
30,30015,300150616,Concordia,ENTRE RÍOS,301,306,517,440,957
30,30015,300150617,Concordia,ENTRE RÍOS,268,298,457,368,825
30,30015,300150618,Concordia,ENTRE RÍOS,124,157,190,150,340
30,30015,300150619,Concordia,ENTRE RÍOS,213,243,328,241,569
30,30015,300150620,Concordia,ENTRE RÍOS,112,155,162,127,289
30,30015,300150621,Concordia,ENTRE RÍOS,136,208,159,116,275
30,30015,300150701,Concordia,ENTRE RÍOS,269,253,480,486,966
30,30015,300150702,Concordia,ENTRE RÍOS,169,178,274,227,501
30,30015,300150703,Concordia,ENTRE RÍOS,195,224,266,227,493
30,30015,300150704,Concordia,ENTRE RÍOS,154,211,206,173,379
30,30015,300150705,Concordia,ENTRE RÍOS,146,218,201,148,349
30,30015,300150706,Concordia,ENTRE RÍOS,118,150,155,102,257
30,30015,300150707,Concordia,ENTRE RÍOS,168,213,231,185,416
30,30015,300150708,Concordia,ENTRE RÍOS,174,192,268,201,469
30,30015,300150709,Concordia,ENTRE RÍOS,179,187,330,294,624
30,30015,300150710,Concordia,ENTRE RÍOS,256,237,488,525,1013
30,30015,300150711,Concordia,ENTRE RÍOS,229,225,417,358,775
30,30015,300150712,Concordia,ENTRE RÍOS,247,238,539,563,1102
30,30015,300150713,Concordia,ENTRE RÍOS,197,217,330,430,760
30,30015,300150714,Concordia,ENTRE RÍOS,182,191,294,224,518
30,30015,300150715,Concordia,ENTRE RÍOS,183,180,349,310,659
30,30015,300150716,Concordia,ENTRE RÍOS,284,270,605,549,1154
30,30015,300150717,Concordia,ENTRE RÍOS,17,22,40,51,91
30,30015,300150718,Concordia,ENTRE RÍOS,421,431,812,857,1669
30,30015,300150719,Concordia,ENTRE RÍOS,387,394,820,757,1577
30,30015,300150720,Concordia,ENTRE RÍOS,131,144,267,294,561
30,30015,300150801,Concordia,ENTRE RÍOS,161,221,212,173,385
30,30015,300150802,Concordia,ENTRE RÍOS,142,216,203,166,369
30,30015,300150803,Concordia,ENTRE RÍOS,132,182,202,143,345
30,30015,300150804,Concordia,ENTRE RÍOS,149,206,216,151,367
30,30015,300150805,Concordia,ENTRE RÍOS,181,211,272,250,522
30,30015,300150806,Concordia,ENTRE RÍOS,200,200,334,320,654
30,30015,300150807,Concordia,ENTRE RÍOS,359,378,573,461,1034
30,30015,300150808,Concordia,ENTRE RÍOS,217,263,328,256,584
30,30015,300150809,Concordia,ENTRE RÍOS,177,226,273,232,505
30,30015,300150810,Concordia,ENTRE RÍOS,220,262,346,288,634
30,30015,300150811,Concordia,ENTRE RÍOS,221,252,372,287,659
30,30015,300150812,Concordia,ENTRE RÍOS,198,240,302,263,565
30,30015,300150813,Concordia,ENTRE RÍOS,5,6,17,26,43
30,30015,300150814,Concordia,ENTRE RÍOS,355,393,601,581,1182
30,30015,300150815,Concordia,ENTRE RÍOS,93,95,167,145,312
30,30015,300150901,Concordia,ENTRE RÍOS,80,101,152,150,302
30,30015,300150902,Concordia,ENTRE RÍOS,91,131,180,191,371
30,30015,300150903,Concordia,ENTRE RÍOS,23,30,39,47,86
30,30015,300150904,Concordia,ENTRE RÍOS,262,284,477,473,950
30,30015,300150905,Concordia,ENTRE RÍOS,316,332,623,587,1210
30,30015,300150906,Concordia,ENTRE RÍOS,318,296,604,637,1241
30,30015,300150907,Concordia,ENTRE RÍOS,298,347,635,594,1229
30,30015,300150908,Concordia,ENTRE RÍOS,303,314,619,620,1239
30,30015,300150909,Concordia,ENTRE RÍOS,142,166,218,228,446
30,30015,300150910,Concordia,ENTRE RÍOS,124,138,208,205,413
30,30015,300150911,Concordia,ENTRE RÍOS,14,51,24,23,47
30,30015,300151001,Concordia,ENTRE RÍOS,187,200,342,361,703
30,30015,300151002,Concordia,ENTRE RÍOS,410,438,799,709,1508
30,30015,300151003,Concordia,ENTRE RÍOS,183,196,347,349,696
30,30015,300151004,Concordia,ENTRE RÍOS,472,455,826,859,1685
30,30015,300151005,Concordia,ENTRE RÍOS,394,394,729,730,1459
30,30015,300151006,Concordia,ENTRE RÍOS,303,306,664,660,1324
30,30015,300151007,Concordia,ENTRE RÍOS,307,326,569,537,1106
30,30015,300151008,Concordia,ENTRE RÍOS,335,342,670,688,1358
30,30015,300151009,Concordia,ENTRE RÍOS,416,444,872,855,1727
30,30015,300151010,Concordia,ENTRE RÍOS,297,312,511,486,997
30,30015,300151011,Concordia,ENTRE RÍOS,398,417,812,817,1629
30,30015,300151012,Concordia,ENTRE RÍOS,441,442,1040,1030,2070
30,30015,300151013,Concordia,ENTRE RÍOS,295,300,592,633,1225
30,30015,300151101,Concordia,ENTRE RÍOS,238,350,411,443,854
30,30015,300151102,Concordia,ENTRE RÍOS,11,13,17,45,62
30,30015,300151103,Concordia,ENTRE RÍOS,224,261,346,348,694
30,30015,300151104,Concordia,ENTRE RÍOS,181,198,337,314,651
30,30015,300151105,Concordia,ENTRE RÍOS,349,364,646,663,1309
30,30015,300151106,Concordia,ENTRE RÍOS,205,220,346,311,657
30,30015,300151107,Concordia,ENTRE RÍOS,203,236,435,415,850
30,30015,300151108,Concordia,ENTRE RÍOS,234,255,506,495,1001
30,30015,300151109,Concordia,ENTRE RÍOS,54,66,82,89,171
30,30015,300151110,Concordia,ENTRE RÍOS,237,294,356,375,731
30,30015,300151111,Concordia,ENTRE RÍOS,177,197,317,450,767
30,30015,300151201,Concordia,ENTRE RÍOS,59,51,83,125,208
30,30015,300151202,Concordia,ENTRE RÍOS,33,48,51,56,107
30,30015,300151203,Concordia,ENTRE RÍOS,42,38,65,55,120
30,30015,300151204,Concordia,ENTRE RÍOS,42,45,90,88,178
30,30015,300151205,Concordia,ENTRE RÍOS,12,12,15,15,30
30,30015,300151206,Concordia,ENTRE RÍOS,29,34,48,44,92
30,30015,300151207,Concordia,ENTRE RÍOS,16,24,16,29,45
30,30015,300151208,Concordia,ENTRE RÍOS,65,70,128,133,261
30,30015,300151209,Concordia,ENTRE RÍOS,23,22,31,48,79
30,30015,300151210,Concordia,ENTRE RÍOS,48,62,57,71,128
30,30015,300151211,Concordia,ENTRE RÍOS,58,68,103,123,226
30,30015,300151212,Concordia,ENTRE RÍOS,275,304,522,519,1041
30,30015,300151213,Concordia,ENTRE RÍOS,300,356,495,531,1026
30,30015,300151214,Concordia,ENTRE RÍOS,296,360,518,495,1013
30,30015,300151301,Concordia,ENTRE RÍOS,110,178,172,874,1046
30,30015,300151302,Concordia,ENTRE RÍOS,20,27,22,126,148
30,30015,300151303,Concordia,ENTRE RÍOS,17,23,21,20,41
30,30015,300151304,Concordia,ENTRE RÍOS,306,319,576,594,1170
30,30015,300151305,Concordia,ENTRE RÍOS,140,155,266,288,554
30,30015,300151306,Concordia,ENTRE RÍOS,44,54,76,432,508
30,30015,300151307,Concordia,ENTRE RÍOS,50,59,74,81,155
30,30015,300151308,Concordia,ENTRE RÍOS,34,43,66,68,134
30,30015,300151309,Concordia,ENTRE RÍOS,15,19,18,24,42
30,30015,300151310,Concordia,ENTRE RÍOS,224,241,389,580,969
30,30015,300151311,Concordia,ENTRE RÍOS,255,290,436,439,875
30,30015,300151312,Concordia,ENTRE RÍOS,193,202,339,329,668
30,30015,300151401,Concordia,ENTRE RÍOS,11,11,14,19,33
30,30015,300151402,Concordia,ENTRE RÍOS,9,14,13,214,227
30,30015,300151403,Concordia,ENTRE RÍOS,58,58,69,105,174
30,30015,300151404,Concordia,ENTRE RÍOS,59,57,114,123,237
30,30015,300151405,Concordia,ENTRE RÍOS,22,31,32,45,77
30,30015,300151406,Concordia,ENTRE RÍOS,30,35,35,59,94
30,30015,300151407,Concordia,ENTRE RÍOS,32,39,39,57,96
30,30015,300151408,Concordia,ENTRE RÍOS,82,103,151,165,316
30,30015,300151501,Concordia,ENTRE RÍOS,57,73,94,95,189
30,30015,300151502,Concordia,ENTRE RÍOS,54,61,79,158,237
30,30015,300151503,Concordia,ENTRE RÍOS,6,9,11,14,25
30,30015,300151504,Concordia,ENTRE RÍOS,60,68,107,109,216
30,30015,300151505,Concordia,ENTRE RÍOS,57,59,79,98,177
30,30015,300151506,Concordia,ENTRE RÍOS,68,87,99,137,236
30,30015,300151507,Concordia,ENTRE RÍOS,56,76,86,103,189
30,30015,300151508,Concordia,ENTRE RÍOS,43,65,65,89,154
30,30015,300151509,Concordia,ENTRE RÍOS,34,69,39,40,79
30,30015,300151510,Concordia,ENTRE RÍOS,161,111,279,299,578
30,30015,300151511,Concordia,ENTRE RÍOS,236,245,447,432,879
30,30015,300151512,Concordia,ENTRE RÍOS,78,127,109,136,245
30,30015,300151513,Concordia,ENTRE RÍOS,87,145,149,154,303
30,30015,300151514,Concordia,ENTRE RÍOS,102,120,191,184,375
30,30015,300151515,Concordia,ENTRE RÍOS,99,158,164,187,351
30,30015,300151601,Concordia,ENTRE RÍOS,11,32,13,19,32
30,30015,300151602,Concordia,ENTRE RÍOS,51,68,83,109,192
30,30015,300151603,Concordia,ENTRE RÍOS,24,28,41,53,94
30,30015,300151604,Concordia,ENTRE RÍOS,14,16,16,22,38
30,30015,300151605,Concordia,ENTRE RÍOS,25,26,27,48,75
30,30015,300151606,Concordia,ENTRE RÍOS,131,192,215,238,453
30,30015,300151607,Concordia,ENTRE RÍOS,134,145,249,267,516
30,30021,300210101,Diamante,ENTRE RÍOS,261,284,450,367,817
30,30021,300210102,Diamante,ENTRE RÍOS,291,315,498,449,947
30,30021,300210103,Diamante,ENTRE RÍOS,44,76,68,64,132
30,30021,300210104,Diamante,ENTRE RÍOS,313,361,514,425,939
30,30021,300210105,Diamante,ENTRE RÍOS,217,229,333,263,596
30,30021,300210106,Diamante,ENTRE RÍOS,272,288,386,312,698
30,30021,300210107,Diamante,ENTRE RÍOS,283,305,475,450,925
30,30021,300210108,Diamante,ENTRE RÍOS,351,372,683,678,1361
30,30021,300210109,Diamante,ENTRE RÍOS,180,206,287,239,526
30,30021,300210110,Diamante,ENTRE RÍOS,150,169,223,178,401
30,30021,300210111,Diamante,ENTRE RÍOS,172,212,293,213,506
30,30021,300210112,Diamante,ENTRE RÍOS,206,231,362,326,688
30,30021,300210201,Diamante,ENTRE RÍOS,207,240,374,369,743
30,30021,300210202,Diamante,ENTRE RÍOS,146,167,207,178,385
30,30021,300210203,Diamante,ENTRE RÍOS,261,283,439,389,828
30,30021,300210204,Diamante,ENTRE RÍOS,28,35,38,41,79
30,30021,300210205,Diamante,ENTRE RÍOS,127,129,265,241,506
30,30021,300210206,Diamante,ENTRE RÍOS,93,99,171,155,326
30,30021,300210207,Diamante,ENTRE RÍOS,184,193,367,327,694
30,30021,300210208,Diamante,ENTRE RÍOS,168,193,263,260,523
30,30021,300210209,Diamante,ENTRE RÍOS,134,149,253,208,461
30,30021,300210210,Diamante,ENTRE RÍOS,297,347,479,384,863
30,30021,300210211,Diamante,ENTRE RÍOS,248,266,415,402,817
30,30021,300210212,Diamante,ENTRE RÍOS,358,391,639,626,1265
30,30021,300210301,Diamante,ENTRE RÍOS,59,37,102,224,326
30,30021,300210302,Diamante,ENTRE RÍOS,115,134,174,199,373
30,30021,300210303,Diamante,ENTRE RÍOS,170,185,242,215,457
30,30021,300210304,Diamante,ENTRE RÍOS,144,167,229,209,438
30,30021,300210305,Diamante,ENTRE RÍOS,140,167,254,252,506
30,30021,300210306,Diamante,ENTRE RÍOS,39,63,55,50,105
30,30021,300210307,Diamante,ENTRE RÍOS,55,72,95,72,167
30,30021,300210308,Diamante,ENTRE RÍOS,93,111,174,168,342
30,30021,300210309,Diamante,ENTRE RÍOS,160,162,341,277,618
30,30021,300210310,Diamante,ENTRE RÍOS,89,100,135,165,300
30,30021,300210311,Diamante,ENTRE RÍOS,58,70,74,96,170
30,30021,300210312,Diamante,ENTRE RÍOS,41,54,48,54,102
30,30021,300210401,Diamante,ENTRE RÍOS,144,305,223,276,499
30,30021,300210402,Diamante,ENTRE RÍOS,15,20,24,20,44
30,30021,300210403,Diamante,ENTRE RÍOS,79,97,131,151,282
30,30021,300210404,Diamante,ENTRE RÍOS,51,74,79,77,156
30,30021,300210405,Diamante,ENTRE RÍOS,163,193,260,260,520
30,30021,300210406,Diamante,ENTRE RÍOS,113,129,189,186,375
30,30021,300210407,Diamante,ENTRE RÍOS,9,34,10,15,25
30,30021,300210408,Diamante,ENTRE RÍOS,21,157,31,28,59
30,30021,300210409,Diamante,ENTRE RÍOS,59,64,91,95,186
30,30021,300210410,Diamante,ENTRE RÍOS,105,111,173,182,355
30,30021,300210501,Diamante,ENTRE RÍOS,70,218,99,98,197
30,30021,300210502,Diamante,ENTRE RÍOS,74,108,120,121,241
30,30021,300210503,Diamante,ENTRE RÍOS,31,61,59,57,116
30,30021,300210504,Diamante,ENTRE RÍOS,61,70,85,112,197
30,30021,300210505,Diamante,ENTRE RÍOS,266,332,360,374,734
30,30021,300210506,Diamante,ENTRE RÍOS,251,281,369,376,745
30,30021,300210507,Diamante,ENTRE RÍOS,204,237,333,337,670
30,30021,300210508,Diamante,ENTRE RÍOS,27,36,31,50,81
30,30021,300210509,Diamante,ENTRE RÍOS,6,25,8,11,19
30,30021,300210510,Diamante,ENTRE RÍOS,43,52,59,65,124
30,30021,300210511,Diamante,ENTRE RÍOS,46,49,75,87,162
30,30021,300210512,Diamante,ENTRE RÍOS,166,196,271,248,519
30,30021,300210601,Diamante,ENTRE RÍOS,60,69,77,97,174
30,30021,300210602,Diamante,ENTRE RÍOS,57,78,83,109,192
30,30021,300210603,Diamante,ENTRE RÍOS,41,55,63,71,134
30,30021,300210604,Diamante,ENTRE RÍOS,161,204,268,246,514
30,30021,300210605,Diamante,ENTRE RÍOS,40,49,68,61,129
30,30021,300210606,Diamante,ENTRE RÍOS,21,27,35,39,74
30,30021,300210701,Diamante,ENTRE RÍOS,10,11,22,18,40
30,30021,300210702,Diamante,ENTRE RÍOS,17,21,21,30,51
30,30021,300210703,Diamante,ENTRE RÍOS,2,3,1,3,4
30,30021,300210704,Diamante,ENTRE RÍOS,33,35,54,54,108
30,30021,300210705,Diamante,ENTRE RÍOS,16,25,15,15,30
30,30021,300210706,Diamante,ENTRE RÍOS,173,232,246,210,456
30,30021,300210707,Diamante,ENTRE RÍOS,143,174,213,210,423
30,30021,300210708,Diamante,ENTRE RÍOS,218,222,353,328,681
30,30021,300210709,Diamante,ENTRE RÍOS,262,279,376,300,676
30,30021,300210710,Diamante,ENTRE RÍOS,268,318,402,274,676
30,30021,300210711,Diamante,ENTRE RÍOS,24,36,368,263,631
30,30021,300210712,Diamante,ENTRE RÍOS,199,208,283,255,538
30,30021,300210713,Diamante,ENTRE RÍOS,132,153,200,166,366
30,30021,300210714,Diamante,ENTRE RÍOS,248,313,350,251,601
30,30021,300210715,Diamante,ENTRE RÍOS,262,265,339,334,673
30,30021,300210716,Diamante,ENTRE RÍOS,214,228,304,287,591
30,30021,300210801,Diamante,ENTRE RÍOS,14,16,22,23,45
30,30021,300210802,Diamante,ENTRE RÍOS,30,34,45,46,91
30,30021,300210803,Diamante,ENTRE RÍOS,28,37,47,48,95
30,30021,300210804,Diamante,ENTRE RÍOS,110,128,165,187,352
30,30021,300210805,Diamante,ENTRE RÍOS,20,28,31,42,73
30,30021,300210806,Diamante,ENTRE RÍOS,27,35,43,44,87
30,30021,300210807,Diamante,ENTRE RÍOS,34,59,31,63,94
30,30021,300210808,Diamante,ENTRE RÍOS,14,22,29,29,58
30,30021,300210809,Diamante,ENTRE RÍOS,32,36,63,70,133
30,30021,300210901,Diamante,ENTRE RÍOS,71,80,120,138,258
30,30021,300210902,Diamante,ENTRE RÍOS,103,111,153,147,300
30,30021,300210903,Diamante,ENTRE RÍOS,228,251,318,302,620
30,30021,300210904,Diamante,ENTRE RÍOS,141,164,198,179,377
30,30021,300210905,Diamante,ENTRE RÍOS,402,432,619,576,1195
30,30021,300210906,Diamante,ENTRE RÍOS,98,100,168,174,342
30,30021,300210907,Diamante,ENTRE RÍOS,237,242,354,333,687
30,30021,300210908,Diamante,ENTRE RÍOS,188,212,271,236,507
30,30021,300210909,Diamante,ENTRE RÍOS,205,232,311,263,574
30,30021,300210910,Diamante,ENTRE RÍOS,188,207,287,276,563
30,30021,300210911,Diamante,ENTRE RÍOS,216,242,365,347,712
30,30021,300211001,Diamante,ENTRE RÍOS,29,36,44,52,96
30,30021,300211002,Diamante,ENTRE RÍOS,153,178,268,237,505
30,30021,300211003,Diamante,ENTRE RÍOS,82,92,134,122,256
30,30021,300211004,Diamante,ENTRE RÍOS,190,207,294,263,557
30,30021,300211005,Diamante,ENTRE RÍOS,112,118,192,188,380
30,30021,300211006,Diamante,ENTRE RÍOS,194,216,302,330,632
30,30021,300211007,Diamante,ENTRE RÍOS,233,267,358,303,661
30,30021,300211101,Diamante,ENTRE RÍOS,38,48,65,69,134
30,30021,300211102,Diamante,ENTRE RÍOS,34,43,57,46,103
30,30021,300211103,Diamante,ENTRE RÍOS,28,29,34,49,83
30,30021,300211104,Diamante,ENTRE RÍOS,19,30,33,31,64
30,30021,300211105,Diamante,ENTRE RÍOS,16,26,25,22,47
30,30021,300211201,Diamante,ENTRE RÍOS,5,7,8,8,16
30,30021,300211202,Diamante,ENTRE RÍOS,4,5,9,5,14
30,30021,300211203,Diamante,ENTRE RÍOS,23,28,43,50,93
30,30021,300211204,Diamante,ENTRE RÍOS,42,54,58,72,130
30,30021,300211205,Diamante,ENTRE RÍOS,21,31,27,27,54
30,30021,300211206,Diamante,ENTRE RÍOS,31,44,48,52,100
30,30021,300211207,Diamante,ENTRE RÍOS,23,33,35,42,77
30,30021,300211208,Diamante,ENTRE RÍOS,39,55,77,73,150
30,30021,300211209,Diamante,ENTRE RÍOS,32,36,55,58,113
30,30021,300211210,Diamante,ENTRE RÍOS,196,263,331,312,643
30,30021,300211211,Diamante,ENTRE RÍOS,13,14,21,24,45
30,30021,300211212,Diamante,ENTRE RÍOS,38,52,74,69,143
30,30021,300211301,Diamante,ENTRE RÍOS,32,47,27,48,75
30,30021,300211302,Diamante,ENTRE RÍOS,12,19,8,21,29
30,30028,300280101,Federación,ENTRE RÍOS,86,122,468,287,755
30,30028,300280102,Federación,ENTRE RÍOS,323,361,672,620,1292
30,30028,300280103,Federación,ENTRE RÍOS,219,257,329,310,639
30,30028,300280104,Federación,ENTRE RÍOS,179,229,249,220,469
30,30028,300280105,Federación,ENTRE RÍOS,366,348,672,624,1296
30,30028,300280106,Federación,ENTRE RÍOS,305,306,628,717,1345
30,30028,300280107,Federación,ENTRE RÍOS,256,274,456,419,875
30,30028,300280108,Federación,ENTRE RÍOS,208,226,331,299,630
30,30028,300280109,Federación,ENTRE RÍOS,170,191,350,266,616
30,30028,300280110,Federación,ENTRE RÍOS,325,351,638,623,1261
30,30028,300280111,Federación,ENTRE RÍOS,156,187,243,225,468
30,30028,300280112,Federación,ENTRE RÍOS,197,239,325,318,643
30,30028,300280113,Federación,ENTRE RÍOS,121,123,234,254,488
30,30028,300280114,Federación,ENTRE RÍOS,49,57,75,96,171
30,30028,300280201,Federación,ENTRE RÍOS,57,78,152,142,294
30,30028,300280202,Federación,ENTRE RÍOS,42,46,98,87,185
30,30028,300280203,Federación,ENTRE RÍOS,250,255,559,590,1149
30,30028,300280204,Federación,ENTRE RÍOS,366,334,760,776,1536
30,30028,300280205,Federación,ENTRE RÍOS,334,313,710,708,1418
30,30028,300280206,Federación,ENTRE RÍOS,274,309,534,594,1128
30,30028,300280301,Federación,ENTRE RÍOS,44,54,49,76,125
30,30028,300280302,Federación,ENTRE RÍOS,7,11,6,12,18
30,30028,300280303,Federación,ENTRE RÍOS,79,100,134,150,284
30,30028,300280304,Federación,ENTRE RÍOS,7,10,10,10,20
30,30028,300280305,Federación,ENTRE RÍOS,22,42,29,44,73
30,30028,300280306,Federación,ENTRE RÍOS,53,63,80,89,169
30,30028,300280307,Federación,ENTRE RÍOS,3,5,3,9,12
30,30028,300280308,Federación,ENTRE RÍOS,12,40,12,176,188
30,30028,300280401,Federación,ENTRE RÍOS,148,157,279,265,544
30,30028,300280402,Federación,ENTRE RÍOS,257,255,413,464,877
30,30028,300280403,Federación,ENTRE RÍOS,336,341,604,625,1229
30,30028,300280404,Federación,ENTRE RÍOS,224,238,389,431,820
30,30028,300280405,Federación,ENTRE RÍOS,209,217,386,394,780
30,30028,300280406,Federación,ENTRE RÍOS,279,299,485,466,951
30,30028,300280407,Federación,ENTRE RÍOS,200,198,353,413,766
30,30028,300280408,Federación,ENTRE RÍOS,252,273,434,416,850
30,30028,300280409,Federación,ENTRE RÍOS,160,168,298,271,569
30,30028,300280410,Federación,ENTRE RÍOS,271,283,462,439,901
30,30028,300280411,Federación,ENTRE RÍOS,215,231,319,336,655
30,30028,300280412,Federación,ENTRE RÍOS,233,259,370,326,696
30,30028,300280413,Federación,ENTRE RÍOS,199,220,296,278,574
30,30028,300280414,Federación,ENTRE RÍOS,195,215,340,321,661
30,30028,300280415,Federación,ENTRE RÍOS,207,199,347,327,674
30,30028,300280416,Federación,ENTRE RÍOS,283,319,488,410,898
30,30028,300280417,Federación,ENTRE RÍOS,233,233,383,354,737
30,30028,300280418,Federación,ENTRE RÍOS,265,287,470,449,919
30,30028,300280419,Federación,ENTRE RÍOS,281,271,542,546,1088
30,30028,300280501,Federación,ENTRE RÍOS,245,243,520,498,1018
30,30028,300280502,Federación,ENTRE RÍOS,286,292,516,485,1001
30,30028,300280503,Federación,ENTRE RÍOS,277,278,504,506,1010
30,30028,300280504,Federación,ENTRE RÍOS,219,220,432,446,878
30,30028,300280505,Federación,ENTRE RÍOS,331,320,631,668,1299
30,30028,300280506,Federación,ENTRE RÍOS,132,144,233,204,437
30,30028,300280507,Federación,ENTRE RÍOS,267,279,501,413,914
30,30028,300280508,Federación,ENTRE RÍOS,178,202,256,223,479
30,30028,300280509,Federación,ENTRE RÍOS,235,256,316,247,563
30,30028,300280510,Federación,ENTRE RÍOS,172,219,249,177,426
30,30028,300280511,Federación,ENTRE RÍOS,222,259,335,299,634
30,30028,300280512,Federación,ENTRE RÍOS,323,353,509,490,999
30,30028,300280513,Federación,ENTRE RÍOS,156,193,244,244,488
30,30028,300280514,Federación,ENTRE RÍOS,293,307,465,446,911
30,30028,300280515,Federación,ENTRE RÍOS,207,240,316,264,580
30,30028,300280516,Federación,ENTRE RÍOS,142,170,205,171,376
30,30028,300280517,Federación,ENTRE RÍOS,316,339,499,456,955
30,30028,300280518,Federación,ENTRE RÍOS,293,338,535,484,1019
30,30028,300280519,Federación,ENTRE RÍOS,251,286,414,439,853
30,30028,300280601,Federación,ENTRE RÍOS,83,89,142,154,296
30,30028,300280602,Federación,ENTRE RÍOS,64,75,97,128,225
30,30028,300280603,Federación,ENTRE RÍOS,184,255,347,366,713
30,30028,300280604,Federación,ENTRE RÍOS,42,43,74,88,162
30,30028,300280605,Federación,ENTRE RÍOS,98,106,155,187,342
30,30028,300280606,Federación,ENTRE RÍOS,109,119,238,224,462
30,30028,300280607,Federación,ENTRE RÍOS,118,151,198,218,416
30,30028,300280608,Federación,ENTRE RÍOS,207,234,367,430,797
30,30028,300280609,Federación,ENTRE RÍOS,207,337,335,389,724
30,30028,300280610,Federación,ENTRE RÍOS,25,30,38,58,96
30,30028,300280611,Federación,ENTRE RÍOS,59,65,114,114,228
30,30028,300280701,Federación,ENTRE RÍOS,2,2,0,5,5
30,30028,300280702,Federación,ENTRE RÍOS,3,4,6,9,15
30,30028,300280703,Federación,ENTRE RÍOS,13,18,12,17,29
30,30028,300280704,Federación,ENTRE RÍOS,32,34,47,48,95
30,30028,300280705,Federación,ENTRE RÍOS,3,3,6,5,11
30,30028,300280706,Federación,ENTRE RÍOS,12,15,15,22,37
30,30028,300280707,Federación,ENTRE RÍOS,8,10,9,13,22
30,30028,300280708,Federación,ENTRE RÍOS,101,99,236,226,462
30,30028,300280709,Federación,ENTRE RÍOS,260,311,488,432,920
30,30028,300280710,Federación,ENTRE RÍOS,342,364,628,582,1210
30,30028,300280711,Federación,ENTRE RÍOS,220,250,399,332,731
30,30028,300280712,Federación,ENTRE RÍOS,200,231,419,401,820
30,30028,300280801,Federación,ENTRE RÍOS,40,69,83,83,166
30,30028,300280802,Federación,ENTRE RÍOS,37,36,54,65,119
30,30028,300280803,Federación,ENTRE RÍOS,60,69,101,125,226
30,30028,300280804,Federación,ENTRE RÍOS,3,5,4,8,12
30,30028,300280805,Federación,ENTRE RÍOS,79,87,99,142,241
30,30028,300280806,Federación,ENTRE RÍOS,50,51,76,86,162
30,30028,300280807,Federación,ENTRE RÍOS,24,26,37,47,84
30,30028,300280808,Federación,ENTRE RÍOS,67,75,117,126,243
30,30028,300280809,Federación,ENTRE RÍOS,307,303,586,636,1222
30,30028,300280810,Federación,ENTRE RÍOS,186,194,304,297,601
30,30028,300280811,Federación,ENTRE RÍOS,150,154,225,247,472
30,30028,300280812,Federación,ENTRE RÍOS,123,127,202,223,425
30,30028,300280901,Federación,ENTRE RÍOS,60,66,100,114,214
30,30028,300280902,Federación,ENTRE RÍOS,16,16,36,32,68
30,30028,300280903,Federación,ENTRE RÍOS,67,107,93,141,234
30,30028,300280904,Federación,ENTRE RÍOS,54,62,79,107,186
30,30028,300280905,Federación,ENTRE RÍOS,31,38,53,64,117
30,30028,300280906,Federación,ENTRE RÍOS,31,173,41,64,105
30,30028,300280907,Federación,ENTRE RÍOS,237,250,417,454,871
30,30028,300281001,Federación,ENTRE RÍOS,9,10,16,22,38
30,30028,300281002,Federación,ENTRE RÍOS,23,30,16,43,59
30,30028,300281003,Federación,ENTRE RÍOS,7,12,2,11,13
30,30028,300281004,Federación,ENTRE RÍOS,6,6,5,11,16
30,30028,300281005,Federación,ENTRE RÍOS,35,37,41,57,98
30,30028,300281006,Federación,ENTRE RÍOS,6,7,12,24,36
30,30028,300281007,Federación,ENTRE RÍOS,9,12,9,16,25
30,30028,300281008,Federación,ENTRE RÍOS,86,87,153,182,335
30,30028,300281101,Federación,ENTRE RÍOS,19,21,34,40,74
30,30028,300281102,Federación,ENTRE RÍOS,2,3,2,6,8
30,30028,300281103,Federación,ENTRE RÍOS,32,36,31,54,85
30,30028,300281104,Federación,ENTRE RÍOS,37,37,68,78,146
30,30028,300281105,Federación,ENTRE RÍOS,12,12,12,21,33
30,30028,300281106,Federación,ENTRE RÍOS,11,14,7,20,27
30,30028,300281107,Federación,ENTRE RÍOS,180,194,351,313,664
30,30028,300281108,Federación,ENTRE RÍOS,143,172,255,258,513
30,30028,300281201,Federación,ENTRE RÍOS,49,51,90,113,203
30,30028,300281202,Federación,ENTRE RÍOS,2,3,2,3,5
30,30028,300281203,Federación,ENTRE RÍOS,30,39,54,54,108
30,30028,300281204,Federación,ENTRE RÍOS,62,70,87,108,195
30,30028,300281205,Federación,ENTRE RÍOS,29,29,42,56,98
30,30028,300281206,Federación,ENTRE RÍOS,37,44,59,74,133
30,30028,300281207,Federación,ENTRE RÍOS,59,60,102,130,232
30,30028,300281208,Federación,ENTRE RÍOS,214,232,360,411,771
30,30028,300281209,Federación,ENTRE RÍOS,15,18,31,33,64
30,30028,300281210,Federación,ENTRE RÍOS,91,99,143,167,310
30,30028,300281211,Federación,ENTRE RÍOS,52,64,106,106,212
30,30028,300281212,Federación,ENTRE RÍOS,62,75,99,118,217
30,30028,300281213,Federación,ENTRE RÍOS,36,47,39,59,98
30,30028,300281214,Federación,ENTRE RÍOS,46,59,66,74,140
30,30028,300281215,Federación,ENTRE RÍOS,118,150,166,229,395
30,30028,300281301,Federación,ENTRE RÍOS,16,26,13,28,41
30,30028,300281302,Federación,ENTRE RÍOS,12,14,14,24,38
30,30028,300281303,Federación,ENTRE RÍOS,62,72,134,124,258
30,30028,300281304,Federación,ENTRE RÍOS,27,26,45,43,88
30,30028,300281305,Federación,ENTRE RÍOS,8,8,13,19,32
30,30028,300281306,Federación,ENTRE RÍOS,31,25,43,61,104
30,30028,300281307,Federación,ENTRE RÍOS,57,66,92,112,204
30,30028,300281308,Federación,ENTRE RÍOS,10,15,15,17,32
30,30028,300281309,Federación,ENTRE RÍOS,108,116,174,212,386
30,30028,300281310,Federación,ENTRE RÍOS,12,13,18,22,40
30,30042,300420101,Feliciano,ENTRE RÍOS,224,245,438,425,863
30,30042,300420102,Feliciano,ENTRE RÍOS,251,282,549,520,1069
30,30042,300420103,Feliciano,ENTRE RÍOS,214,226,428,397,825
30,30042,300420104,Feliciano,ENTRE RÍOS,284,306,493,451,944
30,30042,300420105,Feliciano,ENTRE RÍOS,198,212,349,338,687
30,30042,300420106,Feliciano,ENTRE RÍOS,270,300,510,463,973
30,30042,300420107,Feliciano,ENTRE RÍOS,251,301,449,414,863
30,30042,300420108,Feliciano,ENTRE RÍOS,184,205,409,376,785
30,30042,300420109,Feliciano,ENTRE RÍOS,131,153,254,267,521
30,30042,300420110,Feliciano,ENTRE RÍOS,222,230,428,410,838
30,30042,300420111,Feliciano,ENTRE RÍOS,236,269,493,485,978
30,30042,300420112,Feliciano,ENTRE RÍOS,184,207,396,364,760
30,30042,300420201,Feliciano,ENTRE RÍOS,57,60,101,113,214
30,30042,300420202,Feliciano,ENTRE RÍOS,68,82,122,122,244
30,30042,300420203,Feliciano,ENTRE RÍOS,44,54,88,82,170
30,30042,300420204,Feliciano,ENTRE RÍOS,134,158,243,311,554
30,30042,300420205,Feliciano,ENTRE RÍOS,99,85,211,216,427
30,30042,300420206,Feliciano,ENTRE RÍOS,92,89,188,181,369
30,30042,300420301,Feliciano,ENTRE RÍOS,25,26,53,52,105
30,30042,300420302,Feliciano,ENTRE RÍOS,63,83,121,136,257
30,30042,300420303,Feliciano,ENTRE RÍOS,72,93,127,153,280
30,30042,300420304,Feliciano,ENTRE RÍOS,7,15,2,25,27
30,30042,300420305,Feliciano,ENTRE RÍOS,49,52,67,86,153
30,30042,300420401,Feliciano,ENTRE RÍOS,15,19,24,30,54
30,30042,300420402,Feliciano,ENTRE RÍOS,25,35,35,43,78
30,30042,300420403,Feliciano,ENTRE RÍOS,13,14,24,26,50
30,30042,300420404,Feliciano,ENTRE RÍOS,49,65,77,91,168
30,30042,300420405,Feliciano,ENTRE RÍOS,8,25,6,11,17
30,30042,300420406,Feliciano,ENTRE RÍOS,25,33,36,43,79
30,30042,300420501,Feliciano,ENTRE RÍOS,17,22,27,23,50
30,30042,300420502,Feliciano,ENTRE RÍOS,12,13,24,33,57
30,30042,300420503,Feliciano,ENTRE RÍOS,107,135,220,226,446
30,30042,300420504,Feliciano,ENTRE RÍOS,41,49,82,85,167
30,30042,300420601,Feliciano,ENTRE RÍOS,5,11,9,10,19
30,30042,300420602,Feliciano,ENTRE RÍOS,28,33,41,50,91
30,30042,300420603,Feliciano,ENTRE RÍOS,33,43,68,59,127
30,30042,300420604,Feliciano,ENTRE RÍOS,34,28,77,69,146
30,30042,300420605,Feliciano,ENTRE RÍOS,16,18,21,43,64
30,30042,300420701,Feliciano,ENTRE RÍOS,20,22,17,31,48
30,30042,300420702,Feliciano,ENTRE RÍOS,15,12,21,27,48
30,30042,300420703,Feliciano,ENTRE RÍOS,42,56,72,66,138
30,30042,300420704,Feliciano,ENTRE RÍOS,85,103,153,173,326
30,30049,300490101,Gualeguay,ENTRE RÍOS,91,110,164,146,310
30,30049,300490102,Gualeguay,ENTRE RÍOS,428,395,770,729,1499
30,30049,300490103,Gualeguay,ENTRE RÍOS,252,306,400,409,809
30,30049,300490104,Gualeguay,ENTRE RÍOS,155,163,272,246,518
30,30049,300490105,Gualeguay,ENTRE RÍOS,313,331,485,418,903
30,30049,300490106,Gualeguay,ENTRE RÍOS,328,377,505,434,939
30,30049,300490107,Gualeguay,ENTRE RÍOS,301,341,510,453,963
30,30049,300490108,Gualeguay,ENTRE RÍOS,305,339,489,407,896
30,30049,300490109,Gualeguay,ENTRE RÍOS,149,177,217,176,393
30,30049,300490110,Gualeguay,ENTRE RÍOS,188,251,280,243,523
30,30049,300490111,Gualeguay,ENTRE RÍOS,267,284,406,379,785
30,30049,300490112,Gualeguay,ENTRE RÍOS,200,222,345,296,641
30,30049,300490113,Gualeguay,ENTRE RÍOS,155,178,243,215,458
30,30049,300490114,Gualeguay,ENTRE RÍOS,145,156,229,184,413
30,30049,300490201,Gualeguay,ENTRE RÍOS,242,264,384,357,741
30,30049,300490202,Gualeguay,ENTRE RÍOS,363,388,643,581,1224
30,30049,300490203,Gualeguay,ENTRE RÍOS,210,227,375,382,757
30,30049,300490204,Gualeguay,ENTRE RÍOS,180,190,267,245,512
30,30049,300490205,Gualeguay,ENTRE RÍOS,199,230,328,278,606
30,30049,300490206,Gualeguay,ENTRE RÍOS,194,196,321,325,646
30,30049,300490207,Gualeguay,ENTRE RÍOS,150,167,248,180,428
30,30049,300490208,Gualeguay,ENTRE RÍOS,196,230,275,224,499
30,30049,300490209,Gualeguay,ENTRE RÍOS,227,247,353,324,677
30,30049,300490210,Gualeguay,ENTRE RÍOS,340,346,599,607,1206
30,30049,300490211,Gualeguay,ENTRE RÍOS,263,324,412,339,751
30,30049,300490212,Gualeguay,ENTRE RÍOS,130,173,181,143,324
30,30049,300490213,Gualeguay,ENTRE RÍOS,230,264,327,276,603
30,30049,300490214,Gualeguay,ENTRE RÍOS,167,201,261,184,445
30,30049,300490215,Gualeguay,ENTRE RÍOS,131,155,182,251,433
30,30049,300490216,Gualeguay,ENTRE RÍOS,123,113,224,224,448
30,30049,300490217,Gualeguay,ENTRE RÍOS,84,88,131,143,274
30,30049,300490218,Gualeguay,ENTRE RÍOS,269,298,437,382,819
30,30049,300490219,Gualeguay,ENTRE RÍOS,269,327,350,294,644
30,30049,300490220,Gualeguay,ENTRE RÍOS,301,312,494,420,914
30,30049,300490221,Gualeguay,ENTRE RÍOS,237,218,473,482,955
30,30049,300490222,Gualeguay,ENTRE RÍOS,222,180,403,432,835
30,30049,300490301,Gualeguay,ENTRE RÍOS,389,434,597,529,1126
30,30049,300490302,Gualeguay,ENTRE RÍOS,195,230,287,223,510
30,30049,300490303,Gualeguay,ENTRE RÍOS,141,191,186,165,351
30,30049,300490304,Gualeguay,ENTRE RÍOS,181,209,265,215,480
30,30049,300490305,Gualeguay,ENTRE RÍOS,234,277,351,281,632
30,30049,300490306,Gualeguay,ENTRE RÍOS,296,335,529,446,975
30,30049,300490307,Gualeguay,ENTRE RÍOS,258,293,493,443,936
30,30049,300490308,Gualeguay,ENTRE RÍOS,349,352,632,602,1234
30,30049,300490309,Gualeguay,ENTRE RÍOS,386,383,732,675,1407
30,30049,300490310,Gualeguay,ENTRE RÍOS,385,409,787,792,1579
30,30049,300490311,Gualeguay,ENTRE RÍOS,153,151,296,281,577
30,30049,300490312,Gualeguay,ENTRE RÍOS,259,265,536,543,1079
30,30049,300490401,Gualeguay,ENTRE RÍOS,136,212,219,227,446
30,30049,300490402,Gualeguay,ENTRE RÍOS,100,138,146,172,318
30,30049,300490403,Gualeguay,ENTRE RÍOS,90,115,164,180,344
30,30049,300490404,Gualeguay,ENTRE RÍOS,17,21,33,35,68
30,30049,300490405,Gualeguay,ENTRE RÍOS,21,22,29,40,69
30,30049,300490406,Gualeguay,ENTRE RÍOS,7,53,7,12,19
30,30049,300490407,Gualeguay,ENTRE RÍOS,107,147,171,158,329
30,30049,300490408,Gualeguay,ENTRE RÍOS,42,75,53,68,121
30,30049,300490409,Gualeguay,ENTRE RÍOS,135,152,220,225,445
30,30049,300490410,Gualeguay,ENTRE RÍOS,4,10,2,4,6
30,30049,300490411,Gualeguay,ENTRE RÍOS,166,244,273,293,566
30,30049,300490412,Gualeguay,ENTRE RÍOS,357,406,675,651,1326
30,30049,300490413,Gualeguay,ENTRE RÍOS,320,354,638,595,1233
30,30049,300490414,Gualeguay,ENTRE RÍOS,231,248,417,407,824
30,30049,300490415,Gualeguay,ENTRE RÍOS,210,221,430,432,862
30,30049,300490416,Gualeguay,ENTRE RÍOS,3,7,4,5,9
30,30049,300490417,Gualeguay,ENTRE RÍOS,89,93,170,177,347
30,30049,300490501,Gualeguay,ENTRE RÍOS,23,24,43,37,80
30,30049,300490502,Gualeguay,ENTRE RÍOS,15,18,30,31,61
30,30049,300490503,Gualeguay,ENTRE RÍOS,37,44,64,76,140
30,30049,300490504,Gualeguay,ENTRE RÍOS,15,20,19,19,38
30,30049,300490505,Gualeguay,ENTRE RÍOS,22,29,34,27,61
30,30049,300490506,Gualeguay,ENTRE RÍOS,19,27,32,37,69
30,30049,300490507,Gualeguay,ENTRE RÍOS,27,38,35,34,69
30,30049,300490508,Gualeguay,ENTRE RÍOS,34,47,50,58,108
30,30049,300490509,Gualeguay,ENTRE RÍOS,35,54,48,51,99
30,30049,300490510,Gualeguay,ENTRE RÍOS,37,49,73,62,135
30,30049,300490511,Gualeguay,ENTRE RÍOS,118,147,195,220,415
30,30049,300490512,Gualeguay,ENTRE RÍOS,49,64,90,90,180
30,30049,300490513,Gualeguay,ENTRE RÍOS,16,22,23,24,47
30,30049,300490601,Gualeguay,ENTRE RÍOS,27,40,35,42,77
30,30049,300490602,Gualeguay,ENTRE RÍOS,26,39,26,42,68
30,30049,300490603,Gualeguay,ENTRE RÍOS,24,34,26,45,71
30,30049,300490604,Gualeguay,ENTRE RÍOS,16,36,12,27,39
30,30049,300490605,Gualeguay,ENTRE RÍOS,31,52,40,53,93
30,30049,300490606,Gualeguay,ENTRE RÍOS,22,34,25,35,60
30,30049,300490607,Gualeguay,ENTRE RÍOS,10,18,6,15,21
30,30049,300490608,Gualeguay,ENTRE RÍOS,3,9,10,5,15
30,30049,300490609,Gualeguay,ENTRE RÍOS,37,54,47,61,108
30,30049,300490610,Gualeguay,ENTRE RÍOS,15,18,18,27,45
30,30049,300490611,Gualeguay,ENTRE RÍOS,114,147,166,198,364
30,30049,300490701,Gualeguay,ENTRE RÍOS,17,37,23,30,53
30,30049,300490702,Gualeguay,ENTRE RÍOS,56,54,94,100,194
30,30049,300490703,Gualeguay,ENTRE RÍOS,19,32,26,30,56
30,30049,300490704,Gualeguay,ENTRE RÍOS,7,17,6,13,19
30,30049,300490705,Gualeguay,ENTRE RÍOS,11,22,15,12,27
30,30049,300490706,Gualeguay,ENTRE RÍOS,39,69,48,71,119
30,30049,300490707,Gualeguay,ENTRE RÍOS,20,37,28,27,55
30,30049,300490708,Gualeguay,ENTRE RÍOS,32,63,44,47,91
30,30049,300490709,Gualeguay,ENTRE RÍOS,14,29,22,20,42
30,30049,300490710,Gualeguay,ENTRE RÍOS,11,14,16,16,32
30,30049,300490711,Gualeguay,ENTRE RÍOS,15,18,19,31,50
30,30049,300490712,Gualeguay,ENTRE RÍOS,12,22,10,16,26
30,30049,300490801,Gualeguay,ENTRE RÍOS,6,6,2,8,10
30,30049,300490802,Gualeguay,ENTRE RÍOS,28,37,48,44,92
30,30049,300490803,Gualeguay,ENTRE RÍOS,24,30,23,42,65
30,30049,300490804,Gualeguay,ENTRE RÍOS,27,27,34,47,81
30,30049,300490805,Gualeguay,ENTRE RÍOS,28,39,25,44,69
30,30049,300490806,Gualeguay,ENTRE RÍOS,46,59,61,87,148
30,30049,300490807,Gualeguay,ENTRE RÍOS,10,17,7,16,23
30,30049,300490901,Gualeguay,ENTRE RÍOS,31,18,25,55,80
30,30049,300490902,Gualeguay,ENTRE RÍOS,77,121,63,118,181
30,30049,300491001,Gualeguay,ENTRE RÍOS,1,5,1,1,2
30,30049,300491002,Gualeguay,ENTRE RÍOS,10,15,18,18,36
30,30049,300491003,Gualeguay,ENTRE RÍOS,20,36,35,35,70
30,30049,300491004,Gualeguay,ENTRE RÍOS,18,26,23,26,49
30,30049,300491005,Gualeguay,ENTRE RÍOS,79,95,136,137,273
30,30049,300491006,Gualeguay,ENTRE RÍOS,199,225,264,231,495
30,30049,300491007,Gualeguay,ENTRE RÍOS,305,350,461,473,934
30,30049,300491008,Gualeguay,ENTRE RÍOS,184,224,289,262,551
30,30049,300491009,Gualeguay,ENTRE RÍOS,140,163,216,195,411
30,30049,300491010,Gualeguay,ENTRE RÍOS,322,382,506,493,999
30,30049,300491011,Gualeguay,ENTRE RÍOS,308,351,514,564,1078
30,30056,300560101,Gualeguaychú,ENTRE RÍOS,299,309,495,532,1027
30,30056,300560102,Gualeguaychú,ENTRE RÍOS,249,248,510,501,1011
30,30056,300560103,Gualeguaychú,ENTRE RÍOS,364,370,661,684,1345
30,30056,300560104,Gualeguaychú,ENTRE RÍOS,309,331,447,471,918
30,30056,300560105,Gualeguaychú,ENTRE RÍOS,373,385,611,575,1186
30,30056,300560106,Gualeguaychú,ENTRE RÍOS,365,386,627,579,1206
30,30056,300560107,Gualeguaychú,ENTRE RÍOS,379,418,673,617,1290
30,30056,300560108,Gualeguaychú,ENTRE RÍOS,342,381,547,513,1060
30,30056,300560109,Gualeguaychú,ENTRE RÍOS,243,241,379,374,753
30,30056,300560110,Gualeguaychú,ENTRE RÍOS,382,394,599,561,1160
30,30056,300560111,Gualeguaychú,ENTRE RÍOS,344,368,508,489,997
30,30056,300560112,Gualeguaychú,ENTRE RÍOS,155,181,213,179,392
30,30056,300560113,Gualeguaychú,ENTRE RÍOS,185,230,278,178,456
30,30056,300560114,Gualeguaychú,ENTRE RÍOS,228,243,324,278,602
30,30056,300560115,Gualeguaychú,ENTRE RÍOS,400,429,622,551,1173
30,30056,300560116,Gualeguaychú,ENTRE RÍOS,340,340,568,492,1060
30,30056,300560117,Gualeguaychú,ENTRE RÍOS,290,317,454,389,843
30,30056,300560118,Gualeguaychú,ENTRE RÍOS,114,159,159,145,304
30,30056,300560119,Gualeguaychú,ENTRE RÍOS,194,210,291,242,533
30,30056,300560120,Gualeguaychú,ENTRE RÍOS,227,294,311,250,561
30,30056,300560121,Gualeguaychú,ENTRE RÍOS,170,222,239,190,429
30,30056,300560122,Gualeguaychú,ENTRE RÍOS,227,285,349,269,618
30,30056,300560201,Gualeguaychú,ENTRE RÍOS,274,295,459,422,881
30,30056,300560202,Gualeguaychú,ENTRE RÍOS,226,263,402,392,794
30,30056,300560203,Gualeguaychú,ENTRE RÍOS,376,383,760,723,1483
30,30056,300560204,Gualeguaychú,ENTRE RÍOS,153,164,275,264,539
30,30056,300560205,Gualeguaychú,ENTRE RÍOS,382,409,743,799,1542
30,30056,300560206,Gualeguaychú,ENTRE RÍOS,381,390,739,683,1422
30,30056,300560207,Gualeguaychú,ENTRE RÍOS,235,260,360,349,709
30,30056,300560208,Gualeguaychú,ENTRE RÍOS,201,221,352,314,666
30,30056,300560209,Gualeguaychú,ENTRE RÍOS,203,243,356,297,653
30,30056,300560210,Gualeguaychú,ENTRE RÍOS,197,233,290,267,557
30,30056,300560211,Gualeguaychú,ENTRE RÍOS,142,170,227,168,395
30,30056,300560212,Gualeguaychú,ENTRE RÍOS,201,233,274,244,518
30,30056,300560213,Gualeguaychú,ENTRE RÍOS,214,237,313,253,566
30,30056,300560214,Gualeguaychú,ENTRE RÍOS,234,261,357,329,686
30,30056,300560215,Gualeguaychú,ENTRE RÍOS,227,263,336,298,634
30,30056,300560216,Gualeguaychú,ENTRE RÍOS,292,303,506,472,978
30,30056,300560217,Gualeguaychú,ENTRE RÍOS,231,266,410,339,749
30,30056,300560218,Gualeguaychú,ENTRE RÍOS,187,231,278,221,499
30,30056,300560219,Gualeguaychú,ENTRE RÍOS,169,217,244,200,444
30,30056,300560220,Gualeguaychú,ENTRE RÍOS,267,330,354,297,651
30,30056,300560221,Gualeguaychú,ENTRE RÍOS,177,236,279,248,527
30,30056,300560301,Gualeguaychú,ENTRE RÍOS,76,117,91,73,164
30,30056,300560302,Gualeguaychú,ENTRE RÍOS,119,153,137,106,243
30,30056,300560303,Gualeguaychú,ENTRE RÍOS,255,330,474,456,930
30,30056,300560304,Gualeguaychú,ENTRE RÍOS,181,239,221,173,394
30,30056,300560305,Gualeguaychú,ENTRE RÍOS,128,163,195,147,342
30,30056,300560306,Gualeguaychú,ENTRE RÍOS,179,219,254,204,458
30,30056,300560307,Gualeguaychú,ENTRE RÍOS,214,283,308,247,555
30,30056,300560308,Gualeguaychú,ENTRE RÍOS,279,341,442,364,806
30,30056,300560309,Gualeguaychú,ENTRE RÍOS,175,210,254,198,452
30,30056,300560310,Gualeguaychú,ENTRE RÍOS,243,289,331,245,576
30,30056,300560311,Gualeguaychú,ENTRE RÍOS,185,213,261,215,476
30,30056,300560312,Gualeguaychú,ENTRE RÍOS,221,246,352,339,691
30,30056,300560313,Gualeguaychú,ENTRE RÍOS,343,361,604,586,1190
30,30056,300560314,Gualeguaychú,ENTRE RÍOS,272,288,437,425,862
30,30056,300560315,Gualeguaychú,ENTRE RÍOS,118,138,189,186,375
30,30056,300560316,Gualeguaychú,ENTRE RÍOS,210,243,326,304,630
30,30056,300560317,Gualeguaychú,ENTRE RÍOS,332,367,543,515,1058
30,30056,300560318,Gualeguaychú,ENTRE RÍOS,330,339,578,594,1172
30,30056,300560319,Gualeguaychú,ENTRE RÍOS,125,128,231,234,465
30,30056,300560401,Gualeguaychú,ENTRE RÍOS,214,231,316,298,614
30,30056,300560402,Gualeguaychú,ENTRE RÍOS,192,213,301,241,542
30,30056,300560403,Gualeguaychú,ENTRE RÍOS,142,157,200,177,377
30,30056,300560404,Gualeguaychú,ENTRE RÍOS,160,211,211,178,389
30,30056,300560405,Gualeguaychú,ENTRE RÍOS,318,350,491,388,879
30,30056,300560406,Gualeguaychú,ENTRE RÍOS,241,252,344,292,636
30,30056,300560407,Gualeguaychú,ENTRE RÍOS,272,302,443,398,841
30,30056,300560408,Gualeguaychú,ENTRE RÍOS,333,362,585,556,1141
30,30056,300560409,Gualeguaychú,ENTRE RÍOS,336,362,541,497,1038
30,30056,300560410,Gualeguaychú,ENTRE RÍOS,359,378,596,585,1181
30,30056,300560411,Gualeguaychú,ENTRE RÍOS,287,293,525,450,975
30,30056,300560412,Gualeguaychú,ENTRE RÍOS,272,275,525,587,1112
30,30056,300560413,Gualeguaychú,ENTRE RÍOS,245,278,490,462,952
30,30056,300560414,Gualeguaychú,ENTRE RÍOS,386,376,784,780,1564
30,30056,300560415,Gualeguaychú,ENTRE RÍOS,306,311,581,574,1155
30,30056,300560416,Gualeguaychú,ENTRE RÍOS,203,222,361,342,703
30,30056,300560417,Gualeguaychú,ENTRE RÍOS,283,332,513,468,981
30,30056,300560418,Gualeguaychú,ENTRE RÍOS,257,277,505,476,981
30,30056,300560501,Gualeguaychú,ENTRE RÍOS,141,159,234,212,446
30,30056,300560502,Gualeguaychú,ENTRE RÍOS,151,163,271,245,516
30,30056,300560503,Gualeguaychú,ENTRE RÍOS,145,156,262,246,508
30,30056,300560504,Gualeguaychú,ENTRE RÍOS,317,340,526,449,975
30,30056,300560505,Gualeguaychú,ENTRE RÍOS,195,213,385,388,773
30,30056,300560506,Gualeguaychú,ENTRE RÍOS,158,182,274,226,500
30,30056,300560507,Gualeguaychú,ENTRE RÍOS,230,248,406,367,773
30,30056,300560508,Gualeguaychú,ENTRE RÍOS,228,249,434,401,835
30,30056,300560509,Gualeguaychú,ENTRE RÍOS,198,195,359,331,690
30,30056,300560510,Gualeguaychú,ENTRE RÍOS,249,271,437,429,866
30,30056,300560511,Gualeguaychú,ENTRE RÍOS,299,317,456,450,906
30,30056,300560512,Gualeguaychú,ENTRE RÍOS,186,204,296,294,590
30,30056,300560513,Gualeguaychú,ENTRE RÍOS,305,336,495,463,958
30,30056,300560601,Gualeguaychú,ENTRE RÍOS,62,90,90,121,211
30,30056,300560602,Gualeguaychú,ENTRE RÍOS,120,151,190,216,406
30,30056,300560603,Gualeguaychú,ENTRE RÍOS,23,27,30,51,81
30,30056,300560604,Gualeguaychú,ENTRE RÍOS,46,63,81,78,159
30,30056,300560605,Gualeguaychú,ENTRE RÍOS,371,367,786,801,1587
30,30056,300560606,Gualeguaychú,ENTRE RÍOS,312,326,530,531,1061
30,30056,300560607,Gualeguaychú,ENTRE RÍOS,119,113,216,187,403
30,30056,300560608,Gualeguaychú,ENTRE RÍOS,349,375,664,644,1308
30,30056,300560609,Gualeguaychú,ENTRE RÍOS,23,38,24,39,63
30,30056,300560610,Gualeguaychú,ENTRE RÍOS,198,184,366,371,737
30,30056,300560611,Gualeguaychú,ENTRE RÍOS,67,108,101,118,219
30,30056,300560612,Gualeguaychú,ENTRE RÍOS,19,28,23,30,53
30,30056,300560701,Gualeguaychú,ENTRE RÍOS,389,398,707,747,1454
30,30056,300560702,Gualeguaychú,ENTRE RÍOS,342,388,613,574,1187
30,30056,300560703,Gualeguaychú,ENTRE RÍOS,69,140,99,106,205
30,30056,300560704,Gualeguaychú,ENTRE RÍOS,33,55,46,45,91
30,30056,300560705,Gualeguaychú,ENTRE RÍOS,87,110,155,157,312
30,30056,300560706,Gualeguaychú,ENTRE RÍOS,272,321,471,469,940
30,30056,300560707,Gualeguaychú,ENTRE RÍOS,53,55,92,80,172
30,30056,300560801,Gualeguaychú,ENTRE RÍOS,16,23,24,31,55
30,30056,300560802,Gualeguaychú,ENTRE RÍOS,12,25,19,16,35
30,30056,300560803,Gualeguaychú,ENTRE RÍOS,1,5,0,1,1
30,30056,300560804,Gualeguaychú,ENTRE RÍOS,44,63,60,81,141
30,30056,300560805,Gualeguaychú,ENTRE RÍOS,14,16,14,22,36
30,30056,300560806,Gualeguaychú,ENTRE RÍOS,11,14,14,22,36
30,30056,300560807,Gualeguaychú,ENTRE RÍOS,6,10,7,10,17
30,30056,300560808,Gualeguaychú,ENTRE RÍOS,54,70,56,91,147
30,30056,300560809,Gualeguaychú,ENTRE RÍOS,27,56,21,28,49
30,30056,300560810,Gualeguaychú,ENTRE RÍOS,57,58,101,95,196
30,30056,300560811,Gualeguaychú,ENTRE RÍOS,152,200,232,228,460
30,30056,300560812,Gualeguaychú,ENTRE RÍOS,100,119,161,179,340
30,30056,300560901,Gualeguaychú,ENTRE RÍOS,19,26,24,42,66
30,30056,300560902,Gualeguaychú,ENTRE RÍOS,44,55,56,51,107
30,30056,300560903,Gualeguaychú,ENTRE RÍOS,7,14,10,10,20
30,30056,300560904,Gualeguaychú,ENTRE RÍOS,12,29,12,18,30
30,30056,300560905,Gualeguaychú,ENTRE RÍOS,8,15,10,10,20
30,30056,300560906,Gualeguaychú,ENTRE RÍOS,23,39,25,31,56
30,30056,300560907,Gualeguaychú,ENTRE RÍOS,42,54,55,63,118
30,30056,300560908,Gualeguaychú,ENTRE RÍOS,49,56,77,80,157
30,30056,300560909,Gualeguaychú,ENTRE RÍOS,36,59,51,66,117
30,30056,300560910,Gualeguaychú,ENTRE RÍOS,15,29,31,26,57
30,30056,300560911,Gualeguaychú,ENTRE RÍOS,118,168,179,208,387
30,30056,300560912,Gualeguaychú,ENTRE RÍOS,9,18,17,15,32
30,30056,300560913,Gualeguaychú,ENTRE RÍOS,15,29,14,22,36
30,30056,300560914,Gualeguaychú,ENTRE RÍOS,6,9,4,11,15
30,30056,300560915,Gualeguaychú,ENTRE RÍOS,147,169,248,235,483
30,30056,300560916,Gualeguaychú,ENTRE RÍOS,213,247,309,299,608
30,30056,300561001,Gualeguaychú,ENTRE RÍOS,44,73,71,76,147
30,30056,300561002,Gualeguaychú,ENTRE RÍOS,5,14,7,8,15
30,30056,300561003,Gualeguaychú,ENTRE RÍOS,43,75,61,80,141
30,30056,300561004,Gualeguaychú,ENTRE RÍOS,70,110,91,109,200
30,30056,300561005,Gualeguaychú,ENTRE RÍOS,37,40,67,57,124
30,30056,300561006,Gualeguaychú,ENTRE RÍOS,5,16,11,5,16
30,30056,300561007,Gualeguaychú,ENTRE RÍOS,14,47,15,22,37
30,30056,300561008,Gualeguaychú,ENTRE RÍOS,23,38,31,38,69
30,30056,300561009,Gualeguaychú,ENTRE RÍOS,75,120,102,118,220
30,30056,300561010,Gualeguaychú,ENTRE RÍOS,19,34,19,30,49
30,30056,300561011,Gualeguaychú,ENTRE RÍOS,52,99,81,77,158
30,30056,300561101,Gualeguaychú,ENTRE RÍOS,5,13,5,6,11
30,30056,300561102,Gualeguaychú,ENTRE RÍOS,17,36,14,25,39
30,30056,300561103,Gualeguaychú,ENTRE RÍOS,17,39,20,30,50
30,30056,300561104,Gualeguaychú,ENTRE RÍOS,14,25,21,21,42
30,30056,300561105,Gualeguaychú,ENTRE RÍOS,15,21,21,18,39
30,30056,300561106,Gualeguaychú,ENTRE RÍOS,20,38,16,28,44
30,30056,300561107,Gualeguaychú,ENTRE RÍOS,20,30,21,37,58
30,30056,300561108,Gualeguaychú,ENTRE RÍOS,7,11,5,8,13
30,30056,300561109,Gualeguaychú,ENTRE RÍOS,19,29,26,32,58
30,30056,300561110,Gualeguaychú,ENTRE RÍOS,19,19,18,22,40
30,30056,300561111,Gualeguaychú,ENTRE RÍOS,108,155,144,154,298
30,30056,300561201,Gualeguaychú,ENTRE RÍOS,72,103,88,116,204
30,30056,300561202,Gualeguaychú,ENTRE RÍOS,49,64,60,85,145
30,30056,300561203,Gualeguaychú,ENTRE RÍOS,25,41,17,34,51
30,30056,300561204,Gualeguaychú,ENTRE RÍOS,42,59,41,64,105
30,30056,300561205,Gualeguaychú,ENTRE RÍOS,46,59,65,67,132
30,30056,300561206,Gualeguaychú,ENTRE RÍOS,53,76,59,81,140
30,30056,300561207,Gualeguaychú,ENTRE RÍOS,39,56,61,63,124
30,30056,300561208,Gualeguaychú,ENTRE RÍOS,41,63,44,84,128
30,30056,300561209,Gualeguaychú,ENTRE RÍOS,16,17,23,27,50
30,30056,300561301,Gualeguaychú,ENTRE RÍOS,7,29,7,10,17
30,30056,300561302,Gualeguaychú,ENTRE RÍOS,48,75,65,88,153
30,30056,300561303,Gualeguaychú,ENTRE RÍOS,23,37,22,34,56
30,30056,300561304,Gualeguaychú,ENTRE RÍOS,11,14,10,13,23
30,30056,300561305,Gualeguaychú,ENTRE RÍOS,12,17,17,23,40
30,30056,300561306,Gualeguaychú,ENTRE RÍOS,51,63,81,88,169
30,30056,300561307,Gualeguaychú,ENTRE RÍOS,18,28,26,32,58
30,30056,300561308,Gualeguaychú,ENTRE RÍOS,30,44,40,39,79
30,30056,300561309,Gualeguaychú,ENTRE RÍOS,8,10,6,13,19
30,30056,300561310,Gualeguaychú,ENTRE RÍOS,24,39,30,36,66
30,30056,300561401,Gualeguaychú,ENTRE RÍOS,49,79,70,67,137
30,30056,300561402,Gualeguaychú,ENTRE RÍOS,10,15,14,18,32
30,30056,300561403,Gualeguaychú,ENTRE RÍOS,17,24,6,23,29
30,30056,300561404,Gualeguaychú,ENTRE RÍOS,15,23,19,22,41
30,30056,300561405,Gualeguaychú,ENTRE RÍOS,18,23,28,24,52
30,30056,300561406,Gualeguaychú,ENTRE RÍOS,225,263,385,365,750
30,30056,300561501,Gualeguaychú,ENTRE RÍOS,176,193,290,279,569
30,30056,300561502,Gualeguaychú,ENTRE RÍOS,206,236,375,418,793
30,30056,300561503,Gualeguaychú,ENTRE RÍOS,224,247,371,385,756
30,30056,300561504,Gualeguaychú,ENTRE RÍOS,202,228,302,311,613
30,30056,300561505,Gualeguaychú,ENTRE RÍOS,149,176,192,171,363
30,30056,300561506,Gualeguaychú,ENTRE RÍOS,216,232,315,310,625
30,30056,300561507,Gualeguaychú,ENTRE RÍOS,279,317,414,383,797
30,30056,300561508,Gualeguaychú,ENTRE RÍOS,161,175,212,190,402
30,30056,300561509,Gualeguaychú,ENTRE RÍOS,255,289,339,288,627
30,30056,300561510,Gualeguaychú,ENTRE RÍOS,109,124,159,163,322
30,30056,300561511,Gualeguaychú,ENTRE RÍOS,261,301,421,423,844
30,30056,300561512,Gualeguaychú,ENTRE RÍOS,242,288,343,312,655
30,30056,300561513,Gualeguaychú,ENTRE RÍOS,284,331,403,389,792
30,30056,300561601,Gualeguaychú,ENTRE RÍOS,65,73,112,141,253
30,30056,300561602,Gualeguaychú,ENTRE RÍOS,48,74,62,69,131
30,30056,300561603,Gualeguaychú,ENTRE RÍOS,1,7,1,1,2
30,30056,300561604,Gualeguaychú,ENTRE RÍOS,132,142,186,214,400
30,30056,300561605,Gualeguaychú,ENTRE RÍOS,17,19,15,27,42
30,30056,300561701,Gualeguaychú,ENTRE RÍOS,21,34,20,33,53
30,30056,300561702,Gualeguaychú,ENTRE RÍOS,65,93,103,115,218
30,30056,300561703,Gualeguaychú,ENTRE RÍOS,159,181,295,292,587
30,30056,300561704,Gualeguaychú,ENTRE RÍOS,262,296,425,357,782
30,30056,300561705,Gualeguaychú,ENTRE RÍOS,246,270,422,394,816
30,30056,300561706,Gualeguaychú,ENTRE RÍOS,134,147,223,212,435
30,30056,300561707,Gualeguaychú,ENTRE RÍOS,221,272,424,422,846
30,30056,300561708,Gualeguaychú,ENTRE RÍOS,175,190,321,280,601
30,30056,300561709,Gualeguaychú,ENTRE RÍOS,166,196,252,241,493
30,30056,300561710,Gualeguaychú,ENTRE RÍOS,154,169,271,258,529
30,30056,300561711,Gualeguaychú,ENTRE RÍOS,173,193,291,237,528
30,30056,300561712,Gualeguaychú,ENTRE RÍOS,174,195,290,273,563
30,30056,300561801,Gualeguaychú,ENTRE RÍOS,33,53,36,44,80
30,30056,300561802,Gualeguaychú,ENTRE RÍOS,13,12,22,26,48
30,30056,300561803,Gualeguaychú,ENTRE RÍOS,8,9,16,13,29
30,30056,300561804,Gualeguaychú,ENTRE RÍOS,29,55,38,44,82
30,30056,300561805,Gualeguaychú,ENTRE RÍOS,25,44,21,31,52
30,30056,300561806,Gualeguaychú,ENTRE RÍOS,21,36,21,26,47
30,30056,300561807,Gualeguaychú,ENTRE RÍOS,17,28,22,28,50
30,30056,300561808,Gualeguaychú,ENTRE RÍOS,65,133,62,131,193
30,30056,300561809,Gualeguaychú,ENTRE RÍOS,77,357,111,110,221
30,30056,300561810,Gualeguaychú,ENTRE RÍOS,158,279,243,269,512
30,30056,300561811,Gualeguaychú,ENTRE RÍOS,184,295,276,301,577
30,30056,300561812,Gualeguaychú,ENTRE RÍOS,130,282,169,183,352
30,30056,300561813,Gualeguaychú,ENTRE RÍOS,94,174,139,144,283
30,30056,300561814,Gualeguaychú,ENTRE RÍOS,91,188,142,124,266
30,30056,300561815,Gualeguaychú,ENTRE RÍOS,21,95,14,26,40
30,30070,300700101,La Paz,ENTRE RÍOS,108,134,204,163,367
30,30070,300700102,La Paz,ENTRE RÍOS,163,200,240,213,453
30,30070,300700103,La Paz,ENTRE RÍOS,147,210,264,205,469
30,30070,300700104,La Paz,ENTRE RÍOS,182,193,386,356,742
30,30070,300700105,La Paz,ENTRE RÍOS,184,200,332,303,635
30,30070,300700106,La Paz,ENTRE RÍOS,265,265,535,517,1052
30,30070,300700107,La Paz,ENTRE RÍOS,208,237,333,258,591
30,30070,300700108,La Paz,ENTRE RÍOS,244,271,409,332,741
30,30070,300700109,La Paz,ENTRE RÍOS,257,308,434,336,770
30,30070,300700110,La Paz,ENTRE RÍOS,191,205,349,311,660
30,30070,300700111,La Paz,ENTRE RÍOS,222,224,389,324,713
30,30070,300700112,La Paz,ENTRE RÍOS,176,197,298,226,524
30,30070,300700113,La Paz,ENTRE RÍOS,297,296,508,442,950
30,30070,300700114,La Paz,ENTRE RÍOS,372,395,709,683,1392
30,30070,300700115,La Paz,ENTRE RÍOS,317,338,525,507,1032
30,30070,300700201,La Paz,ENTRE RÍOS,272,293,573,481,1054
30,30070,300700202,La Paz,ENTRE RÍOS,200,223,417,407,824
30,30070,300700203,La Paz,ENTRE RÍOS,250,246,539,548,1087
30,30070,300700204,La Paz,ENTRE RÍOS,219,244,470,444,914
30,30070,300700205,La Paz,ENTRE RÍOS,159,172,343,332,675
30,30070,300700206,La Paz,ENTRE RÍOS,264,254,583,548,1131
30,30070,300700207,La Paz,ENTRE RÍOS,138,142,252,246,498
30,30070,300700208,La Paz,ENTRE RÍOS,149,152,327,317,644
30,30070,300700209,La Paz,ENTRE RÍOS,211,225,492,463,955
30,30070,300700210,La Paz,ENTRE RÍOS,221,224,496,466,962
30,30070,300700301,La Paz,ENTRE RÍOS,5,6,7,9,16
30,30070,300700302,La Paz,ENTRE RÍOS,60,74,104,124,228
30,30070,300700303,La Paz,ENTRE RÍOS,238,261,420,425,845
30,30070,300700304,La Paz,ENTRE RÍOS,239,276,418,361,779
30,30070,300700305,La Paz,ENTRE RÍOS,107,137,210,205,415
30,30070,300700306,La Paz,ENTRE RÍOS,68,61,104,108,212
30,30070,300700307,La Paz,ENTRE RÍOS,52,63,99,110,209
30,30070,300700308,La Paz,ENTRE RÍOS,246,277,440,369,809
30,30070,300700309,La Paz,ENTRE RÍOS,122,159,219,204,423
30,30070,300700310,La Paz,ENTRE RÍOS,286,314,525,500,1025
30,30070,300700311,La Paz,ENTRE RÍOS,151,224,308,283,591
30,30070,300700312,La Paz,ENTRE RÍOS,74,81,148,152,300
30,30070,300700313,La Paz,ENTRE RÍOS,29,39,43,52,95
30,30070,300700314,La Paz,ENTRE RÍOS,9,9,8,18,26
30,30070,300700401,La Paz,ENTRE RÍOS,54,58,114,123,237
30,30070,300700402,La Paz,ENTRE RÍOS,35,41,61,84,145
30,30070,300700403,La Paz,ENTRE RÍOS,5,14,5,6,11
30,30070,300700404,La Paz,ENTRE RÍOS,15,23,18,22,40
30,30070,300700405,La Paz,ENTRE RÍOS,25,41,39,55,94
30,30070,300700406,La Paz,ENTRE RÍOS,88,87,143,180,323
30,30070,300700407,La Paz,ENTRE RÍOS,43,46,93,92,185
30,30070,300700408,La Paz,ENTRE RÍOS,68,79,126,150,276
30,30070,300700409,La Paz,ENTRE RÍOS,31,32,56,68,124
30,30070,300700410,La Paz,ENTRE RÍOS,3,5,2,3,5
30,30070,300700411,La Paz,ENTRE RÍOS,49,59,85,100,185
30,30070,300700412,La Paz,ENTRE RÍOS,14,18,29,25,54
30,30070,300700413,La Paz,ENTRE RÍOS,35,55,44,76,120
30,30070,300700414,La Paz,ENTRE RÍOS,37,43,78,78,156
30,30070,300700415,La Paz,ENTRE RÍOS,60,65,102,109,211
30,30070,300700416,La Paz,ENTRE RÍOS,21,27,46,43,89
30,30070,300700501,La Paz,ENTRE RÍOS,39,50,36,54,90
30,30070,300700502,La Paz,ENTRE RÍOS,32,37,46,61,107
30,30070,300700503,La Paz,ENTRE RÍOS,37,49,70,81,151
30,30070,300700504,La Paz,ENTRE RÍOS,10,15,16,20,36
30,30070,300700505,La Paz,ENTRE RÍOS,46,55,70,84,154
30,30070,300700506,La Paz,ENTRE RÍOS,42,59,67,72,139
30,30070,300700507,La Paz,ENTRE RÍOS,39,52,77,64,141
30,30070,300700508,La Paz,ENTRE RÍOS,7,19,8,12,20
30,30070,300700509,La Paz,ENTRE RÍOS,29,36,33,55,88
30,30070,300700510,La Paz,ENTRE RÍOS,132,159,240,260,500
30,30070,300700511,La Paz,ENTRE RÍOS,202,220,434,391,825
30,30070,300700601,La Paz,ENTRE RÍOS,8,12,8,13,21
30,30070,300700602,La Paz,ENTRE RÍOS,11,15,21,23,44
30,30070,300700603,La Paz,ENTRE RÍOS,10,11,16,17,33
30,30070,300700604,La Paz,ENTRE RÍOS,21,31,43,45,88
30,30070,300700605,La Paz,ENTRE RÍOS,5,6,5,8,13
30,30070,300700606,La Paz,ENTRE RÍOS,6,6,15,15,30
30,30070,300700607,La Paz,ENTRE RÍOS,19,19,31,38,69
30,30070,300700608,La Paz,ENTRE RÍOS,67,75,140,145,285
30,30070,300700609,La Paz,ENTRE RÍOS,25,32,37,61,98
30,30070,300700701,La Paz,ENTRE RÍOS,57,70,95,109,204
30,30070,300700702,La Paz,ENTRE RÍOS,22,18,39,45,84
30,30070,300700703,La Paz,ENTRE RÍOS,49,53,93,114,207
30,30070,300700704,La Paz,ENTRE RÍOS,20,28,33,41,74
30,30070,300700705,La Paz,ENTRE RÍOS,31,40,45,50,95
30,30070,300700706,La Paz,ENTRE RÍOS,46,60,72,72,144
30,30070,300700801,La Paz,ENTRE RÍOS,13,19,36,40,76
30,30070,300700802,La Paz,ENTRE RÍOS,11,14,20,30,50
30,30070,300700803,La Paz,ENTRE RÍOS,26,39,43,49,92
30,30070,300700804,La Paz,ENTRE RÍOS,16,18,28,28,56
30,30070,300700805,La Paz,ENTRE RÍOS,16,20,13,25,38
30,30070,300700806,La Paz,ENTRE RÍOS,21,31,35,36,71
30,30070,300700807,La Paz,ENTRE RÍOS,16,31,23,27,50
30,30070,300700808,La Paz,ENTRE RÍOS,11,11,11,17,28
30,30070,300700809,La Paz,ENTRE RÍOS,17,15,26,31,57
30,30070,300700810,La Paz,ENTRE RÍOS,133,150,238,236,474
30,30070,300700901,La Paz,ENTRE RÍOS,33,44,51,61,112
30,30070,300700902,La Paz,ENTRE RÍOS,10,15,13,29,42
30,30070,300700903,La Paz,ENTRE RÍOS,68,78,105,127,232
30,30070,300700904,La Paz,ENTRE RÍOS,28,41,40,51,91
30,30070,300700905,La Paz,ENTRE RÍOS,23,36,95,117,212
30,30070,300700906,La Paz,ENTRE RÍOS,5,12,9,10,19
30,30070,300700907,La Paz,ENTRE RÍOS,63,81,91,121,212
30,30070,300700908,La Paz,ENTRE RÍOS,31,57,38,46,84
30,30070,300700909,La Paz,ENTRE RÍOS,77,89,145,136,281
30,30070,300701001,La Paz,ENTRE RÍOS,1,2,1,1,2
30,30070,300701002,La Paz,ENTRE RÍOS,11,15,11,23,34
30,30070,300701003,La Paz,ENTRE RÍOS,111,114,202,210,412
30,30070,300701004,La Paz,ENTRE RÍOS,196,212,497,463,960
30,30070,300701005,La Paz,ENTRE RÍOS,210,225,457,437,894
30,30070,300701006,La Paz,ENTRE RÍOS,130,134,236,217,453
30,30070,300701007,La Paz,ENTRE RÍOS,159,180,264,231,495
30,30070,300701008,La Paz,ENTRE RÍOS,310,338,569,528,1097
30,30070,300701009,La Paz,ENTRE RÍOS,275,293,548,524,1072
30,30070,300701010,La Paz,ENTRE RÍOS,329,365,518,513,1031
30,30070,300701011,La Paz,ENTRE RÍOS,192,200,351,298,649
30,30070,300701101,La Paz,ENTRE RÍOS,193,214,298,276,574
30,30070,300701102,La Paz,ENTRE RÍOS,161,186,255,259,514
30,30070,300701103,La Paz,ENTRE RÍOS,220,241,381,340,721
30,30070,300701104,La Paz,ENTRE RÍOS,320,345,664,596,1260
30,30070,300701105,La Paz,ENTRE RÍOS,182,155,371,346,717
30,30070,300701106,La Paz,ENTRE RÍOS,358,368,610,560,1170
30,30070,300701107,La Paz,ENTRE RÍOS,224,229,491,442,933
30,30070,300701108,La Paz,ENTRE RÍOS,218,227,407,332,739
30,30070,300701109,La Paz,ENTRE RÍOS,214,248,456,437,893
30,30070,300701110,La Paz,ENTRE RÍOS,343,362,774,675,1449
30,30070,300701111,La Paz,ENTRE RÍOS,331,329,744,645,1389
30,30070,300701112,La Paz,ENTRE RÍOS,89,109,192,233,425
30,30070,300701201,La Paz,ENTRE RÍOS,83,111,119,149,268
30,30070,300701202,La Paz,ENTRE RÍOS,21,30,24,38,62
30,30070,300701203,La Paz,ENTRE RÍOS,20,21,36,40,76
30,30070,300701204,La Paz,ENTRE RÍOS,68,88,121,117,238
30,30070,300701205,La Paz,ENTRE RÍOS,25,27,38,38,76
30,30070,300701206,La Paz,ENTRE RÍOS,28,38,33,58,91
30,30070,300701207,La Paz,ENTRE RÍOS,39,53,56,65,121
30,30070,300701208,La Paz,ENTRE RÍOS,25,33,39,50,89
30,30070,300701209,La Paz,ENTRE RÍOS,34,41,61,73,134
30,30070,300701210,La Paz,ENTRE RÍOS,21,21,33,34,67
30,30070,300701211,La Paz,ENTRE RÍOS,0,2,0,0,0
30,30070,300701212,La Paz,ENTRE RÍOS,82,144,130,131,261
30,30070,300701213,La Paz,ENTRE RÍOS,310,361,550,551,1101
30,30070,300701301,La Paz,ENTRE RÍOS,84,95,154,148,302
30,30070,300701302,La Paz,ENTRE RÍOS,93,113,155,156,311
30,30070,300701303,La Paz,ENTRE RÍOS,26,47,41,54,95
30,30070,300701304,La Paz,ENTRE RÍOS,45,59,68,80,148
30,30070,300701305,La Paz,ENTRE RÍOS,12,15,18,19,37
30,30070,300701306,La Paz,ENTRE RÍOS,18,16,31,31,62
30,30070,300701307,La Paz,ENTRE RÍOS,22,27,28,48,76
30,30070,300701308,La Paz,ENTRE RÍOS,58,67,100,93,193
30,30070,300701309,La Paz,ENTRE RÍOS,185,205,353,387,740
30,30070,300701310,La Paz,ENTRE RÍOS,115,135,166,166,332
30,30070,300701311,La Paz,ENTRE RÍOS,175,195,318,307,625
30,30070,300701312,La Paz,ENTRE RÍOS,164,176,304,322,626
30,30070,300701401,La Paz,ENTRE RÍOS,12,19,19,29,48
30,30070,300701402,La Paz,ENTRE RÍOS,18,20,39,25,64
30,30070,300701403,La Paz,ENTRE RÍOS,14,14,19,26,45
30,30070,300701404,La Paz,ENTRE RÍOS,17,17,29,27,56
30,30070,300701405,La Paz,ENTRE RÍOS,312,317,654,695,1349
30,30070,300701406,La Paz,ENTRE RÍOS,227,225,398,351,749
30,30070,300701407,La Paz,ENTRE RÍOS,217,228,415,382,797
30,30070,300701408,La Paz,ENTRE RÍOS,248,248,515,478,993
30,30070,300701409,La Paz,ENTRE RÍOS,225,226,403,352,755
30,30070,300701410,La Paz,ENTRE RÍOS,207,219,308,270,578
30,30070,300701411,La Paz,ENTRE RÍOS,372,384,613,547,1160
30,30070,300701412,La Paz,ENTRE RÍOS,258,264,401,406,807
30,30070,300701413,La Paz,ENTRE RÍOS,329,328,697,692,1389
30,30070,300701501,La Paz,ENTRE RÍOS,4,6,8,11,19
30,30077,300770101,Nogoyá,ENTRE RÍOS,124,139,207,239,446
30,30077,300770102,Nogoyá,ENTRE RÍOS,269,292,499,469,968
30,30077,300770103,Nogoyá,ENTRE RÍOS,179,191,297,283,580
30,30077,300770104,Nogoyá,ENTRE RÍOS,206,228,387,357,744
30,30077,300770105,Nogoyá,ENTRE RÍOS,225,252,427,450,877
30,30077,300770106,Nogoyá,ENTRE RÍOS,191,214,324,324,648
30,30077,300770107,Nogoyá,ENTRE RÍOS,215,247,341,310,651
30,30077,300770108,Nogoyá,ENTRE RÍOS,184,211,303,278,581
30,30077,300770109,Nogoyá,ENTRE RÍOS,228,255,422,337,759
30,30077,300770110,Nogoyá,ENTRE RÍOS,351,372,556,543,1099
30,30077,300770111,Nogoyá,ENTRE RÍOS,147,178,222,169,391
30,30077,300770112,Nogoyá,ENTRE RÍOS,98,105,163,173,336
30,30077,300770113,Nogoyá,ENTRE RÍOS,306,353,486,437,923
30,30077,300770114,Nogoyá,ENTRE RÍOS,276,312,414,313,727
30,30077,300770115,Nogoyá,ENTRE RÍOS,234,266,341,266,607
30,30077,300770201,Nogoyá,ENTRE RÍOS,227,256,380,373,753
30,30077,300770202,Nogoyá,ENTRE RÍOS,290,324,443,372,815
30,30077,300770203,Nogoyá,ENTRE RÍOS,131,145,219,218,437
30,30077,300770204,Nogoyá,ENTRE RÍOS,210,234,333,255,588
30,30077,300770205,Nogoyá,ENTRE RÍOS,217,272,320,266,586
30,30077,300770206,Nogoyá,ENTRE RÍOS,192,219,344,274,618
30,30077,300770207,Nogoyá,ENTRE RÍOS,238,278,405,343,748
30,30077,300770208,Nogoyá,ENTRE RÍOS,210,230,318,257,575
30,30077,300770209,Nogoyá,ENTRE RÍOS,188,196,316,340,656
30,30077,300770210,Nogoyá,ENTRE RÍOS,249,270,439,417,856
30,30077,300770211,Nogoyá,ENTRE RÍOS,254,285,421,387,808
30,30077,300770212,Nogoyá,ENTRE RÍOS,102,115,190,175,365
30,30077,300770213,Nogoyá,ENTRE RÍOS,281,288,556,483,1039
30,30077,300770214,Nogoyá,ENTRE RÍOS,182,203,342,352,694
30,30077,300770215,Nogoyá,ENTRE RÍOS,210,229,408,376,784
30,30077,300770216,Nogoyá,ENTRE RÍOS,324,317,681,679,1360
30,30077,300770217,Nogoyá,ENTRE RÍOS,113,115,230,212,442
30,30077,300770301,Nogoyá,ENTRE RÍOS,18,18,14,23,37
30,30077,300770302,Nogoyá,ENTRE RÍOS,75,91,106,112,218
30,30077,300770303,Nogoyá,ENTRE RÍOS,20,24,38,34,72
30,30077,300770304,Nogoyá,ENTRE RÍOS,84,94,138,158,296
30,30077,300770305,Nogoyá,ENTRE RÍOS,100,136,161,169,330
30,30077,300770306,Nogoyá,ENTRE RÍOS,76,83,150,138,288
30,30077,300770401,Nogoyá,ENTRE RÍOS,14,19,18,20,38
30,30077,300770402,Nogoyá,ENTRE RÍOS,20,25,42,28,70
30,30077,300770403,Nogoyá,ENTRE RÍOS,39,50,54,69,123
30,30077,300770404,Nogoyá,ENTRE RÍOS,27,30,42,55,97
30,30077,300770405,Nogoyá,ENTRE RÍOS,51,60,75,100,175
30,30077,300770406,Nogoyá,ENTRE RÍOS,27,31,60,41,101
30,30077,300770407,Nogoyá,ENTRE RÍOS,28,31,54,54,108
30,30077,300770408,Nogoyá,ENTRE RÍOS,38,41,66,81,147
30,30077,300770409,Nogoyá,ENTRE RÍOS,15,21,27,25,52
30,30077,300770410,Nogoyá,ENTRE RÍOS,31,49,46,59,105
30,30077,300770411,Nogoyá,ENTRE RÍOS,26,34,29,38,67
30,30077,300770412,Nogoyá,ENTRE RÍOS,15,19,26,23,49
30,30077,300770413,Nogoyá,ENTRE RÍOS,9,3,14,10,24
30,30077,300770414,Nogoyá,ENTRE RÍOS,41,57,57,71,128
30,30077,300770415,Nogoyá,ENTRE RÍOS,24,27,41,36,77
30,30077,300770416,Nogoyá,ENTRE RÍOS,32,37,57,63,120
30,30077,300770417,Nogoyá,ENTRE RÍOS,16,16,23,29,52
30,30077,300770501,Nogoyá,ENTRE RÍOS,32,46,57,54,111
30,30077,300770502,Nogoyá,ENTRE RÍOS,5,11,8,10,18
30,30077,300770503,Nogoyá,ENTRE RÍOS,24,24,28,42,70
30,30077,300770504,Nogoyá,ENTRE RÍOS,18,22,24,30,54
30,30077,300770505,Nogoyá,ENTRE RÍOS,48,55,80,88,168
30,30077,300770506,Nogoyá,ENTRE RÍOS,40,49,60,74,134
30,30077,300770507,Nogoyá,ENTRE RÍOS,42,48,73,65,138
30,30077,300770508,Nogoyá,ENTRE RÍOS,21,31,25,31,56
30,30077,300770509,Nogoyá,ENTRE RÍOS,7,8,5,12,17
30,30077,300770510,Nogoyá,ENTRE RÍOS,32,41,45,51,96
30,30077,300770511,Nogoyá,ENTRE RÍOS,10,13,11,15,26
30,30077,300770512,Nogoyá,ENTRE RÍOS,5,14,7,9,16
30,30077,300770513,Nogoyá,ENTRE RÍOS,30,33,31,42,73
30,30077,300770514,Nogoyá,ENTRE RÍOS,33,38,58,61,119
30,30077,300770515,Nogoyá,ENTRE RÍOS,20,29,32,35,67
30,30077,300770516,Nogoyá,ENTRE RÍOS,50,52,73,87,160
30,30077,300770517,Nogoyá,ENTRE RÍOS,29,30,45,47,92
30,30077,300770518,Nogoyá,ENTRE RÍOS,21,22,33,42,75
30,30077,300770519,Nogoyá,ENTRE RÍOS,7,14,5,10,15
30,30077,300770601,Nogoyá,ENTRE RÍOS,46,48,74,81,155
30,30077,300770602,Nogoyá,ENTRE RÍOS,11,15,14,18,32
30,30077,300770603,Nogoyá,ENTRE RÍOS,41,46,56,80,136
30,30077,300770604,Nogoyá,ENTRE RÍOS,6,9,6,9,15
30,30077,300770605,Nogoyá,ENTRE RÍOS,45,62,84,85,169
30,30077,300770606,Nogoyá,ENTRE RÍOS,38,45,54,71,125
30,30077,300770607,Nogoyá,ENTRE RÍOS,35,41,51,55,106
30,30077,300770608,Nogoyá,ENTRE RÍOS,14,27,12,20,32
30,30077,300770609,Nogoyá,ENTRE RÍOS,18,29,21,33,54
30,30077,300770610,Nogoyá,ENTRE RÍOS,30,46,46,64,110
30,30077,300770611,Nogoyá,ENTRE RÍOS,19,33,32,42,74
30,30077,300770612,Nogoyá,ENTRE RÍOS,95,119,150,157,307
30,30077,300770613,Nogoyá,ENTRE RÍOS,5,6,5,11,16
30,30077,300770701,Nogoyá,ENTRE RÍOS,47,52,79,78,157
30,30077,300770702,Nogoyá,ENTRE RÍOS,30,41,46,54,100
30,30077,300770703,Nogoyá,ENTRE RÍOS,16,19,22,27,49
30,30077,300770704,Nogoyá,ENTRE RÍOS,19,30,25,25,50
30,30077,300770705,Nogoyá,ENTRE RÍOS,24,34,27,36,63
30,30077,300770706,Nogoyá,ENTRE RÍOS,235,276,323,350,673
30,30077,300770707,Nogoyá,ENTRE RÍOS,259,285,454,444,898
30,30077,300770708,Nogoyá,ENTRE RÍOS,10,16,20,24,44
30,30077,300770709,Nogoyá,ENTRE RÍOS,25,39,40,47,87
30,30077,300770710,Nogoyá,ENTRE RÍOS,21,30,25,38,63
30,30077,300770711,Nogoyá,ENTRE RÍOS,7,16,8,11,19
30,30077,300770801,Nogoyá,ENTRE RÍOS,89,109,144,141,285
30,30077,300770802,Nogoyá,ENTRE RÍOS,140,170,202,213,415
30,30077,300770803,Nogoyá,ENTRE RÍOS,146,191,209,201,410
30,30077,300770804,Nogoyá,ENTRE RÍOS,170,209,230,170,400
30,30077,300770805,Nogoyá,ENTRE RÍOS,31,37,42,45,87
30,30077,300770806,Nogoyá,ENTRE RÍOS,62,79,81,97,178
30,30077,300770807,Nogoyá,ENTRE RÍOS,6,14,8,7,15
30,30077,300770901,Nogoyá,ENTRE RÍOS,21,25,30,35,65
30,30077,300770902,Nogoyá,ENTRE RÍOS,13,22,26,18,44
30,30077,300770903,Nogoyá,ENTRE RÍOS,25,32,29,34,63
30,30077,300770904,Nogoyá,ENTRE RÍOS,66,83,90,124,214
30,30077,300770905,Nogoyá,ENTRE RÍOS,8,16,12,20,32
30,30077,300770906,Nogoyá,ENTRE RÍOS,95,156,114,134,248
30,30077,300770907,Nogoyá,ENTRE RÍOS,20,27,25,31,56
30,30077,300770908,Nogoyá,ENTRE RÍOS,23,33,32,46,78
30,30077,300771001,Nogoyá,ENTRE RÍOS,27,38,34,43,77
30,30077,300771002,Nogoyá,ENTRE RÍOS,31,41,48,62,110
30,30077,300771003,Nogoyá,ENTRE RÍOS,14,18,27,32,59
30,30077,300771004,Nogoyá,ENTRE RÍOS,9,22,10,16,26
30,30077,300771005,Nogoyá,ENTRE RÍOS,13,21,17,14,31
30,30077,300771006,Nogoyá,ENTRE RÍOS,4,6,5,6,11
30,30077,300771101,Nogoyá,ENTRE RÍOS,36,69,47,51,98
30,30077,300771102,Nogoyá,ENTRE RÍOS,20,36,34,43,77
30,30077,300771103,Nogoyá,ENTRE RÍOS,59,87,83,95,178
30,30077,300771104,Nogoyá,ENTRE RÍOS,23,23,28,35,63
30,30077,300771105,Nogoyá,ENTRE RÍOS,20,23,28,30,58
30,30077,300771106,Nogoyá,ENTRE RÍOS,8,15,10,13,23
30,30077,300771107,Nogoyá,ENTRE RÍOS,3,6,2,5,7
30,30077,300771108,Nogoyá,ENTRE RÍOS,21,24,36,32,68
30,30077,300771109,Nogoyá,ENTRE RÍOS,26,33,39,49,88
30,30077,300771110,Nogoyá,ENTRE RÍOS,33,44,70,64,134
30,30077,300771111,Nogoyá,ENTRE RÍOS,27,38,40,35,75
30,30077,300771112,Nogoyá,ENTRE RÍOS,37,47,53,63,116
30,30077,300771113,Nogoyá,ENTRE RÍOS,38,43,61,58,119
30,30077,300771114,Nogoyá,ENTRE RÍOS,31,37,37,50,87
30,30077,300771115,Nogoyá,ENTRE RÍOS,20,32,26,43,69
30,30077,300771201,Nogoyá,ENTRE RÍOS,295,353,498,499,997
30,30077,300771202,Nogoyá,ENTRE RÍOS,132,147,217,205,422
30,30077,300771203,Nogoyá,ENTRE RÍOS,213,230,321,259,580
30,30077,300771204,Nogoyá,ENTRE RÍOS,199,225,276,239,515
30,30077,300771205,Nogoyá,ENTRE RÍOS,199,223,297,254,551
30,30077,300771206,Nogoyá,ENTRE RÍOS,170,211,261,248,509
30,30077,300771207,Nogoyá,ENTRE RÍOS,236,274,349,338,687
30,30077,300771208,Nogoyá,ENTRE RÍOS,35,48,68,69,137
30,30077,300771209,Nogoyá,ENTRE RÍOS,29,36,44,44,88
30,30077,300771210,Nogoyá,ENTRE RÍOS,14,20,21,17,38
30,30077,300771211,Nogoyá,ENTRE RÍOS,10,13,16,15,31
30,30077,300771212,Nogoyá,ENTRE RÍOS,11,21,15,12,27
30,30077,300771213,Nogoyá,ENTRE RÍOS,2,4,1,5,6
30,30088,300880101,San Salvador,ENTRE RÍOS,279,274,405,377,782
30,30088,300880102,San Salvador,ENTRE RÍOS,271,308,359,372,731
30,30088,300880103,San Salvador,ENTRE RÍOS,364,412,550,524,1074
30,30088,300880104,San Salvador,ENTRE RÍOS,246,273,370,319,689
30,30088,300880105,San Salvador,ENTRE RÍOS,230,243,304,285,589
30,30088,300880106,San Salvador,ENTRE RÍOS,275,312,431,421,852
30,30088,300880107,San Salvador,ENTRE RÍOS,232,245,360,351,711
30,30088,300880201,San Salvador,ENTRE RÍOS,53,65,84,107,191
30,30088,300880202,San Salvador,ENTRE RÍOS,38,64,57,73,130
30,30088,300880203,San Salvador,ENTRE RÍOS,52,54,88,86,174
30,30088,300880204,San Salvador,ENTRE RÍOS,263,313,519,529,1048
30,30088,300880205,San Salvador,ENTRE RÍOS,386,411,791,835,1626
30,30088,300880206,San Salvador,ENTRE RÍOS,341,349,623,606,1229
30,30088,300880207,San Salvador,ENTRE RÍOS,318,344,598,546,1144
30,30088,300880208,San Salvador,ENTRE RÍOS,315,347,554,528,1082
30,30088,300880209,San Salvador,ENTRE RÍOS,196,214,373,400,773
30,30088,300880210,San Salvador,ENTRE RÍOS,108,112,201,202,403
30,30088,300880301,San Salvador,ENTRE RÍOS,131,151,227,235,462
30,30088,300880302,San Salvador,ENTRE RÍOS,12,16,12,21,33
30,30088,300880303,San Salvador,ENTRE RÍOS,6,9,6,5,11
30,30088,300880304,San Salvador,ENTRE RÍOS,101,115,171,191,362
30,30088,300880305,San Salvador,ENTRE RÍOS,157,167,276,245,521
30,30088,300880306,San Salvador,ENTRE RÍOS,236,252,385,386,771
30,30088,300880307,San Salvador,ENTRE RÍOS,162,191,242,216,458
30,30088,300880308,San Salvador,ENTRE RÍOS,161,175,271,260,531
30,30088,300880401,San Salvador,ENTRE RÍOS,5,6,7,9,16
30,30088,300880402,San Salvador,ENTRE RÍOS,23,30,36,40,76
30,30088,300880403,San Salvador,ENTRE RÍOS,9,11,10,10,20
30,30088,300880404,San Salvador,ENTRE RÍOS,17,21,21,24,45
30,30088,300880405,San Salvador,ENTRE RÍOS,33,42,43,57,100
30,30088,300880501,San Salvador,ENTRE RÍOS,20,24,31,34,65
30,30088,300880502,San Salvador,ENTRE RÍOS,5,9,3,9,12
30,30088,300880503,San Salvador,ENTRE RÍOS,14,19,15,29,44
30,30088,300880504,San Salvador,ENTRE RÍOS,23,29,25,42,67
30,30088,300880601,San Salvador,ENTRE RÍOS,2,10,1,2,3
30,30088,300880602,San Salvador,ENTRE RÍOS,11,14,9,16,25
30,30088,300880603,San Salvador,ENTRE RÍOS,7,11,11,9,20
30,30088,300880604,San Salvador,ENTRE RÍOS,11,24,16,15,31
30,30088,300880605,San Salvador,ENTRE RÍOS,1,11,1,2,3
30,30088,300880606,San Salvador,ENTRE RÍOS,8,9,11,10,21
30,30088,300880701,San Salvador,ENTRE RÍOS,33,39,44,53,97
30,30088,300880702,San Salvador,ENTRE RÍOS,17,31,27,32,59
30,30088,300880703,San Salvador,ENTRE RÍOS,7,11,11,7,18
30,30088,300880704,San Salvador,ENTRE RÍOS,23,35,36,35,71
30,30088,300880705,San Salvador,ENTRE RÍOS,4,8,9,8,17
30,30088,300880706,San Salvador,ENTRE RÍOS,21,28,36,37,73
30,30088,300880707,San Salvador,ENTRE RÍOS,30,39,43,54,97
30,30091,300910101,Tala,ENTRE RÍOS,277,292,519,565,1084
30,30091,300910102,Tala,ENTRE RÍOS,314,321,566,495,1061
30,30091,300910103,Tala,ENTRE RÍOS,385,417,592,477,1069
30,30091,300910104,Tala,ENTRE RÍOS,261,287,359,292,651
30,30091,300910105,Tala,ENTRE RÍOS,198,216,308,256,564
30,30091,300910106,Tala,ENTRE RÍOS,188,224,248,208,456
30,30091,300910107,Tala,ENTRE RÍOS,181,198,287,220,507
30,30091,300910108,Tala,ENTRE RÍOS,258,288,460,445,905
30,30091,300910109,Tala,ENTRE RÍOS,288,357,435,422,857
30,30091,300910110,Tala,ENTRE RÍOS,183,214,280,281,561
30,30091,300910111,Tala,ENTRE RÍOS,196,220,310,222,532
30,30091,300910112,Tala,ENTRE RÍOS,170,194,270,223,493
30,30091,300910113,Tala,ENTRE RÍOS,212,236,355,331,686
30,30091,300910114,Tala,ENTRE RÍOS,56,73,100,89,189
30,30091,300910115,Tala,ENTRE RÍOS,175,199,316,302,618
30,30091,300910116,Tala,ENTRE RÍOS,332,354,520,458,978
30,30091,300910117,Tala,ENTRE RÍOS,208,239,319,295,614
30,30091,300910118,Tala,ENTRE RÍOS,239,264,430,416,846
30,30091,300910201,Tala,ENTRE RÍOS,9,13,15,13,28
30,30091,300910202,Tala,ENTRE RÍOS,10,17,18,18,36
30,30091,300910203,Tala,ENTRE RÍOS,56,66,90,92,182
30,30091,300910204,Tala,ENTRE RÍOS,28,37,34,56,90
30,30091,300910205,Tala,ENTRE RÍOS,46,107,75,65,140
30,30091,300910206,Tala,ENTRE RÍOS,6,8,8,20,28
30,30091,300910207,Tala,ENTRE RÍOS,52,66,77,86,163
30,30091,300910208,Tala,ENTRE RÍOS,103,147,139,170,309
30,30091,300910209,Tala,ENTRE RÍOS,20,27,37,39,76
30,30091,300910301,Tala,ENTRE RÍOS,15,19,22,32,54
30,30091,300910302,Tala,ENTRE RÍOS,95,133,140,154,294
30,30091,300910303,Tala,ENTRE RÍOS,20,25,23,30,53
30,30091,300910304,Tala,ENTRE RÍOS,60,72,76,76,152
30,30091,300910305,Tala,ENTRE RÍOS,28,32,43,49,92
30,30091,300910306,Tala,ENTRE RÍOS,39,41,47,78,125
30,30091,300910307,Tala,ENTRE RÍOS,50,66,67,77,144
30,30091,300910308,Tala,ENTRE RÍOS,9,12,7,12,19
30,30091,300910309,Tala,ENTRE RÍOS,24,43,21,34,55
30,30091,300910401,Tala,ENTRE RÍOS,1,2,0,1,1
30,30091,300910402,Tala,ENTRE RÍOS,17,24,27,27,54
30,30091,300910403,Tala,ENTRE RÍOS,37,49,39,55,94
30,30091,300910404,Tala,ENTRE RÍOS,40,48,53,69,122
30,30091,300910405,Tala,ENTRE RÍOS,19,35,27,28,55
30,30091,300910406,Tala,ENTRE RÍOS,11,19,15,21,36
30,30091,300910407,Tala,ENTRE RÍOS,13,17,10,23,33
30,30091,300910501,Tala,ENTRE RÍOS,219,256,308,346,654
30,30091,300910502,Tala,ENTRE RÍOS,258,295,374,340,714
30,30091,300910503,Tala,ENTRE RÍOS,236,257,352,340,692
30,30091,300910504,Tala,ENTRE RÍOS,229,254,398,393,791
30,30091,300910505,Tala,ENTRE RÍOS,138,156,178,167,345
30,30091,300910506,Tala,ENTRE RÍOS,311,362,483,416,899
30,30091,300910507,Tala,ENTRE RÍOS,260,315,427,385,812
30,30091,300910508,Tala,ENTRE RÍOS,232,259,487,476,963
30,30091,300910509,Tala,ENTRE RÍOS,58,64,89,87,176
30,30091,300910510,Tala,ENTRE RÍOS,25,33,37,38,75
30,30091,300910511,Tala,ENTRE RÍOS,11,15,18,21,39
30,30091,300910512,Tala,ENTRE RÍOS,11,14,20,16,36
30,30091,300910601,Tala,ENTRE RÍOS,18,25,25,35,60
30,30091,300910602,Tala,ENTRE RÍOS,12,25,14,16,30
30,30091,300910603,Tala,ENTRE RÍOS,6,6,14,8,22
30,30091,300910604,Tala,ENTRE RÍOS,19,20,43,44,87
30,30091,300910605,Tala,ENTRE RÍOS,9,17,20,14,34
30,30091,300910606,Tala,ENTRE RÍOS,158,210,248,243,491
30,30091,300910701,Tala,ENTRE RÍOS,14,27,15,18,33
30,30091,300910702,Tala,ENTRE RÍOS,74,101,101,100,201
30,30091,300910703,Tala,ENTRE RÍOS,18,28,22,39,61
30,30091,300910704,Tala,ENTRE RÍOS,5,13,5,8,13
30,30091,300910705,Tala,ENTRE RÍOS,7,13,9,8,17
30,30091,300910706,Tala,ENTRE RÍOS,6,17,8,15,23
30,30091,300910801,Tala,ENTRE RÍOS,13,21,20,22,42
30,30091,300910802,Tala,ENTRE RÍOS,17,31,25,32,57
30,30091,300910803,Tala,ENTRE RÍOS,11,15,18,18,36
30,30091,300910804,Tala,ENTRE RÍOS,5,11,7,12,19
30,30091,300910805,Tala,ENTRE RÍOS,10,12,12,12,24
30,30091,300910806,Tala,ENTRE RÍOS,8,11,6,13,19
30,30091,300910807,Tala,ENTRE RÍOS,14,21,14,17,31
30,30091,300910808,Tala,ENTRE RÍOS,65,91,96,122,218
30,30091,300910901,Tala,ENTRE RÍOS,14,18,23,15,38
30,30091,300910902,Tala,ENTRE RÍOS,5,5,9,8,17
30,30091,300910903,Tala,ENTRE RÍOS,35,58,50,52,102
30,30091,300910904,Tala,ENTRE RÍOS,10,12,7,12,19
30,30091,300910905,Tala,ENTRE RÍOS,23,26,24,38,62
30,30091,300910906,Tala,ENTRE RÍOS,4,6,6,5,11
30,30091,300911001,Tala,ENTRE RÍOS,137,167,209,204,413
30,30091,300911002,Tala,ENTRE RÍOS,189,227,256,269,525
30,30091,300911003,Tala,ENTRE RÍOS,171,208,255,251,506
30,30091,300911004,Tala,ENTRE RÍOS,205,241,303,299,602
30,30091,300911005,Tala,ENTRE RÍOS,89,124,126,124,250
30,30091,300911101,Tala,ENTRE RÍOS,9,18,12,13,25
30,30091,300911102,Tala,ENTRE RÍOS,16,24,13,19,32
30,30091,300911103,Tala,ENTRE RÍOS,13,18,16,19,35
30,30091,300911104,Tala,ENTRE RÍOS,7,18,7,9,16
30,30091,300911105,Tala,ENTRE RÍOS,50,83,62,74,136
30,30091,300911106,Tala,ENTRE RÍOS,23,36,24,32,56
30,30098,300980101,Uruguay,ENTRE RÍOS,363,336,680,744,1424
30,30098,300980102,Uruguay,ENTRE RÍOS,278,289,446,448,894
30,30098,300980103,Uruguay,ENTRE RÍOS,233,240,393,416,809
30,30098,300980104,Uruguay,ENTRE RÍOS,267,296,423,396,819
30,30098,300980105,Uruguay,ENTRE RÍOS,268,290,493,402,895
30,30098,300980106,Uruguay,ENTRE RÍOS,370,387,643,630,1273
30,30098,300980107,Uruguay,ENTRE RÍOS,221,245,370,366,736
30,30098,300980108,Uruguay,ENTRE RÍOS,262,271,382,380,762
30,30098,300980109,Uruguay,ENTRE RÍOS,347,391,498,447,945
30,30098,300980110,Uruguay,ENTRE RÍOS,323,367,449,462,911
30,30098,300980111,Uruguay,ENTRE RÍOS,298,312,565,580,1145
30,30098,300980112,Uruguay,ENTRE RÍOS,341,385,556,493,1049
30,30098,300980113,Uruguay,ENTRE RÍOS,377,404,551,463,1014
30,30098,300980114,Uruguay,ENTRE RÍOS,212,235,309,272,581
30,30098,300980115,Uruguay,ENTRE RÍOS,264,282,374,360,734
30,30098,300980116,Uruguay,ENTRE RÍOS,435,429,744,685,1429
30,30098,300980117,Uruguay,ENTRE RÍOS,296,295,513,500,1013
30,30098,300980118,Uruguay,ENTRE RÍOS,248,267,404,393,797
30,30098,300980119,Uruguay,ENTRE RÍOS,225,234,401,407,808
30,30098,300980120,Uruguay,ENTRE RÍOS,161,179,247,255,502
30,30098,300980201,Uruguay,ENTRE RÍOS,304,296,484,454,938
30,30098,300980202,Uruguay,ENTRE RÍOS,324,336,534,513,1047
30,30098,300980203,Uruguay,ENTRE RÍOS,300,307,495,432,927
30,30098,300980204,Uruguay,ENTRE RÍOS,322,344,452,385,837
30,30098,300980205,Uruguay,ENTRE RÍOS,318,392,450,382,832
30,30098,300980206,Uruguay,ENTRE RÍOS,142,165,196,194,390
30,30098,300980207,Uruguay,ENTRE RÍOS,206,226,319,287,606
30,30098,300980208,Uruguay,ENTRE RÍOS,324,302,474,408,882
30,30098,300980209,Uruguay,ENTRE RÍOS,318,312,598,549,1147
30,30098,300980210,Uruguay,ENTRE RÍOS,251,269,403,402,805
30,30098,300980211,Uruguay,ENTRE RÍOS,327,343,514,544,1058
30,30098,300980212,Uruguay,ENTRE RÍOS,333,364,565,566,1131
30,30098,300980213,Uruguay,ENTRE RÍOS,230,222,371,359,730
30,30098,300980214,Uruguay,ENTRE RÍOS,287,295,503,490,993
30,30098,300980215,Uruguay,ENTRE RÍOS,234,257,353,339,692
30,30098,300980301,Uruguay,ENTRE RÍOS,160,177,267,214,481
30,30098,300980302,Uruguay,ENTRE RÍOS,212,254,282,251,533
30,30098,300980303,Uruguay,ENTRE RÍOS,349,447,492,375,867
30,30098,300980304,Uruguay,ENTRE RÍOS,331,393,443,382,825
30,30098,300980305,Uruguay,ENTRE RÍOS,298,362,420,396,816
30,30098,300980306,Uruguay,ENTRE RÍOS,206,238,321,274,595
30,30098,300980307,Uruguay,ENTRE RÍOS,231,327,327,263,590
30,30098,300980308,Uruguay,ENTRE RÍOS,207,292,253,221,474
30,30098,300980309,Uruguay,ENTRE RÍOS,202,256,285,235,520
30,30098,300980310,Uruguay,ENTRE RÍOS,194,243,257,172,429
30,30098,300980311,Uruguay,ENTRE RÍOS,56,77,65,54,119
30,30098,300980312,Uruguay,ENTRE RÍOS,183,234,267,151,418
30,30098,300980313,Uruguay,ENTRE RÍOS,133,190,200,159,359
30,30098,300980314,Uruguay,ENTRE RÍOS,201,241,288,270,558
30,30098,300980315,Uruguay,ENTRE RÍOS,147,170,178,184,362
30,30098,300980316,Uruguay,ENTRE RÍOS,277,320,370,361,731
30,30098,300980317,Uruguay,ENTRE RÍOS,151,160,217,168,385
30,30098,300980318,Uruguay,ENTRE RÍOS,223,266,304,242,546
30,30098,300980401,Uruguay,ENTRE RÍOS,182,195,289,239,528
30,30098,300980402,Uruguay,ENTRE RÍOS,226,210,334,300,634
30,30098,300980403,Uruguay,ENTRE RÍOS,263,264,375,336,711
30,30098,300980404,Uruguay,ENTRE RÍOS,178,191,243,180,423
30,30098,300980405,Uruguay,ENTRE RÍOS,151,191,211,169,380
30,30098,300980406,Uruguay,ENTRE RÍOS,210,270,291,211,502
30,30098,300980407,Uruguay,ENTRE RÍOS,146,165,203,157,360
30,30098,300980408,Uruguay,ENTRE RÍOS,189,218,272,201,473
30,30098,300980409,Uruguay,ENTRE RÍOS,224,235,331,280,611
30,30098,300980410,Uruguay,ENTRE RÍOS,293,290,501,518,1019
30,30098,300980411,Uruguay,ENTRE RÍOS,289,281,463,434,897
30,30098,300980412,Uruguay,ENTRE RÍOS,216,225,313,304,617
30,30098,300980413,Uruguay,ENTRE RÍOS,303,318,494,476,970
30,30098,300980414,Uruguay,ENTRE RÍOS,247,270,395,369,764
30,30098,300980415,Uruguay,ENTRE RÍOS,179,214,230,315,545
30,30098,300980416,Uruguay,ENTRE RÍOS,225,244,294,288,582
30,30098,300980417,Uruguay,ENTRE RÍOS,249,284,335,287,622
30,30098,300980418,Uruguay,ENTRE RÍOS,268,280,498,456,954
30,30098,300980419,Uruguay,ENTRE RÍOS,166,176,254,260,514
30,30098,300980420,Uruguay,ENTRE RÍOS,167,226,202,189,391
30,30098,300980421,Uruguay,ENTRE RÍOS,181,223,234,227,461
30,30098,300980501,Uruguay,ENTRE RÍOS,118,97,191,206,397
30,30098,300980502,Uruguay,ENTRE RÍOS,153,200,223,268,491
30,30098,300980503,Uruguay,ENTRE RÍOS,47,86,65,92,157
30,30098,300980504,Uruguay,ENTRE RÍOS,267,250,576,548,1124
30,30098,300980505,Uruguay,ENTRE RÍOS,26,35,47,34,81
30,30098,300980506,Uruguay,ENTRE RÍOS,319,258,609,625,1234
30,30098,300980507,Uruguay,ENTRE RÍOS,235,248,452,423,875
30,30098,300980508,Uruguay,ENTRE RÍOS,319,328,646,681,1327
30,30098,300980509,Uruguay,ENTRE RÍOS,379,373,806,774,1580
30,30098,300980510,Uruguay,ENTRE RÍOS,249,284,499,434,933
30,30098,300980511,Uruguay,ENTRE RÍOS,328,356,575,475,1050
30,30098,300980512,Uruguay,ENTRE RÍOS,268,264,479,448,927
30,30098,300980513,Uruguay,ENTRE RÍOS,223,233,532,462,994
30,30098,300980514,Uruguay,ENTRE RÍOS,70,92,128,124,252
30,30098,300980601,Uruguay,ENTRE RÍOS,11,13,22,28,50
30,30098,300980602,Uruguay,ENTRE RÍOS,57,87,102,101,203
30,30098,300980603,Uruguay,ENTRE RÍOS,91,133,120,139,259
30,30098,300980604,Uruguay,ENTRE RÍOS,82,68,136,130,266
30,30098,300980605,Uruguay,ENTRE RÍOS,229,244,364,407,771
30,30098,300980606,Uruguay,ENTRE RÍOS,365,393,703,748,1451
30,30098,300980607,Uruguay,ENTRE RÍOS,298,280,605,578,1183
30,30098,300980608,Uruguay,ENTRE RÍOS,343,367,607,526,1133
30,30098,300980609,Uruguay,ENTRE RÍOS,131,134,207,226,433
30,30098,300980610,Uruguay,ENTRE RÍOS,229,240,409,420,829
30,30098,300980611,Uruguay,ENTRE RÍOS,343,353,600,578,1178
30,30098,300980612,Uruguay,ENTRE RÍOS,37,52,51,66,117
30,30098,300980613,Uruguay,ENTRE RÍOS,33,44,59,66,125
30,30098,300980614,Uruguay,ENTRE RÍOS,68,100,78,110,188
30,30098,300980701,Uruguay,ENTRE RÍOS,370,420,571,504,1075
30,30098,300980702,Uruguay,ENTRE RÍOS,90,104,171,147,318
30,30098,300980703,Uruguay,ENTRE RÍOS,250,267,396,368,764
30,30098,300980704,Uruguay,ENTRE RÍOS,189,209,306,255,561
30,30098,300980705,Uruguay,ENTRE RÍOS,115,104,218,197,415
30,30098,300980706,Uruguay,ENTRE RÍOS,172,203,241,230,471
30,30098,300980707,Uruguay,ENTRE RÍOS,285,310,478,427,905
30,30098,300980708,Uruguay,ENTRE RÍOS,187,233,277,233,510
30,30098,300980709,Uruguay,ENTRE RÍOS,209,223,326,274,600
30,30098,300980710,Uruguay,ENTRE RÍOS,201,232,276,232,508
30,30098,300980711,Uruguay,ENTRE RÍOS,175,195,280,270,550
30,30098,300980712,Uruguay,ENTRE RÍOS,151,164,236,208,444
30,30098,300980713,Uruguay,ENTRE RÍOS,205,218,308,295,603
30,30098,300980714,Uruguay,ENTRE RÍOS,174,185,278,275,553
30,30098,300980715,Uruguay,ENTRE RÍOS,223,236,381,430,811
30,30098,300980716,Uruguay,ENTRE RÍOS,108,113,190,207,397
30,30098,300980801,Uruguay,ENTRE RÍOS,13,15,16,21,37
30,30098,300980802,Uruguay,ENTRE RÍOS,14,14,16,29,45
30,30098,300980803,Uruguay,ENTRE RÍOS,6,8,8,8,16
30,30098,300980804,Uruguay,ENTRE RÍOS,12,14,15,19,34
30,30098,300980805,Uruguay,ENTRE RÍOS,21,38,66,59,125
30,30098,300980901,Uruguay,ENTRE RÍOS,10,25,13,18,31
30,30098,300980902,Uruguay,ENTRE RÍOS,9,15,13,20,33
30,30098,300980903,Uruguay,ENTRE RÍOS,136,176,187,196,383
30,30098,300980904,Uruguay,ENTRE RÍOS,1,6,7,3,10
30,30098,300980905,Uruguay,ENTRE RÍOS,7,15,14,11,25
30,30098,300980906,Uruguay,ENTRE RÍOS,50,65,60,77,137
30,30098,300980907,Uruguay,ENTRE RÍOS,113,138,159,161,320
30,30098,300980908,Uruguay,ENTRE RÍOS,101,124,148,171,319
30,30098,300980909,Uruguay,ENTRE RÍOS,23,37,33,46,79
30,30098,300980910,Uruguay,ENTRE RÍOS,33,52,40,62,102
30,30098,300980911,Uruguay,ENTRE RÍOS,12,22,12,21,33
30,30098,300980912,Uruguay,ENTRE RÍOS,75,97,97,111,208
30,30098,300980913,Uruguay,ENTRE RÍOS,84,119,114,125,239
30,30098,300980914,Uruguay,ENTRE RÍOS,55,70,79,85,164
30,30098,300980915,Uruguay,ENTRE RÍOS,18,30,33,32,65
30,30098,300980916,Uruguay,ENTRE RÍOS,14,20,17,24,41
30,30098,300980917,Uruguay,ENTRE RÍOS,20,21,26,28,54
30,30098,300981001,Uruguay,ENTRE RÍOS,223,292,279,282,561
30,30098,300981002,Uruguay,ENTRE RÍOS,218,291,313,313,626
30,30098,300981003,Uruguay,ENTRE RÍOS,44,62,61,67,128
30,30098,300981004,Uruguay,ENTRE RÍOS,24,42,27,38,65
30,30098,300981005,Uruguay,ENTRE RÍOS,47,54,63,71,134
30,30098,300981006,Uruguay,ENTRE RÍOS,11,14,15,25,40
30,30098,300981007,Uruguay,ENTRE RÍOS,7,12,8,13,21
30,30098,300981101,Uruguay,ENTRE RÍOS,119,153,180,166,346
30,30098,300981102,Uruguay,ENTRE RÍOS,120,135,178,186,364
30,30098,300981103,Uruguay,ENTRE RÍOS,127,158,208,193,401
30,30098,300981104,Uruguay,ENTRE RÍOS,99,112,155,161,316
30,30098,300981105,Uruguay,ENTRE RÍOS,16,28,20,21,41
30,30098,300981106,Uruguay,ENTRE RÍOS,10,18,15,12,27
30,30098,300981201,Uruguay,ENTRE RÍOS,10,15,17,21,38
30,30098,300981202,Uruguay,ENTRE RÍOS,6,9,6,11,17
30,30098,300981203,Uruguay,ENTRE RÍOS,13,33,15,17,32
30,30098,300981204,Uruguay,ENTRE RÍOS,6,13,4,8,12
30,30098,300981205,Uruguay,ENTRE RÍOS,9,17,11,11,22
30,30098,300981206,Uruguay,ENTRE RÍOS,7,15,12,11,23
30,30098,300981301,Uruguay,ENTRE RÍOS,12,13,13,19,32
30,30098,300981302,Uruguay,ENTRE RÍOS,7,3,6,11,17
30,30098,300981303,Uruguay,ENTRE RÍOS,14,20,22,24,46
30,30098,300981304,Uruguay,ENTRE RÍOS,5,12,10,8,18
30,30098,300981305,Uruguay,ENTRE RÍOS,13,19,21,27,48
30,30098,300981306,Uruguay,ENTRE RÍOS,23,23,27,41,68
30,30098,300981307,Uruguay,ENTRE RÍOS,43,53,60,81,141
30,30098,300981308,Uruguay,ENTRE RÍOS,22,19,25,37,62
30,30098,300981309,Uruguay,ENTRE RÍOS,141,159,213,214,427
30,30098,300981310,Uruguay,ENTRE RÍOS,153,187,240,217,457
30,30098,300981311,Uruguay,ENTRE RÍOS,130,147,196,171,367
30,30098,300981312,Uruguay,ENTRE RÍOS,59,70,85,100,185
30,30098,300981313,Uruguay,ENTRE RÍOS,21,25,27,41,68
30,30098,300981314,Uruguay,ENTRE RÍOS,18,23,24,36,60
30,30098,300981401,Uruguay,ENTRE RÍOS,34,44,49,56,105
30,30098,300981402,Uruguay,ENTRE RÍOS,32,51,43,56,99
30,30098,300981403,Uruguay,ENTRE RÍOS,37,48,61,61,122
30,30098,300981404,Uruguay,ENTRE RÍOS,11,11,18,19,37
30,30098,300981405,Uruguay,ENTRE RÍOS,243,282,344,352,696
30,30098,300981406,Uruguay,ENTRE RÍOS,39,46,51,57,108
30,30098,300981407,Uruguay,ENTRE RÍOS,26,29,37,42,79
30,30098,300981408,Uruguay,ENTRE RÍOS,14,27,11,19,30
30,30098,300981409,Uruguay,ENTRE RÍOS,327,373,495,481,976
30,30098,300981410,Uruguay,ENTRE RÍOS,96,108,128,162,290
30,30098,300981411,Uruguay,ENTRE RÍOS,98,120,131,172,303
30,30098,300981412,Uruguay,ENTRE RÍOS,20,30,19,32,51
30,30098,300981413,Uruguay,ENTRE RÍOS,48,61,81,73,154
30,30098,300981414,Uruguay,ENTRE RÍOS,52,57,66,89,155
30,30098,300981415,Uruguay,ENTRE RÍOS,28,30,36,44,80
30,30098,300981416,Uruguay,ENTRE RÍOS,39,34,60,57,117
30,30098,300981501,Uruguay,ENTRE RÍOS,37,37,49,47,96
30,30098,300981502,Uruguay,ENTRE RÍOS,94,101,157,150,307
30,30098,300981503,Uruguay,ENTRE RÍOS,253,265,424,444,868
30,30098,300981504,Uruguay,ENTRE RÍOS,134,154,185,188,373
30,30098,300981505,Uruguay,ENTRE RÍOS,33,43,45,37,82
30,30098,300981506,Uruguay,ENTRE RÍOS,19,22,24,29,53
30,30098,300981507,Uruguay,ENTRE RÍOS,39,52,62,58,120
30,30098,300981508,Uruguay,ENTRE RÍOS,44,52,55,70,125
30,30098,300981509,Uruguay,ENTRE RÍOS,56,62,101,85,186
30,30098,300981510,Uruguay,ENTRE RÍOS,152,184,215,206,421
30,30098,300981511,Uruguay,ENTRE RÍOS,200,225,322,322,644
30,30098,300981512,Uruguay,ENTRE RÍOS,125,138,165,181,346
30,30098,300981513,Uruguay,ENTRE RÍOS,119,147,175,176,351
30,30098,300981514,Uruguay,ENTRE RÍOS,14,15,17,24,41
30,30098,300981515,Uruguay,ENTRE RÍOS,17,25,23,36,59
30,30098,300981516,Uruguay,ENTRE RÍOS,31,48,41,52,93
30,30098,300981601,Uruguay,ENTRE RÍOS,5,7,6,10,16
30,30098,300981602,Uruguay,ENTRE RÍOS,10,21,12,18,30
30,30098,300981603,Uruguay,ENTRE RÍOS,51,59,61,67,128
30,30098,300981604,Uruguay,ENTRE RÍOS,49,67,46,123,169
30,30098,300981605,Uruguay,ENTRE RÍOS,86,95,126,135,261
30,30098,300981606,Uruguay,ENTRE RÍOS,40,51,53,68,121
30,30098,300981701,Uruguay,ENTRE RÍOS,28,37,40,38,78
30,30098,300981702,Uruguay,ENTRE RÍOS,104,116,153,161,314
30,30098,300981703,Uruguay,ENTRE RÍOS,113,116,193,221,414
30,30098,300981704,Uruguay,ENTRE RÍOS,109,142,156,171,327
30,30098,300981705,Uruguay,ENTRE RÍOS,31,39,41,50,91
30,30098,300981706,Uruguay,ENTRE RÍOS,11,16,17,17,34
30,30098,300981707,Uruguay,ENTRE RÍOS,13,21,16,29,45
30,30098,300981708,Uruguay,ENTRE RÍOS,25,29,33,43,76
30,30098,300981709,Uruguay,ENTRE RÍOS,24,26,47,49,96
30,30098,300981801,Uruguay,ENTRE RÍOS,3,46,0,3,3
30,30098,300981802,Uruguay,ENTRE RÍOS,12,14,14,20,34
30,30105,301050101,Victoria,ENTRE RÍOS,199,214,360,340,700
30,30105,301050102,Victoria,ENTRE RÍOS,156,213,298,321,619
30,30105,301050103,Victoria,ENTRE RÍOS,185,211,337,326,663
30,30105,301050104,Victoria,ENTRE RÍOS,271,290,522,498,1020
30,30105,301050105,Victoria,ENTRE RÍOS,129,144,257,240,497
30,30105,301050106,Victoria,ENTRE RÍOS,122,130,239,195,434
30,30105,301050107,Victoria,ENTRE RÍOS,243,260,413,351,764
30,30105,301050108,Victoria,ENTRE RÍOS,237,265,394,345,739
30,30105,301050109,Victoria,ENTRE RÍOS,168,192,293,313,606
30,30105,301050110,Victoria,ENTRE RÍOS,267,288,390,348,738
30,30105,301050111,Victoria,ENTRE RÍOS,152,169,214,180,394
30,30105,301050112,Victoria,ENTRE RÍOS,160,207,258,182,440
30,30105,301050201,Victoria,ENTRE RÍOS,158,175,263,245,508
30,30105,301050202,Victoria,ENTRE RÍOS,216,228,401,383,784
30,30105,301050203,Victoria,ENTRE RÍOS,221,240,392,373,765
30,30105,301050204,Victoria,ENTRE RÍOS,175,217,306,265,571
30,30105,301050205,Victoria,ENTRE RÍOS,190,223,321,298,619
30,30105,301050206,Victoria,ENTRE RÍOS,208,236,337,345,682
30,30105,301050207,Victoria,ENTRE RÍOS,212,236,410,397,807
30,30105,301050208,Victoria,ENTRE RÍOS,202,239,393,401,794
30,30105,301050209,Victoria,ENTRE RÍOS,269,304,411,384,795
30,30105,301050210,Victoria,ENTRE RÍOS,240,343,382,299,681
30,30105,301050211,Victoria,ENTRE RÍOS,170,198,265,193,458
30,30105,301050212,Victoria,ENTRE RÍOS,205,244,327,256,583
30,30105,301050213,Victoria,ENTRE RÍOS,207,216,337,343,680
30,30105,301050301,Victoria,ENTRE RÍOS,256,313,438,415,853
30,30105,301050302,Victoria,ENTRE RÍOS,37,90,57,51,108
30,30105,301050303,Victoria,ENTRE RÍOS,371,454,560,540,1100
30,30105,301050304,Victoria,ENTRE RÍOS,236,274,396,419,815
30,30105,301050305,Victoria,ENTRE RÍOS,192,237,303,244,547
30,30105,301050306,Victoria,ENTRE RÍOS,296,366,421,391,812
30,30105,301050307,Victoria,ENTRE RÍOS,234,252,440,381,821
30,30105,301050308,Victoria,ENTRE RÍOS,243,290,386,334,720
30,30105,301050309,Victoria,ENTRE RÍOS,209,265,356,321,677
30,30105,301050310,Victoria,ENTRE RÍOS,247,285,408,329,737
30,30105,301050401,Victoria,ENTRE RÍOS,119,147,185,120,305
30,30105,301050402,Victoria,ENTRE RÍOS,132,188,213,169,382
30,30105,301050403,Victoria,ENTRE RÍOS,197,239,310,230,540
30,30105,301050404,Victoria,ENTRE RÍOS,261,293,461,440,901
30,30105,301050405,Victoria,ENTRE RÍOS,176,210,273,265,538
30,30105,301050406,Victoria,ENTRE RÍOS,291,351,538,488,1026
30,30105,301050407,Victoria,ENTRE RÍOS,192,213,365,373,738
30,30105,301050408,Victoria,ENTRE RÍOS,86,108,134,125,259
30,30105,301050409,Victoria,ENTRE RÍOS,268,302,451,502,953
30,30105,301050410,Victoria,ENTRE RÍOS,314,360,579,621,1200
30,30105,301050501,Victoria,ENTRE RÍOS,69,90,110,133,243
30,30105,301050502,Victoria,ENTRE RÍOS,15,22,16,23,39
30,30105,301050503,Victoria,ENTRE RÍOS,63,142,97,117,214
30,30105,301050504,Victoria,ENTRE RÍOS,60,103,112,103,215
30,30105,301050601,Victoria,ENTRE RÍOS,38,46,56,76,132
30,30105,301050602,Victoria,ENTRE RÍOS,29,32,33,32,65
30,30105,301050603,Victoria,ENTRE RÍOS,8,8,9,15,24
30,30105,301050604,Victoria,ENTRE RÍOS,21,41,28,31,59
30,30105,301050605,Victoria,ENTRE RÍOS,55,85,92,98,190
30,30105,301050606,Victoria,ENTRE RÍOS,111,156,170,178,348
30,30105,301050607,Victoria,ENTRE RÍOS,19,35,17,29,46
30,30105,301050608,Victoria,ENTRE RÍOS,13,28,11,16,27
30,30105,301050609,Victoria,ENTRE RÍOS,47,84,70,78,148
30,30105,301050610,Victoria,ENTRE RÍOS,191,215,280,317,597
30,30105,301050611,Victoria,ENTRE RÍOS,35,51,58,68,126
30,30105,301050612,Victoria,ENTRE RÍOS,63,93,86,103,189
30,30105,301050701,Victoria,ENTRE RÍOS,13,19,16,19,35
30,30105,301050702,Victoria,ENTRE RÍOS,29,44,28,40,68
30,30105,301050703,Victoria,ENTRE RÍOS,42,85,63,61,124
30,30105,301050704,Victoria,ENTRE RÍOS,18,21,13,25,38
30,30105,301050705,Victoria,ENTRE RÍOS,29,51,36,44,80
30,30105,301050706,Victoria,ENTRE RÍOS,21,21,33,28,61
30,30105,301050707,Victoria,ENTRE RÍOS,22,30,32,46,78
30,30105,301050708,Victoria,ENTRE RÍOS,42,66,68,94,162
30,30105,301050709,Victoria,ENTRE RÍOS,21,48,26,38,64
30,30105,301050710,Victoria,ENTRE RÍOS,10,26,1,10,11
30,30105,301050711,Victoria,ENTRE RÍOS,136,194,208,212,420
30,30105,301050712,Victoria,ENTRE RÍOS,132,162,235,292,527
30,30105,301050713,Victoria,ENTRE RÍOS,18,25,25,32,57
30,30105,301050714,Victoria,ENTRE RÍOS,12,20,19,19,38
30,30105,301050715,Victoria,ENTRE RÍOS,68,118,111,100,211
30,30105,301050801,Victoria,ENTRE RÍOS,25,37,0,32,32
30,30105,301050802,Victoria,ENTRE RÍOS,13,48,20,26,46
30,30105,301050803,Victoria,ENTRE RÍOS,11,30,5,18,23
30,30105,301050804,Victoria,ENTRE RÍOS,17,11,18,32,50
30,30105,301050805,Victoria,ENTRE RÍOS,21,4,16,43,59
30,30105,301050806,Victoria,ENTRE RÍOS,25,48,29,51,80
30,30105,301050807,Victoria,ENTRE RÍOS,26,64,18,38,56
30,30105,301050808,Victoria,ENTRE RÍOS,22,45,17,37,54
30,30105,301050809,Victoria,ENTRE RÍOS,15,41,14,25,39
30,30105,301050810,Victoria,ENTRE RÍOS,36,113,30,56,86
30,30105,301050811,Victoria,ENTRE RÍOS,25,62,29,51,80
30,30105,301050812,Victoria,ENTRE RÍOS,58,106,54,99,153
30,30113,301130101,Villaguay,ENTRE RÍOS,97,138,182,181,363
30,30113,301130102,Villaguay,ENTRE RÍOS,1,5,0,1,1
30,30113,301130103,Villaguay,ENTRE RÍOS,272,264,586,539,1125
30,30113,301130104,Villaguay,ENTRE RÍOS,206,228,410,418,828
30,30113,301130105,Villaguay,ENTRE RÍOS,368,462,648,592,1240
30,30113,301130106,Villaguay,ENTRE RÍOS,226,231,438,390,828
30,30113,301130107,Villaguay,ENTRE RÍOS,181,181,315,277,592
30,30113,301130108,Villaguay,ENTRE RÍOS,267,294,466,418,884
30,30113,301130109,Villaguay,ENTRE RÍOS,368,458,562,485,1047
30,30113,301130110,Villaguay,ENTRE RÍOS,234,235,412,360,772
30,30113,301130111,Villaguay,ENTRE RÍOS,274,295,482,442,924
30,30113,301130112,Villaguay,ENTRE RÍOS,311,359,473,419,892
30,30113,301130113,Villaguay,ENTRE RÍOS,211,223,331,303,634
30,30113,301130114,Villaguay,ENTRE RÍOS,201,223,288,258,546
30,30113,301130115,Villaguay,ENTRE RÍOS,316,341,540,493,1033
30,30113,301130116,Villaguay,ENTRE RÍOS,193,206,334,321,655
30,30113,301130117,Villaguay,ENTRE RÍOS,191,215,344,344,688
30,30113,301130118,Villaguay,ENTRE RÍOS,258,269,443,407,850
30,30113,301130119,Villaguay,ENTRE RÍOS,233,252,345,274,619
30,30113,301130120,Villaguay,ENTRE RÍOS,107,129,157,108,265
30,30113,301130121,Villaguay,ENTRE RÍOS,168,213,223,186,409
30,30113,301130122,Villaguay,ENTRE RÍOS,329,346,580,489,1069
30,30113,301130123,Villaguay,ENTRE RÍOS,316,357,483,395,878
30,30113,301130201,Villaguay,ENTRE RÍOS,266,318,399,315,714
30,30113,301130202,Villaguay,ENTRE RÍOS,111,134,170,127,297
30,30113,301130203,Villaguay,ENTRE RÍOS,186,236,293,212,505
30,30113,301130204,Villaguay,ENTRE RÍOS,232,217,372,339,711
30,30113,301130205,Villaguay,ENTRE RÍOS,264,321,402,304,706
30,30113,301130206,Villaguay,ENTRE RÍOS,127,146,173,139,312
30,30113,301130207,Villaguay,ENTRE RÍOS,131,160,186,127,313
30,30113,301130208,Villaguay,ENTRE RÍOS,217,236,349,251,600
30,30113,301130209,Villaguay,ENTRE RÍOS,235,261,378,279,657
30,30113,301130210,Villaguay,ENTRE RÍOS,220,265,331,299,630
30,30113,301130211,Villaguay,ENTRE RÍOS,260,291,530,479,1009
30,30113,301130212,Villaguay,ENTRE RÍOS,287,304,536,492,1028
30,30113,301130213,Villaguay,ENTRE RÍOS,130,142,276,246,522
30,30113,301130214,Villaguay,ENTRE RÍOS,269,291,465,454,919
30,30113,301130215,Villaguay,ENTRE RÍOS,194,202,397,347,744
30,30113,301130216,Villaguay,ENTRE RÍOS,191,219,403,377,780
30,30113,301130301,Villaguay,ENTRE RÍOS,7,11,15,13,28
30,30113,301130302,Villaguay,ENTRE RÍOS,67,76,98,122,220
30,30113,301130303,Villaguay,ENTRE RÍOS,183,211,352,365,717
30,30113,301130304,Villaguay,ENTRE RÍOS,66,87,87,172,259
30,30113,301130305,Villaguay,ENTRE RÍOS,197,200,403,389,792
30,30113,301130306,Villaguay,ENTRE RÍOS,58,63,86,97,183
30,30113,301130307,Villaguay,ENTRE RÍOS,308,330,583,525,1108
30,30113,301130308,Villaguay,ENTRE RÍOS,144,128,249,227,476
30,30113,301130309,Villaguay,ENTRE RÍOS,240,245,495,523,1018
30,30113,301130310,Villaguay,ENTRE RÍOS,338,375,685,662,1347
30,30113,301130311,Villaguay,ENTRE RÍOS,206,213,411,437,848
30,30113,301130312,Villaguay,ENTRE RÍOS,13,15,22,30,52
30,30113,301130401,Villaguay,ENTRE RÍOS,6,7,9,11,20
30,30113,301130402,Villaguay,ENTRE RÍOS,3,4,3,6,9
30,30113,301130403,Villaguay,ENTRE RÍOS,12,15,19,16,35
30,30113,301130404,Villaguay,ENTRE RÍOS,209,227,359,378,737
30,30113,301130405,Villaguay,ENTRE RÍOS,261,301,407,367,774
30,30113,301130406,Villaguay,ENTRE RÍOS,290,346,594,621,1215
30,30113,301130501,Villaguay,ENTRE RÍOS,10,15,12,21,33
30,30113,301130502,Villaguay,ENTRE RÍOS,0,1,0,0,0
30,30113,301130503,Villaguay,ENTRE RÍOS,14,17,13,21,34
30,30113,301130504,Villaguay,ENTRE RÍOS,157,172,307,335,642
30,30113,301130505,Villaguay,ENTRE RÍOS,137,158,242,211,453
30,30113,301130506,Villaguay,ENTRE RÍOS,118,140,195,159,354
30,30113,301130507,Villaguay,ENTRE RÍOS,101,129,174,168,342
30,30113,301130601,Villaguay,ENTRE RÍOS,18,22,23,27,50
30,30113,301130602,Villaguay,ENTRE RÍOS,14,23,25,32,57
30,30113,301130603,Villaguay,ENTRE RÍOS,64,71,130,127,257
30,30113,301130604,Villaguay,ENTRE RÍOS,17,26,20,34,54
30,30113,301130605,Villaguay,ENTRE RÍOS,12,17,16,18,34
30,30113,301130606,Villaguay,ENTRE RÍOS,120,147,213,235,448
30,30113,301130607,Villaguay,ENTRE RÍOS,36,45,57,72,129
30,30113,301130608,Villaguay,ENTRE RÍOS,79,100,118,166,284
30,30113,301130609,Villaguay,ENTRE RÍOS,38,44,67,82,149
30,30113,301130610,Villaguay,ENTRE RÍOS,27,27,44,46,90
30,30113,301130701,Villaguay,ENTRE RÍOS,22,25,22,47,69
30,30113,301130702,Villaguay,ENTRE RÍOS,97,119,149,152,301
30,30113,301130703,Villaguay,ENTRE RÍOS,56,61,87,92,179
30,30113,301130704,Villaguay,ENTRE RÍOS,28,36,43,50,93
30,30113,301130705,Villaguay,ENTRE RÍOS,56,72,72,83,155
30,30113,301130706,Villaguay,ENTRE RÍOS,116,131,148,165,313
30,30113,301130801,Villaguay,ENTRE RÍOS,16,24,30,32,62
30,30113,301130802,Villaguay,ENTRE RÍOS,6,12,11,20,31
30,30113,301130803,Villaguay,ENTRE RÍOS,14,26,14,26,40
30,30113,301130804,Villaguay,ENTRE RÍOS,16,23,29,41,70
30,30113,301130805,Villaguay,ENTRE RÍOS,38,40,68,86,154
30,30113,301130806,Villaguay,ENTRE RÍOS,61,69,128,134,262
30,30113,301130807,Villaguay,ENTRE RÍOS,37,40,60,73,133
30,30113,301130808,Villaguay,ENTRE RÍOS,41,46,65,66,131
30,30113,301130809,Villaguay,ENTRE RÍOS,17,25,17,29,46
30,30113,301130810,Villaguay,ENTRE RÍOS,16,28,14,22,36
30,30113,301130811,Villaguay,ENTRE RÍOS,12,20,16,27,43
30,30113,301130812,Villaguay,ENTRE RÍOS,15,17,19,26,45
30,30113,301130813,Villaguay,ENTRE RÍOS,23,41,23,37,60
30,30113,301130814,Villaguay,ENTRE RÍOS,17,26,24,38,62
30,30113,301130815,Villaguay,ENTRE RÍOS,30,32,33,57,90
30,30113,301130901,Villaguay,ENTRE RÍOS,22,26,30,43,73
30,30113,301130902,Villaguay,ENTRE RÍOS,19,34,31,34,65
30,30113,301130903,Villaguay,ENTRE RÍOS,28,33,39,48,87
30,30113,301130904,Villaguay,ENTRE RÍOS,23,25,28,35,63
30,30113,301130905,Villaguay,ENTRE RÍOS,20,23,24,32,56
30,30113,301130906,Villaguay,ENTRE RÍOS,56,64,77,90,167
30,30113,301130907,Villaguay,ENTRE RÍOS,19,20,34,35,69
30,30113,301130908,Villaguay,ENTRE RÍOS,13,25,17,23,40
30,30113,301131001,Villaguay,ENTRE RÍOS,38,43,24,57,81
30,30113,301131002,Villaguay,ENTRE RÍOS,65,88,90,122,212
30,30113,301131003,Villaguay,ENTRE RÍOS,30,46,39,58,97
30,30113,301131004,Villaguay,ENTRE RÍOS,53,60,77,92,169
30,30113,301131005,Villaguay,ENTRE RÍOS,49,50,75,76,151
30,30113,301131006,Villaguay,ENTRE RÍOS,24,28,32,31,63
30,30113,301131007,Villaguay,ENTRE RÍOS,37,42,65,72,137
30,30113,301131008,Villaguay,ENTRE RÍOS,41,50,84,83,167
30,30113,301131101,Villaguay,ENTRE RÍOS,11,14,21,19,40
30,30113,301131102,Villaguay,ENTRE RÍOS,4,5,6,9,15
30,30113,301131103,Villaguay,ENTRE RÍOS,42,44,72,78,150
30,30113,301131104,Villaguay,ENTRE RÍOS,47,54,84,87,171
30,30113,301131105,Villaguay,ENTRE RÍOS,42,49,58,64,122
30,30113,301131106,Villaguay,ENTRE RÍOS,88,108,139,174,313
30,30113,301131107,Villaguay,ENTRE RÍOS,11,13,12,24,36
30,30113,301131108,Villaguay,ENTRE RÍOS,20,26,24,31,55
30,30113,301131109,Villaguay,ENTRE RÍOS,25,39,32,48,80
30,30113,301131110,Villaguay,ENTRE RÍOS,37,51,54,65,119
30,30113,301131201,Villaguay,ENTRE RÍOS,20,21,36,30,66
30,30113,301131202,Villaguay,ENTRE RÍOS,13,17,20,26,46
30,30113,301131203,Villaguay,ENTRE RÍOS,125,142,204,192,396
30,30113,301131204,Villaguay,ENTRE RÍOS,77,76,101,109,210
30,30113,301131205,Villaguay,ENTRE RÍOS,10,11,17,12,29
30,30113,301131206,Villaguay,ENTRE RÍOS,27,33,34,50,84
30,30113,301131207,Villaguay,ENTRE RÍOS,19,28,18,27,45
30,30113,301131208,Villaguay,ENTRE RÍOS,31,34,53,66,119
30,30113,301131209,Villaguay,ENTRE RÍOS,47,62,71,67,138
30,30113,301131301,Villaguay,ENTRE RÍOS,4,4,6,7,13
30,30113,301131302,Villaguay,ENTRE RÍOS,33,34,55,62,117
30,30113,301131303,Villaguay,ENTRE RÍOS,11,12,18,27,45
30,30113,301131304,Villaguay,ENTRE RÍOS,24,24,32,46,78
30,30113,301131305,Villaguay,ENTRE RÍOS,5,5,11,17,28
30,30113,301131306,Villaguay,ENTRE RÍOS,16,15,22,35,57
30,30113,301131307,Villaguay,ENTRE RÍOS,5,5,6,9,15
30,30113,301131308,Villaguay,ENTRE RÍOS,119,131,178,186,364
30,30113,301131309,Villaguay,ENTRE RÍOS,74,94,123,144,267
30,30113,301131401,Villaguay,ENTRE RÍOS,14,14,21,27,48
30,30113,301131402,Villaguay,ENTRE RÍOS,30,33,43,63,106
30,30113,301131403,Villaguay,ENTRE RÍOS,7,12,9,17,26
30,30113,301131404,Villaguay,ENTRE RÍOS,8,10,15,19,34
30,30113,301131405,Villaguay,ENTRE RÍOS,33,39,54,52,106
30,30113,301131406,Villaguay,ENTRE RÍOS,17,17,20,17,37
30,30113,301131407,Villaguay,ENTRE RÍOS,10,8,13,16,29
30,30113,301131408,Villaguay,ENTRE RÍOS,6,7,10,12,22
30,30113,301131409,Villaguay,ENTRE RÍOS,8,11,8,12,20
30,30113,301131410,Villaguay,ENTRE RÍOS,4,19,6,5,11
30,30113,301131411,Villaguay,ENTRE RÍOS,113,143,197,202,399
18,18007,180070101,Bella Vista,CORRIENTES,330,355,647,658,1305
18,18007,180070102,Bella Vista,CORRIENTES,168,177,326,314,640
18,18007,180070103,Bella Vista,CORRIENTES,257,263,522,519,1041
18,18007,180070104,Bella Vista,CORRIENTES,218,242,424,370,794
18,18007,180070105,Bella Vista,CORRIENTES,263,287,501,482,983
18,18007,180070106,Bella Vista,CORRIENTES,303,352,562,551,1113
18,18007,180070107,Bella Vista,CORRIENTES,183,201,321,253,574
18,18007,180070108,Bella Vista,CORRIENTES,292,274,467,404,871
18,18007,180070109,Bella Vista,CORRIENTES,267,287,540,525,1065
18,18007,180070110,Bella Vista,CORRIENTES,229,231,422,371,793
18,18007,180070111,Bella Vista,CORRIENTES,233,237,416,414,830
18,18007,180070112,Bella Vista,CORRIENTES,255,265,447,414,861
18,18007,180070113,Bella Vista,CORRIENTES,323,343,515,472,987
18,18007,180070114,Bella Vista,CORRIENTES,240,247,437,451,888
18,18007,180070115,Bella Vista,CORRIENTES,284,295,613,592,1205
18,18007,180070116,Bella Vista,CORRIENTES,272,285,505,528,1033
18,18007,180070117,Bella Vista,CORRIENTES,262,287,498,460,958
18,18007,180070118,Bella Vista,CORRIENTES,237,245,432,409,841
18,18007,180070119,Bella Vista,CORRIENTES,261,265,514,490,1004
18,18007,180070120,Bella Vista,CORRIENTES,242,254,401,412,813
18,18007,180070121,Bella Vista,CORRIENTES,254,267,440,413,853
18,18007,180070122,Bella Vista,CORRIENTES,279,263,519,490,1009
18,18007,180070123,Bella Vista,CORRIENTES,235,249,462,410,872
18,18007,180070124,Bella Vista,CORRIENTES,271,286,526,462,988
18,18007,180070125,Bella Vista,CORRIENTES,282,287,534,525,1059
18,18007,180070201,Bella Vista,CORRIENTES,74,91,147,158,305
18,18007,180070202,Bella Vista,CORRIENTES,53,57,90,115,205
18,18007,180070203,Bella Vista,CORRIENTES,96,112,187,210,397
18,18007,180070204,Bella Vista,CORRIENTES,98,110,179,196,375
18,18007,180070205,Bella Vista,CORRIENTES,72,87,110,133,243
18,18007,180070206,Bella Vista,CORRIENTES,77,94,140,140,280
18,18007,180070207,Bella Vista,CORRIENTES,70,82,132,148,280
18,18007,180070208,Bella Vista,CORRIENTES,79,97,158,155,313
18,18007,180070209,Bella Vista,CORRIENTES,72,73,154,152,306
18,18007,180070210,Bella Vista,CORRIENTES,19,24,45,42,87
18,18007,180070211,Bella Vista,CORRIENTES,59,67,115,132,247
18,18007,180070212,Bella Vista,CORRIENTES,78,87,140,143,283
18,18007,180070213,Bella Vista,CORRIENTES,266,271,542,539,1081
18,18007,180070214,Bella Vista,CORRIENTES,390,382,890,860,1750
18,18007,180070215,Bella Vista,CORRIENTES,267,273,598,556,1154
18,18007,180070216,Bella Vista,CORRIENTES,167,170,371,399,770
18,18007,180070217,Bella Vista,CORRIENTES,156,159,340,336,676
18,18007,180070218,Bella Vista,CORRIENTES,153,149,354,319,673
18,18007,180070301,Bella Vista,CORRIENTES,217,282,357,440,797
18,18007,180070302,Bella Vista,CORRIENTES,38,43,77,87,164
18,18007,180070303,Bella Vista,CORRIENTES,35,37,77,86,163
18,18007,180070304,Bella Vista,CORRIENTES,116,126,211,236,447
18,18007,180070305,Bella Vista,CORRIENTES,113,146,202,217,419
18,18007,180070401,Bella Vista,CORRIENTES,26,27,51,52,103
18,18007,180070501,Bella Vista,CORRIENTES,38,45,56,68,124
18,18007,180070502,Bella Vista,CORRIENTES,19,22,36,37,73
18,18007,180070503,Bella Vista,CORRIENTES,9,11,9,14,23
18,18007,180070504,Bella Vista,CORRIENTES,31,33,51,59,110
18,18007,180070505,Bella Vista,CORRIENTES,27,33,48,47,95
18,18007,180070506,Bella Vista,CORRIENTES,39,48,79,101,180
18,18007,180070601,Bella Vista,CORRIENTES,141,165,248,270,518
18,18007,180070602,Bella Vista,CORRIENTES,104,115,189,224,413
18,18007,180070701,Bella Vista,CORRIENTES,63,65,114,134,248
18,18007,180070702,Bella Vista,CORRIENTES,104,126,194,255,449
18,18007,180070801,Bella Vista,CORRIENTES,6,13,2,8,10
18,18007,180070802,Bella Vista,CORRIENTES,11,12,15,25,40
18,18014,180140101,Berón de Astrada,CORRIENTES,120,154,212,203,415
18,18014,180140102,Berón de Astrada,CORRIENTES,137,167,229,216,445
18,18014,180140103,Berón de Astrada,CORRIENTES,147,187,263,288,551
18,18014,180140201,Berón de Astrada,CORRIENTES,51,67,74,81,155
18,18014,180140202,Berón de Astrada,CORRIENTES,12,20,13,20,33
18,18014,180140203,Berón de Astrada,CORRIENTES,8,11,6,15,21
18,18014,180140301,Berón de Astrada,CORRIENTES,61,72,167,154,321
18,18014,180140302,Berón de Astrada,CORRIENTES,28,35,37,45,82
18,18014,180140303,Berón de Astrada,CORRIENTES,42,69,80,103,183
18,18014,180140401,Berón de Astrada,CORRIENTES,55,78,104,107,211
18,18014,180140402,Berón de Astrada,CORRIENTES,15,22,16,28,44
18,18014,180140501,Berón de Astrada,CORRIENTES,0,1,0,0,0
18,18014,180140502,Berón de Astrada,CORRIENTES,0,1,0,0,0
18,18021,180210101,Capital,CORRIENTES,454,410,680,536,1216
18,18021,180210102,Capital,CORRIENTES,312,330,472,371,843
18,18021,180210103,Capital,CORRIENTES,403,434,660,499,1159
18,18021,180210104,Capital,CORRIENTES,294,337,450,365,815
18,18021,180210105,Capital,CORRIENTES,259,323,384,326,710
18,18021,180210106,Capital,CORRIENTES,306,377,460,390,850
18,18021,180210107,Capital,CORRIENTES,234,304,392,292,684
18,18021,180210108,Capital,CORRIENTES,202,260,336,229,565
18,18021,180210109,Capital,CORRIENTES,274,398,395,284,679
18,18021,180210110,Capital,CORRIENTES,203,291,307,264,571
18,18021,180210111,Capital,CORRIENTES,221,241,317,267,584
18,18021,180210112,Capital,CORRIENTES,137,161,279,212,491
18,18021,180210113,Capital,CORRIENTES,451,495,697,576,1273
18,18021,180210114,Capital,CORRIENTES,357,429,553,501,1054
18,18021,180210115,Capital,CORRIENTES,413,539,688,889,1577
18,18021,180210116,Capital,CORRIENTES,224,300,334,262,596
18,18021,180210117,Capital,CORRIENTES,405,546,655,511,1166
18,18021,180210118,Capital,CORRIENTES,333,403,554,443,997
18,18021,180210201,Capital,CORRIENTES,442,463,539,503,1042
18,18021,180210202,Capital,CORRIENTES,255,276,383,311,694
18,18021,180210203,Capital,CORRIENTES,364,428,461,399,860
18,18021,180210204,Capital,CORRIENTES,215,263,316,244,560
18,18021,180210205,Capital,CORRIENTES,266,362,385,283,668
18,18021,180210206,Capital,CORRIENTES,284,351,409,307,716
18,18021,180210207,Capital,CORRIENTES,400,416,482,414,896
18,18021,180210208,Capital,CORRIENTES,348,433,467,343,810
18,18021,180210209,Capital,CORRIENTES,280,318,367,307,674
18,18021,180210210,Capital,CORRIENTES,290,427,519,375,894
18,18021,180210211,Capital,CORRIENTES,258,346,395,292,687
18,18021,180210212,Capital,CORRIENTES,236,312,362,270,632
18,18021,180210213,Capital,CORRIENTES,206,298,316,265,581
18,18021,180210214,Capital,CORRIENTES,428,603,560,435,995
18,18021,180210215,Capital,CORRIENTES,293,405,364,286,650
18,18021,180210216,Capital,CORRIENTES,291,418,359,322,681
18,18021,180210217,Capital,CORRIENTES,340,518,509,443,952
18,18021,180210218,Capital,CORRIENTES,154,250,235,204,439
18,18021,180210301,Capital,CORRIENTES,272,262,628,594,1222
18,18021,180210302,Capital,CORRIENTES,288,276,557,529,1086
18,18021,180210303,Capital,CORRIENTES,442,509,883,794,1677
18,18021,180210304,Capital,CORRIENTES,485,451,1097,1183,2280
18,18021,180210305,Capital,CORRIENTES,409,383,809,807,1616
18,18021,180210306,Capital,CORRIENTES,293,252,558,532,1090
18,18021,180210307,Capital,CORRIENTES,255,226,567,531,1098
18,18021,180210308,Capital,CORRIENTES,311,281,605,632,1237
18,18021,180210309,Capital,CORRIENTES,300,301,668,647,1315
18,18021,180210310,Capital,CORRIENTES,291,277,568,564,1132
18,18021,180210311,Capital,CORRIENTES,252,233,443,411,854
18,18021,180210312,Capital,CORRIENTES,293,211,595,522,1117
18,18021,180210313,Capital,CORRIENTES,208,177,376,399,775
18,18021,180210314,Capital,CORRIENTES,337,313,706,693,1399
18,18021,180210315,Capital,CORRIENTES,365,371,719,640,1359
18,18021,180210316,Capital,CORRIENTES,334,309,661,562,1223
18,18021,180210317,Capital,CORRIENTES,502,417,903,835,1738
18,18021,180210318,Capital,CORRIENTES,256,262,383,343,726
18,18021,180210319,Capital,CORRIENTES,323,301,424,392,816
18,18021,180210320,Capital,CORRIENTES,314,357,506,436,942
18,18021,180210321,Capital,CORRIENTES,230,236,375,312,687
18,18021,180210401,Capital,CORRIENTES,444,490,906,898,1804
18,18021,180210402,Capital,CORRIENTES,220,238,393,393,786
18,18021,180210403,Capital,CORRIENTES,506,533,999,965,1964
18,18021,180210404,Capital,CORRIENTES,362,359,856,822,1678
18,18021,180210405,Capital,CORRIENTES,255,254,540,527,1067
18,18021,180210406,Capital,CORRIENTES,385,379,820,838,1658
18,18021,180210407,Capital,CORRIENTES,403,376,894,896,1790
18,18021,180210408,Capital,CORRIENTES,244,273,496,484,980
18,18021,180210409,Capital,CORRIENTES,323,321,695,642,1337
18,18021,180210410,Capital,CORRIENTES,321,312,670,618,1288
18,18021,180210411,Capital,CORRIENTES,505,501,961,946,1907
18,18021,180210412,Capital,CORRIENTES,244,221,450,416,866
18,18021,180210413,Capital,CORRIENTES,268,265,531,534,1065
18,18021,180210414,Capital,CORRIENTES,330,371,623,566,1189
18,18021,180210415,Capital,CORRIENTES,240,246,495,463,958
18,18021,180210416,Capital,CORRIENTES,249,317,382,354,736
18,18021,180210417,Capital,CORRIENTES,328,260,525,466,991
18,18021,180210418,Capital,CORRIENTES,225,279,382,338,720
18,18021,180210419,Capital,CORRIENTES,200,225,215,152,367
18,18021,180210420,Capital,CORRIENTES,166,229,231,170,401
18,18021,180210421,Capital,CORRIENTES,369,502,500,488,988
18,18021,180210422,Capital,CORRIENTES,258,232,445,406,851
18,18021,180210501,Capital,CORRIENTES,241,348,323,274,597
18,18021,180210502,Capital,CORRIENTES,255,257,398,361,759
18,18021,180210503,Capital,CORRIENTES,411,510,569,404,973
18,18021,180210504,Capital,CORRIENTES,319,341,555,446,1001
18,18021,180210505,Capital,CORRIENTES,179,204,319,304,623
18,18021,180210506,Capital,CORRIENTES,299,310,567,537,1104
18,18021,180210507,Capital,CORRIENTES,331,361,656,605,1261
18,18021,180210508,Capital,CORRIENTES,203,193,364,323,687
18,18021,180210509,Capital,CORRIENTES,286,274,549,467,1016
18,18021,180210510,Capital,CORRIENTES,244,262,571,460,1031
18,18021,180210511,Capital,CORRIENTES,315,299,537,522,1059
18,18021,180210512,Capital,CORRIENTES,454,513,730,631,1361
18,18021,180210513,Capital,CORRIENTES,348,337,630,492,1122
18,18021,180210514,Capital,CORRIENTES,250,236,480,453,933
18,18021,180210515,Capital,CORRIENTES,207,202,406,325,731
18,18021,180210516,Capital,CORRIENTES,199,171,369,327,696
18,18021,180210601,Capital,CORRIENTES,233,230,417,386,803
18,18021,180210602,Capital,CORRIENTES,241,206,476,423,899
18,18021,180210603,Capital,CORRIENTES,317,285,580,512,1092
18,18021,180210604,Capital,CORRIENTES,382,380,785,720,1505
18,18021,180210605,Capital,CORRIENTES,348,331,692,610,1302
18,18021,180210606,Capital,CORRIENTES,581,562,1127,1099,2226
18,18021,180210607,Capital,CORRIENTES,268,295,524,496,1020
18,18021,180210608,Capital,CORRIENTES,259,245,528,472,1000
18,18021,180210609,Capital,CORRIENTES,336,342,711,667,1378
18,18021,180210610,Capital,CORRIENTES,260,278,533,519,1052
18,18021,180210611,Capital,CORRIENTES,198,213,386,357,743
18,18021,180210612,Capital,CORRIENTES,344,316,708,652,1360
18,18021,180210613,Capital,CORRIENTES,349,330,613,610,1223
18,18021,180210614,Capital,CORRIENTES,366,335,743,710,1453
18,18021,180210615,Capital,CORRIENTES,284,234,636,567,1203
18,18021,180210616,Capital,CORRIENTES,331,280,643,583,1226
18,18021,180210701,Capital,CORRIENTES,340,308,796,752,1548
18,18021,180210702,Capital,CORRIENTES,268,225,569,528,1097
18,18021,180210703,Capital,CORRIENTES,482,376,1001,1030,2031
18,18021,180210704,Capital,CORRIENTES,346,350,678,608,1286
18,18021,180210705,Capital,CORRIENTES,296,294,601,540,1141
18,18021,180210706,Capital,CORRIENTES,207,216,459,394,853
18,18021,180210707,Capital,CORRIENTES,422,445,822,773,1595
18,18021,180210708,Capital,CORRIENTES,565,524,1205,1106,2311
18,18021,180210709,Capital,CORRIENTES,322,322,698,658,1356
18,18021,180210710,Capital,CORRIENTES,370,341,830,779,1609
18,18021,180210711,Capital,CORRIENTES,416,425,930,884,1814
18,18021,180210712,Capital,CORRIENTES,344,297,770,754,1524
18,18021,180210713,Capital,CORRIENTES,303,297,672,592,1264
18,18021,180210714,Capital,CORRIENTES,264,266,575,523,1098
18,18021,180210715,Capital,CORRIENTES,285,276,613,618,1231
18,18021,180210716,Capital,CORRIENTES,236,234,457,434,891
18,18021,180210801,Capital,CORRIENTES,198,220,326,292,618
18,18021,180210802,Capital,CORRIENTES,269,267,562,535,1097
18,18021,180210803,Capital,CORRIENTES,284,321,453,400,853
18,18021,180210804,Capital,CORRIENTES,204,244,347,294,641
18,18021,180210805,Capital,CORRIENTES,255,310,393,304,697
18,18021,180210806,Capital,CORRIENTES,274,330,457,413,870
18,18021,180210807,Capital,CORRIENTES,217,267,366,262,628
18,18021,180210808,Capital,CORRIENTES,216,229,338,295,633
18,18021,180210809,Capital,CORRIENTES,398,442,778,636,1414
18,18021,180210810,Capital,CORRIENTES,381,412,676,565,1241
18,18021,180210811,Capital,CORRIENTES,524,462,1002,886,1888
18,18021,180210812,Capital,CORRIENTES,214,171,432,403,835
18,18021,180210813,Capital,CORRIENTES,231,200,491,448,939
18,18021,180210901,Capital,CORRIENTES,188,265,334,287,621
18,18021,180210902,Capital,CORRIENTES,208,261,415,290,705
18,18021,180210903,Capital,CORRIENTES,291,383,474,337,811
18,18021,180210904,Capital,CORRIENTES,240,332,352,280,632
18,18021,180210905,Capital,CORRIENTES,273,265,559,517,1076
18,18021,180210906,Capital,CORRIENTES,446,478,751,655,1406
18,18021,180210907,Capital,CORRIENTES,435,528,767,658,1425
18,18021,180210908,Capital,CORRIENTES,432,504,647,546,1193
18,18021,180210909,Capital,CORRIENTES,323,466,461,330,791
18,18021,180210910,Capital,CORRIENTES,296,376,381,295,676
18,18021,180210911,Capital,CORRIENTES,207,238,322,240,562
18,18021,180210912,Capital,CORRIENTES,427,477,650,519,1169
18,18021,180210913,Capital,CORRIENTES,224,263,359,266,625
18,18021,180210914,Capital,CORRIENTES,317,331,482,393,875
18,18021,180210915,Capital,CORRIENTES,238,277,418,339,757
18,18021,180211001,Capital,CORRIENTES,280,250,575,493,1068
18,18021,180211002,Capital,CORRIENTES,292,312,646,556,1202
18,18021,180211003,Capital,CORRIENTES,303,296,599,573,1172
18,18021,180211004,Capital,CORRIENTES,321,339,632,620,1252
18,18021,180211005,Capital,CORRIENTES,253,246,512,513,1025
18,18021,180211006,Capital,CORRIENTES,480,456,1029,939,1968
18,18021,180211007,Capital,CORRIENTES,325,362,701,620,1321
18,18021,180211101,Capital,CORRIENTES,304,399,644,657,1301
18,18021,180211102,Capital,CORRIENTES,23,33,40,91,131
18,18021,180211103,Capital,CORRIENTES,154,192,311,292,603
18,18021,180211104,Capital,CORRIENTES,114,245,162,195,357
18,18021,180211105,Capital,CORRIENTES,151,185,302,305,607
18,18021,180211106,Capital,CORRIENTES,356,347,701,695,1396
18,18021,180211107,Capital,CORRIENTES,312,319,695,643,1338
18,18021,180211108,Capital,CORRIENTES,231,231,521,465,986
18,18021,180211109,Capital,CORRIENTES,268,290,577,598,1175
18,18021,180211110,Capital,CORRIENTES,217,278,413,375,788
18,18021,180211201,Capital,CORRIENTES,27,51,47,56,103
18,18021,180211202,Capital,CORRIENTES,46,66,84,86,170
18,18021,180211203,Capital,CORRIENTES,35,45,70,63,133
18,18021,180211204,Capital,CORRIENTES,48,70,78,420,498
18,18021,180211205,Capital,CORRIENTES,187,205,352,368,720
18,18021,180211206,Capital,CORRIENTES,148,173,290,281,571
18,18021,180211207,Capital,CORRIENTES,145,154,220,275,495
18,18021,180211208,Capital,CORRIENTES,331,340,716,663,1379
18,18021,180211209,Capital,CORRIENTES,432,399,998,937,1935
18,18021,180211210,Capital,CORRIENTES,324,339,750,686,1436
18,18021,180211211,Capital,CORRIENTES,270,264,649,636,1285
18,18021,180211212,Capital,CORRIENTES,348,346,696,680,1376
18,18021,180211213,Capital,CORRIENTES,98,114,189,224,413
18,18021,180211301,Capital,CORRIENTES,319,356,667,675,1342
18,18021,180211302,Capital,CORRIENTES,170,223,300,320,620
18,18021,180211303,Capital,CORRIENTES,51,60,90,108,198
18,18021,180211304,Capital,CORRIENTES,16,31,18,30,48
18,18021,180211305,Capital,CORRIENTES,118,137,235,222,457
18,18021,180211306,Capital,CORRIENTES,190,223,399,381,780
18,18021,180211307,Capital,CORRIENTES,225,290,390,383,773
18,18021,180211401,Capital,CORRIENTES,5,5,2,4,6
18,18021,180211402,Capital,CORRIENTES,10,10,19,18,37
18,18021,180211501,Capital,CORRIENTES,297,261,625,558,1183
18,18021,180211502,Capital,CORRIENTES,256,247,428,358,786
18,18021,180211503,Capital,CORRIENTES,118,131,240,188,428
18,18021,180211504,Capital,CORRIENTES,128,142,260,196,456
18,18021,180211505,Capital,CORRIENTES,286,303,467,422,889
18,18021,180211506,Capital,CORRIENTES,221,205,431,361,792
18,18021,180211507,Capital,CORRIENTES,237,220,456,394,850
18,18021,180211508,Capital,CORRIENTES,238,215,506,431,937
18,18021,180211509,Capital,CORRIENTES,194,193,397,354,751
18,18021,180211510,Capital,CORRIENTES,177,188,328,281,609
18,18021,180211511,Capital,CORRIENTES,421,392,806,669,1475
18,18021,180211512,Capital,CORRIENTES,244,268,465,416,881
18,18021,180211513,Capital,CORRIENTES,231,264,477,419,896
18,18021,180211514,Capital,CORRIENTES,246,248,494,445,939
18,18021,180211515,Capital,CORRIENTES,199,209,409,357,766
18,18021,180211516,Capital,CORRIENTES,468,408,939,835,1774
18,18021,180211601,Capital,CORRIENTES,183,169,412,370,782
18,18021,180211602,Capital,CORRIENTES,197,202,396,419,815
18,18021,180211603,Capital,CORRIENTES,369,359,806,722,1528
18,18021,180211604,Capital,CORRIENTES,504,430,1057,889,1946
18,18021,180211605,Capital,CORRIENTES,170,162,356,322,678
18,18021,180211606,Capital,CORRIENTES,196,220,392,337,729
18,18021,180211607,Capital,CORRIENTES,233,256,436,356,792
18,18021,180211608,Capital,CORRIENTES,242,234,510,396,906
18,18021,180211609,Capital,CORRIENTES,290,359,498,484,982
18,18021,180211610,Capital,CORRIENTES,182,199,381,365,746
18,18021,180211611,Capital,CORRIENTES,268,302,509,499,1008
18,18021,180211612,Capital,CORRIENTES,213,214,474,419,893
18,18021,180211613,Capital,CORRIENTES,242,234,534,560,1094
18,18021,180211614,Capital,CORRIENTES,292,274,545,513,1058
18,18021,180211615,Capital,CORRIENTES,345,351,684,654,1338
18,18021,180211616,Capital,CORRIENTES,345,357,727,710,1437
18,18021,180211701,Capital,CORRIENTES,302,305,445,489,934
18,18021,180211702,Capital,CORRIENTES,339,290,718,675,1393
18,18021,180211703,Capital,CORRIENTES,404,356,876,889,1765
18,18021,180211704,Capital,CORRIENTES,330,336,642,567,1209
18,18021,180211705,Capital,CORRIENTES,262,227,497,404,901
18,18021,180211706,Capital,CORRIENTES,426,391,832,781,1613
18,18021,180211707,Capital,CORRIENTES,250,318,446,360,806
18,18021,180211708,Capital,CORRIENTES,293,254,571,540,1111
18,18021,180211709,Capital,CORRIENTES,272,255,585,585,1170
18,18021,180211710,Capital,CORRIENTES,318,313,603,573,1176
18,18021,180211711,Capital,CORRIENTES,291,306,566,505,1071
18,18021,180211712,Capital,CORRIENTES,213,217,430,345,775
18,18021,180211713,Capital,CORRIENTES,299,268,670,627,1297
18,18021,180211714,Capital,CORRIENTES,219,224,441,393,834
18,18021,180211715,Capital,CORRIENTES,266,261,529,501,1030
18,18021,180211716,Capital,CORRIENTES,216,216,442,398,840
18,18021,180211717,Capital,CORRIENTES,225,224,511,517,1028
18,18021,180211718,Capital,CORRIENTES,398,392,894,871,1765
18,18021,180211801,Capital,CORRIENTES,429,452,939,837,1776
18,18021,180211802,Capital,CORRIENTES,292,291,647,528,1175
18,18021,180211803,Capital,CORRIENTES,424,407,870,799,1669
18,18021,180211804,Capital,CORRIENTES,487,514,1023,927,1950
18,18021,180211805,Capital,CORRIENTES,261,232,544,544,1088
18,18021,180211806,Capital,CORRIENTES,260,233,572,519,1091
18,18021,180211807,Capital,CORRIENTES,417,401,837,802,1639
18,18021,180211808,Capital,CORRIENTES,386,360,920,836,1756
18,18021,180211809,Capital,CORRIENTES,517,529,1217,1150,2367
18,18021,180211810,Capital,CORRIENTES,261,299,494,497,991
18,18021,180211811,Capital,CORRIENTES,331,365,741,683,1424
18,18021,180211812,Capital,CORRIENTES,448,471,1075,1006,2081
18,18021,180211813,Capital,CORRIENTES,421,446,904,834,1738
18,18021,180211901,Capital,CORRIENTES,262,283,433,403,836
18,18021,180211902,Capital,CORRIENTES,306,278,542,470,1012
18,18021,180211903,Capital,CORRIENTES,233,282,364,315,679
18,18021,180211904,Capital,CORRIENTES,202,257,281,236,517
18,18021,180211905,Capital,CORRIENTES,297,254,669,660,1329
18,18021,180211906,Capital,CORRIENTES,257,234,516,499,1015
18,18021,180211907,Capital,CORRIENTES,226,205,497,525,1022
18,18021,180211908,Capital,CORRIENTES,405,342,836,766,1602
18,18021,180211909,Capital,CORRIENTES,332,323,521,468,989
18,18021,180211910,Capital,CORRIENTES,127,168,192,125,317
18,18021,180211911,Capital,CORRIENTES,296,305,514,451,965
18,18021,180211912,Capital,CORRIENTES,514,462,861,775,1636
18,18021,180211913,Capital,CORRIENTES,196,196,407,407,814
18,18021,180211914,Capital,CORRIENTES,232,225,527,417,944
18,18021,180211915,Capital,CORRIENTES,297,294,565,552,1117
18,18021,180211916,Capital,CORRIENTES,234,254,427,337,764
18,18021,180211917,Capital,CORRIENTES,181,222,355,340,695
18,18021,180211918,Capital,CORRIENTES,314,281,568,550,1118
18,18021,180212001,Capital,CORRIENTES,396,346,698,665,1363
18,18021,180212002,Capital,CORRIENTES,429,431,832,799,1631
18,18021,180212003,Capital,CORRIENTES,477,548,808,764,1572
18,18021,180212004,Capital,CORRIENTES,300,275,599,585,1184
18,18021,180212005,Capital,CORRIENTES,251,242,526,537,1063
18,18021,180212006,Capital,CORRIENTES,368,343,731,656,1387
18,18021,180212007,Capital,CORRIENTES,308,342,573,532,1105
18,18021,180212008,Capital,CORRIENTES,283,356,531,409,940
18,18021,180212009,Capital,CORRIENTES,288,288,592,555,1147
18,18021,180212010,Capital,CORRIENTES,338,308,672,641,1313
18,18021,180212011,Capital,CORRIENTES,446,372,866,825,1691
18,18021,180212012,Capital,CORRIENTES,302,292,601,529,1130
18,18021,180212013,Capital,CORRIENTES,364,353,727,626,1353
18,18021,180212101,Capital,CORRIENTES,334,346,638,590,1228
18,18021,180212102,Capital,CORRIENTES,253,243,438,412,850
18,18021,180212103,Capital,CORRIENTES,392,333,884,753,1637
18,18021,180212104,Capital,CORRIENTES,334,371,598,534,1132
18,18021,180212105,Capital,CORRIENTES,177,179,312,219,531
18,18021,180212106,Capital,CORRIENTES,438,391,1065,1110,2175
18,18021,180212107,Capital,CORRIENTES,353,368,727,672,1399
18,18021,180212108,Capital,CORRIENTES,375,386,819,794,1613
18,18021,180212109,Capital,CORRIENTES,282,285,525,498,1023
18,18021,180212110,Capital,CORRIENTES,407,355,801,777,1578
18,18021,180212111,Capital,CORRIENTES,400,342,825,764,1589
18,18021,180212112,Capital,CORRIENTES,409,339,878,885,1763
18,18021,180212201,Capital,CORRIENTES,175,185,301,292,593
18,18021,180212202,Capital,CORRIENTES,275,256,556,503,1059
18,18021,180212203,Capital,CORRIENTES,369,360,794,726,1520
18,18021,180212204,Capital,CORRIENTES,474,457,1035,1005,2040
18,18021,180212205,Capital,CORRIENTES,309,296,713,743,1456
18,18021,180212206,Capital,CORRIENTES,310,297,678,719,1397
18,18021,180212207,Capital,CORRIENTES,486,501,1087,1085,2172
18,18021,180212208,Capital,CORRIENTES,274,272,592,601,1193
18,18021,180212209,Capital,CORRIENTES,400,387,839,760,1599
18,18021,180212210,Capital,CORRIENTES,329,335,668,632,1300
18,18021,180212211,Capital,CORRIENTES,368,369,809,792,1601
18,18021,180212212,Capital,CORRIENTES,486,491,1022,943,1965
18,18021,180212301,Capital,CORRIENTES,462,446,1024,1054,2078
18,18021,180212302,Capital,CORRIENTES,400,391,855,761,1616
18,18021,180212303,Capital,CORRIENTES,404,411,873,826,1699
18,18021,180212304,Capital,CORRIENTES,323,345,721,648,1369
18,18021,180212305,Capital,CORRIENTES,413,387,1037,885,1922
18,18021,180212306,Capital,CORRIENTES,273,300,635,572,1207
18,18021,180212307,Capital,CORRIENTES,365,331,843,775,1618
18,18021,180212308,Capital,CORRIENTES,298,305,664,635,1299
18,18021,180212309,Capital,CORRIENTES,351,328,788,732,1520
18,18021,180212310,Capital,CORRIENTES,352,368,853,848,1701
18,18021,180212311,Capital,CORRIENTES,392,410,861,849,1710
18,18021,180212312,Capital,CORRIENTES,406,431,926,847,1773
18,18021,180212313,Capital,CORRIENTES,401,436,861,792,1653
18,18021,180212314,Capital,CORRIENTES,116,124,266,250,516
18,18028,180280101,Concepción,CORRIENTES,413,458,771,834,1605
18,18028,180280102,Concepción,CORRIENTES,183,247,332,289,621
18,18028,180280103,Concepción,CORRIENTES,297,345,556,545,1101
18,18028,180280201,Concepción,CORRIENTES,21,33,20,62,82
18,18028,180280202,Concepción,CORRIENTES,27,37,58,58,116
18,18028,180280301,Concepción,CORRIENTES,560,584,1102,1202,2304
18,18028,180280302,Concepción,CORRIENTES,15,24,16,29,45
18,18028,180280303,Concepción,CORRIENTES,85,92,158,172,330
18,18028,180280304,Concepción,CORRIENTES,5,12,5,11,16
18,18028,180280305,Concepción,CORRIENTES,18,25,27,46,73
18,18028,180280306,Concepción,CORRIENTES,36,36,95,108,203
18,18028,180280307,Concepción,CORRIENTES,39,41,75,97,172
18,18028,180280308,Concepción,CORRIENTES,171,191,368,380,748
18,18028,180280309,Concepción,CORRIENTES,374,401,784,858,1642
18,18028,180280310,Concepción,CORRIENTES,268,301,527,526,1053
18,18028,180280311,Concepción,CORRIENTES,337,366,685,648,1333
18,18028,180280312,Concepción,CORRIENTES,538,568,1168,1152,2320
18,18028,180280401,Concepción,CORRIENTES,235,285,463,453,916
18,18028,180280402,Concepción,CORRIENTES,21,24,31,57,88
18,18028,180280403,Concepción,CORRIENTES,45,47,106,110,216
18,18028,180280404,Concepción,CORRIENTES,6,8,7,23,30
18,18028,180280405,Concepción,CORRIENTES,138,158,287,322,609
18,18028,180280406,Concepción,CORRIENTES,143,161,296,329,625
18,18028,180280407,Concepción,CORRIENTES,123,138,237,256,493
18,18028,180280408,Concepción,CORRIENTES,79,81,147,156,303
18,18028,180280409,Concepción,CORRIENTES,94,110,197,204,401
18,18028,180280410,Concepción,CORRIENTES,36,39,60,84,144
18,18028,180280411,Concepción,CORRIENTES,67,70,114,126,240
18,18028,180280412,Concepción,CORRIENTES,161,172,376,355,731
18,18028,180280413,Concepción,CORRIENTES,126,150,275,289,564
18,18028,180280501,Concepción,CORRIENTES,19,32,21,42,63
18,18028,180280502,Concepción,CORRIENTES,22,25,8,55,63
18,18028,180280503,Concepción,CORRIENTES,17,22,30,41,71
18,18028,180280601,Concepción,CORRIENTES,25,32,31,57,88
18,18028,180280602,Concepción,CORRIENTES,4,6,2,20,22
18,18028,180280603,Concepción,CORRIENTES,22,25,29,30,59
18,18028,180280604,Concepción,CORRIENTES,85,103,160,167,327
18,18028,180280605,Concepción,CORRIENTES,12,24,20,22,42
18,18028,180280606,Concepción,CORRIENTES,20,30,17,47,64
18,18028,180280701,Concepción,CORRIENTES,64,71,102,103,205
18,18028,180280702,Concepción,CORRIENTES,149,160,345,330,675
18,18028,180280703,Concepción,CORRIENTES,23,25,31,36,67
18,18028,180280704,Concepción,CORRIENTES,16,16,21,37,58
18,18028,180280705,Concepción,CORRIENTES,26,33,31,46,77
18,18028,180280706,Concepción,CORRIENTES,24,28,20,40,60
18,18028,180280707,Concepción,CORRIENTES,16,22,21,27,48
18,18035,180350101,Curuzú Cuatiá,CORRIENTES,294,299,534,512,1046
18,18035,180350102,Curuzú Cuatiá,CORRIENTES,206,204,391,387,778
18,18035,180350103,Curuzú Cuatiá,CORRIENTES,342,372,665,636,1301
18,18035,180350104,Curuzú Cuatiá,CORRIENTES,300,336,495,481,976
18,18035,180350105,Curuzú Cuatiá,CORRIENTES,321,349,481,393,874
18,18035,180350106,Curuzú Cuatiá,CORRIENTES,155,201,238,188,426
18,18035,180350107,Curuzú Cuatiá,CORRIENTES,189,214,314,263,577
18,18035,180350108,Curuzú Cuatiá,CORRIENTES,171,214,265,224,489
18,18035,180350109,Curuzú Cuatiá,CORRIENTES,232,259,446,346,792
18,18035,180350110,Curuzú Cuatiá,CORRIENTES,212,227,352,339,691
18,18035,180350111,Curuzú Cuatiá,CORRIENTES,294,300,609,599,1208
18,18035,180350112,Curuzú Cuatiá,CORRIENTES,220,240,439,389,828
18,18035,180350113,Curuzú Cuatiá,CORRIENTES,232,244,394,329,723
18,18035,180350114,Curuzú Cuatiá,CORRIENTES,6,7,5,7,12
18,18035,180350115,Curuzú Cuatiá,CORRIENTES,225,228,470,448,918
18,18035,180350116,Curuzú Cuatiá,CORRIENTES,201,227,408,404,812
18,18035,180350201,Curuzú Cuatiá,CORRIENTES,34,35,42,83,125
18,18035,180350301,Curuzú Cuatiá,CORRIENTES,50,66,60,103,163
18,18035,180350302,Curuzú Cuatiá,CORRIENTES,33,43,64,70,134
18,18035,180350303,Curuzú Cuatiá,CORRIENTES,41,58,41,81,122
18,18035,180350401,Curuzú Cuatiá,CORRIENTES,17,21,15,69,84
18,18035,180350402,Curuzú Cuatiá,CORRIENTES,33,44,28,71,99
18,18035,180350501,Curuzú Cuatiá,CORRIENTES,114,144,167,175,342
18,18035,180350502,Curuzú Cuatiá,CORRIENTES,78,98,118,134,252
18,18035,180350503,Curuzú Cuatiá,CORRIENTES,12,12,14,40,54
18,18035,180350601,Curuzú Cuatiá,CORRIENTES,30,38,18,44,62
18,18035,180350602,Curuzú Cuatiá,CORRIENTES,25,41,20,55,75
18,18035,180350603,Curuzú Cuatiá,CORRIENTES,114,124,222,234,456
18,18035,180350701,Curuzú Cuatiá,CORRIENTES,41,47,57,101,158
18,18035,180350702,Curuzú Cuatiá,CORRIENTES,19,31,26,50,76
18,18035,180350801,Curuzú Cuatiá,CORRIENTES,21,24,30,41,71
18,18035,180350802,Curuzú Cuatiá,CORRIENTES,73,78,111,122,233
18,18035,180350901,Curuzú Cuatiá,CORRIENTES,18,20,8,66,74
18,18035,180350902,Curuzú Cuatiá,CORRIENTES,30,33,47,54,101
18,18035,180351001,Curuzú Cuatiá,CORRIENTES,16,25,18,27,45
18,18035,180351002,Curuzú Cuatiá,CORRIENTES,6,12,3,21,24
18,18035,180351101,Curuzú Cuatiá,CORRIENTES,147,186,262,294,556
18,18035,180351102,Curuzú Cuatiá,CORRIENTES,36,46,43,65,108
18,18035,180351201,Curuzú Cuatiá,CORRIENTES,44,51,70,82,152
18,18035,180351202,Curuzú Cuatiá,CORRIENTES,15,20,26,29,55
18,18035,180351203,Curuzú Cuatiá,CORRIENTES,24,30,31,54,85
18,18035,180351301,Curuzú Cuatiá,CORRIENTES,70,79,83,114,197
18,18035,180351302,Curuzú Cuatiá,CORRIENTES,25,31,26,35,61
18,18035,180351303,Curuzú Cuatiá,CORRIENTES,74,88,138,141,279
18,18035,180351401,Curuzú Cuatiá,CORRIENTES,147,185,279,270,549
18,18035,180351402,Curuzú Cuatiá,CORRIENTES,39,58,73,83,156
18,18035,180351501,Curuzú Cuatiá,CORRIENTES,308,339,609,542,1151
18,18035,180351502,Curuzú Cuatiá,CORRIENTES,291,322,559,619,1178
18,18035,180351503,Curuzú Cuatiá,CORRIENTES,29,32,48,54,102
18,18035,180351504,Curuzú Cuatiá,CORRIENTES,30,44,61,55,116
18,18035,180351505,Curuzú Cuatiá,CORRIENTES,26,31,23,58,81
18,18035,180351506,Curuzú Cuatiá,CORRIENTES,110,126,201,229,430
18,18035,180351507,Curuzú Cuatiá,CORRIENTES,9,12,10,15,25
18,18035,180351508,Curuzú Cuatiá,CORRIENTES,26,39,34,43,77
18,18035,180351509,Curuzú Cuatiá,CORRIENTES,27,42,46,60,106
18,18035,180351510,Curuzú Cuatiá,CORRIENTES,229,249,414,386,800
18,18035,180351511,Curuzú Cuatiá,CORRIENTES,202,227,388,386,774
18,18035,180351601,Curuzú Cuatiá,CORRIENTES,20,37,32,35,67
18,18035,180351602,Curuzú Cuatiá,CORRIENTES,20,21,19,68,87
18,18035,180351701,Curuzú Cuatiá,CORRIENTES,12,15,9,25,34
18,18035,180351702,Curuzú Cuatiá,CORRIENTES,11,16,11,26,37
18,18035,180351801,Curuzú Cuatiá,CORRIENTES,357,369,827,695,1522
18,18035,180351802,Curuzú Cuatiá,CORRIENTES,377,396,732,682,1414
18,18035,180351803,Curuzú Cuatiá,CORRIENTES,182,244,342,304,646
18,18035,180351804,Curuzú Cuatiá,CORRIENTES,216,234,383,366,749
18,18035,180351805,Curuzú Cuatiá,CORRIENTES,326,315,571,477,1048
18,18035,180351806,Curuzú Cuatiá,CORRIENTES,173,195,300,246,546
18,18035,180351807,Curuzú Cuatiá,CORRIENTES,310,318,546,456,1002
18,18035,180351808,Curuzú Cuatiá,CORRIENTES,343,353,738,618,1356
18,18035,180351809,Curuzú Cuatiá,CORRIENTES,285,317,574,569,1143
18,18035,180351810,Curuzú Cuatiá,CORRIENTES,308,330,672,612,1284
18,18035,180351811,Curuzú Cuatiá,CORRIENTES,173,206,364,367,731
18,18035,180351901,Curuzú Cuatiá,CORRIENTES,119,133,262,220,482
18,18035,180351902,Curuzú Cuatiá,CORRIENTES,223,250,468,390,858
18,18035,180351903,Curuzú Cuatiá,CORRIENTES,347,362,739,645,1384
18,18035,180351904,Curuzú Cuatiá,CORRIENTES,356,366,648,609,1257
18,18035,180351905,Curuzú Cuatiá,CORRIENTES,302,320,572,508,1080
18,18035,180351906,Curuzú Cuatiá,CORRIENTES,200,222,287,234,521
18,18035,180351907,Curuzú Cuatiá,CORRIENTES,177,197,285,223,508
18,18035,180351908,Curuzú Cuatiá,CORRIENTES,140,151,250,205,455
18,18035,180351909,Curuzú Cuatiá,CORRIENTES,202,213,334,282,616
18,18035,180351910,Curuzú Cuatiá,CORRIENTES,224,225,451,412,863
18,18035,180351911,Curuzú Cuatiá,CORRIENTES,172,226,265,219,484
18,18035,180351912,Curuzú Cuatiá,CORRIENTES,269,310,440,358,798
18,18035,180351913,Curuzú Cuatiá,CORRIENTES,289,303,605,568,1173
18,18042,180420101,Empedrado,CORRIENTES,240,273,453,462,915
18,18042,180420102,Empedrado,CORRIENTES,328,386,658,588,1246
18,18042,180420103,Empedrado,CORRIENTES,218,263,422,369,791
18,18042,180420104,Empedrado,CORRIENTES,361,430,712,660,1372
18,18042,180420105,Empedrado,CORRIENTES,209,231,453,427,880
18,18042,180420106,Empedrado,CORRIENTES,243,280,469,480,949
18,18042,180420107,Empedrado,CORRIENTES,296,366,571,520,1091
18,18042,180420108,Empedrado,CORRIENTES,295,347,522,482,1004
18,18042,180420109,Empedrado,CORRIENTES,234,270,455,426,881
18,18042,180420201,Empedrado,CORRIENTES,8,17,17,23,40
18,18042,180420202,Empedrado,CORRIENTES,67,86,112,118,230
18,18042,180420203,Empedrado,CORRIENTES,8,9,13,19,32
18,18042,180420204,Empedrado,CORRIENTES,36,50,57,62,119
18,18042,180420301,Empedrado,CORRIENTES,107,132,206,214,420
18,18042,180420302,Empedrado,CORRIENTES,25,31,28,43,71
18,18042,180420303,Empedrado,CORRIENTES,28,35,45,38,83
18,18042,180420304,Empedrado,CORRIENTES,132,172,240,247,487
18,18042,180420305,Empedrado,CORRIENTES,55,58,91,79,170
18,18042,180420306,Empedrado,CORRIENTES,54,57,100,124,224
18,18042,180420307,Empedrado,CORRIENTES,160,170,293,310,603
18,18042,180420308,Empedrado,CORRIENTES,22,19,36,46,82
18,18042,180420401,Empedrado,CORRIENTES,43,51,83,86,169
18,18042,180420402,Empedrado,CORRIENTES,14,23,21,24,45
18,18042,180420403,Empedrado,CORRIENTES,50,56,96,89,185
18,18042,180420404,Empedrado,CORRIENTES,21,21,36,51,87
18,18042,180420405,Empedrado,CORRIENTES,30,24,60,47,107
18,18042,180420501,Empedrado,CORRIENTES,93,103,178,161,339
18,18042,180420502,Empedrado,CORRIENTES,67,86,135,109,244
18,18042,180420503,Empedrado,CORRIENTES,70,86,120,138,258
18,18042,180420504,Empedrado,CORRIENTES,147,166,225,291,516
18,18042,180420505,Empedrado,CORRIENTES,34,39,56,54,110
18,18042,180420506,Empedrado,CORRIENTES,190,215,360,339,699
18,18042,180420507,Empedrado,CORRIENTES,157,190,299,301,600
18,18042,180420601,Empedrado,CORRIENTES,2,3,0,4,4
18,18042,180420602,Empedrado,CORRIENTES,11,11,20,36,56
18,18042,180420603,Empedrado,CORRIENTES,0,1,0,0,0
18,18049,180490101,Esquina,CORRIENTES,240,246,497,480,977
18,18049,180490102,Esquina,CORRIENTES,248,271,509,485,994
18,18049,180490103,Esquina,CORRIENTES,397,436,820,810,1630
18,18049,180490104,Esquina,CORRIENTES,378,408,739,730,1469
18,18049,180490105,Esquina,CORRIENTES,188,225,333,305,638
18,18049,180490106,Esquina,CORRIENTES,169,197,287,242,529
18,18049,180490107,Esquina,CORRIENTES,270,317,409,342,751
18,18049,180490108,Esquina,CORRIENTES,207,244,320,255,575
18,18049,180490109,Esquina,CORRIENTES,305,361,584,488,1072
18,18049,180490110,Esquina,CORRIENTES,328,407,542,436,978
18,18049,180490111,Esquina,CORRIENTES,191,215,344,308,652
18,18049,180490112,Esquina,CORRIENTES,214,235,370,313,683
18,18049,180490113,Esquina,CORRIENTES,377,416,865,784,1649
18,18049,180490114,Esquina,CORRIENTES,219,213,452,411,863
18,18049,180490115,Esquina,CORRIENTES,192,225,433,407,840
18,18049,180490116,Esquina,CORRIENTES,388,422,721,666,1387
18,18049,180490117,Esquina,CORRIENTES,301,337,592,544,1136
18,18049,180490118,Esquina,CORRIENTES,171,177,328,339,667
18,18049,180490201,Esquina,CORRIENTES,30,33,69,71,140
18,18049,180490202,Esquina,CORRIENTES,129,169,236,250,486
18,18049,180490203,Esquina,CORRIENTES,59,73,141,135,276
18,18049,180490204,Esquina,CORRIENTES,21,26,32,51,83
18,18049,180490205,Esquina,CORRIENTES,16,21,26,28,54
18,18049,180490206,Esquina,CORRIENTES,9,12,10,14,24
18,18049,180490207,Esquina,CORRIENTES,217,230,433,421,854
18,18049,180490301,Esquina,CORRIENTES,284,334,523,561,1084
18,18049,180490302,Esquina,CORRIENTES,6,10,9,12,21
18,18049,180490303,Esquina,CORRIENTES,25,36,40,45,85
18,18049,180490304,Esquina,CORRIENTES,36,44,66,83,149
18,18049,180490305,Esquina,CORRIENTES,35,36,93,79,172
18,18049,180490306,Esquina,CORRIENTES,200,189,364,423,787
18,18049,180490307,Esquina,CORRIENTES,98,109,162,192,354
18,18049,180490308,Esquina,CORRIENTES,254,314,473,459,932
18,18049,180490401,Esquina,CORRIENTES,70,95,112,152,264
18,18049,180490402,Esquina,CORRIENTES,72,73,137,118,255
18,18049,180490403,Esquina,CORRIENTES,29,47,56,53,109
18,18049,180490404,Esquina,CORRIENTES,39,34,56,73,129
18,18049,180490405,Esquina,CORRIENTES,44,37,88,92,180
18,18049,180490501,Esquina,CORRIENTES,73,78,158,151,309
18,18049,180490502,Esquina,CORRIENTES,16,22,24,31,55
18,18049,180490503,Esquina,CORRIENTES,4,6,0,4,4
18,18049,180490601,Esquina,CORRIENTES,16,22,27,28,55
18,18049,180490602,Esquina,CORRIENTES,11,12,13,21,34
18,18049,180490603,Esquina,CORRIENTES,16,19,33,37,70
18,18049,180490701,Esquina,CORRIENTES,629,647,1363,1282,2645
18,18049,180490702,Esquina,CORRIENTES,117,131,256,235,491
18,18049,180490703,Esquina,CORRIENTES,150,166,280,309,589
18,18049,180490704,Esquina,CORRIENTES,217,237,402,432,834
18,18049,180490705,Esquina,CORRIENTES,16,19,27,28,55
18,18049,180490801,Esquina,CORRIENTES,43,50,91,73,164
18,18049,180490802,Esquina,CORRIENTES,61,71,137,148,285
18,18049,180490901,Esquina,CORRIENTES,9,9,19,23,42
18,18049,180490902,Esquina,CORRIENTES,46,54,115,119,234
18,18049,180490903,Esquina,CORRIENTES,17,18,37,51,88
18,18049,180490904,Esquina,CORRIENTES,19,20,36,54,90
18,18049,180491001,Esquina,CORRIENTES,116,123,263,268,531
18,18049,180491002,Esquina,CORRIENTES,45,46,85,90,175
18,18049,180491003,Esquina,CORRIENTES,14,17,29,30,59
18,18049,180491101,Esquina,CORRIENTES,17,30,25,40,65
18,18056,180560101,General Alvear,CORRIENTES,254,296,442,433,875
18,18056,180560102,General Alvear,CORRIENTES,239,247,389,364,753
18,18056,180560103,General Alvear,CORRIENTES,325,338,615,555,1170
18,18056,180560104,General Alvear,CORRIENTES,314,362,558,507,1065
18,18056,180560105,General Alvear,CORRIENTES,162,191,297,266,563
18,18056,180560106,General Alvear,CORRIENTES,160,186,234,199,433
18,18056,180560107,General Alvear,CORRIENTES,156,213,238,217,455
18,18056,180560108,General Alvear,CORRIENTES,140,169,232,220,452
18,18056,180560109,General Alvear,CORRIENTES,156,228,248,214,462
18,18056,180560110,General Alvear,CORRIENTES,118,120,221,204,425
18,18056,180560201,General Alvear,CORRIENTES,87,113,153,178,331
18,18056,180560202,General Alvear,CORRIENTES,35,54,40,71,111
18,18056,180560301,General Alvear,CORRIENTES,71,83,160,146,306
18,18056,180560302,General Alvear,CORRIENTES,18,40,14,34,48
18,18056,180560303,General Alvear,CORRIENTES,15,23,21,31,52
18,18056,180560401,General Alvear,CORRIENTES,39,56,51,65,116
18,18056,180560402,General Alvear,CORRIENTES,16,17,15,21,36
18,18056,180560403,General Alvear,CORRIENTES,12,15,18,21,39
18,18056,180560404,General Alvear,CORRIENTES,6,10,4,7,11
18,18056,180560501,General Alvear,CORRIENTES,10,23,12,24,36
18,18056,180560502,General Alvear,CORRIENTES,10,16,5,17,22
18,18056,180560503,General Alvear,CORRIENTES,17,18,22,34,56
18,18056,180560504,General Alvear,CORRIENTES,5,4,6,7,13
18,18056,180560601,General Alvear,CORRIENTES,5,13,6,14,20
18,18056,180560602,General Alvear,CORRIENTES,2,11,1,6,7
18,18056,180560603,General Alvear,CORRIENTES,3,14,1,5,6
18,18056,180560604,General Alvear,CORRIENTES,10,20,4,55,59
18,18056,180560605,General Alvear,CORRIENTES,2,5,0,4,4
18,18063,180630101,General Paz,CORRIENTES,485,491,866,758,1624
18,18063,180630102,General Paz,CORRIENTES,364,416,688,571,1259
18,18063,180630103,General Paz,CORRIENTES,230,262,436,390,826
18,18063,180630104,General Paz,CORRIENTES,272,285,539,490,1029
18,18063,180630201,General Paz,CORRIENTES,196,216,330,375,705
18,18063,180630202,General Paz,CORRIENTES,340,418,601,563,1164
18,18063,180630203,General Paz,CORRIENTES,32,81,54,64,118
18,18063,180630204,General Paz,CORRIENTES,138,154,249,253,502
18,18063,180630205,General Paz,CORRIENTES,201,225,369,350,719
18,18063,180630206,General Paz,CORRIENTES,230,257,463,468,931
18,18063,180630301,General Paz,CORRIENTES,138,165,226,277,503
18,18063,180630302,General Paz,CORRIENTES,20,28,34,49,83
18,18063,180630303,General Paz,CORRIENTES,64,74,103,124,227
18,18063,180630304,General Paz,CORRIENTES,42,35,64,62,126
18,18063,180630401,General Paz,CORRIENTES,123,142,183,175,358
18,18063,180630402,General Paz,CORRIENTES,32,47,54,56,110
18,18063,180630403,General Paz,CORRIENTES,6,8,16,14,30
18,18063,180630404,General Paz,CORRIENTES,22,29,33,33,66
18,18063,180630405,General Paz,CORRIENTES,3,8,3,8,11
18,18063,180630406,General Paz,CORRIENTES,37,42,61,72,133
18,18063,180630407,General Paz,CORRIENTES,6,6,9,24,33
18,18063,180630408,General Paz,CORRIENTES,8,9,16,18,34
18,18063,180630501,General Paz,CORRIENTES,36,42,62,79,141
18,18063,180630502,General Paz,CORRIENTES,44,55,73,83,156
18,18063,180630503,General Paz,CORRIENTES,55,59,103,129,232
18,18063,180630504,General Paz,CORRIENTES,16,18,29,37,66
18,18063,180630601,General Paz,CORRIENTES,26,32,35,44,79
18,18063,180630602,General Paz,CORRIENTES,27,33,40,64,104
18,18063,180630603,General Paz,CORRIENTES,8,10,10,8,18
18,18063,180630701,General Paz,CORRIENTES,137,162,248,242,490
18,18063,180630702,General Paz,CORRIENTES,31,45,52,57,109
18,18063,180630703,General Paz,CORRIENTES,52,56,96,118,214
18,18063,180630704,General Paz,CORRIENTES,97,109,181,173,354
18,18063,180630705,General Paz,CORRIENTES,87,106,173,169,342
18,18063,180630706,General Paz,CORRIENTES,38,39,75,81,156
18,18063,180630801,General Paz,CORRIENTES,28,32,53,53,106
18,18063,180630802,General Paz,CORRIENTES,76,80,150,170,320
18,18063,180630803,General Paz,CORRIENTES,56,60,83,91,174
18,18063,180630804,General Paz,CORRIENTES,111,126,170,210,380
18,18063,180630805,General Paz,CORRIENTES,73,90,143,152,295
18,18063,180630806,General Paz,CORRIENTES,131,148,258,250,508
18,18063,180630901,General Paz,CORRIENTES,1,6,0,1,1
18,18070,180700101,Goya,CORRIENTES,259,281,431,377,808
18,18070,180700102,Goya,CORRIENTES,253,314,420,348,768
18,18070,180700103,Goya,CORRIENTES,284,317,433,398,831
18,18070,180700104,Goya,CORRIENTES,213,239,390,316,706
18,18070,180700105,Goya,CORRIENTES,233,234,402,349,751
18,18070,180700106,Goya,CORRIENTES,273,312,454,389,843
18,18070,180700107,Goya,CORRIENTES,266,295,411,336,747
18,18070,180700108,Goya,CORRIENTES,241,265,375,330,705
18,18070,180700109,Goya,CORRIENTES,229,238,387,344,731
18,18070,180700110,Goya,CORRIENTES,243,260,507,462,969
18,18070,180700111,Goya,CORRIENTES,333,340,624,523,1147
18,18070,180700112,Goya,CORRIENTES,234,236,447,397,844
18,18070,180700113,Goya,CORRIENTES,219,211,434,406,840
18,18070,180700114,Goya,CORRIENTES,256,270,427,328,755
18,18070,180700115,Goya,CORRIENTES,300,308,544,503,1047
18,18070,180700116,Goya,CORRIENTES,205,209,394,353,747
18,18070,180700117,Goya,CORRIENTES,232,248,411,375,786
18,18070,180700118,Goya,CORRIENTES,91,93,205,186,391
18,18070,180700201,Goya,CORRIENTES,173,203,294,287,581
18,18070,180700202,Goya,CORRIENTES,173,207,380,412,792
18,18070,180700203,Goya,CORRIENTES,148,164,294,314,608
18,18070,180700204,Goya,CORRIENTES,92,136,155,151,306
18,18070,180700205,Goya,CORRIENTES,30,43,53,49,102
18,18070,180700206,Goya,CORRIENTES,33,38,74,75,149
18,18070,180700207,Goya,CORRIENTES,27,27,56,49,105
18,18070,180700208,Goya,CORRIENTES,5,8,5,6,11
18,18070,180700209,Goya,CORRIENTES,52,56,99,111,210
18,18070,180700210,Goya,CORRIENTES,3,12,3,9,12
18,18070,180700301,Goya,CORRIENTES,185,206,325,330,655
18,18070,180700302,Goya,CORRIENTES,107,127,199,196,395
18,18070,180700303,Goya,CORRIENTES,40,46,58,59,117
18,18070,180700401,Goya,CORRIENTES,30,39,46,48,94
18,18070,180700402,Goya,CORRIENTES,40,46,79,70,149
18,18070,180700403,Goya,CORRIENTES,22,36,35,43,78
18,18070,180700404,Goya,CORRIENTES,24,30,43,51,94
18,18070,180700501,Goya,CORRIENTES,61,67,144,129,273
18,18070,180700502,Goya,CORRIENTES,37,37,74,71,145
18,18070,180700503,Goya,CORRIENTES,10,13,9,15,24
18,18070,180700601,Goya,CORRIENTES,25,32,60,52,112
18,18070,180700602,Goya,CORRIENTES,12,21,14,22,36
18,18070,180700603,Goya,CORRIENTES,31,31,59,64,123
18,18070,180700701,Goya,CORRIENTES,30,38,54,50,104
18,18070,180700702,Goya,CORRIENTES,7,10,13,11,24
18,18070,180700703,Goya,CORRIENTES,13,16,25,43,68
18,18070,180700801,Goya,CORRIENTES,56,61,111,136,247
18,18070,180700802,Goya,CORRIENTES,47,55,106,139,245
18,18070,180700803,Goya,CORRIENTES,58,72,124,133,257
18,18070,180700804,Goya,CORRIENTES,79,86,172,178,350
18,18070,180700901,Goya,CORRIENTES,50,64,85,93,178
18,18070,180700902,Goya,CORRIENTES,61,66,125,111,236
18,18070,180701001,Goya,CORRIENTES,31,34,52,54,106
18,18070,180701002,Goya,CORRIENTES,53,61,93,110,203
18,18070,180701003,Goya,CORRIENTES,115,129,217,254,471
18,18070,180701004,Goya,CORRIENTES,43,51,102,114,216
18,18070,180701005,Goya,CORRIENTES,111,119,266,280,546
18,18070,180701101,Goya,CORRIENTES,85,86,192,207,399
18,18070,180701102,Goya,CORRIENTES,103,111,234,244,478
18,18070,180701201,Goya,CORRIENTES,186,212,329,383,712
18,18070,180701202,Goya,CORRIENTES,70,75,162,159,321
18,18070,180701203,Goya,CORRIENTES,50,69,85,99,184
18,18070,180701204,Goya,CORRIENTES,96,109,173,184,357
18,18070,180701301,Goya,CORRIENTES,104,117,190,235,425
18,18070,180701302,Goya,CORRIENTES,34,45,73,84,157
18,18070,180701303,Goya,CORRIENTES,167,194,347,348,695
18,18070,180701304,Goya,CORRIENTES,17,20,19,29,48
18,18070,180701401,Goya,CORRIENTES,106,134,237,228,465
18,18070,180701402,Goya,CORRIENTES,92,94,209,201,410
18,18070,180701403,Goya,CORRIENTES,124,142,243,263,506
18,18070,180701404,Goya,CORRIENTES,72,101,154,138,292
18,18070,180701501,Goya,CORRIENTES,62,68,126,131,257
18,18070,180701502,Goya,CORRIENTES,67,78,126,136,262
18,18070,180701503,Goya,CORRIENTES,111,126,208,231,439
18,18070,180701504,Goya,CORRIENTES,13,17,20,23,43
18,18070,180701505,Goya,CORRIENTES,33,34,72,74,146
18,18070,180701506,Goya,CORRIENTES,331,330,753,639,1392
18,18070,180701507,Goya,CORRIENTES,292,300,662,551,1213
18,18070,180701508,Goya,CORRIENTES,383,381,787,797,1584
18,18070,180701509,Goya,CORRIENTES,350,371,739,651,1390
18,18070,180701601,Goya,CORRIENTES,82,91,161,176,337
18,18070,180701602,Goya,CORRIENTES,40,40,56,75,131
18,18070,180701603,Goya,CORRIENTES,59,65,91,84,175
18,18070,180701604,Goya,CORRIENTES,60,71,114,129,243
18,18070,180701605,Goya,CORRIENTES,64,62,106,114,220
18,18070,180701606,Goya,CORRIENTES,71,82,115,112,227
18,18070,180701607,Goya,CORRIENTES,93,93,179,149,328
18,18070,180701701,Goya,CORRIENTES,62,75,105,113,218
18,18070,180701702,Goya,CORRIENTES,16,22,26,27,53
18,18070,180701703,Goya,CORRIENTES,64,70,106,111,217
18,18070,180701704,Goya,CORRIENTES,23,27,30,34,64
18,18070,180701801,Goya,CORRIENTES,65,77,117,116,233
18,18070,180701802,Goya,CORRIENTES,75,87,128,147,275
18,18070,180701803,Goya,CORRIENTES,81,126,140,141,281
18,18070,180701901,Goya,CORRIENTES,5,6,6,12,18
18,18070,180701902,Goya,CORRIENTES,145,176,318,333,651
18,18070,180701903,Goya,CORRIENTES,6,6,15,17,32
18,18070,180701904,Goya,CORRIENTES,13,13,30,32,62
18,18070,180701905,Goya,CORRIENTES,14,14,28,37,65
18,18070,180701906,Goya,CORRIENTES,0,4,0,0,0
18,18070,180701907,Goya,CORRIENTES,4,6,8,8,16
18,18070,180701908,Goya,CORRIENTES,3,3,5,6,11
18,18070,180701909,Goya,CORRIENTES,25,25,31,49,80
18,18070,180702001,Goya,CORRIENTES,231,177,445,397,842
18,18070,180702002,Goya,CORRIENTES,221,231,403,362,765
18,18070,180702003,Goya,CORRIENTES,212,200,409,310,719
18,18070,180702004,Goya,CORRIENTES,353,350,641,586,1227
18,18070,180702005,Goya,CORRIENTES,286,315,510,447,957
18,18070,180702006,Goya,CORRIENTES,298,345,497,446,943
18,18070,180702007,Goya,CORRIENTES,260,281,455,378,833
18,18070,180702008,Goya,CORRIENTES,346,392,573,498,1071
18,18070,180702009,Goya,CORRIENTES,268,310,433,354,787
18,18070,180702010,Goya,CORRIENTES,222,239,408,355,763
18,18070,180702011,Goya,CORRIENTES,217,272,342,262,604
18,18070,180702012,Goya,CORRIENTES,242,304,400,329,729
18,18070,180702013,Goya,CORRIENTES,264,288,457,360,817
18,18070,180702014,Goya,CORRIENTES,211,239,303,260,563
18,18070,180702015,Goya,CORRIENTES,192,226,307,268,575
18,18070,180702016,Goya,CORRIENTES,271,283,392,325,717
18,18070,180702101,Goya,CORRIENTES,200,195,394,334,728
18,18070,180702102,Goya,CORRIENTES,19,24,37,28,65
18,18070,180702103,Goya,CORRIENTES,386,385,837,732,1569
18,18070,180702104,Goya,CORRIENTES,336,344,684,654,1338
18,18070,180702105,Goya,CORRIENTES,319,333,566,508,1074
18,18070,180702106,Goya,CORRIENTES,238,256,431,372,803
18,18070,180702107,Goya,CORRIENTES,87,92,181,170,351
18,18070,180702108,Goya,CORRIENTES,182,191,379,390,769
18,18070,180702109,Goya,CORRIENTES,305,311,622,558,1180
18,18070,180702110,Goya,CORRIENTES,259,234,484,451,935
18,18070,180702111,Goya,CORRIENTES,245,249,451,411,862
18,18070,180702112,Goya,CORRIENTES,264,259,600,549,1149
18,18070,180702113,Goya,CORRIENTES,362,360,759,717,1476
18,18070,180702114,Goya,CORRIENTES,234,240,438,409,847
18,18070,180702115,Goya,CORRIENTES,370,345,813,732,1545
18,18070,180702116,Goya,CORRIENTES,313,335,629,571,1200
18,18070,180702117,Goya,CORRIENTES,259,244,562,570,1132
18,18070,180702201,Goya,CORRIENTES,384,378,832,848,1680
18,18070,180702202,Goya,CORRIENTES,343,363,714,662,1376
18,18070,180702203,Goya,CORRIENTES,311,282,562,463,1025
18,18070,180702204,Goya,CORRIENTES,421,396,838,712,1550
18,18070,180702205,Goya,CORRIENTES,214,155,416,418,834
18,18070,180702206,Goya,CORRIENTES,343,354,613,596,1209
18,18070,180702207,Goya,CORRIENTES,225,241,377,321,698
18,18070,180702208,Goya,CORRIENTES,251,253,486,487,973
18,18070,180702209,Goya,CORRIENTES,205,218,414,364,778
18,18070,180702210,Goya,CORRIENTES,456,429,893,832,1725
18,18070,180702211,Goya,CORRIENTES,24,23,57,59,116
18,18070,180702212,Goya,CORRIENTES,382,403,729,617,1346
18,18070,180702213,Goya,CORRIENTES,323,329,660,569,1229
18,18070,180702214,Goya,CORRIENTES,261,277,596,538,1134
18,18070,180702215,Goya,CORRIENTES,357,355,867,897,1764
18,18070,180702216,Goya,CORRIENTES,287,299,650,648,1298
18,18070,180702217,Goya,CORRIENTES,273,257,591,497,1088
18,18070,180702218,Goya,CORRIENTES,316,329,654,597,1251
18,18077,180770101,Itatí,CORRIENTES,199,212,391,388,779
18,18077,180770102,Itatí,CORRIENTES,161,207,292,274,566
18,18077,180770103,Itatí,CORRIENTES,320,363,629,536,1165
18,18077,180770104,Itatí,CORRIENTES,314,355,565,519,1084
18,18077,180770105,Itatí,CORRIENTES,209,251,385,358,743
18,18077,180770106,Itatí,CORRIENTES,216,256,481,402,883
18,18077,180770201,Itatí,CORRIENTES,168,201,321,357,678
18,18077,180770202,Itatí,CORRIENTES,86,109,145,130,275
18,18077,180770203,Itatí,CORRIENTES,68,76,112,110,222
18,18077,180770204,Itatí,CORRIENTES,94,109,157,211,368
18,18077,180770205,Itatí,CORRIENTES,67,86,124,135,259
18,18077,180770206,Itatí,CORRIENTES,13,15,19,21,40
18,18077,180770207,Itatí,CORRIENTES,14,16,29,29,58
18,18077,180770208,Itatí,CORRIENTES,146,166,332,320,652
18,18077,180770301,Itatí,CORRIENTES,165,183,272,317,589
18,18077,180770302,Itatí,CORRIENTES,56,69,115,116,231
18,18077,180770401,Itatí,CORRIENTES,23,35,40,42,82
18,18077,180770402,Itatí,CORRIENTES,76,85,131,157,288
18,18077,180770501,Itatí,CORRIENTES,23,25,43,42,85
18,18077,180770502,Itatí,CORRIENTES,32,35,39,66,105
18,18077,180770503,Itatí,CORRIENTES,5,8,12,6,18
18,18077,180770601,Itatí,CORRIENTES,0,1,0,0,0
18,18077,180770602,Itatí,CORRIENTES,1,1,0,1,1
18,18077,180770603,Itatí,CORRIENTES,0,1,0,0,0
18,18084,180840101,Ituzaingó,CORRIENTES,346,475,721,684,1405
18,18084,180840102,Ituzaingó,CORRIENTES,222,452,433,410,843
18,18084,180840103,Ituzaingó,CORRIENTES,244,275,445,446,891
18,18084,180840104,Ituzaingó,CORRIENTES,190,220,358,302,660
18,18084,180840105,Ituzaingó,CORRIENTES,227,259,397,372,769
18,18084,180840106,Ituzaingó,CORRIENTES,247,268,480,483,963
18,18084,180840107,Ituzaingó,CORRIENTES,374,356,739,719,1458
18,18084,180840108,Ituzaingó,CORRIENTES,297,308,556,540,1096
18,18084,180840109,Ituzaingó,CORRIENTES,238,309,375,350,725
18,18084,180840110,Ituzaingó,CORRIENTES,224,289,398,348,746
18,18084,180840111,Ituzaingó,CORRIENTES,246,301,400,332,732
18,18084,180840112,Ituzaingó,CORRIENTES,303,343,530,533,1063
18,18084,180840113,Ituzaingó,CORRIENTES,221,286,388,381,769
18,18084,180840114,Ituzaingó,CORRIENTES,311,331,564,476,1040
18,18084,180840115,Ituzaingó,CORRIENTES,306,328,570,518,1088
18,18084,180840116,Ituzaingó,CORRIENTES,326,349,604,578,1182
18,18084,180840117,Ituzaingó,CORRIENTES,128,261,212,193,405
18,18084,180840118,Ituzaingó,CORRIENTES,445,492,953,904,1857
18,18084,180840201,Ituzaingó,CORRIENTES,293,331,613,663,1276
18,18084,180840202,Ituzaingó,CORRIENTES,14,14,23,44,67
18,18084,180840203,Ituzaingó,CORRIENTES,71,213,139,138,277
18,18084,180840204,Ituzaingó,CORRIENTES,134,155,291,299,590
18,18084,180840205,Ituzaingó,CORRIENTES,234,291,484,514,998
18,18084,180840206,Ituzaingó,CORRIENTES,7,12,9,14,23
18,18084,180840301,Ituzaingó,CORRIENTES,71,83,132,152,284
18,18084,180840302,Ituzaingó,CORRIENTES,21,15,15,42,57
18,18084,180840303,Ituzaingó,CORRIENTES,6,10,2,9,11
18,18084,180840304,Ituzaingó,CORRIENTES,10,16,6,17,23
18,18084,180840305,Ituzaingó,CORRIENTES,6,13,3,9,12
18,18084,180840306,Ituzaingó,CORRIENTES,36,54,21,56,77
18,18084,180840401,Ituzaingó,CORRIENTES,3,10,0,4,4
18,18084,180840402,Ituzaingó,CORRIENTES,4,5,4,16,20
18,18084,180840403,Ituzaingó,CORRIENTES,24,186,30,43,73
18,18084,180840404,Ituzaingó,CORRIENTES,8,13,18,15,33
18,18084,180840501,Ituzaingó,CORRIENTES,36,50,55,88,143
18,18084,180840502,Ituzaingó,CORRIENTES,47,40,23,75,98
18,18084,180840503,Ituzaingó,CORRIENTES,30,33,24,75,99
18,18084,180840601,Ituzaingó,CORRIENTES,19,29,32,38,70
18,18084,180840602,Ituzaingó,CORRIENTES,15,15,7,24,31
18,18084,180840603,Ituzaingó,CORRIENTES,19,29,16,30,46
18,18084,180840701,Ituzaingó,CORRIENTES,27,30,51,71,122
18,18084,180840702,Ituzaingó,CORRIENTES,10,19,13,22,35
18,18084,180840703,Ituzaingó,CORRIENTES,13,57,14,30,44
18,18084,180840801,Ituzaingó,CORRIENTES,6,12,5,8,13
18,18084,180840802,Ituzaingó,CORRIENTES,18,19,30,35,65
18,18084,180840901,Ituzaingó,CORRIENTES,23,27,26,51,77
18,18084,180840902,Ituzaingó,CORRIENTES,23,35,22,45,67
18,18084,180840903,Ituzaingó,CORRIENTES,32,40,27,67,94
18,18084,180841001,Ituzaingó,CORRIENTES,173,196,323,322,645
18,18084,180841002,Ituzaingó,CORRIENTES,201,222,398,418,816
18,18084,180841003,Ituzaingó,CORRIENTES,178,194,335,368,703
18,18084,180841004,Ituzaingó,CORRIENTES,97,93,203,215,418
18,18084,180841005,Ituzaingó,CORRIENTES,39,87,58,78,136
18,18084,180841006,Ituzaingó,CORRIENTES,13,15,18,20,38
18,18084,180841007,Ituzaingó,CORRIENTES,77,94,131,138,269
18,18084,180841008,Ituzaingó,CORRIENTES,17,38,7,26,33
18,18084,180841009,Ituzaingó,CORRIENTES,8,14,12,8,20
18,18084,180841101,Ituzaingó,CORRIENTES,265,298,524,460,984
18,18084,180841102,Ituzaingó,CORRIENTES,75,68,139,139,278
18,18084,180841103,Ituzaingó,CORRIENTES,28,42,44,57,101
18,18084,180841104,Ituzaingó,CORRIENTES,81,93,152,155,307
18,18084,180841105,Ituzaingó,CORRIENTES,136,175,269,289,558
18,18084,180841106,Ituzaingó,CORRIENTES,19,27,29,40,69
18,18084,180841107,Ituzaingó,CORRIENTES,15,17,20,24,44
18,18084,180841108,Ituzaingó,CORRIENTES,37,40,65,66,131
18,18084,180841109,Ituzaingó,CORRIENTES,312,337,641,640,1281
18,18084,180841201,Ituzaingó,CORRIENTES,229,288,488,536,1024
18,18084,180841202,Ituzaingó,CORRIENTES,45,52,50,69,119
18,18084,180841203,Ituzaingó,CORRIENTES,126,124,258,280,538
18,18084,180841204,Ituzaingó,CORRIENTES,38,43,34,75,109
18,18084,180841205,Ituzaingó,CORRIENTES,3,2,0,8,8
18,18084,180841206,Ituzaingó,CORRIENTES,0,1,0,0,0
18,18084,180841207,Ituzaingó,CORRIENTES,0,1,0,0,0
18,18091,180910101,Lavalle,CORRIENTES,311,333,623,597,1220
18,18091,180910102,Lavalle,CORRIENTES,224,263,400,343,743
18,18091,180910103,Lavalle,CORRIENTES,173,203,284,264,548
18,18091,180910104,Lavalle,CORRIENTES,242,255,472,492,964
18,18091,180910105,Lavalle,CORRIENTES,311,321,635,609,1244
18,18091,180910106,Lavalle,CORRIENTES,301,320,628,577,1205
18,18091,180910107,Lavalle,CORRIENTES,276,294,530,546,1076
18,18091,180910108,Lavalle,CORRIENTES,245,283,481,417,898
18,18091,180910109,Lavalle,CORRIENTES,225,242,406,426,832
18,18091,180910110,Lavalle,CORRIENTES,455,482,929,936,1865
18,18091,180910201,Lavalle,CORRIENTES,194,209,343,327,670
18,18091,180910202,Lavalle,CORRIENTES,103,124,202,234,436
18,18091,180910203,Lavalle,CORRIENTES,236,264,497,510,1007
18,18091,180910204,Lavalle,CORRIENTES,134,141,249,257,506
18,18091,180910205,Lavalle,CORRIENTES,17,21,30,33,63
18,18091,180910206,Lavalle,CORRIENTES,131,143,251,294,545
18,18091,180910207,Lavalle,CORRIENTES,169,181,327,355,682
18,18091,180910208,Lavalle,CORRIENTES,194,217,327,362,689
18,18091,180910209,Lavalle,CORRIENTES,260,289,536,521,1057
18,18091,180910210,Lavalle,CORRIENTES,136,181,256,278,534
18,18091,180910211,Lavalle,CORRIENTES,125,139,239,269,508
18,18091,180910212,Lavalle,CORRIENTES,59,70,128,133,261
18,18091,180910301,Lavalle,CORRIENTES,152,179,288,298,586
18,18091,180910302,Lavalle,CORRIENTES,93,100,169,182,351
18,18091,180910303,Lavalle,CORRIENTES,106,120,188,241,429
18,18091,180910304,Lavalle,CORRIENTES,33,37,66,60,126
18,18091,180910305,Lavalle,CORRIENTES,64,68,123,126,249
18,18091,180910401,Lavalle,CORRIENTES,132,165,265,274,539
18,18091,180910402,Lavalle,CORRIENTES,84,93,162,181,343
18,18091,180910403,Lavalle,CORRIENTES,69,73,126,144,270
18,18091,180910404,Lavalle,CORRIENTES,63,70,135,141,276
18,18091,180910405,Lavalle,CORRIENTES,114,131,238,241,479
18,18091,180910406,Lavalle,CORRIENTES,50,39,86,96,182
18,18091,180910407,Lavalle,CORRIENTES,23,25,32,52,84
18,18091,180910501,Lavalle,CORRIENTES,15,18,42,50,92
18,18091,180910502,Lavalle,CORRIENTES,19,27,29,33,62
18,18091,180910503,Lavalle,CORRIENTES,74,86,138,144,282
18,18091,180910504,Lavalle,CORRIENTES,37,52,77,87,164
18,18091,180910505,Lavalle,CORRIENTES,11,13,14,27,41
18,18091,180910506,Lavalle,CORRIENTES,14,17,25,27,52
18,18091,180910601,Lavalle,CORRIENTES,10,15,14,27,41
18,18091,180910602,Lavalle,CORRIENTES,7,9,11,18,29
18,18091,180910603,Lavalle,CORRIENTES,12,20,13,23,36
18,18091,180910701,Lavalle,CORRIENTES,187,202,338,318,656
18,18091,180910702,Lavalle,CORRIENTES,50,55,108,119,227
18,18091,180910703,Lavalle,CORRIENTES,108,120,200,234,434
18,18091,180910704,Lavalle,CORRIENTES,129,145,271,313,584
18,18091,180910705,Lavalle,CORRIENTES,38,43,80,83,163
18,18091,180910706,Lavalle,CORRIENTES,256,276,543,561,1104
18,18091,180910801,Lavalle,CORRIENTES,36,40,57,86,143
18,18091,180910802,Lavalle,CORRIENTES,200,223,411,429,840
18,18091,180910803,Lavalle,CORRIENTES,274,296,480,570,1050
18,18091,180910804,Lavalle,CORRIENTES,160,186,302,316,618
18,18091,180910805,Lavalle,CORRIENTES,51,58,84,121,205
18,18091,180910806,Lavalle,CORRIENTES,116,132,222,239,461
18,18091,180910901,Lavalle,CORRIENTES,3,3,3,4,7
18,18091,180910902,Lavalle,CORRIENTES,1,1,0,1,1
18,18091,180910903,Lavalle,CORRIENTES,0,1,0,0,0
18,18098,180980101,Mburucuyá,CORRIENTES,237,285,481,480,961
18,18098,180980102,Mburucuyá,CORRIENTES,255,306,508,480,988
18,18098,180980103,Mburucuyá,CORRIENTES,378,490,734,658,1392
18,18098,180980104,Mburucuyá,CORRIENTES,211,246,347,300,647
18,18098,180980105,Mburucuyá,CORRIENTES,167,208,310,271,581
18,18098,180980106,Mburucuyá,CORRIENTES,248,326,446,425,871
18,18098,180980107,Mburucuyá,CORRIENTES,233,294,444,413,857
18,18098,180980201,Mburucuyá,CORRIENTES,102,120,180,198,378
18,18098,180980202,Mburucuyá,CORRIENTES,60,82,116,127,243
18,18098,180980203,Mburucuyá,CORRIENTES,183,219,381,369,750
18,18098,180980301,Mburucuyá,CORRIENTES,71,103,132,126,258
18,18098,180980302,Mburucuyá,CORRIENTES,122,151,220,243,463
18,18098,180980303,Mburucuyá,CORRIENTES,47,57,75,91,166
18,18098,180980304,Mburucuyá,CORRIENTES,72,89,108,131,239
18,18098,180980401,Mburucuyá,CORRIENTES,6,21,2,7,9
18,18098,180980402,Mburucuyá,CORRIENTES,25,27,39,43,82
18,18098,180980403,Mburucuyá,CORRIENTES,52,57,88,108,196
18,18098,180980501,Mburucuyá,CORRIENTES,19,30,25,32,57
18,18098,180980502,Mburucuyá,CORRIENTES,18,32,39,33,72
18,18098,180980503,Mburucuyá,CORRIENTES,18,24,16,26,42
18,18105,181050101,Mercedes,CORRIENTES,263,280,540,541,1081
18,18105,181050102,Mercedes,CORRIENTES,270,263,534,533,1067
18,18105,181050103,Mercedes,CORRIENTES,307,321,655,623,1278
18,18105,181050104,Mercedes,CORRIENTES,332,333,554,524,1078
18,18105,181050105,Mercedes,CORRIENTES,204,225,404,382,786
18,18105,181050106,Mercedes,CORRIENTES,368,408,711,660,1371
18,18105,181050107,Mercedes,CORRIENTES,448,483,917,842,1759
18,18105,181050108,Mercedes,CORRIENTES,123,152,247,225,472
18,18105,181050109,Mercedes,CORRIENTES,284,337,508,454,962
18,18105,181050110,Mercedes,CORRIENTES,301,340,445,415,860
18,18105,181050111,Mercedes,CORRIENTES,152,187,248,202,450
18,18105,181050112,Mercedes,CORRIENTES,269,284,501,476,977
18,18105,181050113,Mercedes,CORRIENTES,385,386,755,733,1488
18,18105,181050114,Mercedes,CORRIENTES,363,384,723,715,1438
18,18105,181050115,Mercedes,CORRIENTES,191,236,309,240,549
18,18105,181050201,Mercedes,CORRIENTES,14,21,26,26,52
18,18105,181050202,Mercedes,CORRIENTES,74,109,112,139,251
18,18105,181050203,Mercedes,CORRIENTES,44,51,54,78,132
18,18105,181050204,Mercedes,CORRIENTES,332,367,670,595,1265
18,18105,181050301,Mercedes,CORRIENTES,7,4,7,40,47
18,18105,181050302,Mercedes,CORRIENTES,49,64,33,98,131
18,18105,181050401,Mercedes,CORRIENTES,15,15,21,47,68
18,18105,181050402,Mercedes,CORRIENTES,6,7,13,13,26
18,18105,181050501,Mercedes,CORRIENTES,12,17,9,30,39
18,18105,181050502,Mercedes,CORRIENTES,21,25,20,31,51
18,18105,181050503,Mercedes,CORRIENTES,12,12,14,23,37
18,18105,181050601,Mercedes,CORRIENTES,27,36,38,43,81
18,18105,181050602,Mercedes,CORRIENTES,20,25,30,28,58
18,18105,181050603,Mercedes,CORRIENTES,14,14,11,22,33
18,18105,181050701,Mercedes,CORRIENTES,9,21,10,14,24
18,18105,181050702,Mercedes,CORRIENTES,7,14,6,13,19
18,18105,181050801,Mercedes,CORRIENTES,33,31,66,57,123
18,18105,181050802,Mercedes,CORRIENTES,23,33,35,51,86
18,18105,181050803,Mercedes,CORRIENTES,31,100,42,69,111
18,18105,181050804,Mercedes,CORRIENTES,3,10,3,30,33
18,18105,181050805,Mercedes,CORRIENTES,188,198,408,392,800
18,18105,181050806,Mercedes,CORRIENTES,6,6,7,11,18
18,18105,181050901,Mercedes,CORRIENTES,246,331,461,407,868
18,18105,181050902,Mercedes,CORRIENTES,12,18,16,21,37
18,18105,181050903,Mercedes,CORRIENTES,19,20,26,43,69
18,18105,181050904,Mercedes,CORRIENTES,261,330,493,482,975
18,18105,181051001,Mercedes,CORRIENTES,3,8,2,3,5
18,18105,181051002,Mercedes,CORRIENTES,3,11,0,3,3
18,18105,181051003,Mercedes,CORRIENTES,88,101,159,153,312
18,18105,181051101,Mercedes,CORRIENTES,405,454,703,732,1435
18,18105,181051102,Mercedes,CORRIENTES,15,26,14,25,39
18,18105,181051103,Mercedes,CORRIENTES,17,26,25,33,58
18,18105,181051104,Mercedes,CORRIENTES,10,15,10,16,26
18,18105,181051201,Mercedes,CORRIENTES,40,44,74,80,154
18,18105,181051202,Mercedes,CORRIENTES,49,58,74,86,160
18,18105,181051203,Mercedes,CORRIENTES,27,40,32,42,74
18,18105,181051204,Mercedes,CORRIENTES,82,114,133,141,274
18,18105,181051301,Mercedes,CORRIENTES,83,94,164,144,308
18,18105,181051302,Mercedes,CORRIENTES,25,24,34,41,75
18,18105,181051303,Mercedes,CORRIENTES,4,12,3,12,15
18,18105,181051304,Mercedes,CORRIENTES,48,74,54,59,113
18,18105,181051305,Mercedes,CORRIENTES,25,28,39,49,88
18,18105,181051306,Mercedes,CORRIENTES,2,5,0,5,5
18,18105,181051401,Mercedes,CORRIENTES,5,5,4,10,14
18,18105,181051402,Mercedes,CORRIENTES,6,11,1,14,15
18,18105,181051403,Mercedes,CORRIENTES,7,10,4,10,14
18,18105,181051404,Mercedes,CORRIENTES,2,2,7,4,11
18,18105,181051501,Mercedes,CORRIENTES,9,17,12,15,27
18,18105,181051502,Mercedes,CORRIENTES,1,1,0,1,1
18,18105,181051503,Mercedes,CORRIENTES,4,9,0,15,15
18,18105,181051601,Mercedes,CORRIENTES,83,93,154,164,318
18,18105,181051602,Mercedes,CORRIENTES,22,30,40,41,81
18,18105,181051603,Mercedes,CORRIENTES,20,22,29,30,59
18,18105,181051604,Mercedes,CORRIENTES,18,21,19,24,43
18,18105,181051605,Mercedes,CORRIENTES,23,32,35,56,91
18,18105,181051701,Mercedes,CORRIENTES,5,5,1,23,24
18,18105,181051702,Mercedes,CORRIENTES,7,7,2,22,24
18,18105,181051801,Mercedes,CORRIENTES,33,41,46,71,117
18,18105,181051802,Mercedes,CORRIENTES,9,11,3,10,13
18,18105,181051901,Mercedes,CORRIENTES,15,20,16,37,53
18,18105,181051902,Mercedes,CORRIENTES,21,21,0,38,38
18,18105,181052001,Mercedes,CORRIENTES,4,4,2,27,29
18,18105,181052002,Mercedes,CORRIENTES,11,8,17,27,44
18,18105,181052003,Mercedes,CORRIENTES,24,7,2,33,35
18,18105,181052101,Mercedes,CORRIENTES,180,183,353,351,704
18,18105,181052102,Mercedes,CORRIENTES,439,479,822,760,1582
18,18105,181052103,Mercedes,CORRIENTES,275,298,576,540,1116
18,18105,181052104,Mercedes,CORRIENTES,233,250,477,450,927
18,18105,181052105,Mercedes,CORRIENTES,263,352,456,358,814
18,18105,181052106,Mercedes,CORRIENTES,298,353,501,456,957
18,18105,181052107,Mercedes,CORRIENTES,381,419,776,720,1496
18,18105,181052108,Mercedes,CORRIENTES,289,364,487,453,940
18,18105,181052109,Mercedes,CORRIENTES,213,255,386,375,761
18,18105,181052110,Mercedes,CORRIENTES,190,212,370,357,727
18,18105,181052111,Mercedes,CORRIENTES,314,350,614,603,1217
18,18105,181052112,Mercedes,CORRIENTES,468,502,919,799,1718
18,18105,181052113,Mercedes,CORRIENTES,375,396,737,714,1451
18,18105,181052114,Mercedes,CORRIENTES,254,262,521,476,997
18,18112,181120101,Monte Caseros,CORRIENTES,280,277,587,548,1135
18,18112,181120102,Monte Caseros,CORRIENTES,79,94,156,201,357
18,18112,181120103,Monte Caseros,CORRIENTES,61,82,121,113,234
18,18112,181120104,Monte Caseros,CORRIENTES,326,361,590,508,1098
18,18112,181120105,Monte Caseros,CORRIENTES,218,240,364,352,716
18,18112,181120106,Monte Caseros,CORRIENTES,326,343,661,631,1292
18,18112,181120107,Monte Caseros,CORRIENTES,283,303,536,533,1069
18,18112,181120108,Monte Caseros,CORRIENTES,348,346,663,649,1312
18,18112,181120109,Monte Caseros,CORRIENTES,217,219,382,331,713
18,18112,181120110,Monte Caseros,CORRIENTES,171,192,302,288,590
18,18112,181120111,Monte Caseros,CORRIENTES,189,202,280,219,499
18,18112,181120112,Monte Caseros,CORRIENTES,217,223,394,354,748
18,18112,181120113,Monte Caseros,CORRIENTES,162,193,232,205,437
18,18112,181120114,Monte Caseros,CORRIENTES,349,384,603,588,1191
18,18112,181120201,Monte Caseros,CORRIENTES,24,30,50,45,95
18,18112,181120202,Monte Caseros,CORRIENTES,69,82,114,133,247
18,18112,181120203,Monte Caseros,CORRIENTES,48,56,99,90,189
18,18112,181120204,Monte Caseros,CORRIENTES,32,36,46,53,99
18,18112,181120205,Monte Caseros,CORRIENTES,32,44,43,58,101
18,18112,181120206,Monte Caseros,CORRIENTES,38,49,66,63,129
18,18112,181120207,Monte Caseros,CORRIENTES,23,33,31,43,74
18,18112,181120208,Monte Caseros,CORRIENTES,15,15,22,30,52
18,18112,181120209,Monte Caseros,CORRIENTES,28,38,37,50,87
18,18112,181120210,Monte Caseros,CORRIENTES,43,58,90,93,183
18,18112,181120211,Monte Caseros,CORRIENTES,4,5,7,11,18
18,18112,181120212,Monte Caseros,CORRIENTES,119,125,232,260,492
18,18112,181120301,Monte Caseros,CORRIENTES,17,17,22,32,54
18,18112,181120302,Monte Caseros,CORRIENTES,8,8,13,15,28
18,18112,181120303,Monte Caseros,CORRIENTES,18,18,23,39,62
18,18112,181120304,Monte Caseros,CORRIENTES,4,4,8,5,13
18,18112,181120401,Monte Caseros,CORRIENTES,44,56,80,79,159
18,18112,181120402,Monte Caseros,CORRIENTES,19,27,25,29,54
18,18112,181120403,Monte Caseros,CORRIENTES,52,51,114,98,212
18,18112,181120404,Monte Caseros,CORRIENTES,159,191,284,336,620
18,18112,181120405,Monte Caseros,CORRIENTES,35,40,54,61,115
18,18112,181120406,Monte Caseros,CORRIENTES,8,12,8,28,36
18,18112,181120407,Monte Caseros,CORRIENTES,22,22,55,54,109
18,18112,181120408,Monte Caseros,CORRIENTES,6,10,6,13,19
18,18112,181120409,Monte Caseros,CORRIENTES,17,18,23,41,64
18,18112,181120410,Monte Caseros,CORRIENTES,22,23,40,46,86
18,18112,181120411,Monte Caseros,CORRIENTES,10,16,5,14,19
18,18112,181120501,Monte Caseros,CORRIENTES,2,5,3,8,11
18,18112,181120502,Monte Caseros,CORRIENTES,28,40,25,59,84
18,18112,181120503,Monte Caseros,CORRIENTES,20,27,14,47,61
18,18112,181120504,Monte Caseros,CORRIENTES,5,6,0,10,10
18,18112,181120601,Monte Caseros,CORRIENTES,27,32,31,37,68
18,18112,181120602,Monte Caseros,CORRIENTES,58,44,65,101,166
18,18112,181120603,Monte Caseros,CORRIENTES,7,11,5,16,21
18,18112,181120604,Monte Caseros,CORRIENTES,14,21,16,32,48
18,18112,181120701,Monte Caseros,CORRIENTES,330,355,569,628,1197
18,18112,181120702,Monte Caseros,CORRIENTES,100,111,170,195,365
18,18112,181120703,Monte Caseros,CORRIENTES,19,20,24,29,53
18,18112,181120704,Monte Caseros,CORRIENTES,47,48,72,77,149
18,18112,181120705,Monte Caseros,CORRIENTES,24,27,38,42,80
18,18112,181120706,Monte Caseros,CORRIENTES,10,13,21,20,41
18,18112,181120707,Monte Caseros,CORRIENTES,12,17,6,32,38
18,18112,181120708,Monte Caseros,CORRIENTES,11,27,17,20,37
18,18112,181120709,Monte Caseros,CORRIENTES,0,2,0,0,0
18,18112,181120710,Monte Caseros,CORRIENTES,34,45,58,67,125
18,18112,181120801,Monte Caseros,CORRIENTES,55,79,67,103,170
18,18112,181120802,Monte Caseros,CORRIENTES,50,62,93,89,182
18,18112,181120803,Monte Caseros,CORRIENTES,72,84,116,128,244
18,18112,181120804,Monte Caseros,CORRIENTES,87,91,118,148,266
18,18112,181120805,Monte Caseros,CORRIENTES,15,25,29,33,62
18,18112,181120806,Monte Caseros,CORRIENTES,308,326,437,469,906
18,18112,181120807,Monte Caseros,CORRIENTES,291,319,419,416,835
18,18112,181120808,Monte Caseros,CORRIENTES,489,508,765,921,1686
18,18112,181120809,Monte Caseros,CORRIENTES,259,273,484,522,1006
18,18112,181120810,Monte Caseros,CORRIENTES,405,401,753,788,1541
18,18112,181120901,Monte Caseros,CORRIENTES,210,212,384,370,754
18,18112,181120902,Monte Caseros,CORRIENTES,245,264,408,417,825
18,18112,181120903,Monte Caseros,CORRIENTES,216,244,317,319,636
18,18112,181120904,Monte Caseros,CORRIENTES,186,229,252,222,474
18,18112,181120905,Monte Caseros,CORRIENTES,231,274,316,303,619
18,18112,181120906,Monte Caseros,CORRIENTES,194,230,277,230,507
18,18112,181120907,Monte Caseros,CORRIENTES,306,326,509,436,945
18,18112,181120908,Monte Caseros,CORRIENTES,323,354,573,526,1099
18,18112,181120909,Monte Caseros,CORRIENTES,241,259,412,378,790
18,18112,181120910,Monte Caseros,CORRIENTES,253,277,469,449,918
18,18112,181120911,Monte Caseros,CORRIENTES,285,303,492,430,922
18,18112,181120912,Monte Caseros,CORRIENTES,207,225,356,307,663
18,18112,181120913,Monte Caseros,CORRIENTES,500,506,1004,909,1913
18,18112,181120914,Monte Caseros,CORRIENTES,225,230,508,506,1014
18,18119,181190101,Paso de los Libres,CORRIENTES,238,261,448,501,949
18,18119,181190102,Paso de los Libres,CORRIENTES,244,243,510,457,967
18,18119,181190103,Paso de los Libres,CORRIENTES,352,339,650,565,1215
18,18119,181190104,Paso de los Libres,CORRIENTES,497,511,985,890,1875
18,18119,181190105,Paso de los Libres,CORRIENTES,316,334,587,507,1094
18,18119,181190106,Paso de los Libres,CORRIENTES,153,159,307,247,554
18,18119,181190107,Paso de los Libres,CORRIENTES,215,198,408,401,809
18,18119,181190108,Paso de los Libres,CORRIENTES,285,278,508,469,977
18,18119,181190109,Paso de los Libres,CORRIENTES,423,413,847,887,1734
18,18119,181190110,Paso de los Libres,CORRIENTES,269,175,535,573,1108
18,18119,181190111,Paso de los Libres,CORRIENTES,245,222,500,439,939
18,18119,181190112,Paso de los Libres,CORRIENTES,80,81,131,115,246
18,18119,181190113,Paso de los Libres,CORRIENTES,146,141,307,303,610
18,18119,181190114,Paso de los Libres,CORRIENTES,190,196,386,400,786
18,18119,181190115,Paso de los Libres,CORRIENTES,399,411,835,775,1610
18,18119,181190116,Paso de los Libres,CORRIENTES,300,280,559,533,1092
18,18119,181190117,Paso de los Libres,CORRIENTES,212,207,468,434,902
18,18119,181190201,Paso de los Libres,CORRIENTES,10,14,6,18,24
18,18119,181190202,Paso de los Libres,CORRIENTES,16,16,6,39,45
18,18119,181190301,Paso de los Libres,CORRIENTES,91,116,154,174,328
18,18119,181190302,Paso de los Libres,CORRIENTES,100,104,118,158,276
18,18119,181190303,Paso de los Libres,CORRIENTES,8,7,9,17,26
18,18119,181190401,Paso de los Libres,CORRIENTES,262,212,509,520,1029
18,18119,181190402,Paso de los Libres,CORRIENTES,18,21,25,26,51
18,18119,181190403,Paso de los Libres,CORRIENTES,22,21,21,56,77
18,18119,181190404,Paso de los Libres,CORRIENTES,27,31,42,37,79
18,18119,181190501,Paso de los Libres,CORRIENTES,24,5,39,52,91
18,18119,181190502,Paso de los Libres,CORRIENTES,20,27,26,39,65
18,18119,181190601,Paso de los Libres,CORRIENTES,210,220,362,413,775
18,18119,181190602,Paso de los Libres,CORRIENTES,12,13,9,27,36
18,18119,181190701,Paso de los Libres,CORRIENTES,15,16,15,19,34
18,18119,181190702,Paso de los Libres,CORRIENTES,41,48,61,69,130
18,18119,181190703,Paso de los Libres,CORRIENTES,9,9,11,11,22
18,18119,181190801,Paso de los Libres,CORRIENTES,8,10,2,16,18
18,18119,181190802,Paso de los Libres,CORRIENTES,23,29,12,50,62
18,18119,181190901,Paso de los Libres,CORRIENTES,139,166,244,272,516
18,18119,181190902,Paso de los Libres,CORRIENTES,7,11,3,13,16
18,18119,181190903,Paso de los Libres,CORRIENTES,11,16,6,26,32
18,18119,181190904,Paso de los Libres,CORRIENTES,3,4,0,3,3
18,18119,181190905,Paso de los Libres,CORRIENTES,13,18,15,39,54
18,18119,181191001,Paso de los Libres,CORRIENTES,39,47,64,71,135
18,18119,181191002,Paso de los Libres,CORRIENTES,31,30,42,65,107
18,18119,181191003,Paso de los Libres,CORRIENTES,22,23,37,41,78
18,18119,181191101,Paso de los Libres,CORRIENTES,12,18,5,13,18
18,18119,181191102,Paso de los Libres,CORRIENTES,11,19,9,15,24
18,18119,181191103,Paso de los Libres,CORRIENTES,17,14,16,27,43
18,18119,181191201,Paso de los Libres,CORRIENTES,17,24,23,41,64
18,18119,181191202,Paso de los Libres,CORRIENTES,11,18,7,16,23
18,18119,181191203,Paso de los Libres,CORRIENTES,13,16,16,21,37
18,18119,181191301,Paso de los Libres,CORRIENTES,1,6,0,6,6
18,18119,181191401,Paso de los Libres,CORRIENTES,122,140,238,267,505
18,18119,181191402,Paso de los Libres,CORRIENTES,212,215,446,484,930
18,18119,181191403,Paso de los Libres,CORRIENTES,378,365,853,871,1724
18,18119,181191404,Paso de los Libres,CORRIENTES,153,133,308,315,623
18,18119,181191405,Paso de los Libres,CORRIENTES,394,405,834,765,1599
18,18119,181191406,Paso de los Libres,CORRIENTES,216,244,454,437,891
18,18119,181191407,Paso de los Libres,CORRIENTES,327,373,652,630,1282
18,18119,181191501,Paso de los Libres,CORRIENTES,254,221,522,523,1045
18,18119,181191502,Paso de los Libres,CORRIENTES,164,166,311,357,668
18,18119,181191503,Paso de los Libres,CORRIENTES,365,355,652,547,1199
18,18119,181191504,Paso de los Libres,CORRIENTES,298,304,519,503,1022
18,18119,181191505,Paso de los Libres,CORRIENTES,327,372,555,480,1035
18,18119,181191506,Paso de los Libres,CORRIENTES,183,245,281,241,522
18,18119,181191507,Paso de los Libres,CORRIENTES,234,207,473,426,899
18,18119,181191508,Paso de los Libres,CORRIENTES,281,275,573,555,1128
18,18119,181191509,Paso de los Libres,CORRIENTES,206,200,480,401,881
18,18119,181191510,Paso de los Libres,CORRIENTES,232,244,394,359,753
18,18119,181191511,Paso de los Libres,CORRIENTES,303,384,478,379,857
18,18119,181191512,Paso de los Libres,CORRIENTES,206,247,313,262,575
18,18119,181191513,Paso de los Libres,CORRIENTES,229,259,373,320,693
18,18119,181191514,Paso de los Libres,CORRIENTES,69,95,132,124,256
18,18119,181191515,Paso de los Libres,CORRIENTES,319,325,606,594,1200
18,18119,181191516,Paso de los Libres,CORRIENTES,168,198,269,236,505
18,18119,181191517,Paso de los Libres,CORRIENTES,115,159,206,152,358
18,18119,181191518,Paso de los Libres,CORRIENTES,174,210,248,260,508
18,18119,181191519,Paso de los Libres,CORRIENTES,367,399,699,643,1342
18,18119,181191520,Paso de los Libres,CORRIENTES,399,405,701,590,1291
18,18119,181191521,Paso de los Libres,CORRIENTES,267,264,519,469,988
18,18119,181191522,Paso de los Libres,CORRIENTES,241,216,484,448,932
18,18119,181191523,Paso de los Libres,CORRIENTES,224,209,346,294,640
18,18126,181260101,Saladas,CORRIENTES,315,343,635,600,1235
18,18126,181260102,Saladas,CORRIENTES,317,357,639,532,1171
18,18126,181260103,Saladas,CORRIENTES,251,269,453,432,885
18,18126,181260104,Saladas,CORRIENTES,347,390,689,616,1305
18,18126,181260105,Saladas,CORRIENTES,368,408,811,707,1518
18,18126,181260106,Saladas,CORRIENTES,390,429,750,690,1440
18,18126,181260107,Saladas,CORRIENTES,415,445,808,723,1531
18,18126,181260108,Saladas,CORRIENTES,378,406,833,744,1577
18,18126,181260109,Saladas,CORRIENTES,277,302,527,513,1040
18,18126,181260201,Saladas,CORRIENTES,51,57,92,108,200
18,18126,181260202,Saladas,CORRIENTES,313,344,623,661,1284
18,18126,181260203,Saladas,CORRIENTES,7,18,10,14,24
18,18126,181260301,Saladas,CORRIENTES,135,150,267,334,601
18,18126,181260302,Saladas,CORRIENTES,35,47,52,62,114
18,18126,181260401,Saladas,CORRIENTES,40,48,80,77,157
18,18126,181260402,Saladas,CORRIENTES,31,38,77,69,146
18,18126,181260501,Saladas,CORRIENTES,301,347,631,614,1245
18,18126,181260502,Saladas,CORRIENTES,109,128,194,188,382
18,18126,181260601,Saladas,CORRIENTES,112,123,256,249,505
18,18126,181260602,Saladas,CORRIENTES,18,23,32,46,78
18,18126,181260603,Saladas,CORRIENTES,7,8,12,12,24
18,18126,181260701,Saladas,CORRIENTES,350,383,767,747,1514
18,18126,181260702,Saladas,CORRIENTES,63,78,159,154,313
18,18126,181260703,Saladas,CORRIENTES,131,155,258,265,523
18,18126,181260801,Saladas,CORRIENTES,59,77,87,105,192
18,18126,181260802,Saladas,CORRIENTES,34,49,40,70,110
18,18126,181260901,Saladas,CORRIENTES,283,353,557,580,1137
18,18126,181260902,Saladas,CORRIENTES,360,422,704,711,1415
18,18126,181260903,Saladas,CORRIENTES,81,105,170,204,374
18,18126,181260904,Saladas,CORRIENTES,60,69,93,111,204
18,18133,181330101,San Cosme,CORRIENTES,209,228,414,399,813
18,18133,181330102,San Cosme,CORRIENTES,145,180,235,231,466
18,18133,181330103,San Cosme,CORRIENTES,145,208,244,234,478
18,18133,181330104,San Cosme,CORRIENTES,32,32,76,63,139
18,18133,181330201,San Cosme,CORRIENTES,41,263,67,88,155
18,18133,181330202,San Cosme,CORRIENTES,62,225,110,120,230
18,18133,181330203,San Cosme,CORRIENTES,69,107,99,128,227
18,18133,181330204,San Cosme,CORRIENTES,123,172,201,246,447
18,18133,181330205,San Cosme,CORRIENTES,65,77,112,128,240
18,18133,181330206,San Cosme,CORRIENTES,166,363,290,267,557
18,18133,181330207,San Cosme,CORRIENTES,167,301,283,272,555
18,18133,181330208,San Cosme,CORRIENTES,204,386,359,334,693
18,18133,181330209,San Cosme,CORRIENTES,90,293,136,163,299
18,18133,181330210,San Cosme,CORRIENTES,88,268,180,161,341
18,18133,181330211,San Cosme,CORRIENTES,32,279,35,70,105
18,18133,181330212,San Cosme,CORRIENTES,106,300,191,196,387
18,18133,181330213,San Cosme,CORRIENTES,90,218,172,167,339
18,18133,181330214,San Cosme,CORRIENTES,359,406,774,799,1573
18,18133,181330215,San Cosme,CORRIENTES,71,172,115,113,228
18,18133,181330216,San Cosme,CORRIENTES,18,24,32,46,78
18,18133,181330301,San Cosme,CORRIENTES,259,310,546,533,1079
18,18133,181330302,San Cosme,CORRIENTES,142,187,263,287,550
18,18133,181330303,San Cosme,CORRIENTES,26,47,35,48,83
18,18133,181330304,San Cosme,CORRIENTES,22,27,31,32,63
18,18133,181330305,San Cosme,CORRIENTES,2,6,4,2,6
18,18133,181330401,San Cosme,CORRIENTES,180,222,320,355,675
18,18133,181330402,San Cosme,CORRIENTES,33,49,50,51,101
18,18133,181330403,San Cosme,CORRIENTES,77,90,156,145,301
18,18133,181330501,San Cosme,CORRIENTES,277,344,514,497,1011
18,18133,181330502,San Cosme,CORRIENTES,250,351,463,465,928
18,18133,181330503,San Cosme,CORRIENTES,69,57,126,126,252
18,18133,181330504,San Cosme,CORRIENTES,67,100,113,120,233
18,18133,181330505,San Cosme,CORRIENTES,57,58,96,112,208
18,18133,181330506,San Cosme,CORRIENTES,73,94,160,133,293
18,18133,181330507,San Cosme,CORRIENTES,64,141,134,111,245
18,18133,181330601,San Cosme,CORRIENTES,1,1,1,1,2
18,18133,181330602,San Cosme,CORRIENTES,0,2,0,0,0
18,18133,181330603,San Cosme,CORRIENTES,1,1,0,1,1
18,18140,181400101,San Luis del Palmar,CORRIENTES,274,295,610,521,1131
18,18140,181400102,San Luis del Palmar,CORRIENTES,209,245,423,429,852
18,18140,181400103,San Luis del Palmar,CORRIENTES,259,292,531,484,1015
18,18140,181400104,San Luis del Palmar,CORRIENTES,254,271,475,422,897
18,18140,181400105,San Luis del Palmar,CORRIENTES,286,297,604,537,1141
18,18140,181400106,San Luis del Palmar,CORRIENTES,335,356,731,684,1415
18,18140,181400107,San Luis del Palmar,CORRIENTES,266,306,572,517,1089
18,18140,181400108,San Luis del Palmar,CORRIENTES,259,280,490,441,931
18,18140,181400109,San Luis del Palmar,CORRIENTES,275,306,634,495,1129
18,18140,181400110,San Luis del Palmar,CORRIENTES,303,347,679,593,1272
18,18140,181400201,San Luis del Palmar,CORRIENTES,81,100,154,162,316
18,18140,181400202,San Luis del Palmar,CORRIENTES,90,118,151,171,322
18,18140,181400203,San Luis del Palmar,CORRIENTES,439,480,888,894,1782
18,18140,181400204,San Luis del Palmar,CORRIENTES,41,52,90,78,168
18,18140,181400205,San Luis del Palmar,CORRIENTES,5,9,15,11,26
18,18140,181400206,San Luis del Palmar,CORRIENTES,185,191,387,373,760
18,18140,181400301,San Luis del Palmar,CORRIENTES,28,40,55,59,114
18,18140,181400302,San Luis del Palmar,CORRIENTES,37,48,65,83,148
18,18140,181400303,San Luis del Palmar,CORRIENTES,17,19,24,31,55
18,18140,181400401,San Luis del Palmar,CORRIENTES,13,15,11,27,38
18,18140,181400402,San Luis del Palmar,CORRIENTES,20,21,36,43,79
18,18140,181400403,San Luis del Palmar,CORRIENTES,15,16,29,47,76
18,18140,181400404,San Luis del Palmar,CORRIENTES,22,24,48,54,102
18,18140,181400405,San Luis del Palmar,CORRIENTES,56,60,115,122,237
18,18140,181400501,San Luis del Palmar,CORRIENTES,26,35,46,53,99
18,18140,181400502,San Luis del Palmar,CORRIENTES,15,16,19,38,57
18,18140,181400503,San Luis del Palmar,CORRIENTES,13,12,18,23,41
18,18140,181400504,San Luis del Palmar,CORRIENTES,17,17,32,40,72
18,18140,181400601,San Luis del Palmar,CORRIENTES,58,63,122,134,256
18,18140,181400602,San Luis del Palmar,CORRIENTES,70,71,152,179,331
18,18140,181400603,San Luis del Palmar,CORRIENTES,2,11,3,3,6
18,18140,181400604,San Luis del Palmar,CORRIENTES,7,7,7,13,20
18,18140,181400701,San Luis del Palmar,CORRIENTES,41,44,81,74,155
18,18140,181400702,San Luis del Palmar,CORRIENTES,21,31,26,41,67
18,18140,181400703,San Luis del Palmar,CORRIENTES,71,74,133,140,273
18,18140,181400704,San Luis del Palmar,CORRIENTES,12,14,22,33,55
18,18140,181400801,San Luis del Palmar,CORRIENTES,10,19,16,12,28
18,18140,181400802,San Luis del Palmar,CORRIENTES,32,40,44,55,99
18,18140,181400803,San Luis del Palmar,CORRIENTES,72,87,135,149,284
18,18140,181400804,San Luis del Palmar,CORRIENTES,22,26,45,38,83
18,18140,181400805,San Luis del Palmar,CORRIENTES,36,38,73,76,149
18,18140,181400806,San Luis del Palmar,CORRIENTES,17,22,30,33,63
18,18140,181400807,San Luis del Palmar,CORRIENTES,6,7,6,11,17
18,18140,181400808,San Luis del Palmar,CORRIENTES,1,3,0,2,2
18,18140,181400809,San Luis del Palmar,CORRIENTES,11,14,20,30,50
18,18140,181400901,San Luis del Palmar,CORRIENTES,9,14,7,10,17
18,18140,181400902,San Luis del Palmar,CORRIENTES,40,41,59,61,120
18,18140,181400903,San Luis del Palmar,CORRIENTES,39,42,73,78,151
18,18147,181470101,San Martín,CORRIENTES,283,321,565,497,1062
18,18147,181470102,San Martín,CORRIENTES,290,327,563,435,998
18,18147,181470103,San Martín,CORRIENTES,273,314,494,471,965
18,18147,181470104,San Martín,CORRIENTES,229,268,370,344,714
18,18147,181470105,San Martín,CORRIENTES,292,329,496,441,937
18,18147,181470106,San Martín,CORRIENTES,343,391,689,632,1321
18,18147,181470107,San Martín,CORRIENTES,229,259,419,390,809
18,18147,181470201,San Martín,CORRIENTES,61,62,118,88,206
18,18147,181470202,San Martín,CORRIENTES,57,66,116,111,227
18,18147,181470203,San Martín,CORRIENTES,35,40,61,58,119
18,18147,181470204,San Martín,CORRIENTES,20,23,36,46,82
18,18147,181470205,San Martín,CORRIENTES,175,191,366,333,699
18,18147,181470206,San Martín,CORRIENTES,239,280,445,437,882
18,18147,181470207,San Martín,CORRIENTES,185,220,348,321,669
18,18147,181470301,San Martín,CORRIENTES,13,19,19,29,48
18,18147,181470302,San Martín,CORRIENTES,19,41,11,28,39
18,18147,181470303,San Martín,CORRIENTES,11,21,14,24,38
18,18147,181470304,San Martín,CORRIENTES,18,26,24,39,63
18,18147,181470401,San Martín,CORRIENTES,20,26,23,42,65
18,18147,181470402,San Martín,CORRIENTES,13,22,13,29,42
18,18147,181470403,San Martín,CORRIENTES,12,11,7,49,56
18,18147,181470501,San Martín,CORRIENTES,11,10,11,15,26
18,18147,181470502,San Martín,CORRIENTES,28,27,54,58,112
18,18147,181470503,San Martín,CORRIENTES,7,6,4,8,12
18,18147,181470601,San Martín,CORRIENTES,4,6,0,4,4
18,18147,181470602,San Martín,CORRIENTES,11,23,15,28,43
18,18147,181470603,San Martín,CORRIENTES,9,9,13,19,32
18,18147,181470604,San Martín,CORRIENTES,3,2,5,8,13
18,18147,181470701,San Martín,CORRIENTES,19,24,15,29,44
18,18147,181470702,San Martín,CORRIENTES,5,8,3,6,9
18,18147,181470703,San Martín,CORRIENTES,4,6,2,8,10
18,18147,181470801,San Martín,CORRIENTES,168,217,331,338,669
18,18147,181470802,San Martín,CORRIENTES,167,222,312,326,638
18,18147,181470803,San Martín,CORRIENTES,17,22,21,42,63
18,18147,181470804,San Martín,CORRIENTES,16,26,13,32,45
18,18147,181470901,San Martín,CORRIENTES,9,11,12,16,28
18,18147,181470902,San Martín,CORRIENTES,30,43,32,57,89
18,18147,181470903,San Martín,CORRIENTES,26,37,42,53,95
18,18147,181471001,San Martín,CORRIENTES,14,18,11,33,44
18,18147,181471002,San Martín,CORRIENTES,12,17,9,17,26
18,18147,181471003,San Martín,CORRIENTES,14,18,6,27,33
18,18147,181471004,San Martín,CORRIENTES,4,6,1,7,8
18,18147,181471101,San Martín,CORRIENTES,7,8,6,15,21
18,18147,181471102,San Martín,CORRIENTES,8,8,11,27,38
18,18147,181471103,San Martín,CORRIENTES,1,2,0,3,3
18,18147,181471201,San Martín,CORRIENTES,104,137,222,215,437
18,18147,181471202,San Martín,CORRIENTES,20,26,22,44,66
18,18147,181471203,San Martín,CORRIENTES,9,11,16,22,38
18,18147,181471204,San Martín,CORRIENTES,117,136,213,240,453
18,18154,181540101,San Miguel,CORRIENTES,416,467,875,916,1791
18,18154,181540102,San Miguel,CORRIENTES,360,379,769,700,1469
18,18154,181540103,San Miguel,CORRIENTES,249,270,539,475,1014
18,18154,181540201,San Miguel,CORRIENTES,54,66,120,122,242
18,18154,181540202,San Miguel,CORRIENTES,310,339,705,694,1399
18,18154,181540203,San Miguel,CORRIENTES,220,242,517,508,1025
18,18154,181540204,San Miguel,CORRIENTES,7,11,8,11,19
18,18154,181540301,San Miguel,CORRIENTES,2,2,0,50,50
18,18154,181540302,San Miguel,CORRIENTES,3,6,0,7,7
18,18154,181540401,San Miguel,CORRIENTES,63,69,134,140,274
18,18154,181540402,San Miguel,CORRIENTES,38,39,105,134,239
18,18154,181540501,San Miguel,CORRIENTES,3,3,3,10,13
18,18154,181540502,San Miguel,CORRIENTES,4,4,10,8,18
18,18154,181540601,San Miguel,CORRIENTES,32,32,37,47,84
18,18154,181540602,San Miguel,CORRIENTES,11,13,4,15,19
18,18154,181540603,San Miguel,CORRIENTES,18,24,22,38,60
18,18154,181540701,San Miguel,CORRIENTES,233,284,428,381,809
18,18154,181540702,San Miguel,CORRIENTES,126,158,240,239,479
18,18154,181540703,San Miguel,CORRIENTES,127,158,286,273,559
18,18154,181540704,San Miguel,CORRIENTES,252,287,466,464,930
18,18154,181540801,San Miguel,CORRIENTES,12,20,10,19,29
18,18154,181540802,San Miguel,CORRIENTES,13,19,8,35,43
18,18154,181540901,San Miguel,CORRIENTES,0,1,0,0,0
18,18161,181610101,San Roque,CORRIENTES,199,225,428,381,809
18,18161,181610102,San Roque,CORRIENTES,226,256,517,494,1011
18,18161,181610103,San Roque,CORRIENTES,219,234,414,363,777
18,18161,181610104,San Roque,CORRIENTES,234,273,422,380,802
18,18161,181610105,San Roque,CORRIENTES,287,310,563,538,1101
18,18161,181610106,San Roque,CORRIENTES,363,377,698,662,1360
18,18161,181610107,San Roque,CORRIENTES,210,235,365,375,740
18,18161,181610108,San Roque,CORRIENTES,170,185,389,334,723
18,18161,181610201,San Roque,CORRIENTES,97,100,188,215,403
18,18161,181610202,San Roque,CORRIENTES,116,131,226,260,486
18,18161,181610203,San Roque,CORRIENTES,73,89,147,181,328
18,18161,181610204,San Roque,CORRIENTES,60,68,141,130,271
18,18161,181610205,San Roque,CORRIENTES,26,41,43,63,106
18,18161,181610206,San Roque,CORRIENTES,107,108,212,228,440
18,18161,181610301,San Roque,CORRIENTES,94,106,218,220,438
18,18161,181610302,San Roque,CORRIENTES,2,3,2,4,6
18,18161,181610303,San Roque,CORRIENTES,31,31,79,71,150
18,18161,181610304,San Roque,CORRIENTES,2,9,10,8,18
18,18161,181610401,San Roque,CORRIENTES,154,174,293,303,596
18,18161,181610402,San Roque,CORRIENTES,80,86,153,180,333
18,18161,181610403,San Roque,CORRIENTES,12,15,14,23,37
18,18161,181610404,San Roque,CORRIENTES,61,58,114,138,252
18,18161,181610405,San Roque,CORRIENTES,233,269,473,424,897
18,18161,181610501,San Roque,CORRIENTES,31,40,49,60,109
18,18161,181610502,San Roque,CORRIENTES,27,34,28,34,62
18,18161,181610503,San Roque,CORRIENTES,32,37,44,71,115
18,18161,181610504,San Roque,CORRIENTES,298,344,580,546,1126
18,18161,181610505,San Roque,CORRIENTES,314,387,662,647,1309
18,18161,181610601,San Roque,CORRIENTES,289,332,537,526,1063
18,18161,181610602,San Roque,CORRIENTES,73,106,162,147,309
18,18161,181610603,San Roque,CORRIENTES,90,113,164,189,353
18,18161,181610604,San Roque,CORRIENTES,12,18,17,23,40
18,18161,181610605,San Roque,CORRIENTES,131,159,248,270,518
18,18161,181610606,San Roque,CORRIENTES,55,60,116,133,249
18,18161,181610607,San Roque,CORRIENTES,276,265,577,452,1029
18,18175,181750101,Sauce,CORRIENTES,216,257,437,414,851
18,18175,181750102,Sauce,CORRIENTES,195,229,380,337,717
18,18175,181750103,Sauce,CORRIENTES,227,268,374,319,693
18,18175,181750104,Sauce,CORRIENTES,289,332,563,531,1094
18,18175,181750105,Sauce,CORRIENTES,326,388,657,599,1256
18,18175,181750106,Sauce,CORRIENTES,294,341,520,469,989
18,18175,181750107,Sauce,CORRIENTES,341,400,604,511,1115
18,18175,181750108,Sauce,CORRIENTES,78,79,165,134,299
18,18175,181750201,Sauce,CORRIENTES,12,13,12,32,44
18,18175,181750202,Sauce,CORRIENTES,18,19,24,35,59
18,18175,181750203,Sauce,CORRIENTES,13,19,18,22,40
18,18175,181750204,Sauce,CORRIENTES,30,30,46,49,95
18,18175,181750301,Sauce,CORRIENTES,15,15,21,31,52
18,18175,181750302,Sauce,CORRIENTES,26,39,25,42,67
18,18175,181750303,Sauce,CORRIENTES,25,31,56,71,127
18,18175,181750401,Sauce,CORRIENTES,26,33,44,60,104
18,18175,181750402,Sauce,CORRIENTES,41,52,84,87,171
18,18175,181750403,Sauce,CORRIENTES,58,67,112,119,231
18,18175,181750501,Sauce,CORRIENTES,99,128,166,172,338
18,18175,181750502,Sauce,CORRIENTES,6,9,14,12,26
18,18175,181750503,Sauce,CORRIENTES,18,19,19,64,83
18,18175,181750601,Sauce,CORRIENTES,56,69,125,104,229
18,18175,181750602,Sauce,CORRIENTES,40,54,95,69,164
18,18175,181750603,Sauce,CORRIENTES,8,13,3,16,19
18,18175,181750604,Sauce,CORRIENTES,9,12,4,8,12
18,18175,181750605,Sauce,CORRIENTES,21,30,25,37,62
18,18175,181750701,Sauce,CORRIENTES,3,4,7,15,22
18,18175,181750702,Sauce,CORRIENTES,8,8,6,19,25
18,18175,181750801,Sauce,CORRIENTES,9,22,8,19,27
18,18175,181750802,Sauce,CORRIENTES,7,9,0,21,21
14,14175,141750202,Tulumba,CORDOBA,155,248,211,246,457
14,14175,141750209,Tulumba,CORDOBA,140,197,202,247,449
14,14175,141750101,Tulumba,CORDOBA,35,46,49,68,117
14,14175,141750112,Tulumba,CORDOBA,104,163,153,164,317
14,14175,141750212,Tulumba,CORDOBA,217,268,395,398,793
14,14175,141750114,Tulumba,CORDOBA,233,335,399,380,779
14,14175,141750113,Tulumba,CORDOBA,221,323,367,328,695
14,14175,141750111,Tulumba,CORDOBA,188,236,319,343,662
14,14175,141750218,Tulumba,CORDOBA,353,433,558,546,1104
14,14175,141750217,Tulumba,CORDOBA,207,251,353,335,688
14,14175,141750216,Tulumba,CORDOBA,191,240,276,281,557
14,14175,141750215,Tulumba,CORDOBA,257,321,392,386,778
14,14175,141750214,Tulumba,CORDOBA,253,297,422,388,810
14,14175,141750213,Tulumba,CORDOBA,249,323,453,393,846
14,14175,141750110,Tulumba,CORDOBA,234,293,390,392,782
14,14175,141750201,Tulumba,CORDOBA,158,266,194,231,425
14,14175,141750219,Tulumba,CORDOBA,1,3,0,1,1
14,14175,141750207,Tulumba,CORDOBA,35,54,52,69,121
14,14175,141750107,Tulumba,CORDOBA,76,117,89,112,201
14,14175,141750105,Tulumba,CORDOBA,55,85,65,83,148
14,14175,141750104,Tulumba,CORDOBA,29,38,29,42,71
14,14175,141750102,Tulumba,CORDOBA,27,43,29,45,74
14,14175,141750211,Tulumba,CORDOBA,65,104,89,104,193
14,14175,141750210,Tulumba,CORDOBA,65,73,86,116,202
14,14175,141750208,Tulumba,CORDOBA,66,88,91,128,219
14,14175,141750204,Tulumba,CORDOBA,88,157,85,117,202
14,14175,141750203,Tulumba,CORDOBA,65,107,68,98,166
14,14175,141750109,Tulumba,CORDOBA,51,82,54,81,135
14,14175,141750205,Tulumba,CORDOBA,45,98,47,62,109
14,14175,141750108,Tulumba,CORDOBA,42,71,49,67,116
14,14175,141750106,Tulumba,CORDOBA,22,36,39,47,86
14,14175,141750103,Tulumba,CORDOBA,53,81,79,84,163
14,14175,141750206,Tulumba,CORDOBA,61,86,93,114,207
14,14147,141470304,Santa María,CORDOBA,125,318,223,211,434
14,14147,141470302,Santa María,CORDOBA,105,117,168,203,371
14,14147,141470305,Santa María,CORDOBA,87,224,119,139,258
14,14147,141470303,Santa María,CORDOBA,129,175,182,227,409
14,14147,141470205,Santa María,CORDOBA,290,354,556,729,1285
14,14147,141470204,Santa María,CORDOBA,215,279,353,417,770
14,14147,141470202,Santa María,CORDOBA,510,607,906,916,1822
14,14147,141470201,Santa María,CORDOBA,175,253,270,286,556
14,14147,141470103,Santa María,CORDOBA,173,226,305,315,620
14,14147,141470102,Santa María,CORDOBA,183,294,322,354,676
14,14147,141470601,Santa María,CORDOBA,133,260,212,237,449
14,14147,141471015,Santa María,CORDOBA,460,450,901,921,1822
14,14147,141471014,Santa María,CORDOBA,447,488,772,820,1592
14,14147,141471013,Santa María,CORDOBA,293,338,520,528,1048
14,14147,141471012,Santa María,CORDOBA,276,279,545,514,1059
14,14147,141471011,Santa María,CORDOBA,441,462,786,788,1574
14,14147,141471009,Santa María,CORDOBA,248,295,404,391,795
14,14147,141471008,Santa María,CORDOBA,363,411,631,577,1208
14,14147,141471006,Santa María,CORDOBA,225,291,311,289,600
14,14147,141471005,Santa María,CORDOBA,320,389,482,399,881
14,14147,141471004,Santa María,CORDOBA,222,253,344,296,640
14,14147,141471003,Santa María,CORDOBA,186,210,349,229,578
14,14147,141471002,Santa María,CORDOBA,273,314,463,432,895
14,14147,141471001,Santa María,CORDOBA,222,260,331,325,656
14,14147,141470919,Santa María,CORDOBA,265,286,511,478,989
14,14147,141470918,Santa María,CORDOBA,225,232,414,389,803
14,14147,141470917,Santa María,CORDOBA,195,215,334,316,650
14,14147,141470916,Santa María,CORDOBA,244,264,390,353,743
14,14147,141470915,Santa María,CORDOBA,267,296,460,335,795
14,14147,141470914,Santa María,CORDOBA,251,284,373,324,697
14,14147,141470913,Santa María,CORDOBA,382,452,655,581,1236
14,14147,141470907,Santa María,CORDOBA,172,198,281,232,513
14,14147,141470906,Santa María,CORDOBA,336,371,582,527,1109
14,14147,141470904,Santa María,CORDOBA,213,224,372,361,733
14,14147,141470903,Santa María,CORDOBA,413,427,768,708,1476
14,14147,141470902,Santa María,CORDOBA,413,386,828,810,1638
14,14147,141470901,Santa María,CORDOBA,319,327,601,615,1216
14,14147,141470817,Santa María,CORDOBA,122,182,156,133,289
14,14147,141470816,Santa María,CORDOBA,203,306,275,206,481
14,14147,141470815,Santa María,CORDOBA,238,266,363,297,660
14,14147,141470814,Santa María,CORDOBA,254,269,384,325,709
14,14147,141470813,Santa María,CORDOBA,263,331,387,303,690
14,14147,141470812,Santa María,CORDOBA,343,400,606,597,1203
14,14147,141470802,Santa María,CORDOBA,323,368,622,583,1205
14,14147,141470801,Santa María,CORDOBA,263,348,474,447,921
14,14147,141470714,Santa María,CORDOBA,160,317,259,273,532
14,14147,141470713,Santa María,CORDOBA,46,155,63,84,147
14,14147,141470711,Santa María,CORDOBA,100,320,144,160,304
14,14147,141470808,Santa María,CORDOBA,298,321,470,400,870
14,14147,141470807,Santa María,CORDOBA,297,331,542,507,1049
14,14147,141470806,Santa María,CORDOBA,400,416,718,667,1385
14,14147,141470805,Santa María,CORDOBA,470,511,933,824,1757
14,14147,141470610,Santa María,CORDOBA,158,262,256,227,483
14,14147,141470609,Santa María,CORDOBA,136,231,210,209,419
14,14147,141470804,Santa María,CORDOBA,241,235,477,444,921
14,14147,141470608,Santa María,CORDOBA,170,348,240,247,487
14,14147,141470603,Santa María,CORDOBA,134,328,212,218,430
14,14147,141470507,Santa María,CORDOBA,114,130,177,160,337
14,14147,141470605,Santa María,CORDOBA,90,198,135,135,270
14,14147,141470710,Santa María,CORDOBA,97,277,158,164,322
14,14147,141470709,Santa María,CORDOBA,61,179,98,90,188
14,14147,141470412,Santa María,CORDOBA,351,406,631,594,1225
14,14147,141470411,Santa María,CORDOBA,241,298,394,324,718
14,14147,141470410,Santa María,CORDOBA,232,249,412,380,792
14,14147,141470409,Santa María,CORDOBA,176,204,278,253,531
14,14147,141470408,Santa María,CORDOBA,334,416,533,479,1012
14,14147,141471010,Santa María,CORDOBA,387,427,678,588,1266
14,14147,141470912,Santa María,CORDOBA,361,397,653,585,1238
14,14147,141470314,Santa María,CORDOBA,127,332,198,191,389
14,14147,141470811,Santa María,CORDOBA,232,285,355,329,684
14,14147,141470309,Santa María,CORDOBA,254,343,447,418,865
14,14147,141470308,Santa María,CORDOBA,344,399,648,676,1324
14,14147,141470810,Santa María,CORDOBA,172,213,276,230,506
14,14147,141470107,Santa María,CORDOBA,294,301,621,582,1203
14,14147,141470106,Santa María,CORDOBA,254,249,457,438,895
14,14147,141470105,Santa María,CORDOBA,366,387,652,590,1242
14,14147,141470104,Santa María,CORDOBA,318,383,564,571,1135
14,14147,141470809,Santa María,CORDOBA,257,296,368,317,685
14,14147,141470911,Santa María,CORDOBA,210,217,327,303,630
14,14147,141470910,Santa María,CORDOBA,209,226,355,293,648
14,14147,141470909,Santa María,CORDOBA,226,254,321,269,590
14,14147,141470407,Santa María,CORDOBA,313,356,536,463,999
14,14147,141470406,Santa María,CORDOBA,139,168,249,232,481
14,14147,141470313,Santa María,CORDOBA,118,285,218,198,416
14,14147,141470908,Santa María,CORDOBA,308,339,503,467,970
14,14147,141470405,Santa María,CORDOBA,166,184,293,262,555
14,14147,141470310,Santa María,CORDOBA,296,389,481,486,967
14,14147,141471007,Santa María,CORDOBA,237,280,409,317,726
14,14147,141470905,Santa María,CORDOBA,224,249,399,365,764
14,14147,141470803,Santa María,CORDOBA,343,464,659,688,1347
14,14147,141470312,Santa María,CORDOBA,148,222,272,287,559
14,14147,141470311,Santa María,CORDOBA,195,421,315,330,645
14,14147,141470307,Santa María,CORDOBA,151,176,244,250,494
14,14147,141470213,Santa María,CORDOBA,225,218,459,429,888
14,14147,141470212,Santa María,CORDOBA,203,224,372,367,739
14,14147,141470211,Santa María,CORDOBA,234,284,407,384,791
14,14147,141470210,Santa María,CORDOBA,355,371,713,712,1425
14,14147,141470209,Santa María,CORDOBA,215,233,434,407,841
14,14147,141470208,Santa María,CORDOBA,246,301,462,480,942
14,14147,141470207,Santa María,CORDOBA,299,330,564,586,1150
14,14147,141470114,Santa María,CORDOBA,295,312,518,547,1065
14,14147,141470113,Santa María,CORDOBA,214,234,392,357,749
14,14147,141470112,Santa María,CORDOBA,246,263,403,339,742
14,14147,141470111,Santa María,CORDOBA,302,277,520,496,1016
14,14147,141470110,Santa María,CORDOBA,363,379,677,607,1284
14,14147,141470109,Santa María,CORDOBA,376,398,797,800,1597
14,14147,141470108,Santa María,CORDOBA,166,149,337,346,683
14,14147,141470712,Santa María,CORDOBA,62,378,95,108,203
14,14147,141470708,Santa María,CORDOBA,36,122,47,87,134
14,14147,141470607,Santa María,CORDOBA,123,238,200,163,363
14,14147,141470606,Santa María,CORDOBA,158,312,272,242,514
14,14147,141470604,Santa María,CORDOBA,116,279,184,178,362
14,14147,141470508,Santa María,CORDOBA,196,233,332,344,676
14,14147,141470413,Santa María,CORDOBA,175,187,245,273,518
14,14147,141470301,Santa María,CORDOBA,33,41,43,77,120
14,14147,141470707,Santa María,CORDOBA,30,117,51,56,107
14,14147,141470706,Santa María,CORDOBA,28,45,45,53,98
14,14147,141470704,Santa María,CORDOBA,47,104,55,104,159
14,14147,141470703,Santa María,CORDOBA,17,40,21,24,45
14,14147,141470702,Santa María,CORDOBA,12,60,15,39,54
14,14147,141470701,Santa María,CORDOBA,27,129,39,57,96
14,14147,141470602,Santa María,CORDOBA,72,171,190,247,437
14,14147,141470501,Santa María,CORDOBA,30,44,39,52,91
14,14147,141470403,Santa María,CORDOBA,62,86,93,122,215
14,14147,141470402,Santa María,CORDOBA,39,107,54,59,113
14,14147,141470705,Santa María,CORDOBA,2,7,4,5,9
14,14147,141470506,Santa María,CORDOBA,11,39,17,23,40
14,14147,141470505,Santa María,CORDOBA,21,65,24,36,60
14,14147,141470504,Santa María,CORDOBA,49,98,50,99,149
14,14147,141470503,Santa María,CORDOBA,44,74,57,66,123
14,14147,141470502,Santa María,CORDOBA,28,56,34,47,81
14,14147,141470401,Santa María,CORDOBA,54,73,93,102,195
14,14147,141470404,Santa María,CORDOBA,12,40,13,19,32
14,14147,141470306,Santa María,CORDOBA,23,30,30,37,67
14,14147,141470206,Santa María,CORDOBA,58,83,82,96,178
14,14147,141470203,Santa María,CORDOBA,51,79,307,2483,2790
14,14147,141470101,Santa María,CORDOBA,29,120,43,48,91
14,14070,140700210,Minas,CORDOBA,88,139,124,119,243
14,14070,140700206,Minas,CORDOBA,95,172,127,150,277
14,14070,140700201,Minas,CORDOBA,47,66,73,75,148
14,14070,140700103,Minas,CORDOBA,106,134,164,174,338
14,14070,140700101,Minas,CORDOBA,84,94,144,159,303
14,14070,140700212,Minas,CORDOBA,135,183,214,231,445
14,14070,140700211,Minas,CORDOBA,92,135,156,147,303
14,14070,140700213,Minas,CORDOBA,280,365,454,412,866
14,14070,140700204,Minas,CORDOBA,30,32,38,57,95
14,14070,140700203,Minas,CORDOBA,92,145,126,167,293
14,14070,140700207,Minas,CORDOBA,63,101,132,112,244
14,14070,140700205,Minas,CORDOBA,80,128,83,98,181
14,14070,140700105,Minas,CORDOBA,106,144,148,179,327
14,14070,140700104,Minas,CORDOBA,39,46,48,71,119
14,14070,140700209,Minas,CORDOBA,48,68,65,70,135
14,14070,140700208,Minas,CORDOBA,37,48,64,69,133
14,14070,140700202,Minas,CORDOBA,38,53,67,77,144
14,14070,140700102,Minas,CORDOBA,35,52,67,66,133
14,14028,140280706,Cruz del Eje,CORDOBA,79,146,108,142,250
14,14028,140280702,Cruz del Eje,CORDOBA,58,85,91,107,198
14,14028,140280701,Cruz del Eje,CORDOBA,56,106,94,100,194
14,14028,140280602,Cruz del Eje,CORDOBA,95,156,140,132,272
14,14028,140280101,Cruz del Eje,CORDOBA,25,32,32,52,84
14,14028,140280604,Cruz del Eje,CORDOBA,56,81,105,113,218
14,14028,140280501,Cruz del Eje,CORDOBA,163,164,326,413,739
14,14028,140280104,Cruz del Eje,CORDOBA,250,316,401,493,894
14,14028,140280102,Cruz del Eje,CORDOBA,143,156,263,294,557
14,14028,140280103,Cruz del Eje,CORDOBA,98,117,135,160,295
14,14028,140280606,Cruz del Eje,CORDOBA,198,276,294,266,560
14,14028,140280607,Cruz del Eje,CORDOBA,282,428,487,456,943
14,14028,140280511,Cruz del Eje,CORDOBA,218,239,558,424,982
14,14028,140280510,Cruz del Eje,CORDOBA,231,266,393,365,758
14,14028,140280508,Cruz del Eje,CORDOBA,267,280,514,500,1014
14,14028,140280507,Cruz del Eje,CORDOBA,275,277,560,563,1123
14,14028,140280506,Cruz del Eje,CORDOBA,287,292,615,563,1178
14,14028,140280515,Cruz del Eje,CORDOBA,114,141,208,196,404
14,14028,140280514,Cruz del Eje,CORDOBA,394,474,688,661,1349
14,14028,140280513,Cruz del Eje,CORDOBA,214,244,383,361,744
14,14028,140280512,Cruz del Eje,CORDOBA,217,246,411,427,838
14,14028,140280408,Cruz del Eje,CORDOBA,211,254,398,405,803
14,14028,140280407,Cruz del Eje,CORDOBA,213,273,430,453,883
14,14028,140280409,Cruz del Eje,CORDOBA,268,301,517,516,1033
14,14028,140280312,Cruz del Eje,CORDOBA,175,178,341,326,667
14,14028,140280311,Cruz del Eje,CORDOBA,304,333,631,1644,2275
14,14028,140280310,Cruz del Eje,CORDOBA,294,321,551,492,1043
14,14028,140280309,Cruz del Eje,CORDOBA,303,339,467,383,850
14,14028,140280308,Cruz del Eje,CORDOBA,232,359,326,254,580
14,14028,140280306,Cruz del Eje,CORDOBA,240,306,370,283,653
14,14028,140280304,Cruz del Eje,CORDOBA,365,422,654,550,1204
14,14028,140280303,Cruz del Eje,CORDOBA,324,368,592,530,1122
14,14028,140280302,Cruz del Eje,CORDOBA,326,376,638,595,1233
14,14028,140280301,Cruz del Eje,CORDOBA,296,288,631,585,1216
14,14028,140280207,Cruz del Eje,CORDOBA,221,277,362,280,642
14,14028,140280206,Cruz del Eje,CORDOBA,201,242,332,259,591
14,14028,140280205,Cruz del Eje,CORDOBA,223,240,425,387,812
14,14028,140280204,Cruz del Eje,CORDOBA,448,476,888,815,1703
14,14028,140280203,Cruz del Eje,CORDOBA,273,298,550,510,1060
14,14028,140280210,Cruz del Eje,CORDOBA,236,241,457,382,839
14,14028,140280209,Cruz del Eje,CORDOBA,304,360,540,434,974
14,14028,140280208,Cruz del Eje,CORDOBA,337,373,679,590,1269
14,14028,140280216,Cruz del Eje,CORDOBA,377,430,740,634,1374
14,14028,140280201,Cruz del Eje,CORDOBA,411,376,875,874,1749
14,14028,140280111,Cruz del Eje,CORDOBA,262,301,468,469,937
14,14028,140280215,Cruz del Eje,CORDOBA,362,403,736,636,1372
14,14028,140280213,Cruz del Eje,CORDOBA,321,340,593,561,1154
14,14028,140280110,Cruz del Eje,CORDOBA,386,339,840,909,1749
14,14028,140280109,Cruz del Eje,CORDOBA,206,263,390,410,800
14,14028,140280212,Cruz del Eje,CORDOBA,329,370,607,516,1123
14,14028,140280211,Cruz del Eje,CORDOBA,359,393,629,578,1207
14,14028,140280509,Cruz del Eje,CORDOBA,223,261,365,276,641
14,14028,140280505,Cruz del Eje,CORDOBA,249,301,497,504,1001
14,14028,140280410,Cruz del Eje,CORDOBA,223,251,443,464,907
14,14028,140280406,Cruz del Eje,CORDOBA,197,246,398,357,755
14,14028,140280307,Cruz del Eje,CORDOBA,255,304,391,346,737
14,14028,140280305,Cruz del Eje,CORDOBA,343,353,598,554,1152
14,14028,140280214,Cruz del Eje,CORDOBA,314,354,634,492,1126
14,14028,140280202,Cruz del Eje,CORDOBA,267,295,484,469,953
14,14028,140280705,Cruz del Eje,CORDOBA,24,36,24,35,59
14,14028,140280704,Cruz del Eje,CORDOBA,13,87,16,25,41
14,14028,140280605,Cruz del Eje,CORDOBA,19,31,37,30,67
14,14028,140280603,Cruz del Eje,CORDOBA,145,197,220,210,430
14,14028,140280601,Cruz del Eje,CORDOBA,21,34,32,42,74
14,14028,140280405,Cruz del Eje,CORDOBA,78,136,152,174,326
14,14028,140280404,Cruz del Eje,CORDOBA,119,174,202,212,414
14,14028,140280403,Cruz del Eje,CORDOBA,110,126,268,279,547
14,14028,140280402,Cruz del Eje,CORDOBA,101,129,150,194,344
14,14028,140280401,Cruz del Eje,CORDOBA,24,39,31,50,81
14,14028,140280108,Cruz del Eje,CORDOBA,103,143,180,191,371
14,14028,140280106,Cruz del Eje,CORDOBA,71,92,152,150,302
14,14028,140280105,Cruz del Eje,CORDOBA,166,205,342,308,650
14,14028,140280703,Cruz del Eje,CORDOBA,32,47,50,81,131
14,14028,140280504,Cruz del Eje,CORDOBA,116,162,149,229,378
14,14028,140280503,Cruz del Eje,CORDOBA,48,72,65,77,142
14,14028,140280502,Cruz del Eje,CORDOBA,134,153,242,280,522
14,14028,140280107,Cruz del Eje,CORDOBA,26,48,44,53,97
14,14021,140210103,Colón,CORDOBA,52,104,77,81,158
14,14021,140210205,Colón,CORDOBA,97,161,182,179,361
14,14021,140210802,Colón,CORDOBA,152,153,270,338,608
14,14021,140210607,Colón,CORDOBA,56,74,106,103,209
14,14021,140210504,Colón,CORDOBA,64,152,100,117,217
14,14021,140210502,Colón,CORDOBA,87,116,155,134,289
14,14021,140210313,Colón,CORDOBA,99,108,180,183,363
14,14021,140210308,Colón,CORDOBA,108,127,167,189,356
14,14021,140212120,Colón,CORDOBA,190,314,292,284,576
14,14021,140212119,Colón,CORDOBA,182,259,259,278,537
14,14021,140212118,Colón,CORDOBA,369,386,746,690,1436
14,14021,140212117,Colón,CORDOBA,173,170,273,268,541
14,14021,140212111,Colón,CORDOBA,92,132,169,151,320
14,14021,140212116,Colón,CORDOBA,294,307,563,490,1053
14,14021,140212108,Colón,CORDOBA,213,240,364,337,701
14,14021,140212107,Colón,CORDOBA,219,238,377,344,721
14,14021,140212106,Colón,CORDOBA,292,307,540,500,1040
14,14021,140212114,Colón,CORDOBA,192,205,384,383,767
14,14021,140212112,Colón,CORDOBA,157,222,303,303,606
14,14021,140212105,Colón,CORDOBA,272,261,490,472,962
14,14021,140212018,Colón,CORDOBA,273,282,540,577,1117
14,14021,140212104,Colón,CORDOBA,55,71,99,84,183
14,14021,140212101,Colón,CORDOBA,257,341,478,471,949
14,14021,140212017,Colón,CORDOBA,194,219,347,338,685
14,14021,140212013,Colón,CORDOBA,238,276,425,382,807
14,14021,140212011,Colón,CORDOBA,185,227,311,286,597
14,14021,140212010,Colón,CORDOBA,215,215,458,416,874
14,14021,140212009,Colón,CORDOBA,207,214,410,389,799
14,14021,140212008,Colón,CORDOBA,233,238,435,424,859
14,14021,140212007,Colón,CORDOBA,293,296,670,596,1266
14,14021,140212012,Colón,CORDOBA,251,273,381,331,712
14,14021,140212005,Colón,CORDOBA,307,340,605,609,1214
14,14021,140212003,Colón,CORDOBA,316,356,623,580,1203
14,14021,140212001,Colón,CORDOBA,182,182,366,364,730
14,14021,140212006,Colón,CORDOBA,203,197,481,437,918
14,14021,140211913,Colón,CORDOBA,216,251,402,398,800
14,14021,140211912,Colón,CORDOBA,203,233,383,368,751
14,14021,140211911,Colón,CORDOBA,287,345,515,437,952
14,14021,140211910,Colón,CORDOBA,316,373,566,524,1090
14,14021,140211909,Colón,CORDOBA,254,290,521,468,989
14,14021,140211907,Colón,CORDOBA,170,195,291,266,557
14,14021,140211906,Colón,CORDOBA,200,258,333,281,614
14,14021,140211903,Colón,CORDOBA,178,216,304,306,610
14,14021,140211902,Colón,CORDOBA,283,303,465,431,896
14,14021,140211901,Colón,CORDOBA,238,283,424,424,848
14,14021,140211815,Colón,CORDOBA,330,404,572,497,1069
14,14021,140211814,Colón,CORDOBA,227,286,371,295,666
14,14021,140211813,Colón,CORDOBA,392,418,757,713,1470
14,14021,140211811,Colón,CORDOBA,232,245,456,376,832
14,14021,140211808,Colón,CORDOBA,258,242,591,548,1139
14,14021,140211806,Colón,CORDOBA,215,220,422,455,877
14,14021,140211805,Colón,CORDOBA,298,329,523,457,980
14,14021,140212014,Colón,CORDOBA,341,361,682,663,1345
14,14021,140211802,Colón,CORDOBA,217,211,439,447,886
14,14021,140211801,Colón,CORDOBA,233,259,359,368,727
14,14021,140211710,Colón,CORDOBA,321,380,556,549,1105
14,14021,140211905,Colón,CORDOBA,200,232,420,383,803
14,14021,140211709,Colón,CORDOBA,418,462,871,778,1649
14,14021,140211708,Colón,CORDOBA,421,445,785,766,1551
14,14021,140211706,Colón,CORDOBA,328,399,558,529,1087
14,14021,140211705,Colón,CORDOBA,194,229,321,326,647
14,14021,140211607,Colón,CORDOBA,265,301,420,418,838
14,14021,140211606,Colón,CORDOBA,237,286,635,611,1246
14,14021,140211609,Colón,CORDOBA,223,273,361,382,743
14,14021,140211605,Colón,CORDOBA,240,267,495,491,986
14,14021,140211603,Colón,CORDOBA,218,262,407,339,746
14,14021,140211601,Colón,CORDOBA,277,319,491,510,1001
14,14021,140211511,Colón,CORDOBA,209,244,315,286,601
14,14021,140211510,Colón,CORDOBA,203,223,368,303,671
14,14021,140211509,Colón,CORDOBA,169,235,277,296,573
14,14021,140211508,Colón,CORDOBA,112,174,190,180,370
14,14021,140211503,Colón,CORDOBA,210,268,385,361,746
14,14021,140211502,Colón,CORDOBA,256,348,425,367,792
14,14021,140211904,Colón,CORDOBA,162,208,303,301,604
14,14021,140211507,Colón,CORDOBA,226,234,399,381,780
14,14021,140211506,Colón,CORDOBA,285,340,468,381,849
14,14021,140211504,Colón,CORDOBA,266,317,402,363,765
14,14021,140211411,Colón,CORDOBA,292,334,528,488,1016
14,14021,140211410,Colón,CORDOBA,247,281,412,371,783
14,14021,140211602,Colón,CORDOBA,393,451,638,579,1217
14,14021,140211409,Colón,CORDOBA,204,278,327,327,654
14,14021,140211408,Colón,CORDOBA,206,271,365,320,685
14,14021,140211704,Colón,CORDOBA,224,265,395,407,802
14,14021,140211404,Colón,CORDOBA,290,345,472,416,888
14,14021,140211403,Colón,CORDOBA,209,238,268,255,523
14,14021,140211402,Colón,CORDOBA,166,232,250,221,471
14,14021,140211401,Colón,CORDOBA,213,268,376,308,684
14,14021,140211314,Colón,CORDOBA,278,342,426,398,824
14,14021,140211313,Colón,CORDOBA,260,343,377,341,718
14,14021,140211312,Colón,CORDOBA,207,267,340,274,614
14,14021,140211311,Colón,CORDOBA,203,239,324,256,580
14,14021,140211310,Colón,CORDOBA,238,284,387,327,714
14,14021,140211309,Colón,CORDOBA,192,224,325,319,644
14,14021,140211406,Colón,CORDOBA,245,271,442,477,919
14,14021,140211308,Colón,CORDOBA,351,383,609,549,1158
14,14021,140211307,Colón,CORDOBA,173,221,314,283,597
14,14021,140211306,Colón,CORDOBA,210,278,319,340,659
14,14021,140211305,Colón,CORDOBA,304,393,490,471,961
14,14021,140211405,Colón,CORDOBA,285,323,472,451,923
14,14021,140211304,Colón,CORDOBA,181,266,330,301,631
14,14021,140211303,Colón,CORDOBA,208,282,388,364,752
14,14021,140211407,Colón,CORDOBA,374,445,590,568,1158
14,14021,140211302,Colón,CORDOBA,157,199,262,247,509
14,14021,140211301,Colón,CORDOBA,242,366,408,403,811
14,14021,140211703,Colón,CORDOBA,209,259,379,348,727
14,14021,140211702,Colón,CORDOBA,220,301,387,368,755
14,14021,140211701,Colón,CORDOBA,227,290,403,401,804
14,14021,140211611,Colón,CORDOBA,347,418,687,656,1343
14,14021,140211214,Colón,CORDOBA,267,374,443,384,827
14,14021,140211211,Colón,CORDOBA,260,352,417,390,807
14,14021,140211210,Colón,CORDOBA,256,330,392,354,746
14,14021,140211209,Colón,CORDOBA,137,185,214,188,402
14,14021,140211204,Colón,CORDOBA,226,316,359,334,693
14,14021,140211202,Colón,CORDOBA,164,229,304,287,591
14,14021,140211610,Colón,CORDOBA,223,264,390,398,788
14,14021,140211208,Colón,CORDOBA,139,227,204,211,415
14,14021,140211207,Colón,CORDOBA,197,225,352,305,657
14,14021,140211206,Colón,CORDOBA,231,276,361,364,725
14,14021,140211205,Colón,CORDOBA,245,300,426,404,830
14,14021,140211116,Colón,CORDOBA,222,263,361,318,679
14,14021,140211115,Colón,CORDOBA,216,241,370,311,681
14,14021,140211114,Colón,CORDOBA,223,257,419,383,802
14,14021,140211113,Colón,CORDOBA,281,320,510,444,954
14,14021,140211112,Colón,CORDOBA,386,420,650,593,1243
14,14021,140211111,Colón,CORDOBA,211,242,364,357,721
14,14021,140211110,Colón,CORDOBA,183,218,301,323,624
14,14021,140211109,Colón,CORDOBA,382,423,678,667,1345
14,14021,140211108,Colón,CORDOBA,268,307,475,409,884
14,14021,140211107,Colón,CORDOBA,256,305,459,409,868
14,14021,140211106,Colón,CORDOBA,115,133,183,174,357
14,14021,140211105,Colón,CORDOBA,265,296,393,356,749
14,14021,140211101,Colón,CORDOBA,231,257,425,409,834
14,14021,140211016,Colón,CORDOBA,232,228,502,434,936
14,14021,140211014,Colón,CORDOBA,422,461,809,733,1542
14,14021,140211013,Colón,CORDOBA,370,366,783,767,1550
14,14021,140211012,Colón,CORDOBA,441,418,855,884,1739
14,14021,140211011,Colón,CORDOBA,383,363,697,707,1404
14,14021,140210613,Colón,CORDOBA,259,300,478,436,914
14,14021,140210612,Colón,CORDOBA,371,410,691,628,1319
14,14021,140210611,Colón,CORDOBA,417,483,827,794,1621
14,14021,140210610,Colón,CORDOBA,175,182,306,290,596
14,14021,140210609,Colón,CORDOBA,290,331,478,449,927
14,14021,140210608,Colón,CORDOBA,252,231,468,483,951
14,14021,140210811,Colón,CORDOBA,231,241,418,459,877
14,14021,140210508,Colón,CORDOBA,234,288,428,434,862
14,14021,140210507,Colón,CORDOBA,219,296,425,399,824
14,14021,140210506,Colón,CORDOBA,121,145,262,230,492
14,14021,140210810,Colón,CORDOBA,258,237,495,462,957
14,14021,140210809,Colón,CORDOBA,396,382,806,801,1607
14,14021,140210315,Colón,CORDOBA,250,273,464,537,1001
14,14021,140210314,Colón,CORDOBA,275,271,565,544,1109
14,14021,140210808,Colón,CORDOBA,233,240,503,464,967
14,14021,140210807,Colón,CORDOBA,371,340,745,726,1471
14,14021,140210410,Colón,CORDOBA,266,276,486,496,982
14,14021,140210409,Colón,CORDOBA,369,404,654,639,1293
14,14021,140210213,Colón,CORDOBA,146,175,278,253,531
14,14021,140210408,Colón,CORDOBA,88,93,173,150,323
14,14021,140210407,Colón,CORDOBA,294,314,518,493,1011
14,14021,140210406,Colón,CORDOBA,277,300,470,444,914
14,14021,140210212,Colón,CORDOBA,125,202,188,173,361
14,14021,140210211,Colón,CORDOBA,88,219,109,125,234
14,14021,140210210,Colón,CORDOBA,121,244,188,204,392
14,14021,140210208,Colón,CORDOBA,100,180,151,138,289
14,14021,140210206,Colón,CORDOBA,87,306,134,119,253
14,14021,140211104,Colón,CORDOBA,243,260,407,434,841
14,14021,140210806,Colón,CORDOBA,118,144,261,267,528
14,14021,140210110,Colón,CORDOBA,119,268,195,181,376
14,14021,140210109,Colón,CORDOBA,179,304,264,280,544
14,14021,140210108,Colón,CORDOBA,156,226,239,214,453
14,14021,140210105,Colón,CORDOBA,74,112,125,139,264
14,14021,140210104,Colón,CORDOBA,112,166,190,204,394
14,14021,140211103,Colón,CORDOBA,200,218,341,340,681
14,14021,140211010,Colón,CORDOBA,318,361,493,403,896
14,14021,140211009,Colón,CORDOBA,240,296,384,336,720
14,14021,140211008,Colón,CORDOBA,301,292,508,429,937
14,14021,140211007,Colón,CORDOBA,173,204,313,281,594
14,14021,140211006,Colón,CORDOBA,317,380,572,552,1124
14,14021,140211005,Colón,CORDOBA,240,241,442,399,841
14,14021,140211004,Colón,CORDOBA,372,422,645,575,1220
14,14021,140211003,Colón,CORDOBA,321,372,488,420,908
14,14021,140211002,Colón,CORDOBA,274,285,430,378,808
14,14021,140211001,Colón,CORDOBA,384,418,702,626,1328
14,14021,140211102,Colón,CORDOBA,254,259,511,529,1040
14,14021,140210914,Colón,CORDOBA,325,358,508,447,955
14,14021,140210913,Colón,CORDOBA,306,300,457,420,877
14,14021,140210912,Colón,CORDOBA,204,216,336,300,636
14,14021,140210911,Colón,CORDOBA,403,406,716,1221,1937
14,14021,140210910,Colón,CORDOBA,288,288,525,476,1001
14,14021,140210909,Colón,CORDOBA,204,260,345,264,609
14,14021,140210908,Colón,CORDOBA,180,225,244,213,457
14,14021,140210906,Colón,CORDOBA,275,278,464,455,919
14,14021,140210905,Colón,CORDOBA,189,250,298,225,523
14,14021,140210904,Colón,CORDOBA,197,214,334,303,637
14,14021,140210903,Colón,CORDOBA,216,251,387,355,742
14,14021,140210902,Colón,CORDOBA,260,271,418,435,853
14,14021,140210901,Colón,CORDOBA,242,283,406,405,811
14,14021,140210814,Colón,CORDOBA,269,283,606,643,1249
14,14021,140210803,Colón,CORDOBA,348,351,846,893,1739
14,14021,140210716,Colón,CORDOBA,156,190,311,315,626
14,14021,140210715,Colón,CORDOBA,266,282,582,570,1152
14,14021,140210714,Colón,CORDOBA,164,153,357,395,752
14,14021,140210805,Colón,CORDOBA,313,288,630,627,1257
14,14021,140210713,Colón,CORDOBA,59,67,93,104,197
14,14021,140210711,Colón,CORDOBA,248,260,495,474,969
14,14021,140210705,Colón,CORDOBA,372,395,767,755,1522
14,14021,140210704,Colón,CORDOBA,170,163,352,368,720
14,14021,140210616,Colón,CORDOBA,318,346,584,572,1156
14,14021,140210615,Colón,CORDOBA,416,449,795,813,1608
14,14021,140210614,Colón,CORDOBA,418,459,800,713,1513
14,14021,140210813,Colón,CORDOBA,263,273,558,528,1086
14,14021,140210804,Colón,CORDOBA,303,287,595,611,1206
14,14021,140210812,Colón,CORDOBA,231,250,473,509,982
14,14021,140211816,Colón,CORDOBA,319,344,577,530,1107
14,14021,140211812,Colón,CORDOBA,385,410,687,587,1274
14,14021,140211810,Colón,CORDOBA,305,300,575,484,1059
14,14021,140211809,Colón,CORDOBA,282,284,561,537,1098
14,14021,140211807,Colón,CORDOBA,245,253,504,484,988
14,14021,140211804,Colón,CORDOBA,292,332,442,362,804
14,14021,140211803,Colón,CORDOBA,195,207,357,321,678
14,14021,140211707,Colón,CORDOBA,299,361,589,555,1144
14,14021,140211608,Colón,CORDOBA,245,294,393,354,747
14,14021,140211604,Colón,CORDOBA,249,274,499,505,1004
14,14021,140211505,Colón,CORDOBA,212,226,332,310,642
14,14021,140211501,Colón,CORDOBA,212,315,334,304,638
14,14021,140211412,Colón,CORDOBA,224,268,432,380,812
14,14021,140211213,Colón,CORDOBA,198,291,332,323,655
14,14021,140211212,Colón,CORDOBA,187,241,356,370,726
14,14021,140211203,Colón,CORDOBA,274,389,475,449,924
14,14021,140211201,Colón,CORDOBA,188,265,300,314,614
14,14021,140211119,Colón,CORDOBA,300,328,502,452,954
14,14021,140211118,Colón,CORDOBA,351,367,590,527,1117
14,14021,140211117,Colón,CORDOBA,266,301,429,365,794
14,14021,140211015,Colón,CORDOBA,126,130,254,250,504
14,14021,140210316,Colón,CORDOBA,214,224,462,465,927
14,14021,140210209,Colón,CORDOBA,201,344,271,287,558
14,14021,140210207,Colón,CORDOBA,152,252,227,218,445
14,14021,140212115,Colón,CORDOBA,192,185,340,321,661
14,14021,140212113,Colón,CORDOBA,274,283,551,531,1082
14,14021,140212110,Colón,CORDOBA,311,357,638,653,1291
14,14021,140212109,Colón,CORDOBA,209,209,365,344,709
14,14021,140212103,Colón,CORDOBA,184,211,346,383,729
14,14021,140212102,Colón,CORDOBA,189,194,346,356,702
14,14021,140212016,Colón,CORDOBA,190,204,335,325,660
14,14021,140212015,Colón,CORDOBA,309,360,505,425,930
14,14021,140212004,Colón,CORDOBA,240,252,490,497,987
14,14021,140212002,Colón,CORDOBA,176,218,352,351,703
14,14021,140211908,Colón,CORDOBA,158,180,291,279,570
14,14021,140210107,Colón,CORDOBA,156,333,272,260,532
14,14021,140210106,Colón,CORDOBA,177,285,262,289,551
14,14021,140210907,Colón,CORDOBA,205,249,311,246,557
14,14021,140210712,Colón,CORDOBA,200,206,404,400,804
14,14021,140210710,Colón,CORDOBA,200,193,408,399,807
14,14021,140210709,Colón,CORDOBA,243,230,516,513,1029
14,14021,140210708,Colón,CORDOBA,277,290,618,576,1194
14,14021,140210707,Colón,CORDOBA,289,314,643,634,1277
14,14021,140210706,Colón,CORDOBA,305,338,646,614,1260
14,14021,140210602,Colón,CORDOBA,26,53,43,55,98
14,14021,140210601,Colón,CORDOBA,66,101,83,109,192
14,14021,140210801,Colón,CORDOBA,43,51,70,87,157
14,14021,140210703,Colón,CORDOBA,89,95,144,160,304
14,14021,140210702,Colón,CORDOBA,178,196,295,330,625
14,14021,140210701,Colón,CORDOBA,62,99,108,132,240
14,14021,140210606,Colón,CORDOBA,18,19,32,32,64
14,14021,140210604,Colón,CORDOBA,49,85,78,74,152
14,14021,140210603,Colón,CORDOBA,24,47,40,40,80
14,14021,140210605,Colón,CORDOBA,90,95,174,170,344
14,14021,140210505,Colón,CORDOBA,55,82,98,105,203
14,14021,140210501,Colón,CORDOBA,45,67,81,90,171
14,14021,140210312,Colón,CORDOBA,116,128,205,214,419
14,14021,140210311,Colón,CORDOBA,125,135,198,229,427
14,14021,140210310,Colón,CORDOBA,108,142,160,188,348
14,14021,140210309,Colón,CORDOBA,174,192,346,293,639
14,14021,140210307,Colón,CORDOBA,44,53,58,86,144
14,14021,140210405,Colón,CORDOBA,86,95,152,181,333
14,14021,140210305,Colón,CORDOBA,126,148,209,202,411
14,14021,140210301,Colón,CORDOBA,48,69,99,85,184
14,14021,140210404,Colón,CORDOBA,97,120,175,165,340
14,14021,140210403,Colón,CORDOBA,112,122,248,234,482
14,14021,140210204,Colón,CORDOBA,51,82,62,88,150
14,14021,140210401,Colón,CORDOBA,93,106,143,146,289
14,14021,140210203,Colón,CORDOBA,16,31,22,24,46
14,14021,140210202,Colón,CORDOBA,26,44,37,39,76
14,14021,140210503,Colón,CORDOBA,13,21,16,28,44
14,14021,140210402,Colón,CORDOBA,83,106,122,139,261
14,14021,140210306,Colón,CORDOBA,110,124,189,207,396
14,14021,140210304,Colón,CORDOBA,225,234,419,419,838
14,14021,140210303,Colón,CORDOBA,191,198,329,357,686
14,14021,140210302,Colón,CORDOBA,122,137,198,198,396
14,14021,140210201,Colón,CORDOBA,16,29,21,29,50
14,14021,140210102,Colón,CORDOBA,28,41,38,47,85
14,14021,140210101,Colón,CORDOBA,25,51,24,37,61
14,14007,140070201,Calamuchita,CORDOBA,94,192,147,158,305
14,14007,140070715,Calamuchita,CORDOBA,77,98,102,126,228
14,14007,140070704,Calamuchita,CORDOBA,6,46,8,9,17
14,14007,140070602,Calamuchita,CORDOBA,84,124,128,121,249
14,14007,140070407,Calamuchita,CORDOBA,79,325,113,128,241
14,14007,140070307,Calamuchita,CORDOBA,32,95,32,58,90
14,14007,140070107,Calamuchita,CORDOBA,10,43,59,76,135
14,14007,140070703,Calamuchita,CORDOBA,13,77,12,20,32
14,14007,140070701,Calamuchita,CORDOBA,24,38,33,49,82
14,14007,140070413,Calamuchita,CORDOBA,25,138,68,89,157
14,14007,140070103,Calamuchita,CORDOBA,79,224,96,123,219
14,14007,140070102,Calamuchita,CORDOBA,123,207,233,261,494
14,14007,140070113,Calamuchita,CORDOBA,166,245,274,275,549
14,14007,140070818,Calamuchita,CORDOBA,278,320,428,398,826
14,14007,140070820,Calamuchita,CORDOBA,197,233,314,316,630
14,14007,140070806,Calamuchita,CORDOBA,203,243,290,281,571
14,14007,140070805,Calamuchita,CORDOBA,352,471,579,543,1122
14,14007,140070804,Calamuchita,CORDOBA,69,122,106,94,200
14,14007,140070819,Calamuchita,CORDOBA,35,135,59,59,118
14,14007,140070803,Calamuchita,CORDOBA,275,385,453,411,864
14,14007,140070719,Calamuchita,CORDOBA,184,326,267,223,490
14,14007,140070718,Calamuchita,CORDOBA,28,153,24,37,61
14,14007,140070720,Calamuchita,CORDOBA,19,118,28,26,54
14,14007,140070616,Calamuchita,CORDOBA,109,208,169,158,327
14,14007,140070614,Calamuchita,CORDOBA,250,385,393,411,804
14,14007,140070609,Calamuchita,CORDOBA,153,256,261,235,496
14,14007,140070608,Calamuchita,CORDOBA,228,382,348,339,687
14,14007,140070605,Calamuchita,CORDOBA,68,233,85,87,172
14,14007,140070516,Calamuchita,CORDOBA,125,223,193,200,393
14,14007,140070514,Calamuchita,CORDOBA,179,290,304,283,587
14,14007,140070513,Calamuchita,CORDOBA,259,439,395,365,760
14,14007,140070615,Calamuchita,CORDOBA,140,356,193,224,417
14,14007,140070512,Calamuchita,CORDOBA,299,408,428,402,830
14,14007,140070511,Calamuchita,CORDOBA,304,409,459,379,838
14,14007,140070507,Calamuchita,CORDOBA,173,260,324,334,658
14,14007,140070506,Calamuchita,CORDOBA,227,380,451,434,885
14,14007,140070505,Calamuchita,CORDOBA,182,321,256,241,497
14,14007,140070504,Calamuchita,CORDOBA,168,287,255,267,522
14,14007,140070503,Calamuchita,CORDOBA,169,332,253,244,497
14,14007,140070502,Calamuchita,CORDOBA,118,295,178,178,356
14,14007,140070501,Calamuchita,CORDOBA,206,434,334,331,665
14,14007,140070415,Calamuchita,CORDOBA,58,103,86,97,183
14,14007,140070416,Calamuchita,CORDOBA,133,296,224,202,426
14,14007,140070216,Calamuchita,CORDOBA,77,113,143,160,303
14,14007,140070213,Calamuchita,CORDOBA,179,263,236,225,461
14,14007,140070212,Calamuchita,CORDOBA,184,271,261,230,491
14,14007,140070211,Calamuchita,CORDOBA,302,366,449,465,914
14,14007,140070210,Calamuchita,CORDOBA,157,237,232,179,411
14,14007,140070209,Calamuchita,CORDOBA,206,292,358,318,676
14,14007,140070208,Calamuchita,CORDOBA,293,365,506,474,980
14,14007,140070207,Calamuchita,CORDOBA,273,344,425,382,807
14,14007,140070206,Calamuchita,CORDOBA,321,427,539,492,1031
14,14007,140070205,Calamuchita,CORDOBA,157,271,237,246,483
14,14007,140070111,Calamuchita,CORDOBA,190,397,302,346,648
14,14007,140070908,Calamuchita,CORDOBA,100,184,142,160,302
14,14007,140070904,Calamuchita,CORDOBA,249,465,352,347,699
14,14007,140070817,Calamuchita,CORDOBA,340,416,512,499,1011
14,14007,140070816,Calamuchita,CORDOBA,210,260,390,369,759
14,14007,140070815,Calamuchita,CORDOBA,337,392,524,467,991
14,14007,140070814,Calamuchita,CORDOBA,334,363,521,541,1062
14,14007,140070809,Calamuchita,CORDOBA,254,317,1002,977,1979
14,14007,140070808,Calamuchita,CORDOBA,295,388,423,368,791
14,14007,140070807,Calamuchita,CORDOBA,281,330,453,413,866
14,14007,140070706,Calamuchita,CORDOBA,288,376,443,430,873
14,14007,140070613,Calamuchita,CORDOBA,126,349,211,191,402
14,14007,140070612,Calamuchita,CORDOBA,167,280,241,250,491
14,14007,140070611,Calamuchita,CORDOBA,219,359,376,325,701
14,14007,140070610,Calamuchita,CORDOBA,137,380,225,234,459
14,14007,140070607,Calamuchita,CORDOBA,260,498,391,378,769
14,14007,140070606,Calamuchita,CORDOBA,63,167,94,80,174
14,14007,140070518,Calamuchita,CORDOBA,248,254,463,518,981
14,14007,140070517,Calamuchita,CORDOBA,284,353,516,525,1041
14,14007,140070515,Calamuchita,CORDOBA,195,269,330,328,658
14,14007,140070510,Calamuchita,CORDOBA,328,437,479,454,933
14,14007,140070509,Calamuchita,CORDOBA,267,391,367,335,702
14,14007,140070508,Calamuchita,CORDOBA,153,255,285,307,592
14,14007,140070414,Calamuchita,CORDOBA,280,368,521,576,1097
14,14007,140070312,Calamuchita,CORDOBA,253,297,455,418,873
14,14007,140070311,Calamuchita,CORDOBA,248,294,455,428,883
14,14007,140070310,Calamuchita,CORDOBA,202,233,334,301,635
14,14007,140070309,Calamuchita,CORDOBA,270,322,465,461,926
14,14007,140070308,Calamuchita,CORDOBA,74,123,128,132,260
14,14007,140070215,Calamuchita,CORDOBA,184,248,301,282,583
14,14007,140070214,Calamuchita,CORDOBA,198,277,325,330,655
14,14007,140070112,Calamuchita,CORDOBA,170,387,242,264,506
14,14007,140070110,Calamuchita,CORDOBA,134,343,209,238,447
14,14007,140070902,Calamuchita,CORDOBA,25,52,30,38,68
14,14007,140070905,Calamuchita,CORDOBA,14,36,12,26,38
14,14007,140070813,Calamuchita,CORDOBA,16,34,20,24,44
14,14007,140070812,Calamuchita,CORDOBA,15,45,18,18,36
14,14007,140070811,Calamuchita,CORDOBA,14,30,18,23,41
14,14007,140070810,Calamuchita,CORDOBA,34,60,42,61,103
14,14007,140070801,Calamuchita,CORDOBA,12,17,14,17,31
14,14007,140070717,Calamuchita,CORDOBA,8,37,10,15,25
14,14007,140070716,Calamuchita,CORDOBA,13,48,17,17,34
14,14007,140070709,Calamuchita,CORDOBA,6,14,10,16,26
14,14007,140070601,Calamuchita,CORDOBA,13,38,15,17,32
14,14007,140070410,Calamuchita,CORDOBA,9,22,8,20,28
14,14007,140070408,Calamuchita,CORDOBA,20,41,31,39,70
14,14007,140070405,Calamuchita,CORDOBA,47,117,75,82,157
14,14007,140070404,Calamuchita,CORDOBA,2,10,2,5,7
14,14007,140070306,Calamuchita,CORDOBA,28,58,46,48,94
14,14007,140070304,Calamuchita,CORDOBA,17,52,34,29,63
14,14007,140070301,Calamuchita,CORDOBA,18,43,20,31,51
14,14007,140070203,Calamuchita,CORDOBA,35,54,122,117,239
14,14007,140070202,Calamuchita,CORDOBA,31,47,49,60,109
14,14007,140070105,Calamuchita,CORDOBA,72,158,131,137,268
14,14007,140070907,Calamuchita,CORDOBA,12,24,12,26,38
14,14007,140070906,Calamuchita,CORDOBA,27,71,31,39,70
14,14007,140070903,Calamuchita,CORDOBA,14,39,19,28,47
14,14007,140070901,Calamuchita,CORDOBA,10,20,7,44,51
14,14007,140070802,Calamuchita,CORDOBA,62,114,89,97,186
14,14007,140070714,Calamuchita,CORDOBA,6,22,4,12,16
14,14007,140070713,Calamuchita,CORDOBA,29,55,36,57,93
14,14007,140070712,Calamuchita,CORDOBA,14,30,21,25,46
14,14007,140070711,Calamuchita,CORDOBA,12,19,14,25,39
14,14007,140070710,Calamuchita,CORDOBA,12,15,10,23,33
14,14007,140070708,Calamuchita,CORDOBA,14,41,18,27,45
14,14007,140070707,Calamuchita,CORDOBA,14,31,18,32,50
14,14007,140070705,Calamuchita,CORDOBA,29,66,42,42,84
14,14007,140070702,Calamuchita,CORDOBA,26,48,31,37,68
14,14007,140070604,Calamuchita,CORDOBA,20,59,31,28,59
14,14007,140070603,Calamuchita,CORDOBA,47,115,63,74,137
14,14007,140070403,Calamuchita,CORDOBA,24,58,37,56,93
14,14007,140070402,Calamuchita,CORDOBA,7,20,21,44,65
14,14007,140070401,Calamuchita,CORDOBA,21,59,28,26,54
14,14007,140070305,Calamuchita,CORDOBA,86,144,137,164,301
14,14007,140070303,Calamuchita,CORDOBA,5,27,7,13,20
14,14007,140070302,Calamuchita,CORDOBA,17,47,29,27,56
14,14007,140070204,Calamuchita,CORDOBA,151,279,227,257,484
14,14007,140070108,Calamuchita,CORDOBA,114,158,155,202,357
14,14007,140070106,Calamuchita,CORDOBA,33,57,32,51,83
14,14007,140070104,Calamuchita,CORDOBA,24,46,32,45,77
14,14007,140070101,Calamuchita,CORDOBA,17,31,28,40,68
14,14007,140070412,Calamuchita,CORDOBA,33,53,47,59,106
14,14007,140070411,Calamuchita,CORDOBA,19,30,24,33,57
14,14007,140070409,Calamuchita,CORDOBA,13,29,8,16,24
14,14007,140070406,Calamuchita,CORDOBA,67,116,113,106,219
14,14182,141820702,Unión,CORDOBA,76,96,109,119,228
14,14182,141820202,Unión,CORDOBA,108,118,193,225,418
14,14182,141820707,Unión,CORDOBA,128,164,200,222,422
14,14182,141820705,Unión,CORDOBA,48,68,67,75,142
14,14182,141820802,Unión,CORDOBA,239,255,436,372,808
14,14182,141821312,Unión,CORDOBA,252,274,434,420,854
14,14182,141821310,Unión,CORDOBA,184,206,249,242,491
14,14182,141821309,Unión,CORDOBA,163,194,240,222,462
14,14182,141821308,Unión,CORDOBA,117,127,225,229,454
14,14182,141821307,Unión,CORDOBA,283,333,506,445,951
14,14182,141821306,Unión,CORDOBA,247,281,373,349,722
14,14182,141821305,Unión,CORDOBA,210,257,289,258,547
14,14182,141821304,Unión,CORDOBA,293,345,423,389,812
14,14182,141821303,Unión,CORDOBA,238,276,345,280,625
14,14182,141821302,Unión,CORDOBA,299,355,493,451,944
14,14182,141821301,Unión,CORDOBA,320,363,482,467,949
14,14182,141821211,Unión,CORDOBA,247,261,445,444,889
14,14182,141821210,Unión,CORDOBA,200,232,337,315,652
14,14182,141821209,Unión,CORDOBA,194,216,312,329,641
14,14182,141821208,Unión,CORDOBA,205,245,339,286,625
14,14182,141821207,Unión,CORDOBA,287,336,400,380,780
14,14182,141821206,Unión,CORDOBA,363,360,545,594,1139
14,14182,141821205,Unión,CORDOBA,236,263,353,344,697
14,14182,141821204,Unión,CORDOBA,331,358,587,542,1129
14,14182,141821203,Unión,CORDOBA,277,326,399,357,756
14,14182,141821202,Unión,CORDOBA,188,210,242,237,479
14,14182,141821201,Unión,CORDOBA,214,231,370,342,712
14,14182,141821110,Unión,CORDOBA,357,400,557,496,1053
14,14182,141821109,Unión,CORDOBA,388,428,725,775,1500
14,14182,141821108,Unión,CORDOBA,269,262,429,441,870
14,14182,141821107,Unión,CORDOBA,206,223,307,262,569
14,14182,141821106,Unión,CORDOBA,272,295,422,437,859
14,14182,141821105,Unión,CORDOBA,190,227,252,204,456
14,14182,141821104,Unión,CORDOBA,225,300,311,235,546
14,14182,141821103,Unión,CORDOBA,159,205,234,214,448
14,14182,141821102,Unión,CORDOBA,242,273,329,269,598
14,14182,141821010,Unión,CORDOBA,325,332,570,541,1111
14,14182,141821003,Unión,CORDOBA,205,216,306,298,604
14,14182,141820712,Unión,CORDOBA,138,164,197,190,387
14,14182,141820711,Unión,CORDOBA,229,265,335,364,699
14,14182,141820904,Unión,CORDOBA,230,260,370,351,721
14,14182,141820903,Unión,CORDOBA,293,290,531,560,1091
14,14182,141820902,Unión,CORDOBA,339,355,623,612,1235
14,14182,141820901,Unión,CORDOBA,294,316,476,454,930
14,14182,141820811,Unión,CORDOBA,219,309,325,242,567
14,14182,141820810,Unión,CORDOBA,315,384,470,378,848
14,14182,141820809,Unión,CORDOBA,332,378,480,402,882
14,14182,141820808,Unión,CORDOBA,179,204,230,225,455
14,14182,141820807,Unión,CORDOBA,208,242,331,265,596
14,14182,141820615,Unión,CORDOBA,313,365,436,390,826
14,14182,141820509,Unión,CORDOBA,208,239,320,312,632
14,14182,141820614,Unión,CORDOBA,144,216,199,172,371
14,14182,141820613,Unión,CORDOBA,228,254,337,298,635
14,14182,141820612,Unión,CORDOBA,325,338,514,511,1025
14,14182,141820611,Unión,CORDOBA,202,225,282,258,540
14,14182,141820609,Unión,CORDOBA,418,454,795,727,1522
14,14182,141820521,Unión,CORDOBA,223,258,341,333,674
14,14182,141820520,Unión,CORDOBA,224,249,304,299,603
14,14182,141820519,Unión,CORDOBA,152,174,217,190,407
14,14182,141820518,Unión,CORDOBA,414,418,513,469,982
14,14182,141820517,Unión,CORDOBA,169,189,268,228,496
14,14182,141820516,Unión,CORDOBA,229,249,406,384,790
14,14182,141820515,Unión,CORDOBA,266,301,352,346,698
14,14182,141820415,Unión,CORDOBA,319,361,465,456,921
14,14182,141820414,Unión,CORDOBA,209,237,350,338,688
14,14182,141821002,Unión,CORDOBA,307,358,411,399,810
14,14182,141820307,Unión,CORDOBA,312,364,475,466,941
14,14182,141821001,Unión,CORDOBA,219,290,332,259,591
14,14182,141820208,Unión,CORDOBA,195,237,282,298,580
14,14182,141820207,Unión,CORDOBA,248,266,426,387,813
14,14182,141820206,Unión,CORDOBA,248,292,399,417,816
14,14182,141820911,Unión,CORDOBA,302,354,402,312,714
14,14182,141820413,Unión,CORDOBA,285,327,496,504,1000
14,14182,141820412,Unión,CORDOBA,216,242,380,366,746
14,14182,141820806,Unión,CORDOBA,316,345,533,531,1064
14,14182,141820805,Unión,CORDOBA,327,369,518,443,961
14,14182,141820214,Unión,CORDOBA,170,208,229,241,470
14,14182,141820213,Unión,CORDOBA,328,362,513,530,1043
14,14182,141820804,Unión,CORDOBA,231,257,330,311,641
14,14182,141820115,Unión,CORDOBA,191,215,283,293,576
14,14182,141820114,Unión,CORDOBA,148,178,212,225,437
14,14182,141820803,Unión,CORDOBA,277,303,480,470,950
14,14182,141820910,Unión,CORDOBA,361,404,551,477,1028
14,14182,141820113,Unión,CORDOBA,252,291,389,356,745
14,14182,141820112,Unión,CORDOBA,235,281,365,376,741
14,14182,141820111,Unión,CORDOBA,193,224,260,267,527
14,14182,141820801,Unión,CORDOBA,213,237,390,398,788
14,14182,141820716,Unión,CORDOBA,247,282,350,359,709
14,14182,141820909,Unión,CORDOBA,309,341,527,537,1064
14,14182,141820715,Unión,CORDOBA,314,372,480,465,945
14,14182,141820908,Unión,CORDOBA,366,393,628,629,1257
14,14182,141820714,Unión,CORDOBA,226,280,349,321,670
14,14182,141820713,Unión,CORDOBA,180,219,266,260,526
14,14182,141820907,Unión,CORDOBA,230,244,355,346,701
14,14182,141820619,Unión,CORDOBA,114,146,191,182,373
14,14182,141820906,Unión,CORDOBA,241,284,354,290,644
14,14182,141820905,Unión,CORDOBA,224,244,392,400,792
14,14182,141821007,Unión,CORDOBA,282,310,411,334,745
14,14182,141821006,Unión,CORDOBA,215,232,336,362,698
14,14182,141820618,Unión,CORDOBA,124,140,177,186,363
14,14182,141820617,Unión,CORDOBA,213,233,299,279,578
14,14182,141820616,Unión,CORDOBA,207,239,354,338,692
14,14182,141821005,Unión,CORDOBA,162,168,285,323,608
14,14182,141821009,Unión,CORDOBA,287,325,432,378,810
14,14182,141821008,Unión,CORDOBA,178,219,264,210,474
14,14182,141821004,Unión,CORDOBA,295,314,513,504,1017
14,14182,141821311,Unión,CORDOBA,245,274,417,417,834
14,14182,141821101,Unión,CORDOBA,149,168,226,200,426
14,14182,141820812,Unión,CORDOBA,131,186,168,137,305
14,14182,141820610,Unión,CORDOBA,249,278,392,381,773
14,14182,141820608,Unión,CORDOBA,205,247,289,269,558
14,14182,141820607,Unión,CORDOBA,334,402,498,448,946
14,14182,141820514,Unión,CORDOBA,213,248,295,272,567
14,14182,141820513,Unión,CORDOBA,235,257,362,364,726
14,14182,141820512,Unión,CORDOBA,245,275,365,384,749
14,14182,141820511,Unión,CORDOBA,312,342,467,442,909
14,14182,141820510,Unión,CORDOBA,174,176,231,242,473
14,14182,141820411,Unión,CORDOBA,326,377,463,465,928
14,14182,141820410,Unión,CORDOBA,221,238,362,343,705
14,14182,141820409,Unión,CORDOBA,242,290,356,358,714
14,14182,141820408,Unión,CORDOBA,116,131,175,209,384
14,14182,141820310,Unión,CORDOBA,375,434,635,591,1226
14,14182,141820309,Unión,CORDOBA,174,224,245,216,461
14,14182,141820308,Unión,CORDOBA,229,280,353,364,717
14,14182,141820212,Unión,CORDOBA,167,211,250,282,532
14,14182,141820211,Unión,CORDOBA,271,327,416,441,857
14,14182,141820210,Unión,CORDOBA,265,306,433,385,818
14,14182,141820209,Unión,CORDOBA,266,321,430,430,860
14,14182,141820121,Unión,CORDOBA,224,245,313,276,589
14,14182,141820120,Unión,CORDOBA,320,351,479,447,926
14,14182,141820119,Unión,CORDOBA,298,332,418,349,767
14,14182,141820118,Unión,CORDOBA,271,296,369,354,723
14,14182,141820117,Unión,CORDOBA,225,250,336,365,701
14,14182,141820116,Unión,CORDOBA,344,379,496,507,1003
14,14182,141820304,Unión,CORDOBA,41,78,51,89,140
14,14182,141820303,Unión,CORDOBA,69,108,214,388,602
14,14182,141820302,Unión,CORDOBA,18,31,34,38,72
14,14182,141820706,Unión,CORDOBA,35,55,35,68,103
14,14182,141820704,Unión,CORDOBA,26,38,25,44,69
14,14182,141820703,Unión,CORDOBA,47,76,59,87,146
14,14182,141820701,Unión,CORDOBA,25,41,25,47,72
14,14182,141820606,Unión,CORDOBA,6,29,11,8,19
14,14182,141820605,Unión,CORDOBA,41,79,49,66,115
14,14182,141820603,Unión,CORDOBA,28,62,30,43,73
14,14182,141820602,Unión,CORDOBA,47,104,59,79,138
14,14182,141820601,Unión,CORDOBA,27,88,31,44,75
14,14182,141820507,Unión,CORDOBA,17,74,28,27,55
14,14182,141820505,Unión,CORDOBA,66,111,102,125,227
14,14182,141820504,Unión,CORDOBA,20,40,28,38,66
14,14182,141820502,Unión,CORDOBA,27,69,39,46,85
14,14182,141820501,Unión,CORDOBA,26,54,33,59,92
14,14182,141820407,Unión,CORDOBA,40,99,57,73,130
14,14182,141820406,Unión,CORDOBA,58,117,85,107,192
14,14182,141820404,Unión,CORDOBA,31,47,45,57,102
14,14182,141820401,Unión,CORDOBA,37,76,58,69,127
14,14182,141820306,Unión,CORDOBA,57,83,93,115,208
14,14182,141820301,Unión,CORDOBA,58,115,86,110,196
14,14182,141820204,Unión,CORDOBA,39,56,52,62,114
14,14182,141820203,Unión,CORDOBA,89,126,141,191,332
14,14182,141820201,Unión,CORDOBA,64,103,103,136,239
14,14182,141820109,Unión,CORDOBA,46,74,66,87,153
14,14182,141820108,Unión,CORDOBA,79,122,104,153,257
14,14182,141820107,Unión,CORDOBA,70,104,100,126,226
14,14182,141820103,Unión,CORDOBA,45,78,69,86,155
14,14182,141820710,Unión,CORDOBA,42,68,43,64,107
14,14182,141820709,Unión,CORDOBA,45,55,58,77,135
14,14182,141820708,Unión,CORDOBA,53,94,70,102,172
14,14182,141820604,Unión,CORDOBA,36,48,76,78,154
14,14182,141820508,Unión,CORDOBA,32,72,41,51,92
14,14182,141820506,Unión,CORDOBA,24,60,30,36,66
14,14182,141820503,Unión,CORDOBA,9,34,9,11,20
14,14182,141820405,Unión,CORDOBA,34,68,46,59,105
14,14182,141820403,Unión,CORDOBA,83,134,137,132,269
14,14182,141820402,Unión,CORDOBA,111,198,175,207,382
14,14182,141820305,Unión,CORDOBA,33,36,46,64,110
14,14182,141820205,Unión,CORDOBA,31,41,47,57,104
14,14182,141820106,Unión,CORDOBA,90,107,153,196,349
14,14182,141820105,Unión,CORDOBA,64,74,103,123,226
14,14182,141820104,Unión,CORDOBA,47,58,70,99,169
14,14182,141820102,Unión,CORDOBA,60,66,90,119,209
14,14182,141820101,Unión,CORDOBA,53,86,80,105,185
14,14182,141820110,Unión,CORDOBA,125,198,132,173,305
14,14168,141680309,Totoral,CORDOBA,51,84,76,78,154
14,14168,141680108,Totoral,CORDOBA,90,131,122,146,268
14,14168,141680311,Totoral,CORDOBA,342,354,638,650,1288
14,14168,141680212,Totoral,CORDOBA,239,248,453,474,927
14,14168,141680210,Totoral,CORDOBA,195,221,349,322,671
14,14168,141680209,Totoral,CORDOBA,217,242,419,390,809
14,14168,141680208,Totoral,CORDOBA,295,350,488,460,948
14,14168,141680207,Totoral,CORDOBA,278,293,473,440,913
14,14168,141680206,Totoral,CORDOBA,198,239,295,264,559
14,14168,141680114,Totoral,CORDOBA,312,357,567,587,1154
14,14168,141680113,Totoral,CORDOBA,147,182,266,284,550
14,14168,141680112,Totoral,CORDOBA,272,310,442,394,836
14,14168,141680205,Totoral,CORDOBA,161,208,285,233,518
14,14168,141680204,Totoral,CORDOBA,158,218,254,267,521
14,14168,141680313,Totoral,CORDOBA,342,359,655,662,1317
14,14168,141680312,Totoral,CORDOBA,224,322,431,443,874
14,14168,141680214,Totoral,CORDOBA,191,224,368,342,710
14,14168,141680213,Totoral,CORDOBA,224,246,371,363,734
14,14168,141680211,Totoral,CORDOBA,259,288,462,439,901
14,14168,141680111,Totoral,CORDOBA,211,239,384,370,754
14,14168,141680110,Totoral,CORDOBA,97,156,159,181,340
14,14168,141680310,Totoral,CORDOBA,53,90,68,91,159
14,14168,141680304,Totoral,CORDOBA,37,62,67,92,159
14,14168,141680303,Totoral,CORDOBA,94,204,139,160,299
14,14168,141680302,Totoral,CORDOBA,61,109,100,101,201
14,14168,141680104,Totoral,CORDOBA,15,31,17,19,36
14,14168,141680101,Totoral,CORDOBA,46,75,68,85,153
14,14168,141680103,Totoral,CORDOBA,29,32,46,47,93
14,14168,141680102,Totoral,CORDOBA,52,93,63,78,141
14,14168,141680105,Totoral,CORDOBA,18,42,21,40,61
14,14168,141680307,Totoral,CORDOBA,56,78,81,94,175
14,14168,141680306,Totoral,CORDOBA,27,41,36,44,80
14,14168,141680305,Totoral,CORDOBA,57,85,112,117,229
14,14168,141680301,Totoral,CORDOBA,27,43,37,41,78
14,14168,141680308,Totoral,CORDOBA,20,37,29,33,62
14,14168,141680203,Totoral,CORDOBA,27,52,43,59,102
14,14168,141680201,Totoral,CORDOBA,47,66,66,106,172
14,14168,141680109,Totoral,CORDOBA,27,45,44,41,85
14,14168,141680202,Totoral,CORDOBA,82,110,150,141,291
14,14168,141680107,Totoral,CORDOBA,37,67,43,69,112
14,14168,141680106,Totoral,CORDOBA,48,80,50,72,122
14,14161,141610503,Tercero Arriba,CORDOBA,92,137,129,156,285
14,14161,141610407,Tercero Arriba,CORDOBA,84,132,109,138,247
14,14161,141610401,Tercero Arriba,CORDOBA,53,83,82,91,173
14,14161,141610805,Tercero Arriba,CORDOBA,160,202,202,184,386
14,14161,141610815,Tercero Arriba,CORDOBA,218,249,336,361,697
14,14161,141610814,Tercero Arriba,CORDOBA,264,317,364,291,655
14,14161,141610813,Tercero Arriba,CORDOBA,197,258,268,211,479
14,14161,141610811,Tercero Arriba,CORDOBA,184,210,254,216,470
14,14161,141610810,Tercero Arriba,CORDOBA,303,351,414,346,760
14,14161,141610808,Tercero Arriba,CORDOBA,210,241,339,294,633
14,14161,141610807,Tercero Arriba,CORDOBA,289,329,424,419,843
14,14161,141611009,Tercero Arriba,CORDOBA,204,245,303,249,552
14,14161,141610715,Tercero Arriba,CORDOBA,384,425,687,617,1304
14,14161,141610714,Tercero Arriba,CORDOBA,266,296,470,390,860
14,14161,141610713,Tercero Arriba,CORDOBA,301,343,510,432,942
14,14161,141610712,Tercero Arriba,CORDOBA,360,409,560,535,1095
14,14161,141610711,Tercero Arriba,CORDOBA,198,230,294,269,563
14,14161,141610710,Tercero Arriba,CORDOBA,245,272,374,325,699
14,14161,141610709,Tercero Arriba,CORDOBA,308,353,460,406,866
14,14161,141610708,Tercero Arriba,CORDOBA,294,346,458,433,891
14,14161,141610707,Tercero Arriba,CORDOBA,222,260,345,321,666
14,14161,141610706,Tercero Arriba,CORDOBA,275,297,429,371,800
14,14161,141610705,Tercero Arriba,CORDOBA,150,171,245,208,453
14,14161,141610704,Tercero Arriba,CORDOBA,152,203,244,198,442
14,14161,141610703,Tercero Arriba,CORDOBA,316,365,470,389,859
14,14161,141610702,Tercero Arriba,CORDOBA,175,216,279,261,540
14,14161,141610701,Tercero Arriba,CORDOBA,242,264,365,327,692
14,14161,141610614,Tercero Arriba,CORDOBA,212,228,369,391,760
14,14161,141610512,Tercero Arriba,CORDOBA,200,231,319,324,643
14,14161,141610511,Tercero Arriba,CORDOBA,232,270,359,348,707
14,14161,141610510,Tercero Arriba,CORDOBA,204,249,275,258,533
14,14161,141610509,Tercero Arriba,CORDOBA,213,237,392,363,755
14,14161,141610508,Tercero Arriba,CORDOBA,189,208,296,277,573
14,14161,141610507,Tercero Arriba,CORDOBA,339,388,521,562,1083
14,14161,141610506,Tercero Arriba,CORDOBA,232,246,370,420,790
14,14161,141610605,Tercero Arriba,CORDOBA,185,246,315,314,629
14,14161,141610806,Tercero Arriba,CORDOBA,178,206,259,266,525
14,14161,141610310,Tercero Arriba,CORDOBA,307,352,494,448,942
14,14161,141610309,Tercero Arriba,CORDOBA,191,245,325,326,651
14,14161,141610308,Tercero Arriba,CORDOBA,194,244,315,268,583
14,14161,141610307,Tercero Arriba,CORDOBA,325,381,527,514,1041
14,14161,141610306,Tercero Arriba,CORDOBA,245,280,456,426,882
14,14161,141610604,Tercero Arriba,CORDOBA,296,343,467,464,931
14,14161,141610603,Tercero Arriba,CORDOBA,335,360,597,550,1147
14,14161,141610602,Tercero Arriba,CORDOBA,291,251,505,474,979
14,14161,141610601,Tercero Arriba,CORDOBA,210,233,386,393,779
14,14161,141610216,Tercero Arriba,CORDOBA,228,278,324,327,651
14,14161,141610215,Tercero Arriba,CORDOBA,212,282,277,280,557
14,14161,141610214,Tercero Arriba,CORDOBA,228,269,334,353,687
14,14161,141610212,Tercero Arriba,CORDOBA,197,226,284,299,583
14,14161,141610211,Tercero Arriba,CORDOBA,238,275,341,290,631
14,14161,141610210,Tercero Arriba,CORDOBA,212,243,322,266,588
14,14161,141610209,Tercero Arriba,CORDOBA,277,331,392,353,745
14,14161,141610208,Tercero Arriba,CORDOBA,239,267,384,331,715
14,14161,141610804,Tercero Arriba,CORDOBA,185,209,266,226,492
14,14161,141610803,Tercero Arriba,CORDOBA,191,220,293,243,536
14,14161,141610116,Tercero Arriba,CORDOBA,265,290,407,348,755
14,14161,141610115,Tercero Arriba,CORDOBA,159,183,275,284,559
14,14161,141610114,Tercero Arriba,CORDOBA,167,188,250,245,495
14,14161,141610113,Tercero Arriba,CORDOBA,296,354,449,412,861
14,14161,141610112,Tercero Arriba,CORDOBA,244,294,429,437,866
14,14161,141610802,Tercero Arriba,CORDOBA,123,139,206,200,406
14,14161,141610801,Tercero Arriba,CORDOBA,220,250,392,324,716
14,14161,141610207,Tercero Arriba,CORDOBA,212,243,338,342,680
14,14161,141610613,Tercero Arriba,CORDOBA,274,296,430,457,887
14,14161,141610612,Tercero Arriba,CORDOBA,257,302,380,305,685
14,14161,141610611,Tercero Arriba,CORDOBA,224,263,370,319,689
14,14161,141611018,Tercero Arriba,CORDOBA,289,326,498,462,960
14,14161,141611017,Tercero Arriba,CORDOBA,355,398,517,448,965
14,14161,141611016,Tercero Arriba,CORDOBA,245,294,389,322,711
14,14161,141611117,Tercero Arriba,CORDOBA,223,240,386,371,757
14,14161,141611116,Tercero Arriba,CORDOBA,318,336,552,575,1127
14,14161,141611115,Tercero Arriba,CORDOBA,220,246,371,378,749
14,14161,141611114,Tercero Arriba,CORDOBA,244,279,388,373,761
14,14161,141611113,Tercero Arriba,CORDOBA,261,318,372,323,695
14,14161,141611112,Tercero Arriba,CORDOBA,318,361,469,442,911
14,14161,141611111,Tercero Arriba,CORDOBA,370,411,609,620,1229
14,14161,141611110,Tercero Arriba,CORDOBA,228,256,411,433,844
14,14161,141611109,Tercero Arriba,CORDOBA,173,206,277,232,509
14,14161,141611108,Tercero Arriba,CORDOBA,202,236,275,233,508
14,14161,141611107,Tercero Arriba,CORDOBA,219,265,322,277,599
14,14161,141611106,Tercero Arriba,CORDOBA,251,315,372,354,726
14,14161,141611105,Tercero Arriba,CORDOBA,225,251,356,328,684
14,14161,141611104,Tercero Arriba,CORDOBA,308,332,477,448,925
14,14161,141611103,Tercero Arriba,CORDOBA,175,182,281,302,583
14,14161,141611102,Tercero Arriba,CORDOBA,214,237,405,380,785
14,14161,141611101,Tercero Arriba,CORDOBA,368,455,632,636,1268
14,14161,141611021,Tercero Arriba,CORDOBA,245,263,405,418,823
14,14161,141611020,Tercero Arriba,CORDOBA,253,265,376,374,750
14,14161,141611019,Tercero Arriba,CORDOBA,291,351,546,529,1075
14,14161,141611008,Tercero Arriba,CORDOBA,244,273,383,351,734
14,14161,141611007,Tercero Arriba,CORDOBA,358,400,499,464,963
14,14161,141611004,Tercero Arriba,CORDOBA,238,312,323,253,576
14,14161,141611003,Tercero Arriba,CORDOBA,285,322,363,267,630
14,14161,141611002,Tercero Arriba,CORDOBA,290,341,411,346,757
14,14161,141611001,Tercero Arriba,CORDOBA,241,291,322,244,566
14,14161,141610923,Tercero Arriba,CORDOBA,225,253,341,320,661
14,14161,141610922,Tercero Arriba,CORDOBA,283,300,541,507,1048
14,14161,141610921,Tercero Arriba,CORDOBA,362,394,540,497,1037
14,14161,141610920,Tercero Arriba,CORDOBA,218,242,315,263,578
14,14161,141610919,Tercero Arriba,CORDOBA,240,270,338,322,660
14,14161,141610918,Tercero Arriba,CORDOBA,336,381,450,375,825
14,14161,141610917,Tercero Arriba,CORDOBA,225,255,321,295,616
14,14161,141610916,Tercero Arriba,CORDOBA,198,247,282,242,524
14,14161,141610915,Tercero Arriba,CORDOBA,313,368,446,376,822
14,14161,141610914,Tercero Arriba,CORDOBA,218,251,304,257,561
14,14161,141610912,Tercero Arriba,CORDOBA,245,266,382,386,768
14,14161,141610911,Tercero Arriba,CORDOBA,266,292,436,333,769
14,14161,141610910,Tercero Arriba,CORDOBA,214,264,335,270,605
14,14161,141610909,Tercero Arriba,CORDOBA,239,265,346,311,657
14,14161,141610908,Tercero Arriba,CORDOBA,212,240,368,323,691
14,14161,141610907,Tercero Arriba,CORDOBA,245,256,418,387,805
14,14161,141611012,Tercero Arriba,CORDOBA,325,355,450,403,853
14,14161,141611011,Tercero Arriba,CORDOBA,194,231,276,240,516
14,14161,141611010,Tercero Arriba,CORDOBA,177,207,251,195,446
14,14161,141610906,Tercero Arriba,CORDOBA,287,308,566,547,1113
14,14161,141610905,Tercero Arriba,CORDOBA,265,298,384,418,802
14,14161,141610904,Tercero Arriba,CORDOBA,241,276,399,413,812
14,14161,141610903,Tercero Arriba,CORDOBA,262,292,448,440,888
14,14161,141610902,Tercero Arriba,CORDOBA,301,354,564,555,1119
14,14161,141610901,Tercero Arriba,CORDOBA,218,230,395,413,808
14,14161,141610817,Tercero Arriba,CORDOBA,324,385,478,473,951
14,14161,141610816,Tercero Arriba,CORDOBA,195,221,294,279,573
14,14161,141610609,Tercero Arriba,CORDOBA,227,249,339,305,644
14,14161,141610608,Tercero Arriba,CORDOBA,204,240,310,276,586
14,14161,141610607,Tercero Arriba,CORDOBA,282,313,498,441,939
14,14161,141610606,Tercero Arriba,CORDOBA,338,367,513,482,995
14,14161,141610610,Tercero Arriba,CORDOBA,266,297,387,385,772
14,14161,141611015,Tercero Arriba,CORDOBA,200,219,276,247,523
14,14161,141611006,Tercero Arriba,CORDOBA,287,344,401,328,729
14,14161,141611005,Tercero Arriba,CORDOBA,236,313,306,250,556
14,14161,141610913,Tercero Arriba,CORDOBA,276,306,429,340,769
14,14161,141610812,Tercero Arriba,CORDOBA,192,250,264,222,486
14,14161,141610809,Tercero Arriba,CORDOBA,174,214,257,244,501
14,14161,141610413,Tercero Arriba,CORDOBA,230,255,373,349,722
14,14161,141610412,Tercero Arriba,CORDOBA,245,299,371,404,775
14,14161,141610411,Tercero Arriba,CORDOBA,90,122,164,149,313
14,14161,141610313,Tercero Arriba,CORDOBA,170,181,267,241,508
14,14161,141610312,Tercero Arriba,CORDOBA,152,175,235,218,453
14,14161,141610311,Tercero Arriba,CORDOBA,199,229,289,269,558
14,14161,141610213,Tercero Arriba,CORDOBA,214,258,346,323,669
14,14161,141610117,Tercero Arriba,CORDOBA,330,390,477,469,946
14,14161,141611014,Tercero Arriba,CORDOBA,211,261,326,242,568
14,14161,141611013,Tercero Arriba,CORDOBA,207,268,315,255,570
14,14161,141610408,Tercero Arriba,CORDOBA,18,34,21,31,52
14,14161,141610301,Tercero Arriba,CORDOBA,92,131,121,158,279
14,14161,141610201,Tercero Arriba,CORDOBA,50,123,63,71,134
14,14161,141610108,Tercero Arriba,CORDOBA,31,57,47,61,108
14,14161,141610103,Tercero Arriba,CORDOBA,48,88,68,86,154
14,14161,141610102,Tercero Arriba,CORDOBA,35,88,67,58,125
14,14161,141610505,Tercero Arriba,CORDOBA,47,87,58,79,137
14,14161,141610504,Tercero Arriba,CORDOBA,24,45,40,41,81
14,14161,141610502,Tercero Arriba,CORDOBA,25,41,36,41,77
14,14161,141610501,Tercero Arriba,CORDOBA,24,45,37,38,75
14,14161,141610410,Tercero Arriba,CORDOBA,55,82,88,116,204
14,14161,141610409,Tercero Arriba,CORDOBA,52,71,76,90,166
14,14161,141610406,Tercero Arriba,CORDOBA,51,76,78,91,169
14,14161,141610405,Tercero Arriba,CORDOBA,71,96,110,139,249
14,14161,141610403,Tercero Arriba,CORDOBA,24,46,30,47,77
14,14161,141610402,Tercero Arriba,CORDOBA,34,52,65,68,133
14,14161,141610305,Tercero Arriba,CORDOBA,122,184,215,235,450
14,14161,141610304,Tercero Arriba,CORDOBA,63,83,143,179,322
14,14161,141610303,Tercero Arriba,CORDOBA,43,88,65,81,146
14,14161,141610302,Tercero Arriba,CORDOBA,41,74,330,569,899
14,14161,141610404,Tercero Arriba,CORDOBA,34,56,53,67,120
14,14161,141610206,Tercero Arriba,CORDOBA,35,84,47,56,103
14,14161,141610205,Tercero Arriba,CORDOBA,19,35,22,30,52
14,14161,141610204,Tercero Arriba,CORDOBA,21,58,34,38,72
14,14161,141610203,Tercero Arriba,CORDOBA,21,35,24,33,57
14,14161,141610202,Tercero Arriba,CORDOBA,44,81,54,70,124
14,14161,141610111,Tercero Arriba,CORDOBA,37,110,39,62,101
14,14161,141610110,Tercero Arriba,CORDOBA,61,106,84,106,190
14,14161,141610109,Tercero Arriba,CORDOBA,37,65,64,67,131
14,14161,141610107,Tercero Arriba,CORDOBA,31,77,43,59,102
14,14161,141610106,Tercero Arriba,CORDOBA,25,46,37,43,80
14,14161,141610104,Tercero Arriba,CORDOBA,70,127,102,136,238
14,14161,141610101,Tercero Arriba,CORDOBA,28,50,41,41,82
14,14161,141610105,Tercero Arriba,CORDOBA,64,91,102,134,236
14,14154,141540107,Sobremonte,CORDOBA,34,47,50,60,110
14,14154,141540102,Sobremonte,CORDOBA,45,52,64,81,145
14,14154,141540212,Sobremonte,CORDOBA,90,126,145,137,282
14,14154,141540209,Sobremonte,CORDOBA,173,187,302,267,569
14,14154,141540211,Sobremonte,CORDOBA,278,317,477,466,943
14,14154,141540210,Sobremonte,CORDOBA,182,209,381,363,744
14,14154,141540104,Sobremonte,CORDOBA,89,108,175,178,353
14,14154,141540103,Sobremonte,CORDOBA,102,143,156,181,337
14,14154,141540205,Sobremonte,CORDOBA,28,45,28,50,78
14,14154,141540204,Sobremonte,CORDOBA,55,85,107,176,283
14,14154,141540207,Sobremonte,CORDOBA,36,56,43,56,99
14,14154,141540206,Sobremonte,CORDOBA,24,37,38,38,76
14,14154,141540208,Sobremonte,CORDOBA,36,51,55,61,116
14,14154,141540203,Sobremonte,CORDOBA,28,36,46,44,90
14,14154,141540202,Sobremonte,CORDOBA,5,6,7,14,21
14,14154,141540201,Sobremonte,CORDOBA,47,52,81,95,176
14,14154,141540106,Sobremonte,CORDOBA,7,12,6,13,19
14,14154,141540105,Sobremonte,CORDOBA,21,28,16,43,59
14,14154,141540101,Sobremonte,CORDOBA,31,41,36,55,91
14,14014,140141310,Capital,CORDOBA,166,175,337,303,640
14,14014,140141306,Capital,CORDOBA,186,202,395,402,797
14,14014,140141201,Capital,CORDOBA,258,248,498,506,1004
14,14014,140141018,Capital,CORDOBA,198,258,332,326,658
14,14014,140141001,Capital,CORDOBA,157,201,265,292,557
14,14014,140140812,Capital,CORDOBA,256,277,464,568,1032
14,14014,140140705,Capital,CORDOBA,310,363,614,603,1217
14,14014,140140607,Capital,CORDOBA,439,490,874,824,1698
14,14014,140140606,Capital,CORDOBA,277,316,457,450,907
14,14014,140140504,Capital,CORDOBA,384,325,819,835,1654
14,14014,140140503,Capital,CORDOBA,241,209,550,522,1072
14,14014,140140502,Capital,CORDOBA,342,306,777,722,1499
14,14014,140140404,Capital,CORDOBA,272,280,513,516,1029
14,14014,140140309,Capital,CORDOBA,359,361,782,719,1501
14,14014,140140301,Capital,CORDOBA,127,143,253,227,480
14,14014,140140101,Capital,CORDOBA,160,168,276,306,582
14,14014,140140201,Capital,CORDOBA,241,250,475,499,974
14,14014,140141617,Capital,CORDOBA,321,325,578,624,1202
14,14014,140141611,Capital,CORDOBA,330,273,710,713,1423
14,14014,140141603,Capital,CORDOBA,455,452,998,996,1994
14,14014,140141601,Capital,CORDOBA,349,357,719,714,1433
14,14014,140141610,Capital,CORDOBA,254,282,524,493,1017
14,14014,140141520,Capital,CORDOBA,424,418,751,793,1544
14,14014,140141403,Capital,CORDOBA,343,354,715,670,1385
14,14014,140149202,Capital,CORDOBA,174,208,255,225,480
14,14014,140148004,Capital,CORDOBA,190,284,173,143,316
14,14014,140146914,Capital,CORDOBA,354,578,314,263,577
14,14014,140146805,Capital,CORDOBA,120,231,120,102,222
14,14014,140146602,Capital,CORDOBA,414,531,428,356,784
14,14014,140140205,Capital,CORDOBA,227,228,402,321,723
14,14014,140140111,Capital,CORDOBA,190,193,377,302,679
14,14014,140140110,Capital,CORDOBA,273,334,454,421,875
14,14014,140140204,Capital,CORDOBA,282,299,503,459,962
14,14014,140143608,Capital,CORDOBA,268,302,452,375,827
14,14014,140143207,Capital,CORDOBA,377,378,652,581,1233
14,14014,140143206,Capital,CORDOBA,329,346,594,518,1112
14,14014,140141304,Capital,CORDOBA,358,350,684,642,1326
14,14014,140143205,Capital,CORDOBA,360,332,631,562,1193
14,14014,140142916,Capital,CORDOBA,305,322,558,454,1012
14,14014,140143607,Capital,CORDOBA,262,304,397,358,755
14,14014,140142702,Capital,CORDOBA,323,349,569,538,1107
14,14014,140140109,Capital,CORDOBA,399,401,744,725,1469
14,14014,140140108,Capital,CORDOBA,233,218,393,379,772
14,14014,140146002,Capital,CORDOBA,246,299,373,318,691
14,14014,140142701,Capital,CORDOBA,251,247,489,406,895
14,14014,140145716,Capital,CORDOBA,107,160,98,74,172
14,14014,140145715,Capital,CORDOBA,311,479,305,232,537
14,14014,140145519,Capital,CORDOBA,285,451,281,248,529
14,14014,140145518,Capital,CORDOBA,136,200,157,160,317
14,14014,140141407,Capital,CORDOBA,390,412,709,637,1346
14,14014,140142616,Capital,CORDOBA,267,314,439,347,786
14,14014,140143204,Capital,CORDOBA,245,243,408,396,804
14,14014,140144705,Capital,CORDOBA,192,260,256,221,477
14,14014,140141109,Capital,CORDOBA,406,403,839,807,1646
14,14014,140146009,Capital,CORDOBA,271,368,331,305,636
14,14014,140141303,Capital,CORDOBA,280,288,526,510,1036
14,14014,140141302,Capital,CORDOBA,371,372,668,686,1354
14,14014,140141301,Capital,CORDOBA,138,134,230,215,445
14,14014,140140106,Capital,CORDOBA,344,343,614,565,1179
14,14014,140146007,Capital,CORDOBA,231,256,312,274,586
14,14014,140140203,Capital,CORDOBA,346,415,571,527,1098
14,14014,140140202,Capital,CORDOBA,452,623,684,670,1354
14,14014,140146006,Capital,CORDOBA,260,320,368,337,705
14,14014,140146005,Capital,CORDOBA,366,456,491,427,918
14,14014,140143213,Capital,CORDOBA,291,313,519,487,1006
14,14014,140141010,Capital,CORDOBA,357,365,526,559,1085
14,14014,140143212,Capital,CORDOBA,240,229,469,430,899
14,14014,140141009,Capital,CORDOBA,331,363,548,500,1048
14,14014,140143211,Capital,CORDOBA,305,287,529,510,1039
14,14014,140143312,Capital,CORDOBA,257,275,463,442,905
14,14014,140149116,Capital,CORDOBA,246,250,394,360,754
14,14014,140149216,Capital,CORDOBA,292,325,457,396,853
14,14014,140149115,Capital,CORDOBA,306,343,456,466,922
14,14014,140149114,Capital,CORDOBA,420,431,673,602,1275
14,14014,140149113,Capital,CORDOBA,299,339,517,427,944
14,14014,140149112,Capital,CORDOBA,328,349,477,429,906
14,14014,140149111,Capital,CORDOBA,308,342,414,402,816
14,14014,140149110,Capital,CORDOBA,323,407,410,376,786
14,14014,140149109,Capital,CORDOBA,196,242,250,210,460
14,14014,140149108,Capital,CORDOBA,295,321,377,345,722
14,14014,140149107,Capital,CORDOBA,330,409,400,407,807
14,14014,140149106,Capital,CORDOBA,346,354,507,424,931
14,14014,140149105,Capital,CORDOBA,278,250,482,440,922
14,14014,140149104,Capital,CORDOBA,363,412,596,538,1134
14,14014,140149103,Capital,CORDOBA,255,273,417,366,783
14,14014,140149102,Capital,CORDOBA,310,374,491,458,949
14,14014,140149101,Capital,CORDOBA,384,401,635,581,1216
14,14014,140149015,Capital,CORDOBA,271,311,471,391,862
14,14014,140149215,Capital,CORDOBA,246,301,343,323,666
14,14014,140149014,Capital,CORDOBA,244,276,405,366,771
14,14014,140149013,Capital,CORDOBA,354,336,724,695,1419
14,14014,140149012,Capital,CORDOBA,295,285,547,500,1047
14,14014,140149011,Capital,CORDOBA,218,246,446,402,848
14,14014,140149010,Capital,CORDOBA,175,220,370,318,688
14,14014,140149009,Capital,CORDOBA,261,321,391,332,723
14,14014,140149008,Capital,CORDOBA,210,250,316,270,586
14,14014,140149007,Capital,CORDOBA,348,346,624,601,1225
14,14014,140149006,Capital,CORDOBA,306,295,600,581,1181
14,14014,140149005,Capital,CORDOBA,233,248,417,379,796
14,14014,140149004,Capital,CORDOBA,197,216,298,283,581
14,14014,140149003,Capital,CORDOBA,192,204,342,330,672
14,14014,140149001,Capital,CORDOBA,281,279,343,329,672
14,14014,140148916,Capital,CORDOBA,456,404,866,791,1657
14,14014,140149002,Capital,CORDOBA,256,276,451,492,943
14,14014,140148915,Capital,CORDOBA,377,409,617,556,1173
14,14014,140148914,Capital,CORDOBA,228,252,411,406,817
14,14014,140148913,Capital,CORDOBA,263,280,471,435,906
14,14014,140148911,Capital,CORDOBA,198,210,435,373,808
14,14014,140148910,Capital,CORDOBA,232,250,443,403,846
14,14014,140148909,Capital,CORDOBA,276,293,478,387,865
14,14014,140148908,Capital,CORDOBA,222,233,347,351,698
14,14014,140148907,Capital,CORDOBA,260,278,464,432,896
14,14014,140148906,Capital,CORDOBA,322,338,522,451,973
14,14014,140148905,Capital,CORDOBA,228,261,348,327,675
14,14014,140148904,Capital,CORDOBA,367,410,591,526,1117
14,14014,140148903,Capital,CORDOBA,396,421,597,501,1098
14,14014,140148902,Capital,CORDOBA,198,230,314,269,583
14,14014,140148901,Capital,CORDOBA,253,288,393,344,737
14,14014,140148815,Capital,CORDOBA,331,383,588,552,1140
14,14014,140148814,Capital,CORDOBA,359,360,768,725,1493
14,14014,140148813,Capital,CORDOBA,301,335,572,537,1109
14,14014,140148812,Capital,CORDOBA,288,287,537,495,1032
14,14014,140148811,Capital,CORDOBA,381,393,660,599,1259
14,14014,140148810,Capital,CORDOBA,281,318,479,411,890
14,14014,140148809,Capital,CORDOBA,267,274,427,416,843
14,14014,140148808,Capital,CORDOBA,260,283,414,371,785
14,14014,140148807,Capital,CORDOBA,302,320,510,445,955
14,14014,140148806,Capital,CORDOBA,288,298,491,425,916
14,14014,140148805,Capital,CORDOBA,130,132,206,193,399
14,14014,140148804,Capital,CORDOBA,264,275,415,379,794
14,14014,140148803,Capital,CORDOBA,286,308,486,444,930
14,14014,140148713,Capital,CORDOBA,177,177,315,293,608
14,14014,140148712,Capital,CORDOBA,293,301,520,581,1101
14,14014,140148711,Capital,CORDOBA,292,282,598,616,1214
14,14014,140148710,Capital,CORDOBA,262,226,489,464,953
14,14014,140148709,Capital,CORDOBA,206,213,387,385,772
14,14014,140148708,Capital,CORDOBA,401,394,802,745,1547
14,14014,140148707,Capital,CORDOBA,246,262,480,456,936
14,14014,140148706,Capital,CORDOBA,220,220,382,360,742
14,14014,140148705,Capital,CORDOBA,408,430,712,733,1445
14,14014,140148704,Capital,CORDOBA,228,253,408,407,815
14,14014,140148703,Capital,CORDOBA,191,199,385,336,721
14,14014,140148702,Capital,CORDOBA,279,344,429,433,862
14,14014,140148701,Capital,CORDOBA,314,356,532,500,1032
14,14014,140148612,Capital,CORDOBA,254,237,476,464,940
14,14014,140148611,Capital,CORDOBA,236,229,457,416,873
14,14014,140148608,Capital,CORDOBA,264,270,559,521,1080
14,14014,140148607,Capital,CORDOBA,349,300,671,662,1333
14,14014,140148606,Capital,CORDOBA,313,305,678,598,1276
14,14014,140148605,Capital,CORDOBA,368,355,727,720,1447
14,14014,140148604,Capital,CORDOBA,317,511,682,675,1357
14,14014,140149314,Capital,CORDOBA,170,195,264,231,495
14,14014,140148603,Capital,CORDOBA,261,242,509,523,1032
14,14014,140148602,Capital,CORDOBA,168,155,332,328,660
14,14014,140148601,Capital,CORDOBA,216,218,476,507,983
14,14014,140148516,Capital,CORDOBA,291,326,468,391,859
14,14014,140148515,Capital,CORDOBA,216,256,340,306,646
14,14014,140148514,Capital,CORDOBA,353,370,627,590,1217
14,14014,140148513,Capital,CORDOBA,348,336,644,612,1256
14,14014,140148512,Capital,CORDOBA,306,307,599,556,1155
14,14014,140148511,Capital,CORDOBA,354,366,706,664,1370
14,14014,140148510,Capital,CORDOBA,340,366,673,609,1282
14,14014,140148509,Capital,CORDOBA,402,404,815,741,1556
14,14014,140148508,Capital,CORDOBA,413,420,758,682,1440
14,14014,140148507,Capital,CORDOBA,240,249,396,316,712
14,14014,140148506,Capital,CORDOBA,330,357,504,499,1003
14,14014,140148504,Capital,CORDOBA,269,281,445,402,847
14,14014,140148503,Capital,CORDOBA,219,240,384,309,693
14,14014,140148502,Capital,CORDOBA,230,252,374,307,681
14,14014,140148501,Capital,CORDOBA,270,286,472,439,911
14,14014,140148412,Capital,CORDOBA,259,284,413,306,719
14,14014,140148411,Capital,CORDOBA,243,268,383,360,743
14,14014,140148410,Capital,CORDOBA,233,272,367,329,696
14,14014,140148409,Capital,CORDOBA,249,266,424,378,802
14,14014,140148408,Capital,CORDOBA,234,273,396,309,705
14,14014,140148407,Capital,CORDOBA,175,185,282,255,537
14,14014,140148406,Capital,CORDOBA,187,214,310,276,586
14,14014,140148405,Capital,CORDOBA,293,336,493,463,956
14,14014,140148404,Capital,CORDOBA,195,200,343,288,631
14,14014,140148403,Capital,CORDOBA,276,311,433,393,826
14,14014,140148401,Capital,CORDOBA,298,295,498,425,923
14,14014,140148316,Capital,CORDOBA,164,194,266,220,486
14,14014,140148505,Capital,CORDOBA,311,336,513,451,964
14,14014,140148314,Capital,CORDOBA,260,291,489,440,929
14,14014,140148313,Capital,CORDOBA,242,251,426,387,813
14,14014,140148312,Capital,CORDOBA,278,315,531,483,1014
14,14014,140148311,Capital,CORDOBA,236,254,432,405,837
14,14014,140148310,Capital,CORDOBA,218,223,224,259,483
14,14014,140148309,Capital,CORDOBA,339,393,416,524,940
14,14014,140148308,Capital,CORDOBA,181,179,339,316,655
14,14014,140148307,Capital,CORDOBA,316,337,521,469,990
14,14014,140148306,Capital,CORDOBA,183,191,346,270,616
14,14014,140148305,Capital,CORDOBA,225,270,337,324,661
14,14014,140148304,Capital,CORDOBA,230,269,372,358,730
14,14014,140148303,Capital,CORDOBA,278,323,466,423,889
14,14014,140148302,Capital,CORDOBA,300,353,513,436,949
14,14014,140148301,Capital,CORDOBA,278,302,458,392,850
14,14014,140148315,Capital,CORDOBA,194,209,359,288,647
14,14014,140148211,Capital,CORDOBA,219,331,194,195,389
14,14014,140148210,Capital,CORDOBA,196,363,182,206,388
14,14014,140148209,Capital,CORDOBA,313,502,303,296,599
14,14014,140148208,Capital,CORDOBA,619,899,586,549,1135
14,14014,140148207,Capital,CORDOBA,354,451,311,271,582
14,14014,140148206,Capital,CORDOBA,152,257,141,129,270
14,14014,140148205,Capital,CORDOBA,213,320,198,154,352
14,14014,140148204,Capital,CORDOBA,540,903,559,417,976
14,14014,140148203,Capital,CORDOBA,322,538,325,244,569
14,14014,140148202,Capital,CORDOBA,414,593,378,312,690
14,14014,140148110,Capital,CORDOBA,196,291,262,204,466
14,14014,140148109,Capital,CORDOBA,249,405,268,189,457
14,14014,140148108,Capital,CORDOBA,267,442,297,183,480
14,14014,140148107,Capital,CORDOBA,234,351,263,184,447
14,14014,140148106,Capital,CORDOBA,680,1172,707,539,1246
14,14014,140148105,Capital,CORDOBA,528,825,507,400,907
14,14014,140148104,Capital,CORDOBA,550,999,556,388,944
14,14014,140148103,Capital,CORDOBA,598,962,556,418,974
14,14014,140148102,Capital,CORDOBA,341,659,330,218,548
14,14014,140148101,Capital,CORDOBA,264,410,281,202,483
14,14014,140148014,Capital,CORDOBA,141,147,264,286,550
14,14014,140148012,Capital,CORDOBA,181,211,391,340,731
14,14014,140148011,Capital,CORDOBA,209,245,376,327,703
14,14014,140148010,Capital,CORDOBA,239,352,211,199,410
14,14014,140148009,Capital,CORDOBA,211,278,193,190,383
14,14014,140148008,Capital,CORDOBA,154,276,168,135,303
14,14014,140148007,Capital,CORDOBA,156,232,147,139,286
14,14014,140148006,Capital,CORDOBA,380,609,384,295,679
14,14014,140148005,Capital,CORDOBA,268,377,248,283,531
14,14014,140148002,Capital,CORDOBA,223,340,214,176,390
14,14014,140148001,Capital,CORDOBA,247,385,244,187,431
14,14014,140148013,Capital,CORDOBA,140,177,230,163,393
14,14014,140147920,Capital,CORDOBA,267,293,392,350,742
14,14014,140147919,Capital,CORDOBA,258,278,428,398,826
14,14014,140147916,Capital,CORDOBA,278,318,467,418,885
14,14014,140147915,Capital,CORDOBA,346,370,638,571,1209
14,14014,140147914,Capital,CORDOBA,195,216,377,330,707
14,14014,140147913,Capital,CORDOBA,271,264,477,506,983
14,14014,140147912,Capital,CORDOBA,187,180,340,302,642
14,14014,140147911,Capital,CORDOBA,308,300,520,487,1007
14,14014,140147910,Capital,CORDOBA,244,259,421,375,796
14,14014,140147909,Capital,CORDOBA,379,447,576,480,1056
14,14014,140147908,Capital,CORDOBA,229,257,377,295,672
14,14014,140147907,Capital,CORDOBA,329,383,521,485,1006
14,14014,140147905,Capital,CORDOBA,229,280,353,287,640
14,14014,140147904,Capital,CORDOBA,208,248,343,266,609
14,14014,140147903,Capital,CORDOBA,223,253,396,317,713
14,14014,140147902,Capital,CORDOBA,290,374,444,384,828
14,14014,140147901,Capital,CORDOBA,298,362,491,441,932
14,14014,140147816,Capital,CORDOBA,196,207,317,277,594
14,14014,140147815,Capital,CORDOBA,184,210,272,221,493
14,14014,140147814,Capital,CORDOBA,426,721,715,573,1288
14,14014,140147813,Capital,CORDOBA,207,233,364,276,640
14,14014,140147812,Capital,CORDOBA,298,306,498,407,905
14,14014,140147811,Capital,CORDOBA,380,438,618,488,1106
14,14014,140147810,Capital,CORDOBA,302,334,465,433,898
14,14014,140147809,Capital,CORDOBA,311,302,569,531,1100
14,14014,140147906,Capital,CORDOBA,309,353,490,399,889
14,14014,140147808,Capital,CORDOBA,278,323,442,393,835
14,14014,140147807,Capital,CORDOBA,300,310,466,447,913
14,14014,140147806,Capital,CORDOBA,138,135,246,203,449
14,14014,140147805,Capital,CORDOBA,242,251,425,377,802
14,14014,140147804,Capital,CORDOBA,246,258,455,398,853
14,14014,140147803,Capital,CORDOBA,238,279,419,355,774
14,14014,140147802,Capital,CORDOBA,186,232,322,282,604
14,14014,140147801,Capital,CORDOBA,348,401,568,521,1089
14,14014,140147722,Capital,CORDOBA,286,281,565,521,1086
14,14014,140147601,Capital,CORDOBA,422,373,737,690,1427
14,14014,140147519,Capital,CORDOBA,444,420,992,977,1969
14,14014,140147518,Capital,CORDOBA,309,310,707,709,1416
14,14014,140147517,Capital,CORDOBA,334,337,589,531,1120
14,14014,140147516,Capital,CORDOBA,284,276,520,505,1025
14,14014,140147515,Capital,CORDOBA,424,422,787,740,1527
14,14014,140147514,Capital,CORDOBA,441,418,913,877,1790
14,14014,140147513,Capital,CORDOBA,448,448,860,878,1738
14,14014,140147511,Capital,CORDOBA,345,363,603,600,1203
14,14014,140147510,Capital,CORDOBA,357,373,693,586,1279
14,14014,140147509,Capital,CORDOBA,324,292,664,699,1363
14,14014,140147508,Capital,CORDOBA,253,254,512,523,1035
14,14014,140147507,Capital,CORDOBA,335,324,746,696,1442
14,14014,140147506,Capital,CORDOBA,324,303,686,620,1306
14,14014,140147505,Capital,CORDOBA,243,259,572,527,1099
14,14014,140147504,Capital,CORDOBA,238,232,507,504,1011
14,14014,140147503,Capital,CORDOBA,275,252,525,517,1042
14,14014,140147502,Capital,CORDOBA,253,202,534,498,1032
14,14014,140147501,Capital,CORDOBA,336,340,748,751,1499
14,14014,140147417,Capital,CORDOBA,261,288,404,356,760
14,14014,140147416,Capital,CORDOBA,220,241,361,337,698
14,14014,140147415,Capital,CORDOBA,312,327,522,481,1003
14,14014,140147414,Capital,CORDOBA,285,318,460,403,863
14,14014,140147413,Capital,CORDOBA,244,320,453,343,796
14,14014,140147412,Capital,CORDOBA,341,379,621,499,1120
14,14014,140147411,Capital,CORDOBA,340,362,643,620,1263
14,14014,140147410,Capital,CORDOBA,262,290,437,357,794
14,14014,140147409,Capital,CORDOBA,250,260,446,360,806
14,14014,140147405,Capital,CORDOBA,249,264,425,421,846
14,14014,140147404,Capital,CORDOBA,223,255,386,366,752
14,14014,140147403,Capital,CORDOBA,217,231,428,408,836
14,14014,140147402,Capital,CORDOBA,264,268,510,504,1014
14,14014,140147401,Capital,CORDOBA,314,282,641,584,1225
14,14014,140147310,Capital,CORDOBA,193,227,304,261,565
14,14014,140147309,Capital,CORDOBA,310,360,538,441,979
14,14014,140147308,Capital,CORDOBA,225,269,343,316,659
14,14014,140147307,Capital,CORDOBA,187,160,429,307,736
14,14014,140147306,Capital,CORDOBA,269,315,423,363,786
14,14014,140147305,Capital,CORDOBA,223,273,388,306,694
14,14014,140147304,Capital,CORDOBA,243,303,434,309,743
14,14014,140147303,Capital,CORDOBA,196,239,355,290,645
14,14014,140147302,Capital,CORDOBA,215,261,382,314,696
14,14014,140147301,Capital,CORDOBA,221,253,384,347,731
14,14014,140147313,Capital,CORDOBA,223,277,377,326,703
14,14014,140147312,Capital,CORDOBA,208,300,315,267,582
14,14014,140147207,Capital,CORDOBA,698,1069,657,451,1108
14,14014,140147206,Capital,CORDOBA,587,947,554,438,992
14,14014,140149913,Capital,CORDOBA,444,399,832,821,1653
14,14014,140149912,Capital,CORDOBA,239,227,453,469,922
14,14014,140149911,Capital,CORDOBA,191,198,419,350,769
14,14014,140149910,Capital,CORDOBA,333,331,619,608,1227
14,14014,140149909,Capital,CORDOBA,322,336,601,546,1147
14,14014,140149908,Capital,CORDOBA,421,436,795,756,1551
14,14014,140149907,Capital,CORDOBA,233,253,411,397,808
14,14014,140149906,Capital,CORDOBA,307,296,561,505,1066
14,14014,140149905,Capital,CORDOBA,230,216,395,369,764
14,14014,140149903,Capital,CORDOBA,347,362,679,604,1283
14,14014,140149902,Capital,CORDOBA,337,350,579,540,1119
14,14014,140149901,Capital,CORDOBA,329,359,613,568,1181
14,14014,140149813,Capital,CORDOBA,422,380,818,766,1584
14,14014,140149812,Capital,CORDOBA,240,209,479,477,956
14,14014,140149811,Capital,CORDOBA,239,233,442,401,843
14,14014,140149810,Capital,CORDOBA,213,212,424,378,802
14,14014,140149809,Capital,CORDOBA,334,354,575,550,1125
14,14014,140149808,Capital,CORDOBA,240,248,468,426,894
14,14014,140149807,Capital,CORDOBA,414,390,764,789,1553
14,14014,140149806,Capital,CORDOBA,256,253,460,456,916
14,14014,140149805,Capital,CORDOBA,166,175,344,312,656
14,14014,140149803,Capital,CORDOBA,233,210,475,451,926
14,14014,140149802,Capital,CORDOBA,370,344,634,627,1261
14,14014,140149801,Capital,CORDOBA,282,274,516,431,947
14,14014,140149717,Capital,CORDOBA,469,437,970,918,1888
14,14014,140149716,Capital,CORDOBA,295,233,586,571,1157
14,14014,140149713,Capital,CORDOBA,198,193,410,414,824
14,14014,140149712,Capital,CORDOBA,264,260,520,504,1024
14,14014,140149711,Capital,CORDOBA,373,342,761,744,1505
14,14014,140149710,Capital,CORDOBA,333,329,659,628,1287
14,14014,140149709,Capital,CORDOBA,408,366,828,759,1587
14,14014,140149708,Capital,CORDOBA,400,373,765,777,1542
14,14014,140149707,Capital,CORDOBA,331,306,637,682,1319
14,14014,140149706,Capital,CORDOBA,411,400,844,845,1689
14,14014,140149705,Capital,CORDOBA,234,234,432,374,806
14,14014,140149704,Capital,CORDOBA,187,197,366,334,700
14,14014,140149703,Capital,CORDOBA,234,241,468,403,871
14,14014,140149702,Capital,CORDOBA,197,198,385,377,762
14,14014,140149714,Capital,CORDOBA,472,446,871,868,1739
14,14014,140149701,Capital,CORDOBA,448,425,1019,1016,2035
14,14014,140149617,Capital,CORDOBA,448,447,862,909,1771
14,14014,140149616,Capital,CORDOBA,351,395,673,686,1359
14,14014,140149615,Capital,CORDOBA,229,250,367,370,737
14,14014,140149614,Capital,CORDOBA,238,251,405,377,782
14,14014,140149613,Capital,CORDOBA,336,345,607,594,1201
14,14014,140149612,Capital,CORDOBA,318,336,592,531,1123
14,14014,140149611,Capital,CORDOBA,260,283,456,417,873
14,14014,140149715,Capital,CORDOBA,325,340,628,581,1209
14,14014,140149607,Capital,CORDOBA,217,242,369,333,702
14,14014,140149606,Capital,CORDOBA,214,208,381,361,742
14,14014,140149605,Capital,CORDOBA,249,264,450,444,894
14,14014,140149604,Capital,CORDOBA,331,360,641,532,1173
14,14014,140149603,Capital,CORDOBA,336,360,607,564,1171
14,14014,140149602,Capital,CORDOBA,227,242,377,372,749
14,14014,140149601,Capital,CORDOBA,238,267,379,390,769
14,14014,140149514,Capital,CORDOBA,386,376,726,719,1445
14,14014,140149513,Capital,CORDOBA,373,358,772,731,1503
14,14014,140149512,Capital,CORDOBA,369,362,854,825,1679
14,14014,140149511,Capital,CORDOBA,252,250,474,503,977
14,14014,140149610,Capital,CORDOBA,325,351,572,561,1133
14,14014,140149609,Capital,CORDOBA,267,293,496,460,956
14,14014,140149608,Capital,CORDOBA,297,340,491,475,966
14,14014,140149510,Capital,CORDOBA,344,403,593,474,1067
14,14014,140149509,Capital,CORDOBA,274,287,487,434,921
14,14014,140149508,Capital,CORDOBA,360,344,715,736,1451
14,14014,140149507,Capital,CORDOBA,278,257,603,608,1211
14,14014,140149506,Capital,CORDOBA,300,296,658,568,1226
14,14014,140149505,Capital,CORDOBA,315,312,705,662,1367
14,14014,140149504,Capital,CORDOBA,309,276,676,655,1331
14,14014,140149503,Capital,CORDOBA,205,213,344,335,679
14,14014,140149501,Capital,CORDOBA,233,259,393,347,740
14,14014,140149414,Capital,CORDOBA,207,205,438,416,854
14,14014,140149413,Capital,CORDOBA,262,258,551,514,1065
14,14014,140149412,Capital,CORDOBA,300,278,643,555,1198
14,14014,140149411,Capital,CORDOBA,275,277,570,542,1112
14,14014,140149410,Capital,CORDOBA,258,253,506,492,998
14,14014,140149409,Capital,CORDOBA,312,288,610,615,1225
14,14014,140149408,Capital,CORDOBA,430,408,961,922,1883
14,14014,140149407,Capital,CORDOBA,416,401,829,818,1647
14,14014,140149502,Capital,CORDOBA,244,256,360,345,705
14,14014,140149406,Capital,CORDOBA,279,280,530,482,1012
14,14014,140149405,Capital,CORDOBA,346,360,698,629,1327
14,14014,140149404,Capital,CORDOBA,435,438,977,919,1896
14,14014,140149403,Capital,CORDOBA,224,227,413,371,784
14,14014,140149402,Capital,CORDOBA,288,276,498,501,999
14,14014,140149401,Capital,CORDOBA,315,318,594,501,1095
14,14014,140149320,Capital,CORDOBA,163,163,326,297,623
14,14014,140149319,Capital,CORDOBA,324,311,614,554,1168
14,14014,140149318,Capital,CORDOBA,306,349,463,411,874
14,14014,140149317,Capital,CORDOBA,435,429,842,756,1598
14,14014,140149316,Capital,CORDOBA,246,256,416,358,774
14,14014,140149315,Capital,CORDOBA,255,263,444,429,873
14,14014,140149313,Capital,CORDOBA,229,232,389,347,736
14,14014,140149312,Capital,CORDOBA,413,428,744,633,1377
14,14014,140149311,Capital,CORDOBA,403,400,737,694,1431
14,14014,140149310,Capital,CORDOBA,349,374,598,515,1113
14,14014,140149309,Capital,CORDOBA,262,294,444,396,840
14,14014,140149307,Capital,CORDOBA,281,284,555,549,1104
14,14014,140149306,Capital,CORDOBA,361,361,652,581,1233
14,14014,140149305,Capital,CORDOBA,272,307,476,422,898
14,14014,140149304,Capital,CORDOBA,425,409,729,666,1395
14,14014,140149303,Capital,CORDOBA,351,378,621,527,1148
14,14014,140149302,Capital,CORDOBA,250,274,408,361,769
14,14014,140149301,Capital,CORDOBA,239,258,406,342,748
14,14014,140149218,Capital,CORDOBA,219,306,243,193,436
14,14014,140149217,Capital,CORDOBA,300,324,495,410,905
14,14014,140149214,Capital,CORDOBA,314,347,480,421,901
14,14014,140149213,Capital,CORDOBA,172,204,260,216,476
14,14014,140149212,Capital,CORDOBA,331,391,441,426,867
14,14014,140149210,Capital,CORDOBA,258,314,338,305,643
14,14014,140149209,Capital,CORDOBA,297,348,440,364,804
14,14014,140149208,Capital,CORDOBA,202,217,336,316,652
14,14014,140149207,Capital,CORDOBA,189,207,343,284,627
14,14014,140149206,Capital,CORDOBA,249,238,421,364,785
14,14014,140149205,Capital,CORDOBA,269,268,443,398,841
14,14014,140149204,Capital,CORDOBA,254,246,462,458,920
14,14014,140149203,Capital,CORDOBA,178,218,277,225,502
14,14014,140149201,Capital,CORDOBA,315,375,428,360,788
14,14014,140149120,Capital,CORDOBA,234,305,293,294,587
14,14014,140149119,Capital,CORDOBA,312,325,494,439,933
14,14014,140149118,Capital,CORDOBA,309,325,514,469,983
14,14014,140149117,Capital,CORDOBA,265,300,453,419,872
14,14014,140147205,Capital,CORDOBA,259,388,258,198,456
14,14014,140147204,Capital,CORDOBA,581,925,529,531,1060
14,14014,140147109,Capital,CORDOBA,446,693,456,305,761
14,14014,140147108,Capital,CORDOBA,256,420,256,197,453
14,14014,140147107,Capital,CORDOBA,428,669,414,332,746
14,14014,140147106,Capital,CORDOBA,367,604,367,255,622
14,14014,140147105,Capital,CORDOBA,291,489,253,215,468
14,14014,140147104,Capital,CORDOBA,376,650,375,273,648
14,14014,140147103,Capital,CORDOBA,286,453,326,212,538
14,14014,140147102,Capital,CORDOBA,382,628,384,280,664
14,14014,140147101,Capital,CORDOBA,177,298,217,187,404
14,14014,140147011,Capital,CORDOBA,217,321,235,155,390
14,14014,140147010,Capital,CORDOBA,345,529,313,230,543
14,14014,140147009,Capital,CORDOBA,241,370,234,179,413
14,14014,140147008,Capital,CORDOBA,277,407,314,186,500
14,14014,140147007,Capital,CORDOBA,254,404,266,188,454
14,14014,140147006,Capital,CORDOBA,349,551,357,257,614
14,14014,140147005,Capital,CORDOBA,340,590,319,264,583
14,14014,140147004,Capital,CORDOBA,195,344,331,227,558
14,14014,140147003,Capital,CORDOBA,351,512,334,312,646
14,14014,140147002,Capital,CORDOBA,280,397,270,243,513
14,14014,140147001,Capital,CORDOBA,297,548,312,209,521
14,14014,140146913,Capital,CORDOBA,85,139,66,76,142
14,14014,140146912,Capital,CORDOBA,185,273,189,158,347
14,14014,140146911,Capital,CORDOBA,474,664,492,478,970
14,14014,140146910,Capital,CORDOBA,188,223,281,279,560
14,14014,140146908,Capital,CORDOBA,260,246,388,362,750
14,14014,140146907,Capital,CORDOBA,208,265,294,277,571
14,14014,140146906,Capital,CORDOBA,230,270,314,319,633
14,14014,140146905,Capital,CORDOBA,271,353,290,280,570
14,14014,140146904,Capital,CORDOBA,218,361,237,175,412
14,14014,140146903,Capital,CORDOBA,215,262,261,158,419
14,14014,140146902,Capital,CORDOBA,130,194,126,86,212
14,14014,140146901,Capital,CORDOBA,230,369,231,163,394
14,14014,140146814,Capital,CORDOBA,311,432,373,326,699
14,14014,140146813,Capital,CORDOBA,114,140,145,150,295
14,14014,140146812,Capital,CORDOBA,181,229,229,209,438
14,14014,140146811,Capital,CORDOBA,118,155,139,119,258
14,14014,140146810,Capital,CORDOBA,211,381,209,175,384
14,14014,140146809,Capital,CORDOBA,276,449,270,220,490
14,14014,140146808,Capital,CORDOBA,89,128,90,65,155
14,14014,140146807,Capital,CORDOBA,161,265,177,135,312
14,14014,140146806,Capital,CORDOBA,255,365,299,233,532
14,14014,140146804,Capital,CORDOBA,438,723,440,352,792
14,14014,140146803,Capital,CORDOBA,318,557,294,211,505
14,14014,140146802,Capital,CORDOBA,139,445,157,122,279
14,14014,140146801,Capital,CORDOBA,193,370,183,129,312
14,14014,140146711,Capital,CORDOBA,472,789,486,354,840
14,14014,140146710,Capital,CORDOBA,233,461,217,185,402
14,14014,140146709,Capital,CORDOBA,273,440,274,195,469
14,14014,140146708,Capital,CORDOBA,257,462,256,203,459
14,14014,140146707,Capital,CORDOBA,202,300,175,143,318
14,14014,140146705,Capital,CORDOBA,213,405,233,164,397
14,14014,140146704,Capital,CORDOBA,170,277,224,116,340
14,14014,140146703,Capital,CORDOBA,359,613,401,298,699
14,14014,140146702,Capital,CORDOBA,100,216,109,81,190
14,14014,140146701,Capital,CORDOBA,214,471,278,198,476
14,14014,140146614,Capital,CORDOBA,369,575,392,310,702
14,14014,140146613,Capital,CORDOBA,177,295,164,149,313
14,14014,140146612,Capital,CORDOBA,217,385,240,193,433
14,14014,140146611,Capital,CORDOBA,134,331,137,92,229
14,14014,140146610,Capital,CORDOBA,163,280,143,111,254
14,14014,140146609,Capital,CORDOBA,222,396,230,187,417
14,14014,140146608,Capital,CORDOBA,77,181,80,63,143
14,14014,140146607,Capital,CORDOBA,245,381,255,193,448
14,14014,140146606,Capital,CORDOBA,229,409,227,173,400
14,14014,140146605,Capital,CORDOBA,193,387,191,152,343
14,14014,140146604,Capital,CORDOBA,233,440,243,181,424
14,14014,140146603,Capital,CORDOBA,146,233,149,107,256
14,14014,140146516,Capital,CORDOBA,310,363,469,467,936
14,14014,140146515,Capital,CORDOBA,155,182,282,233,515
14,14014,140146514,Capital,CORDOBA,408,437,706,633,1339
14,14014,140146513,Capital,CORDOBA,188,221,347,300,647
14,14014,140146512,Capital,CORDOBA,307,374,461,398,859
14,14014,140146511,Capital,CORDOBA,286,303,479,466,945
14,14014,140146510,Capital,CORDOBA,188,222,299,233,532
14,14014,140146509,Capital,CORDOBA,191,227,313,238,551
14,14014,140146508,Capital,CORDOBA,153,221,176,162,338
14,14014,140146507,Capital,CORDOBA,174,195,276,255,531
14,14014,140146506,Capital,CORDOBA,276,385,380,333,713
14,14014,140146505,Capital,CORDOBA,212,269,328,290,618
14,14014,140146503,Capital,CORDOBA,215,327,248,172,420
14,14014,140146502,Capital,CORDOBA,322,444,396,340,736
14,14014,140146501,Capital,CORDOBA,215,303,271,257,528
14,14014,140146411,Capital,CORDOBA,278,300,481,444,925
14,14014,140146410,Capital,CORDOBA,340,369,586,519,1105
14,14014,140146409,Capital,CORDOBA,326,376,522,449,971
14,14014,140146408,Capital,CORDOBA,311,347,484,394,878
14,14014,140146407,Capital,CORDOBA,355,439,506,471,977
14,14014,140146406,Capital,CORDOBA,216,281,284,222,506
14,14014,140146405,Capital,CORDOBA,263,293,322,308,630
14,14014,140146401,Capital,CORDOBA,212,265,315,286,601
14,14014,140146313,Capital,CORDOBA,227,224,390,325,715
14,14014,140146312,Capital,CORDOBA,177,206,298,257,555
14,14014,140146311,Capital,CORDOBA,206,232,328,307,635
14,14014,140146310,Capital,CORDOBA,219,250,362,325,687
14,14014,140146309,Capital,CORDOBA,280,307,468,428,896
14,14014,140146308,Capital,CORDOBA,289,316,493,419,912
14,14014,140146307,Capital,CORDOBA,285,308,441,375,816
14,14014,140146305,Capital,CORDOBA,375,405,587,501,1088
14,14014,140146304,Capital,CORDOBA,234,255,410,330,740
14,14014,140146303,Capital,CORDOBA,215,231,305,291,596
14,14014,140146302,Capital,CORDOBA,224,236,369,288,657
14,14014,140146301,Capital,CORDOBA,215,252,337,299,636
14,14014,140146213,Capital,CORDOBA,272,286,507,434,941
14,14014,140146212,Capital,CORDOBA,318,320,630,590,1220
14,14014,140146211,Capital,CORDOBA,434,421,842,871,1713
14,14014,140146402,Capital,CORDOBA,396,483,533,469,1002
14,14014,140146210,Capital,CORDOBA,320,352,567,474,1041
14,14014,140146209,Capital,CORDOBA,340,372,526,475,1001
14,14014,140146208,Capital,CORDOBA,271,277,454,449,903
14,14014,140146207,Capital,CORDOBA,243,250,444,431,875
14,14014,140146206,Capital,CORDOBA,258,290,448,421,869
14,14014,140146205,Capital,CORDOBA,216,258,357,328,685
14,14014,140146204,Capital,CORDOBA,219,251,382,315,697
14,14014,140146203,Capital,CORDOBA,274,293,438,400,838
14,14014,140146202,Capital,CORDOBA,283,341,431,371,802
14,14014,140146201,Capital,CORDOBA,278,272,489,422,911
14,14014,140146115,Capital,CORDOBA,322,254,684,697,1381
14,14014,140146114,Capital,CORDOBA,250,233,514,480,994
14,14014,140146112,Capital,CORDOBA,460,470,932,917,1849
14,14014,140146111,Capital,CORDOBA,274,272,541,564,1105
14,14014,140146110,Capital,CORDOBA,231,236,459,407,866
14,14014,140146109,Capital,CORDOBA,239,238,446,409,855
14,14014,140146403,Capital,CORDOBA,306,407,363,278,641
14,14014,140146108,Capital,CORDOBA,284,273,564,562,1126
14,14014,140146107,Capital,CORDOBA,254,232,550,571,1121
14,14014,140146106,Capital,CORDOBA,230,235,447,417,864
14,14014,140146105,Capital,CORDOBA,322,294,619,682,1301
14,14014,140146104,Capital,CORDOBA,226,208,447,468,915
14,14014,140146103,Capital,CORDOBA,243,239,491,499,990
14,14014,140146101,Capital,CORDOBA,311,289,602,590,1192
14,14014,140146018,Capital,CORDOBA,317,422,461,384,845
14,14014,140146017,Capital,CORDOBA,338,400,535,485,1020
14,14014,140146016,Capital,CORDOBA,256,288,422,343,765
14,14014,140146015,Capital,CORDOBA,335,451,471,418,889
14,14014,140146014,Capital,CORDOBA,370,450,532,428,960
14,14014,140146013,Capital,CORDOBA,220,274,305,249,554
14,14014,140146001,Capital,CORDOBA,291,320,445,389,834
14,14014,140145912,Capital,CORDOBA,325,414,470,388,858
14,14014,140145911,Capital,CORDOBA,182,212,228,184,412
14,14014,140145910,Capital,CORDOBA,214,293,216,203,419
14,14014,140145909,Capital,CORDOBA,240,314,241,214,455
14,14014,140145908,Capital,CORDOBA,122,188,146,119,265
14,14014,140145907,Capital,CORDOBA,218,312,271,190,461
14,14014,140145906,Capital,CORDOBA,232,324,250,199,449
14,14014,140145905,Capital,CORDOBA,247,309,279,241,520
14,14014,140145904,Capital,CORDOBA,273,367,310,261,571
14,14014,140145903,Capital,CORDOBA,288,436,321,260,581
14,14014,140145902,Capital,CORDOBA,156,250,159,153,312
14,14014,140145901,Capital,CORDOBA,305,294,504,438,942
14,14014,140145813,Capital,CORDOBA,91,201,103,92,195
14,14014,140145812,Capital,CORDOBA,275,376,271,205,476
14,14014,140145811,Capital,CORDOBA,302,485,321,264,585
14,14014,140145810,Capital,CORDOBA,122,149,148,104,252
14,14014,140145809,Capital,CORDOBA,263,424,285,223,508
14,14014,140145808,Capital,CORDOBA,301,493,289,240,529
14,14014,140145807,Capital,CORDOBA,200,290,232,165,397
14,14014,140145806,Capital,CORDOBA,292,399,377,272,649
14,14014,140145805,Capital,CORDOBA,280,342,327,265,592
14,14014,140145804,Capital,CORDOBA,222,320,249,185,434
14,14014,140145803,Capital,CORDOBA,165,237,199,154,353
14,14014,140144805,Capital,CORDOBA,237,311,330,260,590
14,14014,140144804,Capital,CORDOBA,244,300,291,228,519
14,14014,140144803,Capital,CORDOBA,282,344,313,280,593
14,14014,140144802,Capital,CORDOBA,269,339,312,255,567
14,14014,140144801,Capital,CORDOBA,174,240,214,159,373
14,14014,140144712,Capital,CORDOBA,446,560,613,439,1052
14,14014,140144711,Capital,CORDOBA,250,267,389,347,736
14,14014,140144710,Capital,CORDOBA,192,268,266,222,488
14,14014,140144709,Capital,CORDOBA,204,284,294,246,540
14,14014,140144708,Capital,CORDOBA,330,426,460,432,892
14,14014,140144707,Capital,CORDOBA,286,320,471,412,883
14,14014,140144702,Capital,CORDOBA,203,191,290,279,569
14,14014,140144701,Capital,CORDOBA,158,169,236,217,453
14,14014,140144616,Capital,CORDOBA,291,258,527,499,1026
14,14014,140144614,Capital,CORDOBA,359,341,602,580,1182
14,14014,140144613,Capital,CORDOBA,150,179,237,228,465
14,14014,140144612,Capital,CORDOBA,342,377,531,423,954
14,14014,140144611,Capital,CORDOBA,411,372,665,656,1321
14,14014,140144610,Capital,CORDOBA,331,290,597,555,1152
14,14014,140144609,Capital,CORDOBA,313,300,578,524,1102
14,14014,140144608,Capital,CORDOBA,235,263,431,342,773
14,14014,140144607,Capital,CORDOBA,250,251,463,383,846
14,14014,140144606,Capital,CORDOBA,281,317,499,432,931
14,14014,140144605,Capital,CORDOBA,247,228,440,403,843
14,14014,140144604,Capital,CORDOBA,214,229,374,361,735
14,14014,140144603,Capital,CORDOBA,296,302,520,458,978
14,14014,140144602,Capital,CORDOBA,381,393,643,612,1255
14,14014,140144601,Capital,CORDOBA,276,256,505,484,989
14,14014,140144512,Capital,CORDOBA,278,288,479,436,915
14,14014,140144511,Capital,CORDOBA,285,319,514,453,967
14,14014,140144510,Capital,CORDOBA,395,454,689,659,1348
14,14014,140144509,Capital,CORDOBA,330,364,578,549,1127
14,14014,140144508,Capital,CORDOBA,288,368,465,413,878
14,14014,140144507,Capital,CORDOBA,336,395,588,520,1108
14,14014,140144505,Capital,CORDOBA,318,341,497,477,974
14,14014,140144504,Capital,CORDOBA,331,356,563,508,1071
14,14014,140144503,Capital,CORDOBA,271,272,460,443,903
14,14014,140144502,Capital,CORDOBA,502,495,947,944,1891
14,14014,140144501,Capital,CORDOBA,373,362,686,705,1391
14,14014,140144703,Capital,CORDOBA,310,351,498,391,889
14,14014,140144411,Capital,CORDOBA,424,462,793,715,1508
14,14014,140144410,Capital,CORDOBA,259,272,431,395,826
14,14014,140144409,Capital,CORDOBA,283,279,572,525,1097
14,14014,140144408,Capital,CORDOBA,208,236,326,292,618
14,14014,140144407,Capital,CORDOBA,366,344,591,540,1131
14,14014,140144406,Capital,CORDOBA,487,519,862,764,1626
14,14014,140144405,Capital,CORDOBA,225,224,367,353,720
14,14014,140147721,Capital,CORDOBA,202,194,372,367,739
14,14014,140147719,Capital,CORDOBA,281,280,686,603,1289
14,14014,140147718,Capital,CORDOBA,241,269,353,338,691
14,14014,140147717,Capital,CORDOBA,322,338,590,580,1170
14,14014,140147716,Capital,CORDOBA,241,235,432,351,783
14,14014,140147715,Capital,CORDOBA,305,309,583,534,1117
14,14014,140147714,Capital,CORDOBA,251,244,492,455,947
14,14014,140147713,Capital,CORDOBA,405,416,780,673,1453
14,14014,140147712,Capital,CORDOBA,273,302,520,442,962
14,14014,140147710,Capital,CORDOBA,286,341,466,425,891
14,14014,140147709,Capital,CORDOBA,265,319,428,363,791
14,14014,140147708,Capital,CORDOBA,274,318,450,422,872
14,14014,140147707,Capital,CORDOBA,360,388,580,492,1072
14,14014,140147706,Capital,CORDOBA,275,283,479,404,883
14,14014,140147705,Capital,CORDOBA,295,328,510,474,984
14,14014,140147704,Capital,CORDOBA,267,288,443,403,846
14,14014,140147703,Capital,CORDOBA,241,295,396,337,733
14,14014,140147702,Capital,CORDOBA,244,276,431,386,817
14,14014,140147701,Capital,CORDOBA,348,387,589,514,1103
14,14014,140147617,Capital,CORDOBA,350,319,738,730,1468
14,14014,140147616,Capital,CORDOBA,380,376,835,725,1560
14,14014,140147615,Capital,CORDOBA,244,277,466,401,867
14,14014,140147614,Capital,CORDOBA,299,287,546,504,1050
14,14014,140147613,Capital,CORDOBA,236,228,425,398,823
14,14014,140147612,Capital,CORDOBA,329,329,649,609,1258
14,14014,140147611,Capital,CORDOBA,287,316,524,439,963
14,14014,140147610,Capital,CORDOBA,298,339,471,456,927
14,14014,140147609,Capital,CORDOBA,314,329,578,550,1128
14,14014,140147608,Capital,CORDOBA,254,265,467,418,885
14,14014,140147607,Capital,CORDOBA,279,296,520,516,1036
14,14014,140147606,Capital,CORDOBA,594,585,1278,1162,2440
14,14014,140147605,Capital,CORDOBA,295,315,528,498,1026
14,14014,140147604,Capital,CORDOBA,291,304,527,488,1015
14,14014,140147603,Capital,CORDOBA,247,275,465,445,910
14,14014,140147602,Capital,CORDOBA,308,320,538,493,1031
14,14014,140144404,Capital,CORDOBA,208,221,340,287,627
14,14014,140144403,Capital,CORDOBA,293,322,569,483,1052
14,14014,140144402,Capital,CORDOBA,259,258,456,464,920
14,14014,140144401,Capital,CORDOBA,539,813,609,559,1168
14,14014,140144309,Capital,CORDOBA,353,367,686,701,1387
14,14014,140144308,Capital,CORDOBA,383,364,738,757,1495
14,14014,140144307,Capital,CORDOBA,306,301,615,587,1202
14,14014,140144306,Capital,CORDOBA,451,381,872,781,1653
14,14014,140144305,Capital,CORDOBA,175,165,346,332,678
14,14014,140144303,Capital,CORDOBA,336,317,647,642,1289
14,14014,140144302,Capital,CORDOBA,453,505,821,797,1618
14,14014,140144301,Capital,CORDOBA,330,382,555,529,1084
14,14014,140144706,Capital,CORDOBA,229,313,333,276,609
14,14014,140144513,Capital,CORDOBA,200,209,325,256,581
14,14014,140144220,Capital,CORDOBA,327,373,554,519,1073
14,14014,140144217,Capital,CORDOBA,245,283,394,339,733
14,14014,140144216,Capital,CORDOBA,321,339,548,510,1058
14,14014,140144215,Capital,CORDOBA,201,239,305,313,618
14,14014,140144214,Capital,CORDOBA,305,335,519,449,968
14,14014,140144213,Capital,CORDOBA,226,269,397,318,715
14,14014,140144212,Capital,CORDOBA,277,319,457,369,826
14,14014,140144211,Capital,CORDOBA,246,274,371,372,743
14,14014,140144210,Capital,CORDOBA,195,216,318,295,613
14,14014,140144209,Capital,CORDOBA,202,240,289,251,540
14,14014,140144208,Capital,CORDOBA,380,444,614,562,1176
14,14014,140144207,Capital,CORDOBA,275,308,472,387,859
14,14014,140144206,Capital,CORDOBA,229,289,373,313,686
14,14014,140144205,Capital,CORDOBA,189,229,349,264,613
14,14014,140144204,Capital,CORDOBA,178,214,297,250,547
14,14014,140144203,Capital,CORDOBA,139,197,233,179,412
14,14014,140144202,Capital,CORDOBA,139,178,232,188,420
14,14014,140144201,Capital,CORDOBA,193,255,376,290,666
14,14014,140144119,Capital,CORDOBA,217,246,346,335,681
14,14014,140144118,Capital,CORDOBA,256,286,328,272,600
14,14014,140144117,Capital,CORDOBA,261,332,457,381,838
14,14014,140144116,Capital,CORDOBA,198,229,331,271,602
14,14014,140144115,Capital,CORDOBA,263,300,385,334,719
14,14014,140144114,Capital,CORDOBA,310,362,484,404,888
14,14014,140144113,Capital,CORDOBA,294,347,454,366,820
14,14014,140144112,Capital,CORDOBA,303,350,477,401,878
14,14014,140144111,Capital,CORDOBA,210,224,353,279,632
14,14014,140144109,Capital,CORDOBA,222,258,320,299,619
14,14014,140144108,Capital,CORDOBA,161,185,248,208,456
14,14014,140144107,Capital,CORDOBA,222,285,359,280,639
14,14014,140144106,Capital,CORDOBA,244,291,383,314,697
14,14014,140144105,Capital,CORDOBA,214,240,320,240,560
14,14014,140144104,Capital,CORDOBA,195,226,273,260,533
14,14014,140144103,Capital,CORDOBA,320,374,506,420,926
14,14014,140144102,Capital,CORDOBA,210,246,294,253,547
14,14014,140144101,Capital,CORDOBA,257,302,366,309,675
14,14014,140144012,Capital,CORDOBA,258,296,363,338,701
14,14014,140144011,Capital,CORDOBA,224,259,369,319,688
14,14014,140144010,Capital,CORDOBA,315,345,480,392,872
14,14014,140144008,Capital,CORDOBA,322,373,513,471,984
14,14014,140144007,Capital,CORDOBA,247,248,405,1120,1525
14,14014,140144005,Capital,CORDOBA,158,216,245,230,475
14,14014,140144004,Capital,CORDOBA,200,225,320,297,617
14,14014,140144003,Capital,CORDOBA,231,286,379,331,710
14,14014,140144002,Capital,CORDOBA,223,270,343,291,634
14,14014,140144001,Capital,CORDOBA,251,327,348,307,655
14,14014,140143913,Capital,CORDOBA,179,210,293,258,551
14,14014,140143912,Capital,CORDOBA,324,445,428,384,812
14,14014,140143910,Capital,CORDOBA,260,438,304,248,552
14,14014,140143909,Capital,CORDOBA,286,398,414,334,748
14,14014,140143908,Capital,CORDOBA,261,408,348,300,648
14,14014,140143907,Capital,CORDOBA,212,241,370,342,712
14,14014,140143906,Capital,CORDOBA,220,293,344,298,642
14,14014,140143905,Capital,CORDOBA,191,276,307,276,583
14,14014,140143904,Capital,CORDOBA,229,282,323,280,603
14,14014,140143903,Capital,CORDOBA,345,492,531,425,956
14,14014,140143902,Capital,CORDOBA,377,500,599,509,1108
14,14014,140144006,Capital,CORDOBA,178,227,238,159,397
14,14014,140143901,Capital,CORDOBA,177,236,277,265,542
14,14014,140143816,Capital,CORDOBA,231,313,340,303,643
14,14014,140143815,Capital,CORDOBA,248,301,379,301,680
14,14014,140143814,Capital,CORDOBA,300,413,388,353,741
14,14014,140143813,Capital,CORDOBA,297,336,435,385,820
14,14014,140143812,Capital,CORDOBA,225,265,390,350,740
14,14014,140143811,Capital,CORDOBA,260,337,452,308,760
14,14014,140143810,Capital,CORDOBA,319,375,471,367,838
14,14014,140143809,Capital,CORDOBA,254,281,399,336,735
14,14014,140143808,Capital,CORDOBA,368,452,632,568,1200
14,14014,140143807,Capital,CORDOBA,251,306,384,330,714
14,14014,140143806,Capital,CORDOBA,254,300,381,342,723
14,14014,140143805,Capital,CORDOBA,235,249,394,323,717
14,14014,140143804,Capital,CORDOBA,308,357,474,424,898
14,14014,140143803,Capital,CORDOBA,346,380,539,442,981
14,14014,140143802,Capital,CORDOBA,339,378,553,463,1016
14,14014,140143801,Capital,CORDOBA,379,419,654,544,1198
14,14014,140143721,Capital,CORDOBA,163,200,274,242,516
14,14014,140143720,Capital,CORDOBA,209,249,307,283,590
14,14014,140143719,Capital,CORDOBA,216,262,315,283,598
14,14014,140143718,Capital,CORDOBA,166,216,257,211,468
14,14014,140143717,Capital,CORDOBA,215,219,307,299,606
14,14014,140143716,Capital,CORDOBA,192,212,302,263,565
14,14014,140143715,Capital,CORDOBA,217,254,339,306,645
14,14014,140143714,Capital,CORDOBA,207,214,344,289,633
14,14014,140143713,Capital,CORDOBA,241,274,394,309,703
14,14014,140143712,Capital,CORDOBA,244,267,473,392,865
14,14014,140143711,Capital,CORDOBA,428,469,739,633,1372
14,14014,140143710,Capital,CORDOBA,233,229,410,383,793
14,14014,140143709,Capital,CORDOBA,240,282,367,317,684
14,14014,140143708,Capital,CORDOBA,330,360,553,500,1053
14,14014,140143707,Capital,CORDOBA,303,315,561,516,1077
14,14014,140143706,Capital,CORDOBA,289,229,574,538,1112
14,14014,140143705,Capital,CORDOBA,266,245,447,440,887
14,14014,140143704,Capital,CORDOBA,260,253,491,403,894
14,14014,140143703,Capital,CORDOBA,243,238,423,392,815
14,14014,140143701,Capital,CORDOBA,421,394,750,657,1407
14,14014,140143614,Capital,CORDOBA,208,229,344,318,662
14,14014,140143613,Capital,CORDOBA,234,246,379,331,710
14,14014,140143612,Capital,CORDOBA,253,296,419,323,742
14,14014,140143611,Capital,CORDOBA,259,269,433,377,810
14,14014,140143606,Capital,CORDOBA,250,281,424,374,798
14,14014,140143602,Capital,CORDOBA,233,257,388,347,735
14,14014,140143601,Capital,CORDOBA,245,270,399,353,752
14,14014,140143514,Capital,CORDOBA,385,379,667,586,1253
14,14014,140143512,Capital,CORDOBA,305,275,570,472,1042
14,14014,140143511,Capital,CORDOBA,328,307,575,538,1113
14,14014,140143510,Capital,CORDOBA,238,230,386,327,713
14,14014,140143509,Capital,CORDOBA,240,276,429,388,817
14,14014,140143507,Capital,CORDOBA,354,363,669,579,1248
14,14014,140143506,Capital,CORDOBA,850,704,1622,1651,3273
14,14014,140146011,Capital,CORDOBA,378,477,552,448,1000
14,14014,140143605,Capital,CORDOBA,313,318,549,447,996
14,14014,140143604,Capital,CORDOBA,311,337,530,462,992
14,14014,140143603,Capital,CORDOBA,353,357,622,556,1178
14,14014,140143505,Capital,CORDOBA,186,559,343,350,693
14,14014,140143504,Capital,CORDOBA,403,414,700,632,1332
14,14014,140143503,Capital,CORDOBA,213,228,359,332,691
14,14014,140143502,Capital,CORDOBA,430,457,788,705,1493
14,14014,140143501,Capital,CORDOBA,261,265,454,454,908
14,14014,140143419,Capital,CORDOBA,202,250,343,296,639
14,14014,140143418,Capital,CORDOBA,363,395,658,530,1188
14,14014,140143415,Capital,CORDOBA,218,223,374,314,688
14,14014,140143414,Capital,CORDOBA,221,227,396,339,735
14,14014,140143413,Capital,CORDOBA,244,269,413,337,750
14,14014,140143412,Capital,CORDOBA,236,245,424,375,799
14,14014,140143411,Capital,CORDOBA,198,215,320,304,624
14,14014,140143410,Capital,CORDOBA,208,223,363,315,678
14,14014,140143408,Capital,CORDOBA,219,218,363,368,731
14,14014,140143407,Capital,CORDOBA,211,228,365,345,710
14,14014,140143406,Capital,CORDOBA,176,193,325,281,606
14,14014,140143405,Capital,CORDOBA,176,199,302,280,582
14,14014,140143404,Capital,CORDOBA,134,156,200,205,405
14,14014,140143403,Capital,CORDOBA,257,290,424,378,802
14,14014,140143402,Capital,CORDOBA,294,297,565,480,1045
14,14014,140143401,Capital,CORDOBA,241,244,429,390,819
14,14014,140143320,Capital,CORDOBA,227,236,383,362,745
14,14014,140143319,Capital,CORDOBA,287,319,543,493,1036
14,14014,140143318,Capital,CORDOBA,377,395,672,598,1270
14,14014,140143317,Capital,CORDOBA,336,362,570,516,1086
14,14014,140143316,Capital,CORDOBA,218,224,357,335,692
14,14014,140143315,Capital,CORDOBA,285,339,464,386,850
14,14014,140143313,Capital,CORDOBA,292,290,513,447,960
14,14014,140142601,Capital,CORDOBA,238,250,429,400,829
14,14014,140142518,Capital,CORDOBA,316,356,485,439,924
14,14014,140142517,Capital,CORDOBA,233,250,415,327,742
14,14014,140142516,Capital,CORDOBA,344,361,536,504,1040
14,14014,140142515,Capital,CORDOBA,369,402,550,468,1018
14,14014,140142514,Capital,CORDOBA,211,218,328,293,621
14,14014,140142513,Capital,CORDOBA,233,260,370,321,691
14,14014,140142512,Capital,CORDOBA,239,267,397,298,695
14,14014,140142511,Capital,CORDOBA,255,256,416,357,773
14,14014,140142510,Capital,CORDOBA,221,232,360,301,661
14,14014,140142509,Capital,CORDOBA,226,210,382,352,734
14,14014,140142508,Capital,CORDOBA,185,223,300,256,556
14,14014,140142507,Capital,CORDOBA,334,338,567,472,1039
14,14014,140142506,Capital,CORDOBA,347,354,563,483,1046
14,14014,140142505,Capital,CORDOBA,247,254,441,387,828
14,14014,140142504,Capital,CORDOBA,344,369,662,557,1219
14,14014,140142503,Capital,CORDOBA,89,105,150,127,277
14,14014,140142615,Capital,CORDOBA,309,379,475,405,880
14,14014,140142501,Capital,CORDOBA,280,382,278,206,484
14,14014,140142414,Capital,CORDOBA,199,234,342,256,598
14,14014,140142413,Capital,CORDOBA,220,273,355,276,631
14,14014,140142412,Capital,CORDOBA,188,283,296,225,521
14,14014,140142411,Capital,CORDOBA,231,253,339,301,640
14,14014,140142410,Capital,CORDOBA,194,204,268,190,458
14,14014,140142408,Capital,CORDOBA,251,289,414,337,751
14,14014,140142407,Capital,CORDOBA,260,295,391,335,726
14,14014,140142406,Capital,CORDOBA,311,367,521,402,923
14,14014,140142405,Capital,CORDOBA,268,303,427,398,825
14,14014,140142404,Capital,CORDOBA,419,467,657,630,1287
14,14014,140142502,Capital,CORDOBA,212,188,333,292,625
14,14014,140142403,Capital,CORDOBA,301,331,448,397,845
14,14014,140142402,Capital,CORDOBA,341,384,516,455,971
14,14014,140142401,Capital,CORDOBA,336,401,578,537,1115
14,14014,140142316,Capital,CORDOBA,200,252,322,312,634
14,14014,140142314,Capital,CORDOBA,254,273,438,433,871
14,14014,140142313,Capital,CORDOBA,450,529,931,846,1777
14,14014,140142312,Capital,CORDOBA,252,289,460,414,874
14,14014,140142311,Capital,CORDOBA,218,271,379,361,740
14,14014,140143103,Capital,CORDOBA,442,404,862,800,1662
14,14014,140142309,Capital,CORDOBA,182,191,310,291,601
14,14014,140142308,Capital,CORDOBA,351,412,660,614,1274
14,14014,140142307,Capital,CORDOBA,262,303,424,396,820
14,14014,140142306,Capital,CORDOBA,259,320,418,344,762
14,14014,140142305,Capital,CORDOBA,182,220,287,249,536
14,14014,140142304,Capital,CORDOBA,186,185,284,236,520
14,14014,140145802,Capital,CORDOBA,282,404,339,265,604
14,14014,140145801,Capital,CORDOBA,138,205,151,115,266
14,14014,140145714,Capital,CORDOBA,262,474,262,177,439
14,14014,140145713,Capital,CORDOBA,232,412,251,176,427
14,14014,140145712,Capital,CORDOBA,135,261,143,101,244
14,14014,140145711,Capital,CORDOBA,172,312,192,143,335
14,14014,140145710,Capital,CORDOBA,155,325,168,109,277
14,14014,140145709,Capital,CORDOBA,140,241,168,105,273
14,14014,140145708,Capital,CORDOBA,71,185,86,57,143
14,14014,140145707,Capital,CORDOBA,194,345,185,119,304
14,14014,140145706,Capital,CORDOBA,113,174,126,73,199
14,14014,140145705,Capital,CORDOBA,152,212,199,154,353
14,14014,140145704,Capital,CORDOBA,399,764,419,283,702
14,14014,140145702,Capital,CORDOBA,227,361,258,183,441
14,14014,140145701,Capital,CORDOBA,383,516,447,294,741
14,14014,140145619,Capital,CORDOBA,165,231,174,138,312
14,14014,140145618,Capital,CORDOBA,216,378,282,188,470
14,14014,140145617,Capital,CORDOBA,179,328,222,151,373
14,14014,140145616,Capital,CORDOBA,145,197,176,114,290
14,14014,140145615,Capital,CORDOBA,129,225,157,110,267
14,14014,140145614,Capital,CORDOBA,126,220,111,97,208
14,14014,140145613,Capital,CORDOBA,145,253,149,141,290
14,14014,140145612,Capital,CORDOBA,113,146,107,94,201
14,14014,140145611,Capital,CORDOBA,279,353,272,271,543
14,14014,140145610,Capital,CORDOBA,89,151,91,73,164
14,14014,140145609,Capital,CORDOBA,138,239,170,130,300
14,14014,140145608,Capital,CORDOBA,122,207,125,123,248
14,14014,140145607,Capital,CORDOBA,130,268,149,109,258
14,14014,140145606,Capital,CORDOBA,149,256,189,122,311
14,14014,140145605,Capital,CORDOBA,160,180,206,186,392
14,14014,140145604,Capital,CORDOBA,161,260,177,173,350
14,14014,140145603,Capital,CORDOBA,226,434,264,234,498
14,14014,140145602,Capital,CORDOBA,219,339,342,238,580
14,14014,140145601,Capital,CORDOBA,217,325,221,190,411
14,14014,140145508,Capital,CORDOBA,57,140,68,46,114
14,14014,140145507,Capital,CORDOBA,150,341,163,115,278
14,14014,140145506,Capital,CORDOBA,106,199,108,83,191
14,14014,140145505,Capital,CORDOBA,144,222,151,162,313
14,14014,140145504,Capital,CORDOBA,122,157,127,104,231
14,14014,140145503,Capital,CORDOBA,125,125,125,123,248
14,14014,140145502,Capital,CORDOBA,231,344,216,244,460
14,14014,140145501,Capital,CORDOBA,227,309,296,256,552
14,14014,140145416,Capital,CORDOBA,197,298,205,156,361
14,14014,140145415,Capital,CORDOBA,244,402,235,188,423
14,14014,140145414,Capital,CORDOBA,257,534,252,192,444
14,14014,140145413,Capital,CORDOBA,428,689,428,294,722
14,14014,140145412,Capital,CORDOBA,223,360,248,241,489
14,14014,140145411,Capital,CORDOBA,114,202,129,139,268
14,14014,140145410,Capital,CORDOBA,173,230,274,243,517
14,14014,140145409,Capital,CORDOBA,252,387,331,291,622
14,14014,140145408,Capital,CORDOBA,194,273,216,163,379
14,14014,140145407,Capital,CORDOBA,157,237,161,120,281
14,14014,140145406,Capital,CORDOBA,280,405,325,270,595
14,14014,140145405,Capital,CORDOBA,144,212,183,171,354
14,14014,140145404,Capital,CORDOBA,212,317,249,198,447
14,14014,140145403,Capital,CORDOBA,216,328,235,243,478
14,14014,140145402,Capital,CORDOBA,205,278,237,223,460
14,14014,140145401,Capital,CORDOBA,181,274,218,222,440
14,14014,140145320,Capital,CORDOBA,141,161,212,182,394
14,14014,140145319,Capital,CORDOBA,211,234,316,318,634
14,14014,140145318,Capital,CORDOBA,206,236,304,275,579
14,14014,140145317,Capital,CORDOBA,174,204,285,236,521
14,14014,140145316,Capital,CORDOBA,161,203,247,227,474
14,14014,140145315,Capital,CORDOBA,338,479,410,300,710
14,14014,140145314,Capital,CORDOBA,193,227,285,287,572
14,14014,140145313,Capital,CORDOBA,190,224,285,212,497
14,14014,140145312,Capital,CORDOBA,208,263,337,259,596
14,14014,140145311,Capital,CORDOBA,251,311,360,303,663
14,14014,140145310,Capital,CORDOBA,285,338,412,302,714
14,14014,140145309,Capital,CORDOBA,225,272,360,283,643
14,14014,140145308,Capital,CORDOBA,302,352,492,429,921
14,14014,140145306,Capital,CORDOBA,273,417,355,265,620
14,14014,140145305,Capital,CORDOBA,182,319,258,209,467
14,14014,140145509,Capital,CORDOBA,169,314,143,135,278
14,14014,140145303,Capital,CORDOBA,140,179,233,173,406
14,14014,140145302,Capital,CORDOBA,222,307,385,304,689
14,14014,140145301,Capital,CORDOBA,243,341,454,316,770
14,14014,140145219,Capital,CORDOBA,296,272,582,559,1141
14,14014,140145218,Capital,CORDOBA,315,276,692,675,1367
14,14014,140145217,Capital,CORDOBA,231,227,444,471,915
14,14014,140145216,Capital,CORDOBA,253,272,470,438,908
14,14014,140145304,Capital,CORDOBA,165,230,259,217,476
14,14014,140145215,Capital,CORDOBA,197,178,355,351,706
14,14014,140145214,Capital,CORDOBA,242,275,381,334,715
14,14014,140145213,Capital,CORDOBA,248,260,432,380,812
14,14014,140145212,Capital,CORDOBA,299,311,595,561,1156
14,14014,140145211,Capital,CORDOBA,163,175,305,259,564
14,14014,140145210,Capital,CORDOBA,182,234,296,263,559
14,14014,140145209,Capital,CORDOBA,187,228,277,267,544
14,14014,140145208,Capital,CORDOBA,213,280,359,273,632
14,14014,140145207,Capital,CORDOBA,223,246,373,291,664
14,14014,140145206,Capital,CORDOBA,191,227,293,234,527
14,14014,140145204,Capital,CORDOBA,421,425,787,790,1577
14,14014,140145203,Capital,CORDOBA,232,252,398,333,731
14,14014,140145202,Capital,CORDOBA,340,394,563,448,1011
14,14014,140145201,Capital,CORDOBA,222,253,327,250,577
14,14014,140145121,Capital,CORDOBA,258,267,528,461,989
14,14014,140145120,Capital,CORDOBA,532,509,1041,1023,2064
14,14014,140145119,Capital,CORDOBA,359,356,646,637,1283
14,14014,140145118,Capital,CORDOBA,282,282,471,425,896
14,14014,140145117,Capital,CORDOBA,377,369,721,639,1360
14,14014,140145116,Capital,CORDOBA,164,156,298,288,586
14,14014,140145115,Capital,CORDOBA,204,198,409,387,796
14,14014,140145114,Capital,CORDOBA,268,269,478,438,916
14,14014,140145110,Capital,CORDOBA,237,263,423,367,790
14,14014,140145109,Capital,CORDOBA,312,336,541,478,1019
14,14014,140145108,Capital,CORDOBA,268,271,479,401,880
14,14014,140145107,Capital,CORDOBA,320,288,568,501,1069
14,14014,140145106,Capital,CORDOBA,326,332,554,484,1038
14,14014,140145105,Capital,CORDOBA,248,238,413,352,765
14,14014,140145104,Capital,CORDOBA,277,275,487,408,895
14,14014,140145103,Capital,CORDOBA,203,203,307,279,586
14,14014,140145102,Capital,CORDOBA,262,281,372,353,725
14,14014,140145101,Capital,CORDOBA,269,296,405,367,772
14,14014,140145015,Capital,CORDOBA,275,292,414,354,768
14,14014,140145014,Capital,CORDOBA,241,271,353,287,640
14,14014,140145013,Capital,CORDOBA,196,237,293,254,547
14,14014,140145012,Capital,CORDOBA,228,259,393,336,729
14,14014,140145011,Capital,CORDOBA,259,299,372,314,686
14,14014,140145010,Capital,CORDOBA,258,289,397,332,729
14,14014,140145008,Capital,CORDOBA,246,287,393,294,687
14,14014,140145007,Capital,CORDOBA,284,313,394,316,710
14,14014,140145006,Capital,CORDOBA,211,252,308,275,583
14,14014,140145005,Capital,CORDOBA,218,251,433,340,773
14,14014,140145004,Capital,CORDOBA,235,274,385,326,711
14,14014,140145003,Capital,CORDOBA,213,247,314,294,608
14,14014,140145002,Capital,CORDOBA,293,324,464,434,898
14,14014,140145001,Capital,CORDOBA,290,287,394,357,751
14,14014,140144921,Capital,CORDOBA,297,407,329,272,601
14,14014,140144920,Capital,CORDOBA,199,342,223,197,420
14,14014,140144919,Capital,CORDOBA,218,351,248,176,424
14,14014,140144918,Capital,CORDOBA,161,222,162,139,301
14,14014,140144917,Capital,CORDOBA,153,246,149,116,265
14,14014,140144916,Capital,CORDOBA,347,515,365,342,707
14,14014,140144915,Capital,CORDOBA,252,376,324,258,582
14,14014,140144914,Capital,CORDOBA,232,382,300,241,541
14,14014,140144913,Capital,CORDOBA,343,504,405,332,737
14,14014,140144912,Capital,CORDOBA,180,248,237,200,437
14,14014,140144911,Capital,CORDOBA,124,153,153,136,289
14,14014,140144909,Capital,CORDOBA,322,461,384,293,677
14,14014,140144908,Capital,CORDOBA,303,383,471,432,903
14,14014,140144907,Capital,CORDOBA,355,434,539,515,1054
14,14014,140144906,Capital,CORDOBA,148,190,222,204,426
14,14014,140144905,Capital,CORDOBA,219,292,329,258,587
14,14014,140144904,Capital,CORDOBA,205,206,305,253,558
14,14014,140144903,Capital,CORDOBA,148,194,243,208,451
14,14014,140144902,Capital,CORDOBA,175,227,240,208,448
14,14014,140144901,Capital,CORDOBA,148,202,227,211,438
14,14014,140144816,Capital,CORDOBA,268,341,322,325,647
14,14014,140144815,Capital,CORDOBA,389,509,464,472,936
14,14014,140144814,Capital,CORDOBA,238,287,342,311,653
14,14014,140144813,Capital,CORDOBA,266,384,331,294,625
14,14014,140144812,Capital,CORDOBA,239,294,309,253,562
14,14014,140144811,Capital,CORDOBA,257,336,317,257,574
14,14014,140144810,Capital,CORDOBA,335,438,457,399,856
14,14014,140144809,Capital,CORDOBA,162,206,229,197,426
14,14014,140144808,Capital,CORDOBA,228,284,301,245,546
14,14014,140144807,Capital,CORDOBA,308,389,404,339,743
14,14014,140144806,Capital,CORDOBA,219,253,284,281,565
14,14014,140142303,Capital,CORDOBA,217,258,373,328,701
14,14014,140142302,Capital,CORDOBA,332,341,539,452,991
14,14014,140142301,Capital,CORDOBA,245,245,450,395,845
14,14014,140142218,Capital,CORDOBA,426,439,815,710,1525
14,14014,140142216,Capital,CORDOBA,291,730,468,425,893
14,14014,140142214,Capital,CORDOBA,257,275,419,404,823
14,14014,140142213,Capital,CORDOBA,3,3,3,4,7
14,14014,140142212,Capital,CORDOBA,377,427,547,550,1097
14,14014,140142211,Capital,CORDOBA,309,347,565,534,1099
14,14014,140142208,Capital,CORDOBA,355,379,621,602,1223
14,14014,140142206,Capital,CORDOBA,437,495,742,715,1457
14,14014,140142205,Capital,CORDOBA,126,181,306,254,560
14,14014,140142204,Capital,CORDOBA,207,216,396,399,795
14,14014,140142310,Capital,CORDOBA,259,354,404,431,835
14,14014,140142217,Capital,CORDOBA,322,330,581,600,1181
14,14014,140142203,Capital,CORDOBA,217,339,379,353,732
14,14014,140142201,Capital,CORDOBA,198,267,348,353,701
14,14014,140142917,Capital,CORDOBA,341,356,610,512,1122
14,14014,140142105,Capital,CORDOBA,213,264,457,722,1179
14,14014,140142103,Capital,CORDOBA,258,305,469,493,962
14,14014,140146010,Capital,CORDOBA,226,289,302,258,560
14,14014,140142210,Capital,CORDOBA,310,319,550,504,1054
14,14014,140142102,Capital,CORDOBA,282,342,576,543,1119
14,14014,140142101,Capital,CORDOBA,274,359,497,470,967
14,14014,140142015,Capital,CORDOBA,188,232,326,285,611
14,14014,140142014,Capital,CORDOBA,310,309,581,538,1119
14,14014,140142209,Capital,CORDOBA,245,267,440,351,791
14,14014,140142013,Capital,CORDOBA,289,320,527,476,1003
14,14014,140142012,Capital,CORDOBA,299,339,505,483,988
14,14014,140142011,Capital,CORDOBA,238,256,394,355,749
14,14014,140142010,Capital,CORDOBA,267,291,461,453,914
14,14014,140142009,Capital,CORDOBA,228,237,368,333,701
14,14014,140142008,Capital,CORDOBA,213,245,399,382,781
14,14014,140142007,Capital,CORDOBA,257,286,446,391,837
14,14014,140142006,Capital,CORDOBA,253,263,448,430,878
14,14014,140142005,Capital,CORDOBA,396,409,713,610,1323
14,14014,140142004,Capital,CORDOBA,327,348,561,551,1112
14,14014,140143417,Capital,CORDOBA,196,216,322,281,603
14,14014,140142003,Capital,CORDOBA,255,288,467,411,878
14,14014,140142002,Capital,CORDOBA,236,284,392,370,762
14,14014,140142001,Capital,CORDOBA,281,290,529,488,1017
14,14014,140141919,Capital,CORDOBA,244,243,484,475,959
14,14014,140141918,Capital,CORDOBA,247,268,425,404,829
14,14014,140141917,Capital,CORDOBA,246,243,424,401,825
14,14014,140141916,Capital,CORDOBA,407,431,783,686,1469
14,14014,140141915,Capital,CORDOBA,441,430,853,777,1630
14,14014,140141913,Capital,CORDOBA,348,334,762,697,1459
14,14014,140141912,Capital,CORDOBA,252,235,494,541,1035
14,14014,140141911,Capital,CORDOBA,405,426,588,543,1131
14,14014,140141910,Capital,CORDOBA,205,200,485,441,926
14,14014,140141909,Capital,CORDOBA,318,334,687,692,1379
14,14014,140141914,Capital,CORDOBA,348,339,794,771,1565
14,14014,140141908,Capital,CORDOBA,433,422,931,899,1830
14,14014,140141907,Capital,CORDOBA,417,371,888,847,1735
14,14014,140141906,Capital,CORDOBA,366,356,814,768,1582
14,14014,140141905,Capital,CORDOBA,268,231,551,571,1122
14,14014,140141904,Capital,CORDOBA,306,295,604,573,1177
14,14014,140141903,Capital,CORDOBA,267,249,535,536,1071
14,14014,140141902,Capital,CORDOBA,234,250,404,389,793
14,14014,140141901,Capital,CORDOBA,402,398,690,594,1284
14,14014,140141818,Capital,CORDOBA,317,250,688,732,1420
14,14014,140141817,Capital,CORDOBA,306,250,614,643,1257
14,14014,140141816,Capital,CORDOBA,450,466,937,928,1865
14,14014,140141815,Capital,CORDOBA,281,268,549,504,1053
14,14014,140141814,Capital,CORDOBA,350,341,705,701,1406
14,14014,140141812,Capital,CORDOBA,328,339,602,558,1160
14,14014,140141811,Capital,CORDOBA,358,347,663,585,1248
14,14014,140141810,Capital,CORDOBA,245,307,391,351,742
14,14014,140141809,Capital,CORDOBA,348,340,641,624,1265
14,14014,140141808,Capital,CORDOBA,471,532,864,834,1698
14,14014,140141807,Capital,CORDOBA,229,243,470,422,892
14,14014,140141806,Capital,CORDOBA,237,229,496,450,946
14,14014,140141805,Capital,CORDOBA,429,422,846,861,1707
14,14014,140141804,Capital,CORDOBA,237,217,532,496,1028
14,14014,140141803,Capital,CORDOBA,282,271,540,518,1058
14,14014,140141813,Capital,CORDOBA,309,308,555,527,1082
14,14014,140141802,Capital,CORDOBA,279,310,569,540,1109
14,14014,140141801,Capital,CORDOBA,438,473,807,788,1595
14,14014,140141721,Capital,CORDOBA,401,408,654,644,1298
14,14014,140141720,Capital,CORDOBA,193,220,344,311,655
14,14014,140141719,Capital,CORDOBA,297,300,527,531,1058
14,14014,140141718,Capital,CORDOBA,349,386,689,652,1341
14,14014,140141717,Capital,CORDOBA,475,470,885,851,1736
14,14014,140141714,Capital,CORDOBA,266,285,498,459,957
14,14014,140141713,Capital,CORDOBA,466,467,902,847,1749
14,14014,140141712,Capital,CORDOBA,276,266,519,499,1018
14,14014,140141711,Capital,CORDOBA,336,376,637,582,1219
14,14014,140141710,Capital,CORDOBA,344,382,616,590,1206
14,14014,140141709,Capital,CORDOBA,236,244,466,414,880
14,14014,140141708,Capital,CORDOBA,310,326,638,603,1241
14,14014,140141707,Capital,CORDOBA,240,292,490,483,973
14,14014,140141706,Capital,CORDOBA,446,456,805,824,1629
14,14014,140141705,Capital,CORDOBA,307,356,582,569,1151
14,14014,140141704,Capital,CORDOBA,389,410,732,678,1410
14,14014,140141703,Capital,CORDOBA,280,270,612,578,1190
14,14014,140141702,Capital,CORDOBA,323,321,568,590,1158
14,14014,140141616,Capital,CORDOBA,544,579,887,939,1826
14,14014,140141615,Capital,CORDOBA,232,267,449,435,884
14,14014,140141614,Capital,CORDOBA,253,290,526,517,1043
14,14014,140141613,Capital,CORDOBA,268,293,513,547,1060
14,14014,140141608,Capital,CORDOBA,187,220,393,333,726
14,14014,140141607,Capital,CORDOBA,329,331,671,612,1283
14,14014,140141606,Capital,CORDOBA,341,338,680,656,1336
14,14014,140141605,Capital,CORDOBA,273,261,554,487,1041
14,14014,140141604,Capital,CORDOBA,204,190,369,409,778
14,14014,140141602,Capital,CORDOBA,413,414,934,922,1856
14,14014,140141716,Capital,CORDOBA,479,426,962,980,1942
14,14014,140141701,Capital,CORDOBA,409,427,704,709,1413
14,14014,140141519,Capital,CORDOBA,261,311,495,515,1010
14,14014,140141518,Capital,CORDOBA,227,290,511,451,962
14,14014,140143416,Capital,CORDOBA,249,280,399,382,781
14,14014,140141516,Capital,CORDOBA,169,183,320,330,650
14,14014,140141515,Capital,CORDOBA,247,296,494,542,1036
14,14014,140141514,Capital,CORDOBA,353,381,646,598,1244
14,14014,140141513,Capital,CORDOBA,540,514,1046,1016,2062
14,14014,140141512,Capital,CORDOBA,191,199,338,289,627
14,14014,140141715,Capital,CORDOBA,390,390,740,670,1410
14,14014,140141511,Capital,CORDOBA,410,416,753,704,1457
14,14014,140141510,Capital,CORDOBA,324,355,655,617,1272
14,14014,140141509,Capital,CORDOBA,395,446,718,606,1324
14,14014,140141508,Capital,CORDOBA,269,253,497,463,960
14,14014,140141507,Capital,CORDOBA,199,213,358,312,670
14,14014,140141506,Capital,CORDOBA,451,509,810,777,1587
14,14014,140141505,Capital,CORDOBA,308,325,562,491,1053
14,14014,140141503,Capital,CORDOBA,198,229,350,315,665
14,14014,140141502,Capital,CORDOBA,248,281,438,389,827
14,14014,140141501,Capital,CORDOBA,203,241,386,388,774
14,14014,140141402,Capital,CORDOBA,503,464,1096,1134,2230
14,14014,140141401,Capital,CORDOBA,364,331,763,733,1496
14,14014,140141309,Capital,CORDOBA,445,429,946,959,1905
14,14014,140141307,Capital,CORDOBA,337,360,722,685,1407
14,14014,140141204,Capital,CORDOBA,376,383,769,767,1536
14,14014,140141203,Capital,CORDOBA,350,344,721,703,1424
14,14014,140141202,Capital,CORDOBA,341,345,614,575,1189
14,14014,140141111,Capital,CORDOBA,295,313,532,522,1054
14,14014,140141110,Capital,CORDOBA,270,245,570,512,1082
14,14014,140143311,Capital,CORDOBA,291,294,480,416,896
14,14014,140143310,Capital,CORDOBA,262,277,452,376,828
14,14014,140143309,Capital,CORDOBA,266,286,442,393,835
14,14014,140143308,Capital,CORDOBA,347,380,676,683,1359
14,14014,140143307,Capital,CORDOBA,307,334,587,564,1151
14,14014,140143306,Capital,CORDOBA,209,230,378,360,738
14,14014,140143305,Capital,CORDOBA,223,229,385,339,724
14,14014,140143304,Capital,CORDOBA,241,235,421,389,810
14,14014,140143303,Capital,CORDOBA,271,265,524,479,1003
14,14014,140143302,Capital,CORDOBA,234,228,427,368,795
14,14014,140143301,Capital,CORDOBA,285,288,512,453,965
14,14014,140143203,Capital,CORDOBA,229,232,407,372,779
14,14014,140143202,Capital,CORDOBA,417,401,783,656,1439
14,14014,140143201,Capital,CORDOBA,245,227,436,379,815
14,14014,140143116,Capital,CORDOBA,359,325,652,626,1278
14,14014,140143114,Capital,CORDOBA,292,303,497,435,932
14,14014,140143113,Capital,CORDOBA,285,325,506,465,971
14,14014,140143112,Capital,CORDOBA,413,409,735,684,1419
14,14014,140143111,Capital,CORDOBA,275,256,534,462,996
14,14014,140143110,Capital,CORDOBA,266,244,461,495,956
14,14014,140143109,Capital,CORDOBA,450,402,886,843,1729
14,14014,140143108,Capital,CORDOBA,324,311,604,558,1162
14,14014,140143107,Capital,CORDOBA,425,459,780,724,1504
14,14014,140143106,Capital,CORDOBA,264,278,545,532,1077
14,14014,140143105,Capital,CORDOBA,367,330,745,671,1416
14,14014,140143104,Capital,CORDOBA,310,301,596,608,1204
14,14014,140143102,Capital,CORDOBA,478,392,971,978,1949
14,14014,140143101,Capital,CORDOBA,296,269,604,591,1195
14,14014,140143015,Capital,CORDOBA,285,274,548,500,1048
14,14014,140143014,Capital,CORDOBA,333,336,631,559,1190
14,14014,140143013,Capital,CORDOBA,319,328,554,554,1108
14,14014,140143012,Capital,CORDOBA,331,338,628,593,1221
14,14014,140143011,Capital,CORDOBA,302,304,552,466,1018
14,14014,140143010,Capital,CORDOBA,316,291,591,550,1141
14,14014,140143009,Capital,CORDOBA,399,391,728,709,1437
14,14014,140143008,Capital,CORDOBA,289,287,675,628,1303
14,14014,140143007,Capital,CORDOBA,173,156,344,353,697
14,14014,140143006,Capital,CORDOBA,309,293,593,646,1239
14,14014,140143005,Capital,CORDOBA,239,214,437,505,942
14,14014,140143004,Capital,CORDOBA,373,359,754,701,1455
14,14014,140143003,Capital,CORDOBA,275,281,517,498,1015
14,14014,140143002,Capital,CORDOBA,404,430,759,660,1419
14,14014,140143001,Capital,CORDOBA,269,300,431,404,835
14,14014,140142919,Capital,CORDOBA,237,234,461,417,878
14,14014,140142918,Capital,CORDOBA,249,241,462,458,920
14,14014,140142915,Capital,CORDOBA,418,407,685,636,1321
14,14014,140142914,Capital,CORDOBA,290,316,532,440,972
14,14014,140142913,Capital,CORDOBA,267,268,417,380,797
14,14014,140142912,Capital,CORDOBA,282,268,571,526,1097
14,14014,140142911,Capital,CORDOBA,237,225,435,403,838
14,14014,140142910,Capital,CORDOBA,299,298,560,535,1095
14,14014,140142909,Capital,CORDOBA,325,306,621,600,1221
14,14014,140142908,Capital,CORDOBA,283,285,473,403,876
14,14014,140142906,Capital,CORDOBA,376,405,612,480,1092
14,14014,140142905,Capital,CORDOBA,371,322,681,606,1287
14,14014,140142904,Capital,CORDOBA,330,307,645,626,1271
14,14014,140142903,Capital,CORDOBA,317,296,637,587,1224
14,14014,140142902,Capital,CORDOBA,270,278,523,505,1028
14,14014,140142901,Capital,CORDOBA,315,328,582,572,1154
14,14014,140142816,Capital,CORDOBA,465,438,949,927,1876
14,14014,140142815,Capital,CORDOBA,269,265,504,431,935
14,14014,140142814,Capital,CORDOBA,347,333,872,863,1735
14,14014,140142813,Capital,CORDOBA,398,370,816,781,1597
14,14014,140142812,Capital,CORDOBA,258,258,511,418,929
14,14014,140142811,Capital,CORDOBA,294,296,560,510,1070
14,14014,140142810,Capital,CORDOBA,344,353,648,615,1263
14,14014,140142809,Capital,CORDOBA,304,321,528,478,1006
14,14014,140142808,Capital,CORDOBA,394,391,690,586,1276
14,14014,140142807,Capital,CORDOBA,238,228,395,336,731
14,14014,140142806,Capital,CORDOBA,261,266,451,387,838
14,14014,140142805,Capital,CORDOBA,352,332,628,565,1193
14,14014,140142804,Capital,CORDOBA,442,418,698,636,1334
14,14014,140142803,Capital,CORDOBA,381,388,652,547,1199
14,14014,140142802,Capital,CORDOBA,328,356,504,493,997
14,14014,140142801,Capital,CORDOBA,400,404,655,612,1267
14,14014,140142712,Capital,CORDOBA,214,245,356,293,649
14,14014,140142711,Capital,CORDOBA,272,296,448,415,863
14,14014,140142710,Capital,CORDOBA,301,312,487,449,936
14,14014,140142709,Capital,CORDOBA,225,218,402,319,721
14,14014,140142708,Capital,CORDOBA,324,336,556,445,1001
14,14014,140142707,Capital,CORDOBA,302,317,501,408,909
14,14014,140142706,Capital,CORDOBA,238,252,431,394,825
14,14014,140142705,Capital,CORDOBA,195,202,350,288,638
14,14014,140142704,Capital,CORDOBA,300,265,507,450,957
14,14014,140142703,Capital,CORDOBA,357,350,688,613,1301
14,14014,140142613,Capital,CORDOBA,215,245,335,329,664
14,14014,140142612,Capital,CORDOBA,280,346,443,362,805
14,14014,140142611,Capital,CORDOBA,376,434,613,600,1213
14,14014,140142610,Capital,CORDOBA,203,230,322,280,602
14,14014,140142609,Capital,CORDOBA,275,365,428,354,782
14,14014,140142608,Capital,CORDOBA,370,464,592,518,1110
14,14014,140142607,Capital,CORDOBA,247,250,401,340,741
14,14014,140142606,Capital,CORDOBA,252,276,408,347,755
14,14014,140142605,Capital,CORDOBA,179,213,269,208,477
14,14014,140142604,Capital,CORDOBA,173,230,293,228,521
14,14014,140142603,Capital,CORDOBA,267,261,474,424,898
14,14014,140142602,Capital,CORDOBA,199,223,357,307,664
14,14014,140143210,Capital,CORDOBA,433,438,738,611,1349
14,14014,140146004,Capital,CORDOBA,300,418,431,389,820
14,14014,140141008,Capital,CORDOBA,501,512,810,811,1621
14,14014,140140313,Capital,CORDOBA,409,365,713,704,1417
14,14014,140143209,Capital,CORDOBA,243,233,434,407,841
14,14014,140140211,Capital,CORDOBA,189,199,337,321,658
14,14014,140143208,Capital,CORDOBA,285,330,590,598,1188
14,14014,140140210,Capital,CORDOBA,265,282,433,378,811
14,14014,140140209,Capital,CORDOBA,268,259,418,364,782
14,14014,140140208,Capital,CORDOBA,279,290,440,394,834
14,14014,140140207,Capital,CORDOBA,358,400,577,504,1081
14,14014,140141007,Capital,CORDOBA,157,182,269,220,489
14,14014,140140206,Capital,CORDOBA,183,221,277,287,564
14,14014,140140811,Capital,CORDOBA,386,351,733,706,1439
14,14014,140146003,Capital,CORDOBA,212,260,319,264,583
14,14014,140140810,Capital,CORDOBA,380,377,768,739,1507
14,14014,140140808,Capital,CORDOBA,198,199,441,435,876
14,14014,140140113,Capital,CORDOBA,349,320,606,592,1198
14,14014,140143609,Capital,CORDOBA,227,254,345,308,653
14,14014,140140112,Capital,CORDOBA,315,331,516,434,950
14,14014,140144704,Capital,CORDOBA,158,209,214,195,409
14,14014,140145517,Capital,CORDOBA,342,641,339,252,591
14,14014,140141108,Capital,CORDOBA,275,259,571,574,1145
14,14014,140141107,Capital,CORDOBA,236,236,476,449,925
14,14014,140141106,Capital,CORDOBA,239,246,434,426,860
14,14014,140141105,Capital,CORDOBA,278,288,468,448,916
14,14014,140141104,Capital,CORDOBA,200,219,389,347,736
14,14014,140141103,Capital,CORDOBA,276,300,492,510,1002
14,14014,140141102,Capital,CORDOBA,243,244,466,481,947
14,14014,140141406,Capital,CORDOBA,369,360,678,671,1349
14,14014,140141209,Capital,CORDOBA,321,347,561,548,1109
14,14014,140141208,Capital,CORDOBA,329,358,576,512,1088
14,14014,140141017,Capital,CORDOBA,225,274,389,380,769
14,14014,140141015,Capital,CORDOBA,221,225,473,421,894
14,14014,140141014,Capital,CORDOBA,193,215,308,318,626
14,14014,140146008,Capital,CORDOBA,190,273,250,192,442
14,14014,140141002,Capital,CORDOBA,449,501,841,784,1625
14,14014,140140914,Capital,CORDOBA,268,253,542,515,1057
14,14014,140141207,Capital,CORDOBA,283,303,532,463,995
14,14014,140140913,Capital,CORDOBA,316,351,646,625,1271
14,14014,140140912,Capital,CORDOBA,481,485,1029,1018,2047
14,14014,140140911,Capital,CORDOBA,415,427,783,776,1559
14,14014,140140907,Capital,CORDOBA,140,145,275,265,540
14,14014,140140906,Capital,CORDOBA,256,222,513,467,980
14,14014,140140904,Capital,CORDOBA,265,246,498,484,982
14,14014,140141405,Capital,CORDOBA,254,270,443,443,886
14,14014,140141206,Capital,CORDOBA,274,255,491,466,957
14,14014,140141205,Capital,CORDOBA,415,396,869,792,1661
14,14014,140140903,Capital,CORDOBA,291,291,586,626,1212
14,14014,140140807,Capital,CORDOBA,291,313,500,484,984
14,14014,140140806,Capital,CORDOBA,249,283,481,403,884
14,14014,140140805,Capital,CORDOBA,452,513,831,828,1659
14,14014,140140804,Capital,CORDOBA,303,349,604,615,1219
14,14014,140140802,Capital,CORDOBA,206,220,434,459,893
14,14014,140141013,Capital,CORDOBA,300,305,539,521,1060
14,14014,140140704,Capital,CORDOBA,260,275,535,549,1084
14,14014,140140702,Capital,CORDOBA,245,226,428,415,843
14,14014,140140608,Capital,CORDOBA,156,155,303,321,624
14,14014,140141012,Capital,CORDOBA,229,267,381,351,732
14,14014,140140707,Capital,CORDOBA,204,203,437,458,895
14,14014,140141404,Capital,CORDOBA,205,215,409,367,776
14,14014,140140515,Capital,CORDOBA,385,394,725,699,1424
14,14014,140140514,Capital,CORDOBA,340,323,779,758,1537
14,14014,140140513,Capital,CORDOBA,350,348,746,670,1416
14,14014,140140512,Capital,CORDOBA,319,306,628,583,1211
14,14014,140140511,Capital,CORDOBA,311,313,606,576,1182
14,14014,140140510,Capital,CORDOBA,396,428,750,689,1439
14,14014,140140509,Capital,CORDOBA,260,239,474,451,925
14,14014,140140508,Capital,CORDOBA,384,368,711,718,1429
14,14014,140140506,Capital,CORDOBA,221,195,434,412,846
14,14014,140140505,Capital,CORDOBA,442,413,893,818,1711
14,14014,140140410,Capital,CORDOBA,385,359,774,723,1497
14,14014,140140409,Capital,CORDOBA,293,338,556,516,1072
14,14014,140140408,Capital,CORDOBA,437,476,805,749,1554
14,14014,140140407,Capital,CORDOBA,299,329,499,483,982
14,14014,140140406,Capital,CORDOBA,428,410,871,865,1736
14,14014,140140708,Capital,CORDOBA,300,314,674,652,1326
14,14014,140140405,Capital,CORDOBA,473,464,993,951,1944
14,14014,140140402,Capital,CORDOBA,295,286,637,665,1302
14,14014,140140401,Capital,CORDOBA,394,405,795,807,1602
14,14014,140141305,Capital,CORDOBA,213,222,443,427,870
14,14014,140140312,Capital,CORDOBA,365,397,655,558,1213
14,14014,140140311,Capital,CORDOBA,273,284,425,374,799
14,14014,140140310,Capital,CORDOBA,270,290,483,423,906
14,14014,140140308,Capital,CORDOBA,333,335,647,603,1250
14,14014,140140307,Capital,CORDOBA,230,238,389,362,751
14,14014,140140306,Capital,CORDOBA,237,247,440,440,880
14,14014,140140305,Capital,CORDOBA,310,283,569,560,1129
14,14014,140140304,Capital,CORDOBA,358,386,718,732,1450
14,14014,140143610,Capital,CORDOBA,202,228,338,282,620
14,14014,140141011,Capital,CORDOBA,432,420,804,731,1535
14,14014,140140303,Capital,CORDOBA,421,431,771,749,1520
14,14014,140140302,Capital,CORDOBA,547,513,1094,1038,2132
14,14014,140140215,Capital,CORDOBA,381,372,654,568,1222
14,14014,140140214,Capital,CORDOBA,368,368,624,552,1176
14,14014,140140213,Capital,CORDOBA,360,383,598,527,1125
14,14014,140140212,Capital,CORDOBA,239,271,416,413,829
14,14014,140140107,Capital,CORDOBA,248,259,397,362,759
14,14014,140140105,Capital,CORDOBA,302,335,487,458,945
14,14014,140140104,Capital,CORDOBA,212,225,408,403,811
14,14014,140140103,Capital,CORDOBA,362,357,642,641,1283
14,14014,140140102,Capital,CORDOBA,313,303,599,639,1238
14,14014,140145516,Capital,CORDOBA,202,326,204,185,389
14,14014,140145515,Capital,CORDOBA,91,137,70,65,135
14,14014,140145514,Capital,CORDOBA,151,218,186,141,327
14,14014,140145513,Capital,CORDOBA,128,256,218,180,398
14,14014,140149904,Capital,CORDOBA,235,230,398,379,777
14,14014,140149804,Capital,CORDOBA,245,232,452,455,907
14,14014,140149321,Capital,CORDOBA,288,378,483,430,913
14,14014,140149308,Capital,CORDOBA,412,445,718,620,1338
14,14014,140149211,Capital,CORDOBA,295,294,407,373,780
14,14014,140148912,Capital,CORDOBA,248,227,499,454,953
14,14014,140148802,Capital,CORDOBA,301,332,492,489,981
14,14014,140148801,Capital,CORDOBA,242,261,397,347,744
14,14014,140148610,Capital,CORDOBA,387,361,765,720,1485
14,14014,140148609,Capital,CORDOBA,265,270,541,552,1093
14,14014,140148402,Capital,CORDOBA,287,274,502,425,927
14,14014,140145703,Capital,CORDOBA,248,371,282,190,472
14,14014,140145307,Capital,CORDOBA,220,275,328,268,596
14,14014,140145205,Capital,CORDOBA,161,191,246,210,456
14,14014,140145113,Capital,CORDOBA,308,307,504,484,988
14,14014,140145112,Capital,CORDOBA,340,346,597,518,1115
14,14014,140145111,Capital,CORDOBA,250,279,414,388,802
14,14014,140145009,Capital,CORDOBA,358,428,511,376,887
14,14014,140144910,Capital,CORDOBA,148,242,151,157,308
14,14014,140144615,Capital,CORDOBA,320,317,527,466,993
14,14014,140144506,Capital,CORDOBA,298,366,387,361,748
14,14014,140143409,Capital,CORDOBA,250,275,403,375,778
14,14014,140143314,Capital,CORDOBA,237,254,465,402,867
14,14014,140143115,Capital,CORDOBA,254,244,454,411,865
14,14014,140148201,Capital,CORDOBA,315,549,292,257,549
14,14014,140148003,Capital,CORDOBA,190,301,183,150,333
14,14014,140147918,Capital,CORDOBA,256,267,424,376,800
14,14014,140147917,Capital,CORDOBA,283,329,427,397,824
14,14014,140147720,Capital,CORDOBA,340,345,633,582,1215
14,14014,140147711,Capital,CORDOBA,223,238,367,322,689
14,14014,140147512,Capital,CORDOBA,301,242,588,540,1128
14,14014,140147418,Capital,CORDOBA,264,314,470,393,863
14,14014,140147408,Capital,CORDOBA,302,291,567,501,1068
14,14014,140147407,Capital,CORDOBA,286,302,539,483,1022
14,14014,140147406,Capital,CORDOBA,361,352,738,698,1436
14,14014,140147203,Capital,CORDOBA,662,1009,607,495,1102
14,14014,140147202,Capital,CORDOBA,717,1114,784,559,1343
14,14014,140147201,Capital,CORDOBA,626,1100,621,513,1134
14,14014,140147111,Capital,CORDOBA,267,428,293,192,485
14,14014,140147110,Capital,CORDOBA,409,838,394,297,691
14,14014,140146706,Capital,CORDOBA,308,538,354,223,577
14,14014,140146601,Capital,CORDOBA,352,519,372,293,665
14,14014,140146504,Capital,CORDOBA,162,189,164,162,326
14,14014,140146306,Capital,CORDOBA,313,351,485,465,950
14,14014,140146113,Capital,CORDOBA,373,371,810,801,1611
14,14014,140146102,Capital,CORDOBA,280,274,533,528,1061
14,14014,140142907,Capital,CORDOBA,232,259,382,319,701
14,14014,140142614,Capital,CORDOBA,259,300,433,362,795
14,14014,140142409,Capital,CORDOBA,314,358,502,420,922
14,14014,140142315,Capital,CORDOBA,271,316,444,417,861
14,14014,140142215,Capital,CORDOBA,322,358,559,475,1034
14,14014,140142207,Capital,CORDOBA,204,240,400,368,768
14,14014,140141618,Capital,CORDOBA,403,399,926,902,1828
14,14014,140141612,Capital,CORDOBA,267,305,541,537,1078
14,14014,140141609,Capital,CORDOBA,261,240,487,489,976
14,14014,140141517,Capital,CORDOBA,323,358,609,604,1213
14,14014,140141504,Capital,CORDOBA,292,291,558,481,1039
14,14014,140144311,Capital,CORDOBA,280,329,481,426,907
14,14014,140144310,Capital,CORDOBA,226,245,397,377,774
14,14014,140144304,Capital,CORDOBA,353,349,742,714,1456
14,14014,140144219,Capital,CORDOBA,321,367,634,556,1190
14,14014,140144218,Capital,CORDOBA,282,274,547,533,1080
14,14014,140144110,Capital,CORDOBA,291,342,428,357,785
14,14014,140144009,Capital,CORDOBA,237,292,309,287,596
14,14014,140143911,Capital,CORDOBA,243,336,313,235,548
14,14014,140143702,Capital,CORDOBA,193,174,332,316,648
14,14014,140143513,Capital,CORDOBA,268,217,483,451,934
14,14014,140143508,Capital,CORDOBA,278,265,523,470,993
14,14014,140141308,Capital,CORDOBA,312,290,667,645,1312
14,14014,140141101,Capital,CORDOBA,110,120,208,245,453
14,14014,140141016,Capital,CORDOBA,271,280,543,508,1051
14,14014,140141006,Capital,CORDOBA,373,401,564,527,1091
14,14014,140141005,Capital,CORDOBA,205,218,340,330,670
14,14014,140141004,Capital,CORDOBA,259,266,451,339,790
14,14014,140141003,Capital,CORDOBA,220,244,356,301,657
14,14014,140140910,Capital,CORDOBA,346,374,692,623,1315
14,14014,140140909,Capital,CORDOBA,389,445,709,693,1402
14,14014,140140908,Capital,CORDOBA,387,413,819,820,1639
14,14014,140140905,Capital,CORDOBA,401,388,797,757,1554
14,14014,140140902,Capital,CORDOBA,330,362,682,666,1348
14,14014,140140809,Capital,CORDOBA,466,429,958,938,1896
14,14014,140140803,Capital,CORDOBA,114,121,208,179,387
14,14014,140140715,Capital,CORDOBA,240,240,571,573,1144
14,14014,140140714,Capital,CORDOBA,287,269,710,678,1388
14,14014,140140713,Capital,CORDOBA,251,260,554,589,1143
14,14014,140140711,Capital,CORDOBA,171,173,426,415,841
14,14014,140140709,Capital,CORDOBA,359,377,742,782,1524
14,14014,140140703,Capital,CORDOBA,179,186,331,318,649
14,14014,140140701,Capital,CORDOBA,359,363,638,651,1289
14,14014,140140610,Capital,CORDOBA,313,319,558,530,1088
14,14014,140140609,Capital,CORDOBA,309,335,615,615,1230
14,14014,140140507,Capital,CORDOBA,257,212,605,618,1223
14,14014,140140411,Capital,CORDOBA,417,422,774,793,1567
14,14014,140142202,Capital,CORDOBA,322,349,646,573,1219
14,14014,140142104,Capital,CORDOBA,383,456,810,762,1572
14,14014,140142016,Capital,CORDOBA,385,404,687,644,1331
14,14014,140147311,Capital,CORDOBA,229,318,325,273,598
14,14014,140146909,Capital,CORDOBA,170,234,199,202,401
14,14014,140146404,Capital,CORDOBA,327,406,400,314,714
14,14014,140146012,Capital,CORDOBA,163,244,228,178,406
14,14014,140145512,Capital,CORDOBA,155,253,178,139,317
14,14014,140145511,Capital,CORDOBA,217,372,231,196,427
14,14014,140145510,Capital,CORDOBA,158,294,158,127,285
14,14014,140141408,Capital,CORDOBA,50,26,111,92,203
14,14014,140140915,Capital,CORDOBA,13,15,32,32,64
14,14014,140140901,Capital,CORDOBA,11,11,18,24,42
14,14014,140140801,Capital,CORDOBA,3,3,26,16,42
14,14014,140140712,Capital,CORDOBA,130,134,230,274,504
14,14014,140140710,Capital,CORDOBA,59,62,103,105,208
14,14014,140140605,Capital,CORDOBA,252,260,440,493,933
14,14014,140140604,Capital,CORDOBA,221,253,408,449,857
14,14014,140140603,Capital,CORDOBA,66,72,120,119,239
14,14014,140140602,Capital,CORDOBA,43,55,93,81,174
14,14014,140140601,Capital,CORDOBA,225,253,399,411,810
14,14014,140140706,Capital,CORDOBA,15,16,11,18,29
14,14014,140140501,Capital,CORDOBA,248,260,450,449,899
14,14014,140140403,Capital,CORDOBA,101,123,186,190,376
14,14091,140910802,Punilla,CORDOBA,74,241,107,126,233
14,14091,140910605,Punilla,CORDOBA,21,71,31,28,59
14,14091,140910203,Punilla,CORDOBA,79,123,94,107,201
14,14091,140911703,Punilla,CORDOBA,9,36,16,16,32
14,14091,140911608,Punilla,CORDOBA,140,249,314,232,546
14,14091,140911309,Punilla,CORDOBA,111,180,179,206,385
14,14091,140910204,Punilla,CORDOBA,50,76,75,81,156
14,14091,140910201,Punilla,CORDOBA,92,118,160,161,321
14,14091,140911914,Punilla,CORDOBA,147,306,232,230,462
14,14091,140911809,Punilla,CORDOBA,171,401,232,278,510
14,14091,140911714,Punilla,CORDOBA,161,433,233,236,469
14,14091,140911712,Punilla,CORDOBA,142,311,232,207,439
14,14091,140911711,Punilla,CORDOBA,170,418,243,216,459
14,14091,140911710,Punilla,CORDOBA,149,298,228,222,450
14,14091,140911709,Punilla,CORDOBA,224,335,337,319,656
14,14091,140911708,Punilla,CORDOBA,196,299,263,246,509
14,14091,140911610,Punilla,CORDOBA,84,175,123,126,249
14,14091,140911609,Punilla,CORDOBA,130,231,205,218,423
14,14091,140911713,Punilla,CORDOBA,259,450,390,377,767
14,14091,140911510,Punilla,CORDOBA,243,272,436,398,834
14,14091,140911507,Punilla,CORDOBA,209,222,381,382,763
14,14091,140911505,Punilla,CORDOBA,169,264,259,234,493
14,14091,140911509,Punilla,CORDOBA,218,267,405,360,765
14,14091,140911508,Punilla,CORDOBA,213,291,358,331,689
14,14091,140911504,Punilla,CORDOBA,195,255,321,279,600
14,14091,140911415,Punilla,CORDOBA,169,287,357,299,656
14,14091,140911502,Punilla,CORDOBA,141,151,258,232,490
14,14091,140911413,Punilla,CORDOBA,281,351,403,342,745
14,14091,140911412,Punilla,CORDOBA,209,246,353,321,674
14,14091,140911410,Punilla,CORDOBA,364,411,619,573,1192
14,14091,140911409,Punilla,CORDOBA,283,313,492,433,925
14,14091,140911407,Punilla,CORDOBA,301,377,439,401,840
14,14091,140911406,Punilla,CORDOBA,139,251,251,245,496
14,14091,140911408,Punilla,CORDOBA,237,296,380,310,690
14,14091,140911323,Punilla,CORDOBA,183,341,301,324,625
14,14091,140911318,Punilla,CORDOBA,120,259,203,175,378
14,14091,140911317,Punilla,CORDOBA,126,254,183,158,341
14,14091,140911316,Punilla,CORDOBA,101,223,160,146,306
14,14091,140911315,Punilla,CORDOBA,239,326,432,400,832
14,14091,140911314,Punilla,CORDOBA,135,231,206,219,425
14,14091,140911313,Punilla,CORDOBA,243,352,411,423,834
14,14091,140911312,Punilla,CORDOBA,170,409,296,269,565
14,14091,140911311,Punilla,CORDOBA,287,487,512,500,1012
14,14091,140911310,Punilla,CORDOBA,100,128,137,150,287
14,14091,140911223,Punilla,CORDOBA,173,212,350,349,699
14,14091,140911222,Punilla,CORDOBA,234,266,376,365,741
14,14091,140911221,Punilla,CORDOBA,220,270,410,378,788
14,14091,140911220,Punilla,CORDOBA,221,273,379,328,707
14,14091,140911219,Punilla,CORDOBA,275,409,446,394,840
14,14091,140911218,Punilla,CORDOBA,194,359,299,287,586
14,14091,140911217,Punilla,CORDOBA,184,350,296,270,566
14,14091,140911216,Punilla,CORDOBA,136,351,195,199,394
14,14091,140911215,Punilla,CORDOBA,283,370,462,472,934
14,14091,140911214,Punilla,CORDOBA,273,343,488,431,919
14,14091,140911213,Punilla,CORDOBA,223,370,362,331,693
14,14091,140911212,Punilla,CORDOBA,175,334,303,280,583
14,14091,140911211,Punilla,CORDOBA,280,328,507,467,974
14,14091,140911210,Punilla,CORDOBA,272,327,469,484,953
14,14091,140911209,Punilla,CORDOBA,218,236,355,333,688
14,14091,140911206,Punilla,CORDOBA,192,240,283,280,563
14,14091,140911205,Punilla,CORDOBA,317,391,502,453,955
14,14091,140911204,Punilla,CORDOBA,291,343,493,432,925
14,14091,140911203,Punilla,CORDOBA,262,343,379,345,724
14,14091,140911201,Punilla,CORDOBA,315,474,454,431,885
14,14091,140911118,Punilla,CORDOBA,198,288,299,294,593
14,14091,140911117,Punilla,CORDOBA,121,254,304,265,569
14,14091,140911116,Punilla,CORDOBA,174,248,273,247,520
14,14091,140911115,Punilla,CORDOBA,221,328,294,265,559
14,14091,140911114,Punilla,CORDOBA,186,262,286,236,522
14,14091,140911113,Punilla,CORDOBA,185,267,328,292,620
14,14091,140911112,Punilla,CORDOBA,247,362,375,366,741
14,14091,140911111,Punilla,CORDOBA,157,437,197,132,329
14,14091,140911110,Punilla,CORDOBA,322,465,465,369,834
14,14091,140911109,Punilla,CORDOBA,202,379,513,389,902
14,14091,140911108,Punilla,CORDOBA,200,366,246,233,479
14,14091,140911107,Punilla,CORDOBA,146,303,178,139,317
14,14091,140911106,Punilla,CORDOBA,104,252,130,106,236
14,14091,140911105,Punilla,CORDOBA,287,377,495,470,965
14,14091,140911104,Punilla,CORDOBA,194,319,365,266,631
14,14091,140911103,Punilla,CORDOBA,191,281,345,305,650
14,14091,140911102,Punilla,CORDOBA,158,301,358,230,588
14,14091,140911101,Punilla,CORDOBA,214,418,358,301,659
14,14091,140911020,Punilla,CORDOBA,112,197,158,155,313
14,14091,140911019,Punilla,CORDOBA,181,239,287,245,532
14,14091,140911018,Punilla,CORDOBA,215,330,377,315,692
14,14091,140911017,Punilla,CORDOBA,199,289,371,302,673
14,14091,140911016,Punilla,CORDOBA,192,266,380,297,677
14,14091,140911015,Punilla,CORDOBA,236,371,350,290,640
14,14091,140911014,Punilla,CORDOBA,178,235,253,241,494
14,14091,140911013,Punilla,CORDOBA,274,378,486,393,879
14,14091,140911012,Punilla,CORDOBA,209,240,333,276,609
14,14091,140911011,Punilla,CORDOBA,218,337,352,310,662
14,14091,140911010,Punilla,CORDOBA,238,348,355,355,710
14,14091,140911004,Punilla,CORDOBA,339,521,571,443,1014
14,14091,140911003,Punilla,CORDOBA,222,396,381,332,713
14,14091,140911002,Punilla,CORDOBA,212,392,390,320,710
14,14091,140911001,Punilla,CORDOBA,214,372,498,441,939
14,14091,140910923,Punilla,CORDOBA,0,401,0,0,0
14,14091,140910921,Punilla,CORDOBA,413,423,860,793,1653
14,14091,140910920,Punilla,CORDOBA,255,291,460,400,860
14,14091,140910919,Punilla,CORDOBA,217,259,364,309,673
14,14091,140910918,Punilla,CORDOBA,140,284,295,297,592
14,14091,140910917,Punilla,CORDOBA,241,402,469,400,869
14,14091,140910915,Punilla,CORDOBA,328,342,594,574,1168
14,14091,140910914,Punilla,CORDOBA,300,341,534,516,1050
14,14091,140910912,Punilla,CORDOBA,219,338,309,315,624
14,14091,140910911,Punilla,CORDOBA,129,340,169,122,291
14,14091,140910909,Punilla,CORDOBA,236,377,425,396,821
14,14091,140910908,Punilla,CORDOBA,257,314,431,361,792
14,14091,140910907,Punilla,CORDOBA,249,258,419,398,817
14,14091,140910906,Punilla,CORDOBA,293,337,547,504,1051
14,14091,140910904,Punilla,CORDOBA,325,466,599,618,1217
14,14091,140910903,Punilla,CORDOBA,155,290,339,278,617
14,14091,140910902,Punilla,CORDOBA,163,307,262,273,535
14,14091,140910901,Punilla,CORDOBA,255,390,437,417,854
14,14091,140911208,Punilla,CORDOBA,345,339,679,605,1284
14,14091,140910813,Punilla,CORDOBA,315,465,511,555,1066
14,14091,140910812,Punilla,CORDOBA,243,438,524,492,1016
14,14091,140911005,Punilla,CORDOBA,219,396,421,396,817
14,14091,140910811,Punilla,CORDOBA,171,350,296,241,537
14,14091,140910809,Punilla,CORDOBA,214,336,314,315,629
14,14091,140910808,Punilla,CORDOBA,134,258,200,230,430
14,14091,140910922,Punilla,CORDOBA,386,403,786,730,1516
14,14091,140910806,Punilla,CORDOBA,198,306,326,303,629
14,14091,140910805,Punilla,CORDOBA,166,291,306,255,561
14,14091,140910913,Punilla,CORDOBA,215,243,377,378,755
14,14091,140910807,Punilla,CORDOBA,174,354,288,282,570
14,14091,140910804,Punilla,CORDOBA,99,227,174,169,343
14,14091,140911207,Punilla,CORDOBA,277,316,498,469,967
14,14091,140910905,Punilla,CORDOBA,358,481,626,574,1200
14,14091,140910723,Punilla,CORDOBA,246,264,466,458,924
14,14091,140910720,Punilla,CORDOBA,399,448,652,614,1266
14,14091,140910719,Punilla,CORDOBA,189,243,286,265,551
14,14091,140910718,Punilla,CORDOBA,308,385,480,430,910
14,14091,140910717,Punilla,CORDOBA,168,250,287,298,585
14,14091,140911009,Punilla,CORDOBA,222,356,319,279,598
14,14091,140910722,Punilla,CORDOBA,332,373,612,584,1196
14,14091,140910716,Punilla,CORDOBA,288,370,434,349,783
14,14091,140910505,Punilla,CORDOBA,281,319,533,504,1037
14,14091,140910504,Punilla,CORDOBA,316,400,497,468,965
14,14091,140910502,Punilla,CORDOBA,153,211,280,270,550
14,14091,140910714,Punilla,CORDOBA,251,258,425,423,848
14,14091,140910611,Punilla,CORDOBA,213,287,371,311,682
14,14091,140910419,Punilla,CORDOBA,202,247,361,334,695
14,14091,140910418,Punilla,CORDOBA,252,311,401,355,756
14,14091,140910713,Punilla,CORDOBA,412,469,712,638,1350
14,14091,140910413,Punilla,CORDOBA,357,418,550,445,995
14,14091,140910412,Punilla,CORDOBA,110,145,159,137,296
14,14091,140910510,Punilla,CORDOBA,200,229,353,341,694
14,14091,140910408,Punilla,CORDOBA,227,301,370,349,719
14,14091,140910407,Punilla,CORDOBA,322,471,610,506,1116
14,14091,140910406,Punilla,CORDOBA,243,339,387,308,695
14,14091,140910404,Punilla,CORDOBA,263,298,490,454,944
14,14091,140910403,Punilla,CORDOBA,236,283,397,321,718
14,14091,140910402,Punilla,CORDOBA,290,313,512,433,945
14,14091,140910401,Punilla,CORDOBA,265,301,537,522,1059
14,14091,140910310,Punilla,CORDOBA,196,268,308,284,592
14,14091,140910309,Punilla,CORDOBA,284,355,454,364,818
14,14091,140910307,Punilla,CORDOBA,203,278,420,369,789
14,14091,140910306,Punilla,CORDOBA,179,252,271,280,551
14,14091,140910304,Punilla,CORDOBA,291,400,514,476,990
14,14091,140910405,Punilla,CORDOBA,265,328,424,310,734
14,14091,140910311,Punilla,CORDOBA,180,303,332,317,649
14,14091,140910210,Punilla,CORDOBA,250,377,500,440,940
14,14091,140910209,Punilla,CORDOBA,267,391,436,416,852
14,14091,140911913,Punilla,CORDOBA,196,345,333,331,664
14,14091,140911910,Punilla,CORDOBA,195,259,316,358,674
14,14091,140911909,Punilla,CORDOBA,200,259,350,329,679
14,14091,140911908,Punilla,CORDOBA,225,584,326,353,679
14,14091,140911907,Punilla,CORDOBA,126,253,220,256,476
14,14091,140911906,Punilla,CORDOBA,195,429,283,300,583
14,14091,140911810,Punilla,CORDOBA,36,189,53,78,131
14,14091,140910211,Punilla,CORDOBA,99,168,155,147,302
14,14091,140910119,Punilla,CORDOBA,145,247,229,201,430
14,14091,140910118,Punilla,CORDOBA,232,318,354,335,689
14,14091,140910117,Punilla,CORDOBA,153,194,232,212,444
14,14091,140910115,Punilla,CORDOBA,106,146,181,164,345
14,14091,140910114,Punilla,CORDOBA,247,296,462,409,871
14,14091,140910113,Punilla,CORDOBA,273,354,411,368,779
14,14091,140910112,Punilla,CORDOBA,205,287,290,274,564
14,14091,140910111,Punilla,CORDOBA,175,267,283,250,533
14,14091,140910110,Punilla,CORDOBA,204,248,282,241,523
14,14091,140910109,Punilla,CORDOBA,151,215,244,213,457
14,14091,140910108,Punilla,CORDOBA,247,335,395,281,676
14,14091,140910107,Punilla,CORDOBA,241,316,401,356,757
14,14091,140910105,Punilla,CORDOBA,92,140,143,136,279
14,14091,140910104,Punilla,CORDOBA,233,327,331,301,632
14,14091,140910103,Punilla,CORDOBA,222,273,335,282,617
14,14091,140910102,Punilla,CORDOBA,119,146,249,206,455
14,14091,140910101,Punilla,CORDOBA,231,268,417,419,836
14,14091,140910710,Punilla,CORDOBA,167,222,247,205,452
14,14091,140910709,Punilla,CORDOBA,335,442,510,427,937
14,14091,140910708,Punilla,CORDOBA,279,358,410,337,747
14,14091,140910712,Punilla,CORDOBA,289,401,417,356,773
14,14091,140910711,Punilla,CORDOBA,288,377,487,381,868
14,14091,140910707,Punilla,CORDOBA,271,393,443,369,812
14,14091,140910706,Punilla,CORDOBA,151,208,229,227,456
14,14091,140911008,Punilla,CORDOBA,239,388,478,412,890
14,14091,140910705,Punilla,CORDOBA,200,276,303,257,560
14,14091,140910703,Punilla,CORDOBA,337,387,506,464,970
14,14091,140910702,Punilla,CORDOBA,198,318,338,348,686
14,14091,140910618,Punilla,CORDOBA,142,203,321,342,663
14,14091,140911006,Punilla,CORDOBA,290,394,456,428,884
14,14091,140910617,Punilla,CORDOBA,191,304,369,309,678
14,14091,140910615,Punilla,CORDOBA,173,256,281,245,526
14,14091,140910614,Punilla,CORDOBA,197,270,276,287,563
14,14091,140910613,Punilla,CORDOBA,227,363,399,363,762
14,14091,140910610,Punilla,CORDOBA,325,416,525,462,987
14,14091,140910609,Punilla,CORDOBA,179,248,274,241,515
14,14091,140910607,Punilla,CORDOBA,308,355,519,463,982
14,14091,140910606,Punilla,CORDOBA,254,295,445,428,873
14,14091,140910612,Punilla,CORDOBA,180,249,325,317,642
14,14091,140910721,Punilla,CORDOBA,401,440,754,696,1450
14,14091,140910509,Punilla,CORDOBA,191,293,303,295,598
14,14091,140910508,Punilla,CORDOBA,101,216,174,149,323
14,14091,140910507,Punilla,CORDOBA,161,223,300,261,561
14,14091,140910715,Punilla,CORDOBA,356,446,628,491,1119
14,14091,140911715,Punilla,CORDOBA,98,241,148,155,303
14,14091,140911202,Punilla,CORDOBA,233,368,343,295,638
14,14091,140911007,Punilla,CORDOBA,155,202,301,305,606
14,14091,140910916,Punilla,CORDOBA,346,435,590,617,1207
14,14091,140910910,Punilla,CORDOBA,170,293,281,208,489
14,14091,140911904,Punilla,CORDOBA,14,15,25,54,79
14,14091,140911903,Punilla,CORDOBA,1,2,1,1,2
14,14091,140911805,Punilla,CORDOBA,54,66,88,93,181
14,14091,140911803,Punilla,CORDOBA,11,28,21,27,48
14,14091,140911902,Punilla,CORDOBA,34,39,49,45,94
14,14091,140911704,Punilla,CORDOBA,2,15,2,1,3
14,14091,140911702,Punilla,CORDOBA,2,10,3,5,8
14,14091,140911901,Punilla,CORDOBA,41,56,74,76,150
14,14091,140911603,Punilla,CORDOBA,3,4,6,4,10
14,14091,140911602,Punilla,CORDOBA,18,45,17,26,43
14,14091,140911607,Punilla,CORDOBA,5,10,13,9,22
14,14091,140911501,Punilla,CORDOBA,5,7,8,10,18
14,14091,140911405,Punilla,CORDOBA,32,61,39,59,98
14,14091,140911403,Punilla,CORDOBA,10,14,15,16,31
14,14091,140911402,Punilla,CORDOBA,22,28,41,36,77
14,14091,140911401,Punilla,CORDOBA,14,37,18,24,42
14,14091,140911307,Punilla,CORDOBA,6,11,9,9,18
14,14091,140911305,Punilla,CORDOBA,7,11,10,6,16
14,14091,140911304,Punilla,CORDOBA,5,6,8,7,15
14,14091,140911306,Punilla,CORDOBA,9,20,11,14,25
14,14091,140910803,Punilla,CORDOBA,4,10,6,10,16
14,14091,140910602,Punilla,CORDOBA,103,121,203,196,399
14,14091,140910501,Punilla,CORDOBA,5,7,8,10,18
14,14091,140910302,Punilla,CORDOBA,15,21,24,34,58
14,14091,140910212,Punilla,CORDOBA,4,21,2,3,5
14,14091,140910208,Punilla,CORDOBA,6,9,10,15,25
14,14091,140910205,Punilla,CORDOBA,4,8,7,11,18
14,14091,140910202,Punilla,CORDOBA,39,49,58,82,140
14,14091,140911912,Punilla,CORDOBA,42,191,47,61,108
14,14091,140911911,Punilla,CORDOBA,285,406,479,450,929
14,14091,140911808,Punilla,CORDOBA,194,416,318,309,627
14,14091,140911807,Punilla,CORDOBA,90,238,140,142,282
14,14091,140911806,Punilla,CORDOBA,117,470,167,169,336
14,14091,140910810,Punilla,CORDOBA,230,342,398,375,773
14,14091,140910704,Punilla,CORDOBA,228,363,369,330,699
14,14091,140910616,Punilla,CORDOBA,165,286,279,240,519
14,14091,140910608,Punilla,CORDOBA,296,354,556,578,1134
14,14091,140910506,Punilla,CORDOBA,202,262,385,306,691
14,14091,140910503,Punilla,CORDOBA,244,297,410,358,768
14,14091,140910420,Punilla,CORDOBA,294,304,525,521,1046
14,14091,140910417,Punilla,CORDOBA,327,377,710,608,1318
14,14091,140910416,Punilla,CORDOBA,178,209,279,259,538
14,14091,140910415,Punilla,CORDOBA,247,284,443,430,873
14,14091,140910414,Punilla,CORDOBA,230,290,318,267,585
14,14091,140910411,Punilla,CORDOBA,319,403,509,411,920
14,14091,140910410,Punilla,CORDOBA,147,152,264,182,446
14,14091,140910409,Punilla,CORDOBA,345,463,524,413,937
14,14091,140910308,Punilla,CORDOBA,224,298,374,385,759
14,14091,140910305,Punilla,CORDOBA,224,327,356,330,686
14,14091,140910303,Punilla,CORDOBA,218,333,446,422,868
14,14091,140910116,Punilla,CORDOBA,215,287,329,308,637
14,14091,140910106,Punilla,CORDOBA,224,297,369,288,657
14,14091,140911707,Punilla,CORDOBA,159,232,287,273,560
14,14091,140911706,Punilla,CORDOBA,236,375,410,403,813
14,14091,140911506,Punilla,CORDOBA,209,249,304,273,577
14,14091,140911503,Punilla,CORDOBA,201,292,352,362,714
14,14091,140911414,Punilla,CORDOBA,250,364,406,293,699
14,14091,140911411,Punilla,CORDOBA,191,246,336,291,627
14,14091,140911322,Punilla,CORDOBA,84,206,131,124,255
14,14091,140911321,Punilla,CORDOBA,89,276,139,152,291
14,14091,140911320,Punilla,CORDOBA,104,301,157,147,304
14,14091,140911319,Punilla,CORDOBA,107,173,175,146,321
14,14091,140911802,Punilla,CORDOBA,5,15,10,10,20
14,14091,140911801,Punilla,CORDOBA,7,28,21,24,45
14,14091,140911705,Punilla,CORDOBA,4,6,8,10,18
14,14091,140911701,Punilla,CORDOBA,2,16,1,2,3
14,14091,140911606,Punilla,CORDOBA,25,41,45,42,87
14,14091,140911605,Punilla,CORDOBA,62,74,87,112,199
14,14091,140911604,Punilla,CORDOBA,8,12,8,10,18
14,14091,140911601,Punilla,CORDOBA,7,14,6,12,18
14,14091,140911404,Punilla,CORDOBA,17,34,26,46,72
14,14091,140911308,Punilla,CORDOBA,7,21,7,8,15
14,14091,140911303,Punilla,CORDOBA,28,52,36,43,79
14,14091,140911302,Punilla,CORDOBA,9,9,16,28,44
14,14091,140911301,Punilla,CORDOBA,5,8,3,8,11
14,14091,140910801,Punilla,CORDOBA,11,34,5,10,15
14,14091,140910701,Punilla,CORDOBA,13,17,51,49,100
14,14091,140910604,Punilla,CORDOBA,18,26,31,29,60
14,14091,140910603,Punilla,CORDOBA,23,22,31,38,69
14,14091,140910601,Punilla,CORDOBA,1,8,2,2,4
14,14091,140910301,Punilla,CORDOBA,6,19,12,12,24
14,14091,140910207,Punilla,CORDOBA,4,8,2,4,6
14,14091,140910206,Punilla,CORDOBA,24,33,35,47,82
14,14091,140911905,Punilla,CORDOBA,11,18,11,20,31
14,14091,140911804,Punilla,CORDOBA,69,115,170,193,363
14,14077,140770207,Pocho,CORDOBA,56,76,93,96,189
14,14077,140770203,Pocho,CORDOBA,124,198,268,250,518
14,14077,140770202,Pocho,CORDOBA,83,129,133,157,290
14,14077,140770211,Pocho,CORDOBA,196,286,318,277,595
14,14077,140770210,Pocho,CORDOBA,230,323,347,333,680
14,14077,140770110,Pocho,CORDOBA,122,164,212,210,422
14,14077,140770213,Pocho,CORDOBA,58,101,85,86,171
14,14077,140770212,Pocho,CORDOBA,56,110,95,88,183
14,14077,140770209,Pocho,CORDOBA,34,53,30,47,77
14,14077,140770109,Pocho,CORDOBA,31,34,54,65,119
14,14077,140770108,Pocho,CORDOBA,26,34,40,59,99
14,14077,140770107,Pocho,CORDOBA,44,62,63,71,134
14,14077,140770205,Pocho,CORDOBA,55,92,69,79,148
14,14077,140770106,Pocho,CORDOBA,46,54,79,88,167
14,14077,140770103,Pocho,CORDOBA,44,51,65,69,134
14,14077,140770101,Pocho,CORDOBA,13,20,16,28,44
14,14077,140770206,Pocho,CORDOBA,18,35,22,26,48
14,14077,140770104,Pocho,CORDOBA,24,26,38,55,93
14,14077,140770208,Pocho,CORDOBA,58,81,69,93,162
14,14077,140770204,Pocho,CORDOBA,190,248,335,396,731
14,14077,140770201,Pocho,CORDOBA,50,83,68,96,164
14,14077,140770105,Pocho,CORDOBA,45,54,102,86,188
14,14077,140770102,Pocho,CORDOBA,8,13,10,14,24
14,14049,140490213,Ischilín,CORDOBA,69,107,93,112,205
14,14049,140490207,Ischilín,CORDOBA,52,99,95,106,201
14,14049,140490202,Ischilín,CORDOBA,45,78,62,80,142
14,14049,140490211,Ischilín,CORDOBA,126,173,229,238,467
14,14049,140490204,Ischilín,CORDOBA,81,157,103,177,280
14,14049,140490201,Ischilín,CORDOBA,200,277,371,463,834
14,14049,140490109,Ischilín,CORDOBA,109,160,164,174,338
14,14049,140490324,Ischilín,CORDOBA,167,188,386,383,769
14,14049,140490305,Ischilín,CORDOBA,234,244,499,470,969
14,14049,140490325,Ischilín,CORDOBA,272,319,505,505,1010
14,14049,140490111,Ischilín,CORDOBA,130,156,279,278,557
14,14049,140490323,Ischilín,CORDOBA,211,238,425,406,831
14,14049,140490322,Ischilín,CORDOBA,326,361,649,554,1203
14,14049,140490314,Ischilín,CORDOBA,208,224,429,374,803
14,14049,140490313,Ischilín,CORDOBA,224,271,446,366,812
14,14049,140490312,Ischilín,CORDOBA,265,306,516,454,970
14,14049,140490311,Ischilín,CORDOBA,329,382,677,552,1229
14,14049,140490310,Ischilín,CORDOBA,240,294,386,340,726
14,14049,140490309,Ischilín,CORDOBA,306,366,499,427,926
14,14049,140490308,Ischilín,CORDOBA,237,271,454,423,877
14,14049,140490307,Ischilín,CORDOBA,267,286,512,460,972
14,14049,140490306,Ischilín,CORDOBA,165,176,327,317,644
14,14049,140490304,Ischilín,CORDOBA,174,202,378,360,738
14,14049,140490303,Ischilín,CORDOBA,314,342,635,511,1146
14,14049,140490302,Ischilín,CORDOBA,175,184,348,343,691
14,14049,140490301,Ischilín,CORDOBA,172,188,343,355,698
14,14049,140490215,Ischilín,CORDOBA,86,112,152,130,282
14,14049,140490214,Ischilín,CORDOBA,147,164,271,279,550
14,14049,140490116,Ischilín,CORDOBA,361,421,681,659,1340
14,14049,140490112,Ischilín,CORDOBA,122,193,224,222,446
14,14049,140490321,Ischilín,CORDOBA,215,233,392,388,780
14,14049,140490320,Ischilín,CORDOBA,300,350,538,470,1008
14,14049,140490319,Ischilín,CORDOBA,358,409,619,499,1118
14,14049,140490318,Ischilín,CORDOBA,229,275,372,296,668
14,14049,140490317,Ischilín,CORDOBA,196,228,330,279,609
14,14049,140490316,Ischilín,CORDOBA,216,231,372,308,680
14,14049,140490315,Ischilín,CORDOBA,121,179,182,152,334
14,14049,140490115,Ischilín,CORDOBA,182,256,434,400,834
14,14049,140490114,Ischilín,CORDOBA,231,274,397,370,767
14,14049,140490113,Ischilín,CORDOBA,315,382,625,526,1151
14,14049,140490212,Ischilín,CORDOBA,28,39,50,56,106
14,14049,140490208,Ischilín,CORDOBA,9,21,8,14,22
14,14049,140490206,Ischilín,CORDOBA,26,40,29,41,70
14,14049,140490205,Ischilín,CORDOBA,24,53,33,47,80
14,14049,140490203,Ischilín,CORDOBA,34,49,35,45,80
14,14049,140490108,Ischilín,CORDOBA,59,105,101,109,210
14,14049,140490107,Ischilín,CORDOBA,25,40,30,46,76
14,14049,140490106,Ischilín,CORDOBA,23,28,35,51,86
14,14049,140490103,Ischilín,CORDOBA,62,89,101,124,225
14,14049,140490102,Ischilín,CORDOBA,46,73,62,62,124
14,14049,140490101,Ischilín,CORDOBA,40,43,49,56,105
14,14049,140490210,Ischilín,CORDOBA,50,128,48,72,120
14,14049,140490209,Ischilín,CORDOBA,25,99,25,32,57
14,14049,140490110,Ischilín,CORDOBA,18,26,28,37,65
14,14049,140490105,Ischilín,CORDOBA,51,64,61,89,150
14,14049,140490104,Ischilín,CORDOBA,37,59,59,72,131
14,14112,141120306,Río Seco,CORDOBA,124,157,171,178,349
14,14112,141120304,Río Seco,CORDOBA,188,293,284,325,609
14,14112,141120309,Río Seco,CORDOBA,68,102,115,122,237
14,14112,141120201,Río Seco,CORDOBA,187,233,272,329,601
14,14112,141120302,Río Seco,CORDOBA,91,140,137,143,280
14,14112,141120106,Río Seco,CORDOBA,86,117,115,126,241
14,14112,141120104,Río Seco,CORDOBA,94,148,145,182,327
14,14112,141120314,Río Seco,CORDOBA,66,165,114,111,225
14,14112,141120312,Río Seco,CORDOBA,257,296,463,473,936
14,14112,141120311,Río Seco,CORDOBA,192,239,356,352,708
14,14112,141120115,Río Seco,CORDOBA,176,265,337,317,654
14,14112,141120114,Río Seco,CORDOBA,113,109,195,180,375
14,14112,141120113,Río Seco,CORDOBA,203,288,338,308,646
14,14112,141120112,Río Seco,CORDOBA,293,346,597,582,1179
14,14112,141120111,Río Seco,CORDOBA,134,152,212,184,396
14,14112,141120313,Río Seco,CORDOBA,235,260,438,399,837
14,14112,141120310,Río Seco,CORDOBA,206,260,336,339,675
14,14112,141120207,Río Seco,CORDOBA,137,171,269,273,542
14,14112,141120110,Río Seco,CORDOBA,197,231,356,337,693
14,14112,141120109,Río Seco,CORDOBA,198,245,367,338,705
14,14112,141120206,Río Seco,CORDOBA,52,55,70,110,180
14,14112,141120308,Río Seco,CORDOBA,36,48,39,60,99
14,14112,141120307,Río Seco,CORDOBA,68,71,95,100,195
14,14112,141120305,Río Seco,CORDOBA,72,90,111,137,248
14,14112,141120303,Río Seco,CORDOBA,39,53,64,67,131
14,14112,141120107,Río Seco,CORDOBA,24,59,39,56,95
14,14112,141120105,Río Seco,CORDOBA,44,78,78,84,162
14,14112,141120205,Río Seco,CORDOBA,20,22,29,42,71
14,14112,141120103,Río Seco,CORDOBA,46,68,69,68,137
14,14112,141120204,Río Seco,CORDOBA,19,26,25,43,68
14,14112,141120102,Río Seco,CORDOBA,40,50,68,69,137
14,14112,141120301,Río Seco,CORDOBA,34,78,49,55,104
14,14112,141120203,Río Seco,CORDOBA,20,25,39,45,84
14,14112,141120202,Río Seco,CORDOBA,23,32,14,44,58
14,14112,141120108,Río Seco,CORDOBA,48,60,92,87,179
14,14112,141120101,Río Seco,CORDOBA,16,19,34,45,79
14,14105,141050604,Río Primero,CORDOBA,113,159,223,202,425
14,14105,141050410,Río Primero,CORDOBA,97,144,144,155,299
14,14105,141050404,Río Primero,CORDOBA,55,105,74,97,171
14,14105,141050305,Río Primero,CORDOBA,109,143,171,210,381
14,14105,141050303,Río Primero,CORDOBA,55,100,85,104,189
14,14105,141050208,Río Primero,CORDOBA,70,103,109,116,225
14,14105,141050306,Río Primero,CORDOBA,44,70,78,96,174
14,14105,141050110,Río Primero,CORDOBA,73,109,134,134,268
14,14105,141050109,Río Primero,CORDOBA,127,168,182,201,383
14,14105,141050108,Río Primero,CORDOBA,86,144,121,151,272
14,14105,141050106,Río Primero,CORDOBA,79,136,108,145,253
14,14105,141050103,Río Primero,CORDOBA,124,173,186,185,371
14,14105,141050101,Río Primero,CORDOBA,82,101,124,129,253
14,14105,141050111,Río Primero,CORDOBA,61,77,108,124,232
14,14105,141050416,Río Primero,CORDOBA,85,95,141,146,287
14,14105,141050610,Río Primero,CORDOBA,366,399,652,607,1259
14,14105,141050609,Río Primero,CORDOBA,300,368,496,452,948
14,14105,141050608,Río Primero,CORDOBA,298,325,485,477,962
14,14105,141050607,Río Primero,CORDOBA,186,205,335,294,629
14,14105,141050606,Río Primero,CORDOBA,173,203,312,307,619
14,14105,141050513,Río Primero,CORDOBA,141,156,241,224,465
14,14105,141050512,Río Primero,CORDOBA,225,280,399,385,784
14,14105,141050511,Río Primero,CORDOBA,216,231,364,318,682
14,14105,141050510,Río Primero,CORDOBA,294,331,533,466,999
14,14105,141050509,Río Primero,CORDOBA,211,226,433,418,851
14,14105,141050508,Río Primero,CORDOBA,301,322,575,540,1115
14,14105,141050507,Río Primero,CORDOBA,234,260,412,383,795
14,14105,141050506,Río Primero,CORDOBA,243,309,420,388,808
14,14105,141050505,Río Primero,CORDOBA,334,340,662,652,1314
14,14105,141050415,Río Primero,CORDOBA,244,271,390,401,791
14,14105,141050414,Río Primero,CORDOBA,141,156,281,275,556
14,14105,141050308,Río Primero,CORDOBA,146,168,269,240,509
14,14105,141050315,Río Primero,CORDOBA,332,382,581,529,1110
14,14105,141050314,Río Primero,CORDOBA,315,372,567,510,1077
14,14105,141050313,Río Primero,CORDOBA,342,395,605,599,1204
14,14105,141050215,Río Primero,CORDOBA,311,327,483,455,938
14,14105,141050214,Río Primero,CORDOBA,254,297,428,395,823
14,14105,141050213,Río Primero,CORDOBA,209,228,307,304,611
14,14105,141050212,Río Primero,CORDOBA,216,232,353,341,694
14,14105,141050211,Río Primero,CORDOBA,247,260,398,409,807
14,14105,141050210,Río Primero,CORDOBA,135,142,245,224,469
14,14105,141050515,Río Primero,CORDOBA,247,308,406,391,797
14,14105,141050312,Río Primero,CORDOBA,228,252,428,403,831
14,14105,141050311,Río Primero,CORDOBA,159,186,278,257,535
14,14105,141050310,Río Primero,CORDOBA,293,305,501,469,970
14,14105,141050309,Río Primero,CORDOBA,367,423,599,599,1198
14,14105,141050316,Río Primero,CORDOBA,287,324,459,377,836
14,14105,141050514,Río Primero,CORDOBA,392,426,742,699,1441
14,14105,141050217,Río Primero,CORDOBA,312,344,531,533,1064
14,14105,141050216,Río Primero,CORDOBA,356,396,565,556,1121
14,14105,141050209,Río Primero,CORDOBA,49,68,64,70,134
14,14105,141050613,Río Primero,CORDOBA,99,121,180,185,365
14,14105,141050612,Río Primero,CORDOBA,384,445,712,685,1397
14,14105,141050611,Río Primero,CORDOBA,317,360,622,608,1230
14,14105,141050114,Río Primero,CORDOBA,275,339,518,446,964
14,14105,141050113,Río Primero,CORDOBA,196,229,409,392,801
14,14105,141050112,Río Primero,CORDOBA,189,210,347,308,655
14,14105,141050605,Río Primero,CORDOBA,90,135,162,186,348
14,14105,141050602,Río Primero,CORDOBA,80,114,148,138,286
14,14105,141050601,Río Primero,CORDOBA,68,102,95,115,210
14,14105,141050504,Río Primero,CORDOBA,166,231,254,388,642
14,14105,141050503,Río Primero,CORDOBA,248,290,360,439,799
14,14105,141050502,Río Primero,CORDOBA,102,135,168,197,365
14,14105,141050501,Río Primero,CORDOBA,43,68,61,78,139
14,14105,141050413,Río Primero,CORDOBA,31,41,44,56,100
14,14105,141050412,Río Primero,CORDOBA,42,92,76,84,160
14,14105,141050411,Río Primero,CORDOBA,23,37,41,42,83
14,14105,141050409,Río Primero,CORDOBA,40,61,70,69,139
14,14105,141050408,Río Primero,CORDOBA,27,54,45,51,96
14,14105,141050407,Río Primero,CORDOBA,64,83,125,127,252
14,14105,141050406,Río Primero,CORDOBA,52,82,84,115,199
14,14105,141050405,Río Primero,CORDOBA,44,73,62,99,161
14,14105,141050403,Río Primero,CORDOBA,21,48,35,42,77
14,14105,141050402,Río Primero,CORDOBA,50,89,69,92,161
14,14105,141050304,Río Primero,CORDOBA,23,30,36,33,69
14,14105,141050307,Río Primero,CORDOBA,38,72,43,72,115
14,14105,141050302,Río Primero,CORDOBA,44,67,71,84,155
14,14105,141050301,Río Primero,CORDOBA,17,44,27,31,58
14,14105,141050205,Río Primero,CORDOBA,71,114,127,148,275
14,14105,141050204,Río Primero,CORDOBA,33,58,49,56,105
14,14105,141050203,Río Primero,CORDOBA,63,89,107,133,240
14,14105,141050202,Río Primero,CORDOBA,16,21,32,26,58
14,14105,141050207,Río Primero,CORDOBA,27,61,33,39,72
14,14105,141050107,Río Primero,CORDOBA,56,89,72,74,146
14,14105,141050206,Río Primero,CORDOBA,64,89,87,127,214
14,14105,141050105,Río Primero,CORDOBA,20,35,24,26,50
14,14105,141050104,Río Primero,CORDOBA,34,67,51,66,117
14,14105,141050102,Río Primero,CORDOBA,35,55,65,57,122
14,14105,141050401,Río Primero,CORDOBA,13,28,18,21,39
14,14105,141050603,Río Primero,CORDOBA,57,104,97,109,206
14,14105,141050201,Río Primero,CORDOBA,26,47,32,44,76
14,14098,140981106,Río Cuarto,CORDOBA,97,151,127,215,342
14,14098,140980902,Río Cuarto,CORDOBA,145,196,201,246,447
14,14098,140980509,Río Cuarto,CORDOBA,50,84,75,83,158
14,14098,140980203,Río Cuarto,CORDOBA,84,101,111,135,246
14,14098,140980506,Río Cuarto,CORDOBA,135,183,258,354,612
14,14098,140980210,Río Cuarto,CORDOBA,265,312,373,374,747
14,14098,140982704,Río Cuarto,CORDOBA,226,248,296,257,553
14,14098,140982408,Río Cuarto,CORDOBA,201,298,329,222,551
14,14098,140982407,Río Cuarto,CORDOBA,189,355,236,155,391
14,14098,140982406,Río Cuarto,CORDOBA,375,580,501,388,889
14,14098,140982405,Río Cuarto,CORDOBA,368,486,459,408,867
14,14098,140982404,Río Cuarto,CORDOBA,328,452,460,400,860
14,14098,140982403,Río Cuarto,CORDOBA,138,241,204,157,361
14,14098,140982402,Río Cuarto,CORDOBA,212,353,260,180,440
14,14098,140982401,Río Cuarto,CORDOBA,295,387,388,309,697
14,14098,140982314,Río Cuarto,CORDOBA,222,248,405,418,823
14,14098,140982312,Río Cuarto,CORDOBA,423,448,694,656,1350
14,14098,140982311,Río Cuarto,CORDOBA,262,298,433,433,866
14,14098,140982310,Río Cuarto,CORDOBA,254,291,443,429,872
14,14098,140982309,Río Cuarto,CORDOBA,258,291,453,423,876
14,14098,140982308,Río Cuarto,CORDOBA,332,370,534,496,1030
14,14098,140982307,Río Cuarto,CORDOBA,194,213,319,651,970
14,14098,140982306,Río Cuarto,CORDOBA,267,356,400,342,742
14,14098,140982305,Río Cuarto,CORDOBA,178,221,264,222,486
14,14098,140982304,Río Cuarto,CORDOBA,414,462,652,618,1270
14,14098,140982303,Río Cuarto,CORDOBA,232,265,371,307,678
14,14098,140982302,Río Cuarto,CORDOBA,265,300,380,396,776
14,14098,140982301,Río Cuarto,CORDOBA,358,425,517,460,977
14,14098,140982313,Río Cuarto,CORDOBA,334,382,566,532,1098
14,14098,140982212,Río Cuarto,CORDOBA,230,269,403,431,834
14,14098,140982211,Río Cuarto,CORDOBA,299,310,564,566,1130
14,14098,140982210,Río Cuarto,CORDOBA,357,385,647,657,1304
14,14098,140982209,Río Cuarto,CORDOBA,271,311,451,488,939
14,14098,140982208,Río Cuarto,CORDOBA,304,332,566,597,1163
14,14098,140982207,Río Cuarto,CORDOBA,335,378,648,526,1174
14,14098,140982206,Río Cuarto,CORDOBA,360,383,541,534,1075
14,14098,140982205,Río Cuarto,CORDOBA,398,425,627,555,1182
14,14098,140982204,Río Cuarto,CORDOBA,201,199,366,351,717
14,14098,140982203,Río Cuarto,CORDOBA,345,387,573,529,1102
14,14098,140982202,Río Cuarto,CORDOBA,397,464,645,525,1170
14,14098,140982201,Río Cuarto,CORDOBA,399,487,685,624,1309
14,14098,140982114,Río Cuarto,CORDOBA,340,382,566,576,1142
14,14098,140982113,Río Cuarto,CORDOBA,287,289,519,510,1029
14,14098,140982112,Río Cuarto,CORDOBA,254,262,472,459,931
14,14098,140982111,Río Cuarto,CORDOBA,341,348,527,477,1004
14,14098,140982110,Río Cuarto,CORDOBA,328,375,525,485,1010
14,14098,140982109,Río Cuarto,CORDOBA,339,430,465,374,839
14,14098,140982108,Río Cuarto,CORDOBA,347,426,511,404,915
14,14098,140982105,Río Cuarto,CORDOBA,237,274,362,302,664
14,14098,140982104,Río Cuarto,CORDOBA,260,325,375,310,685
14,14098,140982103,Río Cuarto,CORDOBA,419,491,631,556,1187
14,14098,140982102,Río Cuarto,CORDOBA,188,178,350,299,649
14,14098,140982101,Río Cuarto,CORDOBA,261,295,485,492,977
14,14098,140982019,Río Cuarto,CORDOBA,93,213,134,84,218
14,14098,140982018,Río Cuarto,CORDOBA,349,563,473,330,803
14,14098,140982017,Río Cuarto,CORDOBA,316,468,428,299,727
14,14098,140982016,Río Cuarto,CORDOBA,284,451,337,245,582
14,14098,140982015,Río Cuarto,CORDOBA,155,307,204,164,368
14,14098,140982014,Río Cuarto,CORDOBA,230,474,291,195,486
14,14098,140982013,Río Cuarto,CORDOBA,223,423,273,170,443
14,14098,140982012,Río Cuarto,CORDOBA,211,343,273,218,491
14,14098,140982011,Río Cuarto,CORDOBA,183,287,201,158,359
14,14098,140982010,Río Cuarto,CORDOBA,295,363,390,370,760
14,14098,140982009,Río Cuarto,CORDOBA,229,238,372,318,690
14,14098,140982007,Río Cuarto,CORDOBA,256,335,319,222,541
14,14098,140982006,Río Cuarto,CORDOBA,334,444,453,323,776
14,14098,140982005,Río Cuarto,CORDOBA,139,250,177,119,296
14,14098,140982004,Río Cuarto,CORDOBA,179,297,227,164,391
14,14098,140982003,Río Cuarto,CORDOBA,287,460,380,308,688
14,14098,140982002,Río Cuarto,CORDOBA,230,311,322,255,577
14,14098,140982001,Río Cuarto,CORDOBA,115,133,173,151,324
14,14098,140981912,Río Cuarto,CORDOBA,335,395,529,512,1041
14,14098,140981904,Río Cuarto,CORDOBA,232,243,436,459,895
14,14098,140981903,Río Cuarto,CORDOBA,335,365,601,602,1203
14,14098,140981902,Río Cuarto,CORDOBA,595,630,1140,1201,2341
14,14098,140981901,Río Cuarto,CORDOBA,201,233,352,332,684
14,14098,140981813,Río Cuarto,CORDOBA,313,362,535,519,1054
14,14098,140981812,Río Cuarto,CORDOBA,305,360,494,457,951
14,14098,140981811,Río Cuarto,CORDOBA,319,372,475,452,927
14,14098,140981810,Río Cuarto,CORDOBA,442,534,675,644,1319
14,14098,140981809,Río Cuarto,CORDOBA,451,507,777,717,1494
14,14098,140981907,Río Cuarto,CORDOBA,223,244,423,419,842
14,14098,140981808,Río Cuarto,CORDOBA,331,362,546,562,1108
14,14098,140981807,Río Cuarto,CORDOBA,315,371,488,481,969
14,14098,140981806,Río Cuarto,CORDOBA,295,348,534,452,986
14,14098,140981805,Río Cuarto,CORDOBA,382,418,705,617,1322
14,14098,140981804,Río Cuarto,CORDOBA,441,520,757,664,1421
14,14098,140981803,Río Cuarto,CORDOBA,454,494,782,738,1520
14,14098,140981802,Río Cuarto,CORDOBA,399,465,633,598,1231
14,14098,140981713,Río Cuarto,CORDOBA,276,311,430,403,833
14,14098,140981711,Río Cuarto,CORDOBA,324,363,496,433,929
14,14098,140981710,Río Cuarto,CORDOBA,266,297,397,387,784
14,14098,140981709,Río Cuarto,CORDOBA,249,268,458,413,871
14,14098,140981707,Río Cuarto,CORDOBA,204,271,346,299,645
14,14098,140981706,Río Cuarto,CORDOBA,236,281,380,377,757
14,14098,140981705,Río Cuarto,CORDOBA,401,488,615,567,1182
14,14098,140981704,Río Cuarto,CORDOBA,208,262,343,336,679
14,14098,140981703,Río Cuarto,CORDOBA,297,380,514,456,970
14,14098,140981702,Río Cuarto,CORDOBA,283,342,538,550,1088
14,14098,140981701,Río Cuarto,CORDOBA,436,440,792,765,1557
14,14098,140981615,Río Cuarto,CORDOBA,176,314,229,161,390
14,14098,140981614,Río Cuarto,CORDOBA,197,322,234,173,407
14,14098,140981612,Río Cuarto,CORDOBA,353,566,432,319,751
14,14098,140981611,Río Cuarto,CORDOBA,346,514,419,340,759
14,14098,140981610,Río Cuarto,CORDOBA,396,493,627,571,1198
14,14098,140981609,Río Cuarto,CORDOBA,432,488,770,688,1458
14,14098,140981905,Río Cuarto,CORDOBA,213,239,405,390,795
14,14098,140981605,Río Cuarto,CORDOBA,399,466,599,519,1118
14,14098,140981604,Río Cuarto,CORDOBA,207,234,354,324,678
14,14098,140981603,Río Cuarto,CORDOBA,193,225,314,301,615
14,14098,140981602,Río Cuarto,CORDOBA,371,390,642,666,1308
14,14098,140981601,Río Cuarto,CORDOBA,283,278,482,491,973
14,14098,140981515,Río Cuarto,CORDOBA,247,302,369,270,639
14,14098,140981514,Río Cuarto,CORDOBA,324,363,529,439,968
14,14098,140981513,Río Cuarto,CORDOBA,359,400,563,532,1095
14,14098,140981512,Río Cuarto,CORDOBA,165,272,310,301,611
14,14098,140981511,Río Cuarto,CORDOBA,278,337,442,515,957
14,14098,140981510,Río Cuarto,CORDOBA,346,392,559,544,1103
14,14098,140981507,Río Cuarto,CORDOBA,288,350,416,400,816
14,14098,140981504,Río Cuarto,CORDOBA,289,322,493,489,982
14,14098,140981503,Río Cuarto,CORDOBA,355,409,660,629,1289
14,14098,140981502,Río Cuarto,CORDOBA,321,335,547,575,1122
14,14098,140981501,Río Cuarto,CORDOBA,323,349,527,550,1077
14,14098,140981410,Río Cuarto,CORDOBA,270,288,451,518,969
14,14098,140981708,Río Cuarto,CORDOBA,318,333,547,518,1065
14,14098,140981506,Río Cuarto,CORDOBA,217,241,396,385,781
14,14098,140981608,Río Cuarto,CORDOBA,193,217,361,342,703
14,14098,140982914,Río Cuarto,CORDOBA,310,365,506,511,1017
14,14098,140980908,Río Cuarto,CORDOBA,244,278,349,325,674
14,14098,140980907,Río Cuarto,CORDOBA,261,313,349,288,637
14,14098,140980905,Río Cuarto,CORDOBA,230,254,347,318,665
14,14098,140980904,Río Cuarto,CORDOBA,202,238,362,306,668
14,14098,140981111,Río Cuarto,CORDOBA,275,309,386,379,765
14,14098,140981110,Río Cuarto,CORDOBA,195,237,300,304,604
14,14098,140980914,Río Cuarto,CORDOBA,263,318,390,370,760
14,14098,140980811,Río Cuarto,CORDOBA,106,144,141,151,292
14,14098,140980810,Río Cuarto,CORDOBA,152,191,219,227,446
14,14098,140980807,Río Cuarto,CORDOBA,171,351,260,208,468
14,14098,140980706,Río Cuarto,CORDOBA,31,97,35,46,81
14,14098,140982913,Río Cuarto,CORDOBA,267,313,485,460,945
14,14098,140980913,Río Cuarto,CORDOBA,279,306,380,312,692
14,14098,140980912,Río Cuarto,CORDOBA,365,413,567,532,1099
14,14098,140980911,Río Cuarto,CORDOBA,118,132,157,168,325
14,14098,140980910,Río Cuarto,CORDOBA,215,247,333,313,646
14,14098,140980909,Río Cuarto,CORDOBA,260,300,388,402,790
14,14098,140980609,Río Cuarto,CORDOBA,36,181,64,72,136
14,14098,140980605,Río Cuarto,CORDOBA,34,139,57,69,126
14,14098,140980515,Río Cuarto,CORDOBA,226,254,365,352,717
14,14098,140980512,Río Cuarto,CORDOBA,292,350,459,455,914
14,14098,140980511,Río Cuarto,CORDOBA,247,300,369,364,733
14,14098,140980510,Río Cuarto,CORDOBA,274,352,454,456,910
14,14098,140982912,Río Cuarto,CORDOBA,217,244,421,400,821
14,14098,140982911,Río Cuarto,CORDOBA,231,274,394,387,781
14,14098,140980708,Río Cuarto,CORDOBA,48,227,70,67,137
14,14098,140980707,Río Cuarto,CORDOBA,55,222,73,77,150
14,14098,140982910,Río Cuarto,CORDOBA,259,305,432,397,829
14,14098,140981607,Río Cuarto,CORDOBA,225,240,385,368,753
14,14098,140980517,Río Cuarto,CORDOBA,298,361,368,401,769
14,14098,140980208,Río Cuarto,CORDOBA,260,295,361,316,677
14,14098,140982909,Río Cuarto,CORDOBA,183,218,294,285,579
14,14098,140980516,Río Cuarto,CORDOBA,202,309,199,202,401
14,14098,140980311,Río Cuarto,CORDOBA,251,286,452,391,843
14,14098,140980310,Río Cuarto,CORDOBA,200,221,305,305,610
14,14098,140980309,Río Cuarto,CORDOBA,208,235,331,316,647
14,14098,140980308,Río Cuarto,CORDOBA,295,348,426,376,802
14,14098,140980307,Río Cuarto,CORDOBA,212,246,320,232,552
14,14098,140980306,Río Cuarto,CORDOBA,312,368,457,382,839
14,14098,140982908,Río Cuarto,CORDOBA,167,207,232,211,443
14,14098,140980117,Río Cuarto,CORDOBA,290,348,475,444,919
14,14098,140980116,Río Cuarto,CORDOBA,247,301,346,292,638
14,14098,140980115,Río Cuarto,CORDOBA,244,272,396,367,763
14,14098,140980114,Río Cuarto,CORDOBA,213,253,335,331,666
14,14098,140980113,Río Cuarto,CORDOBA,245,312,329,273,602
14,14098,140980112,Río Cuarto,CORDOBA,205,252,281,262,543
14,14098,140980111,Río Cuarto,CORDOBA,214,231,337,269,606
14,14098,140980110,Río Cuarto,CORDOBA,256,276,446,431,877
14,14098,140980109,Río Cuarto,CORDOBA,240,296,380,360,740
14,14098,140980108,Río Cuarto,CORDOBA,177,186,259,256,515
14,14098,140980211,Río Cuarto,CORDOBA,306,345,528,464,992
14,14098,140980209,Río Cuarto,CORDOBA,187,219,283,286,569
14,14098,140981211,Río Cuarto,CORDOBA,177,201,272,254,526
14,14098,140981209,Río Cuarto,CORDOBA,187,228,268,267,535
14,14098,140981208,Río Cuarto,CORDOBA,264,298,328,329,657
14,14098,140981207,Río Cuarto,CORDOBA,263,295,427,456,883
14,14098,140982903,Río Cuarto,CORDOBA,163,172,230,220,450
14,14098,140981313,Río Cuarto,CORDOBA,165,187,291,317,608
14,14098,140981312,Río Cuarto,CORDOBA,329,385,543,508,1051
14,14098,140981311,Río Cuarto,CORDOBA,233,276,377,390,767
14,14098,140981012,Río Cuarto,CORDOBA,219,253,368,302,670
14,14098,140981011,Río Cuarto,CORDOBA,307,361,557,505,1062
14,14098,140981010,Río Cuarto,CORDOBA,202,281,300,309,609
14,14098,140982811,Río Cuarto,CORDOBA,187,215,308,307,615
14,14098,140982810,Río Cuarto,CORDOBA,255,289,387,359,746
14,14098,140982809,Río Cuarto,CORDOBA,274,312,412,369,781
14,14098,140982808,Río Cuarto,CORDOBA,182,211,274,218,492
14,14098,140982807,Río Cuarto,CORDOBA,220,254,398,409,807
14,14098,140982806,Río Cuarto,CORDOBA,232,256,418,439,857
14,14098,140982805,Río Cuarto,CORDOBA,211,231,334,325,659
14,14098,140982804,Río Cuarto,CORDOBA,188,245,289,243,532
14,14098,140982803,Río Cuarto,CORDOBA,196,235,275,224,499
14,14098,140982802,Río Cuarto,CORDOBA,326,381,507,460,967
14,14098,140982801,Río Cuarto,CORDOBA,383,423,629,586,1215
14,14098,140982708,Río Cuarto,CORDOBA,311,328,517,452,969
14,14098,140982707,Río Cuarto,CORDOBA,335,367,491,456,947
14,14098,140982706,Río Cuarto,CORDOBA,258,284,370,352,722
14,14098,140982703,Río Cuarto,CORDOBA,367,397,537,501,1038
14,14098,140982702,Río Cuarto,CORDOBA,381,402,634,662,1296
14,14098,140982701,Río Cuarto,CORDOBA,368,376,611,663,1274
14,14098,140982613,Río Cuarto,CORDOBA,173,198,337,326,663
14,14098,140982612,Río Cuarto,CORDOBA,292,294,566,541,1107
14,14098,140982611,Río Cuarto,CORDOBA,269,276,486,471,957
14,14098,140982610,Río Cuarto,CORDOBA,257,257,501,480,981
14,14098,140982609,Río Cuarto,CORDOBA,260,295,488,454,942
14,14098,140982608,Río Cuarto,CORDOBA,312,317,566,524,1090
14,14098,140982607,Río Cuarto,CORDOBA,328,356,511,465,976
14,14098,140982606,Río Cuarto,CORDOBA,251,275,439,385,824
14,14098,140982605,Río Cuarto,CORDOBA,291,308,528,514,1042
14,14098,140982604,Río Cuarto,CORDOBA,383,420,562,554,1116
14,14098,140982603,Río Cuarto,CORDOBA,447,495,748,722,1470
14,14098,140982602,Río Cuarto,CORDOBA,299,337,458,434,892
14,14098,140982601,Río Cuarto,CORDOBA,290,354,464,409,873
14,14098,140982512,Río Cuarto,CORDOBA,417,435,820,775,1595
14,14098,140982511,Río Cuarto,CORDOBA,427,462,780,768,1548
14,14098,140982510,Río Cuarto,CORDOBA,244,265,408,348,756
14,14098,140982509,Río Cuarto,CORDOBA,233,271,402,378,780
14,14098,140982508,Río Cuarto,CORDOBA,335,397,635,596,1231
14,14098,140982507,Río Cuarto,CORDOBA,350,356,669,684,1353
14,14098,140982506,Río Cuarto,CORDOBA,378,395,672,622,1294
14,14098,140982505,Río Cuarto,CORDOBA,376,402,654,599,1253
14,14098,140982504,Río Cuarto,CORDOBA,283,301,485,402,887
14,14098,140982503,Río Cuarto,CORDOBA,290,342,456,407,863
14,14098,140982502,Río Cuarto,CORDOBA,378,432,587,486,1073
14,14098,140982501,Río Cuarto,CORDOBA,308,343,448,421,869
14,14098,140982421,Río Cuarto,CORDOBA,251,302,369,317,686
14,14098,140982420,Río Cuarto,CORDOBA,356,418,500,426,926
14,14098,140982418,Río Cuarto,CORDOBA,238,287,329,269,598
14,14098,140982417,Río Cuarto,CORDOBA,308,426,433,364,797
14,14098,140982416,Río Cuarto,CORDOBA,290,425,396,319,715
14,14098,140982415,Río Cuarto,CORDOBA,229,355,324,217,541
14,14098,140982414,Río Cuarto,CORDOBA,356,423,479,414,893
14,14098,140982413,Río Cuarto,CORDOBA,327,396,440,378,818
14,14098,140982412,Río Cuarto,CORDOBA,315,387,442,370,812
14,14098,140982411,Río Cuarto,CORDOBA,365,590,447,349,796
14,14098,140982410,Río Cuarto,CORDOBA,298,408,396,325,721
14,14098,140982409,Río Cuarto,CORDOBA,311,494,394,329,723
14,14098,140981009,Río Cuarto,CORDOBA,168,202,274,308,582
14,14098,140981606,Río Cuarto,CORDOBA,176,224,304,264,568
14,14098,140981509,Río Cuarto,CORDOBA,330,356,576,519,1095
14,14098,140982902,Río Cuarto,CORDOBA,285,329,477,468,945
14,14098,140982901,Río Cuarto,CORDOBA,254,280,429,411,840
14,14098,140982022,Río Cuarto,CORDOBA,210,412,271,222,493
14,14098,140982812,Río Cuarto,CORDOBA,274,303,423,412,835
14,14098,140981910,Río Cuarto,CORDOBA,232,265,368,303,671
14,14098,140981909,Río Cuarto,CORDOBA,217,251,360,311,671
14,14098,140982907,Río Cuarto,CORDOBA,138,169,196,177,373
14,14098,140981210,Río Cuarto,CORDOBA,193,217,293,266,559
14,14098,140982906,Río Cuarto,CORDOBA,235,271,344,335,679
14,14098,140982419,Río Cuarto,CORDOBA,169,231,230,182,412
14,14098,140981908,Río Cuarto,CORDOBA,268,273,490,446,936
14,14098,140982021,Río Cuarto,CORDOBA,236,423,266,189,455
14,14098,140982020,Río Cuarto,CORDOBA,200,334,235,164,399
14,14098,140981911,Río Cuarto,CORDOBA,312,346,502,422,924
14,14098,140980104,Río Cuarto,CORDOBA,25,51,30,50,80
14,14098,140981205,Río Cuarto,CORDOBA,35,67,50,68,118
14,14098,140981204,Río Cuarto,CORDOBA,134,217,172,249,421
14,14098,140981401,Río Cuarto,CORDOBA,58,96,89,106,195
14,14098,140981308,Río Cuarto,CORDOBA,32,112,46,64,110
14,14098,140981403,Río Cuarto,CORDOBA,50,103,29,82,111
14,14098,140981402,Río Cuarto,CORDOBA,46,70,43,83,126
14,14098,140982107,Río Cuarto,CORDOBA,233,359,290,234,524
14,14098,140982106,Río Cuarto,CORDOBA,198,271,273,230,503
14,14098,140982008,Río Cuarto,CORDOBA,373,458,517,410,927
14,14098,140981906,Río Cuarto,CORDOBA,231,245,418,424,842
14,14098,140981801,Río Cuarto,CORDOBA,417,480,647,610,1257
14,14098,140981712,Río Cuarto,CORDOBA,435,462,735,679,1414
14,14098,140981613,Río Cuarto,CORDOBA,186,302,229,175,404
14,14098,140981508,Río Cuarto,CORDOBA,239,265,375,358,733
14,14098,140981505,Río Cuarto,CORDOBA,241,264,381,405,786
14,14098,140981409,Río Cuarto,CORDOBA,132,154,199,215,414
14,14098,140981212,Río Cuarto,CORDOBA,214,228,344,331,675
14,14098,140981206,Río Cuarto,CORDOBA,97,108,170,198,368
14,14098,140981109,Río Cuarto,CORDOBA,252,315,426,406,832
14,14098,140980608,Río Cuarto,CORDOBA,93,219,132,144,276
14,14098,140980607,Río Cuarto,CORDOBA,75,257,113,108,221
14,14098,140980606,Río Cuarto,CORDOBA,50,200,83,96,179
14,14098,140980514,Río Cuarto,CORDOBA,201,236,286,283,569
14,14098,140980513,Río Cuarto,CORDOBA,232,277,350,322,672
14,14098,140982905,Río Cuarto,CORDOBA,193,223,332,333,665
14,14098,140982904,Río Cuarto,CORDOBA,219,240,323,331,654
14,14098,140982705,Río Cuarto,CORDOBA,274,298,400,387,787
14,14098,140980409,Río Cuarto,CORDOBA,102,144,161,143,304
14,14098,140980408,Río Cuarto,CORDOBA,233,267,370,367,737
14,14098,140980407,Río Cuarto,CORDOBA,207,232,366,353,719
14,14098,140980305,Río Cuarto,CORDOBA,299,346,469,479,948
14,14098,140980304,Río Cuarto,CORDOBA,245,294,358,320,678
14,14098,140981014,Río Cuarto,CORDOBA,245,285,385,381,766
14,14098,140981013,Río Cuarto,CORDOBA,282,334,485,452,937
14,14098,140980906,Río Cuarto,CORDOBA,265,322,396,364,760
14,14098,140980809,Río Cuarto,CORDOBA,205,247,309,297,606
14,14098,140980808,Río Cuarto,CORDOBA,280,346,406,361,767
14,14098,140981408,Río Cuarto,CORDOBA,31,50,20,90,110
14,14098,140981406,Río Cuarto,CORDOBA,40,65,55,71,126
14,14098,140981107,Río Cuarto,CORDOBA,66,116,87,108,195
14,14098,140981104,Río Cuarto,CORDOBA,22,49,21,33,54
14,14098,140981307,Río Cuarto,CORDOBA,14,53,9,18,27
14,14098,140981103,Río Cuarto,CORDOBA,22,55,28,37,65
14,14098,140981306,Río Cuarto,CORDOBA,29,44,25,53,78
14,14098,140981102,Río Cuarto,CORDOBA,93,128,122,161,283
14,14098,140981305,Río Cuarto,CORDOBA,35,65,27,58,85
14,14098,140981203,Río Cuarto,CORDOBA,113,158,182,229,411
14,14098,140981202,Río Cuarto,CORDOBA,87,137,113,161,274
14,14098,140981201,Río Cuarto,CORDOBA,74,107,111,140,251
14,14098,140981101,Río Cuarto,CORDOBA,86,140,109,148,257
14,14098,140981007,Río Cuarto,CORDOBA,56,97,93,104,197
14,14098,140981003,Río Cuarto,CORDOBA,178,214,294,318,612
14,14098,140981002,Río Cuarto,CORDOBA,19,34,25,33,58
14,14098,140981001,Río Cuarto,CORDOBA,12,20,20,19,39
14,14098,140980903,Río Cuarto,CORDOBA,61,110,74,111,185
14,14098,140981008,Río Cuarto,CORDOBA,64,94,96,114,210
14,14098,140980901,Río Cuarto,CORDOBA,46,72,61,78,139
14,14098,140981108,Río Cuarto,CORDOBA,38,85,43,72,115
14,14098,140980805,Río Cuarto,CORDOBA,20,37,18,32,50
14,14098,140980804,Río Cuarto,CORDOBA,72,136,84,130,214
14,14098,140980803,Río Cuarto,CORDOBA,68,103,94,105,199
14,14098,140980703,Río Cuarto,CORDOBA,49,77,67,77,144
14,14098,140980603,Río Cuarto,CORDOBA,45,81,60,81,141
14,14098,140981304,Río Cuarto,CORDOBA,42,106,55,76,131
14,14098,140980806,Río Cuarto,CORDOBA,71,121,97,121,218
14,14098,140980508,Río Cuarto,CORDOBA,20,32,24,35,59
14,14098,140980802,Río Cuarto,CORDOBA,49,75,64,94,158
14,14098,140980507,Río Cuarto,CORDOBA,39,70,48,71,119
14,14098,140980504,Río Cuarto,CORDOBA,12,29,12,17,29
14,14098,140980503,Río Cuarto,CORDOBA,23,26,36,36,72
14,14098,140980502,Río Cuarto,CORDOBA,63,86,83,100,183
14,14098,140981303,Río Cuarto,CORDOBA,41,89,71,72,143
14,14098,140980501,Río Cuarto,CORDOBA,17,42,21,32,53
14,14098,140980406,Río Cuarto,CORDOBA,46,95,69,73,142
14,14098,140980404,Río Cuarto,CORDOBA,20,51,25,32,57
14,14098,140980403,Río Cuarto,CORDOBA,24,61,33,47,80
14,14098,140980402,Río Cuarto,CORDOBA,49,89,78,97,175
14,14098,140980401,Río Cuarto,CORDOBA,22,54,24,43,67
14,14098,140980301,Río Cuarto,CORDOBA,19,44,23,32,55
14,14098,140980207,Río Cuarto,CORDOBA,19,47,30,27,57
14,14098,140980205,Río Cuarto,CORDOBA,37,69,44,56,100
14,14098,140981302,Río Cuarto,CORDOBA,48,92,49,86,135
14,14098,140980302,Río Cuarto,CORDOBA,26,74,42,51,93
14,14098,140980204,Río Cuarto,CORDOBA,45,77,66,76,142
14,14098,140980202,Río Cuarto,CORDOBA,36,68,47,62,109
14,14098,140980107,Río Cuarto,CORDOBA,17,38,22,19,41
14,14098,140981301,Río Cuarto,CORDOBA,49,86,50,91,141
14,14098,140980106,Río Cuarto,CORDOBA,18,32,28,35,63
14,14098,140980105,Río Cuarto,CORDOBA,13,47,17,20,37
14,14098,140980103,Río Cuarto,CORDOBA,33,57,44,59,103
14,14098,140980102,Río Cuarto,CORDOBA,18,38,25,32,57
14,14098,140980101,Río Cuarto,CORDOBA,6,33,6,8,14
14,14098,140981407,Río Cuarto,CORDOBA,38,79,33,71,104
14,14098,140981405,Río Cuarto,CORDOBA,55,97,68,99,167
14,14098,140981404,Río Cuarto,CORDOBA,55,94,73,99,172
14,14098,140981310,Río Cuarto,CORDOBA,67,100,50,97,147
14,14098,140981309,Río Cuarto,CORDOBA,65,71,40,104,144
14,14098,140981105,Río Cuarto,CORDOBA,32,82,50,51,101
14,14098,140981006,Río Cuarto,CORDOBA,38,75,38,64,102
14,14098,140981005,Río Cuarto,CORDOBA,47,67,73,76,149
14,14098,140981004,Río Cuarto,CORDOBA,51,77,70,82,152
14,14098,140980801,Río Cuarto,CORDOBA,49,111,60,90,150
14,14098,140980705,Río Cuarto,CORDOBA,20,28,26,29,55
14,14098,140980704,Río Cuarto,CORDOBA,70,108,102,134,236
14,14098,140980702,Río Cuarto,CORDOBA,50,87,62,85,147
14,14098,140980701,Río Cuarto,CORDOBA,27,99,29,48,77
14,14098,140980604,Río Cuarto,CORDOBA,45,125,44,61,105
14,14098,140980602,Río Cuarto,CORDOBA,72,107,72,108,180
14,14098,140980601,Río Cuarto,CORDOBA,25,58,32,38,70
14,14098,140980505,Río Cuarto,CORDOBA,109,147,171,183,354
14,14098,140980405,Río Cuarto,CORDOBA,21,60,31,34,65
14,14098,140980303,Río Cuarto,CORDOBA,16,29,13,21,34
14,14098,140980206,Río Cuarto,CORDOBA,18,27,20,33,53
14,14098,140980201,Río Cuarto,CORDOBA,10,40,11,20,31
14,14084,140840404,Presidente Roque Sáenz Peña,CORDOBA,76,119,124,118,242
14,14084,140840307,Presidente Roque Sáenz Peña,CORDOBA,25,34,45,47,92
14,14084,140840103,Presidente Roque Sáenz Peña,CORDOBA,49,70,55,80,135
14,14084,140840527,Presidente Roque Sáenz Peña,CORDOBA,175,200,279,278,557
14,14084,140840526,Presidente Roque Sáenz Peña,CORDOBA,209,229,345,342,687
14,14084,140840525,Presidente Roque Sáenz Peña,CORDOBA,203,224,308,270,578
14,14084,140840524,Presidente Roque Sáenz Peña,CORDOBA,229,253,377,388,765
14,14084,140840523,Presidente Roque Sáenz Peña,CORDOBA,260,283,438,390,828
14,14084,140840522,Presidente Roque Sáenz Peña,CORDOBA,283,332,377,313,690
14,14084,140840521,Presidente Roque Sáenz Peña,CORDOBA,295,348,492,428,920
14,14084,140840520,Presidente Roque Sáenz Peña,CORDOBA,189,213,278,249,527
14,14084,140840519,Presidente Roque Sáenz Peña,CORDOBA,238,276,353,360,713
14,14084,140840518,Presidente Roque Sáenz Peña,CORDOBA,245,263,366,326,692
14,14084,140840517,Presidente Roque Sáenz Peña,CORDOBA,214,235,299,267,566
14,14084,140840515,Presidente Roque Sáenz Peña,CORDOBA,271,328,353,290,643
14,14084,140840514,Presidente Roque Sáenz Peña,CORDOBA,365,414,551,517,1068
14,14084,140840513,Presidente Roque Sáenz Peña,CORDOBA,257,297,382,343,725
14,14084,140840512,Presidente Roque Sáenz Peña,CORDOBA,311,344,504,477,981
14,14084,140840508,Presidente Roque Sáenz Peña,CORDOBA,346,393,533,452,985
14,14084,140840507,Presidente Roque Sáenz Peña,CORDOBA,249,293,401,384,785
14,14084,140840506,Presidente Roque Sáenz Peña,CORDOBA,245,275,391,374,765
14,14084,140840505,Presidente Roque Sáenz Peña,CORDOBA,258,287,451,432,883
14,14084,140840504,Presidente Roque Sáenz Peña,CORDOBA,328,368,569,566,1135
14,14084,140840503,Presidente Roque Sáenz Peña,CORDOBA,203,222,379,362,741
14,14084,140840502,Presidente Roque Sáenz Peña,CORDOBA,197,211,367,324,691
14,14084,140840501,Presidente Roque Sáenz Peña,CORDOBA,267,283,480,476,956
14,14084,140840406,Presidente Roque Sáenz Peña,CORDOBA,214,250,314,270,584
14,14084,140840316,Presidente Roque Sáenz Peña,CORDOBA,157,195,258,250,508
14,14084,140840315,Presidente Roque Sáenz Peña,CORDOBA,175,205,257,268,525
14,14084,140840314,Presidente Roque Sáenz Peña,CORDOBA,225,261,346,374,720
14,14084,140840111,Presidente Roque Sáenz Peña,CORDOBA,296,315,521,541,1062
14,14084,140840110,Presidente Roque Sáenz Peña,CORDOBA,283,291,445,411,856
14,14084,140840109,Presidente Roque Sáenz Peña,CORDOBA,298,333,485,476,961
14,14084,140840108,Presidente Roque Sáenz Peña,CORDOBA,384,440,551,560,1111
14,14084,140840106,Presidente Roque Sáenz Peña,CORDOBA,356,396,537,527,1064
14,14084,140840409,Presidente Roque Sáenz Peña,CORDOBA,306,339,473,501,974
14,14084,140840408,Presidente Roque Sáenz Peña,CORDOBA,293,336,478,479,957
14,14084,140840407,Presidente Roque Sáenz Peña,CORDOBA,231,271,340,307,647
14,14084,140840405,Presidente Roque Sáenz Peña,CORDOBA,88,105,126,158,284
14,14084,140840516,Presidente Roque Sáenz Peña,CORDOBA,312,405,422,324,746
14,14084,140840511,Presidente Roque Sáenz Peña,CORDOBA,286,383,387,335,722
14,14084,140840510,Presidente Roque Sáenz Peña,CORDOBA,217,279,289,248,537
14,14084,140840509,Presidente Roque Sáenz Peña,CORDOBA,256,292,341,307,648
14,14084,140840313,Presidente Roque Sáenz Peña,CORDOBA,212,239,297,301,598
14,14084,140840210,Presidente Roque Sáenz Peña,CORDOBA,281,312,395,430,825
14,14084,140840209,Presidente Roque Sáenz Peña,CORDOBA,123,137,194,179,373
14,14084,140840107,Presidente Roque Sáenz Peña,CORDOBA,264,301,343,300,643
14,14084,140840403,Presidente Roque Sáenz Peña,CORDOBA,14,46,21,24,45
14,14084,140840402,Presidente Roque Sáenz Peña,CORDOBA,54,82,69,105,174
14,14084,140840401,Presidente Roque Sáenz Peña,CORDOBA,41,59,29,66,95
14,14084,140840312,Presidente Roque Sáenz Peña,CORDOBA,33,75,34,44,78
14,14084,140840311,Presidente Roque Sáenz Peña,CORDOBA,18,43,25,29,54
14,14084,140840310,Presidente Roque Sáenz Peña,CORDOBA,22,50,22,40,62
14,14084,140840309,Presidente Roque Sáenz Peña,CORDOBA,29,53,23,45,68
14,14084,140840308,Presidente Roque Sáenz Peña,CORDOBA,30,54,27,59,86
14,14084,140840306,Presidente Roque Sáenz Peña,CORDOBA,22,31,35,44,79
14,14084,140840305,Presidente Roque Sáenz Peña,CORDOBA,42,71,56,74,130
14,14084,140840304,Presidente Roque Sáenz Peña,CORDOBA,26,49,34,43,77
14,14084,140840303,Presidente Roque Sáenz Peña,CORDOBA,27,46,44,44,88
14,14084,140840302,Presidente Roque Sáenz Peña,CORDOBA,48,85,76,101,177
14,14084,140840208,Presidente Roque Sáenz Peña,CORDOBA,38,74,53,69,122
14,14084,140840206,Presidente Roque Sáenz Peña,CORDOBA,58,71,84,95,179
14,14084,140840205,Presidente Roque Sáenz Peña,CORDOBA,28,44,30,48,78
14,14084,140840204,Presidente Roque Sáenz Peña,CORDOBA,46,72,68,79,147
14,14084,140840203,Presidente Roque Sáenz Peña,CORDOBA,24,33,38,32,70
14,14084,140840202,Presidente Roque Sáenz Peña,CORDOBA,27,42,25,45,70
14,14084,140840201,Presidente Roque Sáenz Peña,CORDOBA,24,35,26,42,68
14,14084,140840207,Presidente Roque Sáenz Peña,CORDOBA,45,85,60,86,146
14,14084,140840105,Presidente Roque Sáenz Peña,CORDOBA,22,38,18,43,61
14,14084,140840104,Presidente Roque Sáenz Peña,CORDOBA,19,33,22,39,61
14,14084,140840101,Presidente Roque Sáenz Peña,CORDOBA,50,52,56,71,127
14,14084,140840301,Presidente Roque Sáenz Peña,CORDOBA,31,52,38,49,87
14,14084,140840102,Presidente Roque Sáenz Peña,CORDOBA,49,96,68,90,158
14,14063,140630701,Marcos Juárez,CORDOBA,100,139,136,146,282
14,14063,140630303,Marcos Juárez,CORDOBA,108,176,153,156,309
14,14063,140630211,Marcos Juárez,CORDOBA,29,85,38,50,88
14,14063,140630209,Marcos Juárez,CORDOBA,24,62,35,41,76
14,14063,140630104,Marcos Juárez,CORDOBA,12,25,17,24,41
14,14063,140630811,Marcos Juárez,CORDOBA,200,235,280,354,634
14,14063,140631314,Marcos Juárez,CORDOBA,293,348,428,413,841
14,14063,140631313,Marcos Juárez,CORDOBA,192,230,287,289,576
14,14063,140631312,Marcos Juárez,CORDOBA,203,232,297,295,592
14,14063,140631311,Marcos Juárez,CORDOBA,232,259,325,285,610
14,14063,140631310,Marcos Juárez,CORDOBA,158,197,226,215,441
14,14063,140631309,Marcos Juárez,CORDOBA,343,386,486,386,872
14,14063,140631308,Marcos Juárez,CORDOBA,266,316,346,274,620
14,14063,140631307,Marcos Juárez,CORDOBA,177,219,228,214,442
14,14063,140631306,Marcos Juárez,CORDOBA,284,310,379,339,718
14,14063,140631305,Marcos Juárez,CORDOBA,424,468,655,629,1284
14,14063,140631304,Marcos Juárez,CORDOBA,244,268,355,332,687
14,14063,140631303,Marcos Juárez,CORDOBA,339,368,491,457,948
14,14063,140631302,Marcos Juárez,CORDOBA,205,218,311,338,649
14,14063,140631301,Marcos Juárez,CORDOBA,351,370,565,562,1127
14,14063,140631215,Marcos Juárez,CORDOBA,319,316,563,599,1162
14,14063,140631214,Marcos Juárez,CORDOBA,328,352,572,521,1093
14,14063,140631213,Marcos Juárez,CORDOBA,264,290,404,388,792
14,14063,140631212,Marcos Juárez,CORDOBA,307,324,457,430,887
14,14063,140631211,Marcos Juárez,CORDOBA,288,307,475,464,939
14,14063,140631210,Marcos Juárez,CORDOBA,354,357,666,665,1331
14,14063,140631209,Marcos Juárez,CORDOBA,341,365,594,574,1168
14,14063,140631208,Marcos Juárez,CORDOBA,260,288,401,305,706
14,14063,140631207,Marcos Juárez,CORDOBA,281,312,417,363,780
14,14063,140631206,Marcos Juárez,CORDOBA,319,323,480,467,947
14,14063,140631205,Marcos Juárez,CORDOBA,360,414,537,482,1019
14,14063,140631204,Marcos Juárez,CORDOBA,171,230,232,184,416
14,14063,140631203,Marcos Juárez,CORDOBA,260,305,366,364,730
14,14063,140631202,Marcos Juárez,CORDOBA,207,230,280,272,552
14,14063,140631201,Marcos Juárez,CORDOBA,227,254,352,347,699
14,14063,140631116,Marcos Juárez,CORDOBA,370,420,544,546,1090
14,14063,140631115,Marcos Juárez,CORDOBA,224,246,297,290,587
14,14063,140631114,Marcos Juárez,CORDOBA,241,312,326,229,555
14,14063,140631113,Marcos Juárez,CORDOBA,306,325,398,339,737
14,14063,140631112,Marcos Juárez,CORDOBA,156,202,250,156,406
14,14063,140631111,Marcos Juárez,CORDOBA,254,284,338,281,619
14,14063,140631109,Marcos Juárez,CORDOBA,195,215,349,363,712
14,14063,140631106,Marcos Juárez,CORDOBA,199,229,262,243,505
14,14063,140631105,Marcos Juárez,CORDOBA,374,407,522,474,996
14,14063,140631104,Marcos Juárez,CORDOBA,268,276,426,441,867
14,14063,140631102,Marcos Juárez,CORDOBA,283,291,527,532,1059
14,14063,140631101,Marcos Juárez,CORDOBA,366,397,672,697,1369
14,14063,140631013,Marcos Juárez,CORDOBA,381,418,655,637,1292
14,14063,140631012,Marcos Juárez,CORDOBA,344,384,520,471,991
14,14063,140631011,Marcos Juárez,CORDOBA,238,290,319,276,595
14,14063,140631010,Marcos Juárez,CORDOBA,223,250,319,307,626
14,14063,140631009,Marcos Juárez,CORDOBA,256,303,350,329,679
14,14063,140631008,Marcos Juárez,CORDOBA,235,264,321,262,583
14,14063,140631007,Marcos Juárez,CORDOBA,356,385,545,568,1113
14,14063,140631006,Marcos Juárez,CORDOBA,262,288,375,323,698
14,14063,140631005,Marcos Juárez,CORDOBA,194,224,262,278,540
14,14063,140631004,Marcos Juárez,CORDOBA,229,252,359,324,683
14,14063,140631003,Marcos Juárez,CORDOBA,353,400,521,500,1021
14,14063,140631002,Marcos Juárez,CORDOBA,308,340,467,472,939
14,14063,140631001,Marcos Juárez,CORDOBA,165,165,296,335,631
14,14063,140630923,Marcos Juárez,CORDOBA,189,221,321,287,608
14,14063,140630916,Marcos Juárez,CORDOBA,312,340,454,402,856
14,14063,140630915,Marcos Juárez,CORDOBA,332,390,494,492,986
14,14063,140630914,Marcos Juárez,CORDOBA,290,313,493,517,1010
14,14063,140630913,Marcos Juárez,CORDOBA,185,204,314,277,591
14,14063,140630912,Marcos Juárez,CORDOBA,224,269,348,272,620
14,14063,140630911,Marcos Juárez,CORDOBA,187,222,300,260,560
14,14063,140630922,Marcos Juárez,CORDOBA,353,399,537,568,1105
14,14063,140630921,Marcos Juárez,CORDOBA,301,319,472,455,927
14,14063,140630920,Marcos Juárez,CORDOBA,272,317,480,406,886
14,14063,140630812,Marcos Juárez,CORDOBA,208,238,281,287,568
14,14063,140630810,Marcos Juárez,CORDOBA,239,288,346,308,654
14,14063,140630809,Marcos Juárez,CORDOBA,219,257,317,282,599
14,14063,140630808,Marcos Juárez,CORDOBA,248,314,361,311,672
14,14063,140630807,Marcos Juárez,CORDOBA,151,170,272,231,503
14,14063,140630711,Marcos Juárez,CORDOBA,217,206,381,423,804
14,14063,140630710,Marcos Juárez,CORDOBA,120,117,217,225,442
14,14063,140630613,Marcos Juárez,CORDOBA,293,300,439,417,856
14,14063,140630612,Marcos Juárez,CORDOBA,228,230,316,269,585
14,14063,140630611,Marcos Juárez,CORDOBA,306,312,462,403,865
14,14063,140630610,Marcos Juárez,CORDOBA,252,260,328,308,636
14,14063,140630609,Marcos Juárez,CORDOBA,296,308,436,453,889
14,14063,140630608,Marcos Juárez,CORDOBA,219,241,305,273,578
14,14063,140630607,Marcos Juárez,CORDOBA,291,298,417,371,788
14,14063,140630517,Marcos Juárez,CORDOBA,131,149,203,216,419
14,14063,140630504,Marcos Juárez,CORDOBA,185,221,265,262,527
14,14063,140630510,Marcos Juárez,CORDOBA,351,359,568,616,1184
14,14063,140630407,Marcos Juárez,CORDOBA,322,366,483,474,957
14,14063,140630309,Marcos Juárez,CORDOBA,198,235,300,280,580
14,14063,140630308,Marcos Juárez,CORDOBA,256,284,397,418,815
14,14063,140630307,Marcos Juárez,CORDOBA,247,281,345,314,659
14,14063,140630306,Marcos Juárez,CORDOBA,312,357,448,427,875
14,14063,140630305,Marcos Juárez,CORDOBA,272,297,412,461,873
14,14063,140630304,Marcos Juárez,CORDOBA,249,273,429,430,859
14,14063,140630513,Marcos Juárez,CORDOBA,288,346,397,303,700
14,14063,140630512,Marcos Juárez,CORDOBA,188,217,245,255,500
14,14063,140630511,Marcos Juárez,CORDOBA,221,236,341,337,678
14,14063,140630509,Marcos Juárez,CORDOBA,193,225,306,229,535
14,14063,140630508,Marcos Juárez,CORDOBA,282,319,401,399,800
14,14063,140630507,Marcos Juárez,CORDOBA,231,263,318,278,596
14,14063,140630215,Marcos Juárez,CORDOBA,142,166,222,226,448
14,14063,140630214,Marcos Juárez,CORDOBA,204,241,310,273,583
14,14063,140630506,Marcos Juárez,CORDOBA,276,297,450,418,868
14,14063,140630505,Marcos Juárez,CORDOBA,282,318,393,368,761
14,14063,140630109,Marcos Juárez,CORDOBA,278,355,409,380,789
14,14063,140630515,Marcos Juárez,CORDOBA,340,373,465,429,894
14,14063,140631216,Marcos Juárez,CORDOBA,292,314,538,515,1053
14,14063,140630514,Marcos Juárez,CORDOBA,261,307,351,333,684
14,14063,140631108,Marcos Juárez,CORDOBA,226,257,366,395,761
14,14063,140630917,Marcos Juárez,CORDOBA,129,151,232,213,445
14,14063,140630516,Marcos Juárez,CORDOBA,296,335,427,379,806
14,14063,140631107,Marcos Juárez,CORDOBA,248,294,347,373,720
14,14063,140630709,Marcos Juárez,CORDOBA,308,368,443,370,813
14,14063,140630919,Marcos Juárez,CORDOBA,214,254,301,239,540
14,14063,140630918,Marcos Juárez,CORDOBA,280,309,389,333,722
14,14063,140630708,Marcos Juárez,CORDOBA,312,374,397,370,767
14,14063,140630706,Marcos Juárez,CORDOBA,280,311,434,389,823
14,14063,140630615,Marcos Juárez,CORDOBA,253,264,355,383,738
14,14063,140631110,Marcos Juárez,CORDOBA,355,365,545,518,1063
14,14063,140631103,Marcos Juárez,CORDOBA,214,228,341,343,684
14,14063,140630910,Marcos Juárez,CORDOBA,191,211,267,251,518
14,14063,140630707,Marcos Juárez,CORDOBA,263,280,370,342,712
14,14063,140630614,Marcos Juárez,CORDOBA,142,84,234,249,483
14,14063,140630415,Marcos Juárez,CORDOBA,212,224,369,360,729
14,14063,140630414,Marcos Juárez,CORDOBA,263,277,396,346,742
14,14063,140630413,Marcos Juárez,CORDOBA,332,365,468,448,916
14,14063,140630412,Marcos Juárez,CORDOBA,167,196,243,225,468
14,14063,140630411,Marcos Juárez,CORDOBA,193,213,273,252,525
14,14063,140630410,Marcos Juárez,CORDOBA,196,231,273,231,504
14,14063,140630409,Marcos Juárez,CORDOBA,191,221,282,231,513
14,14063,140630408,Marcos Juárez,CORDOBA,266,304,408,334,742
14,14063,140630311,Marcos Juárez,CORDOBA,283,308,498,478,976
14,14063,140630310,Marcos Juárez,CORDOBA,222,238,304,276,580
14,14063,140630213,Marcos Juárez,CORDOBA,268,332,403,371,774
14,14063,140630212,Marcos Juárez,CORDOBA,335,384,500,472,972
14,14063,140630207,Marcos Juárez,CORDOBA,29,44,55,53,108
14,14063,140630909,Marcos Juárez,CORDOBA,56,73,66,86,152
14,14063,140630908,Marcos Juárez,CORDOBA,37,54,58,69,127
14,14063,140630907,Marcos Juárez,CORDOBA,32,47,40,61,101
14,14063,140630906,Marcos Juárez,CORDOBA,21,35,37,29,66
14,14063,140630905,Marcos Juárez,CORDOBA,30,51,65,73,138
14,14063,140630904,Marcos Juárez,CORDOBA,66,98,82,95,177
14,14063,140630903,Marcos Juárez,CORDOBA,73,107,93,108,201
14,14063,140630902,Marcos Juárez,CORDOBA,38,48,54,62,116
14,14063,140630901,Marcos Juárez,CORDOBA,21,38,28,35,63
14,14063,140630806,Marcos Juárez,CORDOBA,21,45,17,37,54
14,14063,140630805,Marcos Juárez,CORDOBA,20,30,24,31,55
14,14063,140630804,Marcos Juárez,CORDOBA,55,114,84,99,183
14,14063,140630803,Marcos Juárez,CORDOBA,44,83,46,70,116
14,14063,140630802,Marcos Juárez,CORDOBA,31,64,34,54,88
14,14063,140630801,Marcos Juárez,CORDOBA,24,56,38,42,80
14,14063,140630705,Marcos Juárez,CORDOBA,41,61,51,71,122
14,14063,140630703,Marcos Juárez,CORDOBA,35,64,50,52,102
14,14063,140630702,Marcos Juárez,CORDOBA,50,65,67,74,141
14,14063,140630606,Marcos Juárez,CORDOBA,31,61,42,48,90
14,14063,140630605,Marcos Juárez,CORDOBA,20,19,37,39,76
14,14063,140630604,Marcos Juárez,CORDOBA,38,66,52,59,111
14,14063,140630603,Marcos Juárez,CORDOBA,44,111,57,72,129
14,14063,140630602,Marcos Juárez,CORDOBA,4,25,7,6,13
14,14063,140630601,Marcos Juárez,CORDOBA,5,16,7,9,16
14,14063,140630502,Marcos Juárez,CORDOBA,52,76,56,74,130
14,14063,140630503,Marcos Juárez,CORDOBA,27,56,20,33,53
14,14063,140630501,Marcos Juárez,CORDOBA,66,109,67,112,179
14,14063,140630406,Marcos Juárez,CORDOBA,9,14,17,20,37
14,14063,140630405,Marcos Juárez,CORDOBA,30,33,45,75,120
14,14063,140630403,Marcos Juárez,CORDOBA,14,47,16,18,34
14,14063,140630402,Marcos Juárez,CORDOBA,23,43,30,33,63
14,14063,140630302,Marcos Juárez,CORDOBA,37,92,50,64,114
14,14063,140630401,Marcos Juárez,CORDOBA,12,40,19,17,36
14,14063,140630301,Marcos Juárez,CORDOBA,14,14,19,24,43
14,14063,140630404,Marcos Juárez,CORDOBA,23,37,31,37,68
14,14063,140630210,Marcos Juárez,CORDOBA,37,75,46,66,112
14,14063,140630208,Marcos Juárez,CORDOBA,33,45,49,50,99
14,14063,140630203,Marcos Juárez,CORDOBA,30,56,44,60,104
14,14063,140630201,Marcos Juárez,CORDOBA,31,72,34,60,94
14,14063,140630108,Marcos Juárez,CORDOBA,19,59,29,35,64
14,14063,140630107,Marcos Juárez,CORDOBA,17,40,28,29,57
14,14063,140630204,Marcos Juárez,CORDOBA,30,63,45,58,103
14,14063,140630106,Marcos Juárez,CORDOBA,37,80,46,60,106
14,14063,140630105,Marcos Juárez,CORDOBA,18,33,19,28,47
14,14063,140630103,Marcos Juárez,CORDOBA,23,50,20,31,51
14,14063,140630704,Marcos Juárez,CORDOBA,28,58,30,54,84
14,14063,140630206,Marcos Juárez,CORDOBA,33,82,49,48,97
14,14063,140630205,Marcos Juárez,CORDOBA,16,32,22,29,51
14,14063,140630202,Marcos Juárez,CORDOBA,70,114,116,124,240
14,14063,140630102,Marcos Juárez,CORDOBA,29,59,36,44,80
14,14063,140630101,Marcos Juárez,CORDOBA,30,65,53,49,102
14,14056,140560613,Juárez Celman,CORDOBA,71,90,92,132,224
14,14056,140560612,Juárez Celman,CORDOBA,70,111,77,128,205
14,14056,140560611,Juárez Celman,CORDOBA,57,71,71,91,162
14,14056,140560401,Juárez Celman,CORDOBA,34,54,43,54,97
14,14056,140560714,Juárez Celman,CORDOBA,230,254,288,279,567
14,14056,140560713,Juárez Celman,CORDOBA,317,381,547,561,1108
14,14056,140560705,Juárez Celman,CORDOBA,198,234,311,275,586
14,14056,140560704,Juárez Celman,CORDOBA,247,280,402,360,762
14,14056,140560703,Juárez Celman,CORDOBA,290,316,517,460,977
14,14056,140560702,Juárez Celman,CORDOBA,218,238,333,313,646
14,14056,140560701,Juárez Celman,CORDOBA,231,256,343,344,687
14,14056,140560617,Juárez Celman,CORDOBA,270,300,435,424,859
14,14056,140560616,Juárez Celman,CORDOBA,229,244,345,361,706
14,14056,140560615,Juárez Celman,CORDOBA,259,307,430,406,836
14,14056,140560710,Juárez Celman,CORDOBA,228,255,381,376,757
14,14056,140560509,Juárez Celman,CORDOBA,201,231,286,270,556
14,14056,140560508,Juárez Celman,CORDOBA,205,231,281,294,575
14,14056,140560709,Juárez Celman,CORDOBA,400,447,609,568,1177
14,14056,140560414,Juárez Celman,CORDOBA,290,336,422,420,842
14,14056,140560413,Juárez Celman,CORDOBA,298,328,489,473,962
14,14056,140560412,Juárez Celman,CORDOBA,191,222,312,280,592
14,14056,140560411,Juárez Celman,CORDOBA,237,270,330,311,641
14,14056,140560410,Juárez Celman,CORDOBA,204,236,352,364,716
14,14056,140560409,Juárez Celman,CORDOBA,218,240,359,353,712
14,14056,140560408,Juárez Celman,CORDOBA,152,168,240,250,490
14,14056,140560407,Juárez Celman,CORDOBA,382,401,601,641,1242
14,14056,140560708,Juárez Celman,CORDOBA,350,451,526,470,996
14,14056,140560707,Juárez Celman,CORDOBA,213,245,347,283,630
14,14056,140560706,Juárez Celman,CORDOBA,340,372,536,493,1029
14,14056,140560320,Juárez Celman,CORDOBA,212,244,306,313,619
14,14056,140560319,Juárez Celman,CORDOBA,353,415,544,544,1088
14,14056,140560318,Juárez Celman,CORDOBA,188,219,304,319,623
14,14056,140560317,Juárez Celman,CORDOBA,184,217,311,293,604
14,14056,140560316,Juárez Celman,CORDOBA,290,334,456,457,913
14,14056,140560315,Juárez Celman,CORDOBA,199,238,292,241,533
14,14056,140560314,Juárez Celman,CORDOBA,261,295,342,366,708
14,14056,140560313,Juárez Celman,CORDOBA,354,417,523,459,982
14,14056,140560311,Juárez Celman,CORDOBA,303,357,471,444,915
14,14056,140560206,Juárez Celman,CORDOBA,309,356,419,472,891
14,14056,140560205,Juárez Celman,CORDOBA,323,330,577,558,1135
14,14056,140560204,Juárez Celman,CORDOBA,214,225,296,298,594
14,14056,140560118,Juárez Celman,CORDOBA,248,294,380,358,738
14,14056,140560117,Juárez Celman,CORDOBA,360,405,573,556,1129
14,14056,140560116,Juárez Celman,CORDOBA,239,263,350,270,620
14,14056,140560115,Juárez Celman,CORDOBA,192,245,262,265,527
14,14056,140560114,Juárez Celman,CORDOBA,227,243,349,303,652
14,14056,140560113,Juárez Celman,CORDOBA,309,368,436,402,838
14,14056,140560112,Juárez Celman,CORDOBA,244,284,323,301,624
14,14056,140560111,Juárez Celman,CORDOBA,251,285,398,396,794
14,14056,140560110,Juárez Celman,CORDOBA,278,304,460,467,927
14,14056,140560109,Juárez Celman,CORDOBA,263,283,500,504,1004
14,14056,140560108,Juárez Celman,CORDOBA,345,355,570,570,1140
14,14056,140560107,Juárez Celman,CORDOBA,285,330,401,387,788
14,14056,140560106,Juárez Celman,CORDOBA,366,414,593,581,1174
14,14056,140560214,Juárez Celman,CORDOBA,450,483,818,881,1699
14,14056,140560213,Juárez Celman,CORDOBA,476,514,864,912,1776
14,14056,140560712,Juárez Celman,CORDOBA,409,447,755,757,1512
14,14056,140560711,Juárez Celman,CORDOBA,355,385,568,535,1103
14,14056,140560212,Juárez Celman,CORDOBA,356,382,545,579,1124
14,14056,140560211,Juárez Celman,CORDOBA,364,400,511,531,1042
14,14056,140560210,Juárez Celman,CORDOBA,335,386,513,498,1011
14,14056,140560209,Juárez Celman,CORDOBA,251,288,379,409,788
14,14056,140560208,Juárez Celman,CORDOBA,232,244,314,295,609
14,14056,140560207,Juárez Celman,CORDOBA,158,219,212,180,392
14,14056,140560618,Juárez Celman,CORDOBA,189,213,284,275,559
14,14056,140560415,Juárez Celman,CORDOBA,274,319,444,389,833
14,14056,140560312,Juárez Celman,CORDOBA,289,320,407,366,773
14,14056,140560105,Juárez Celman,CORDOBA,389,417,698,669,1367
14,14056,140560104,Juárez Celman,CORDOBA,381,410,670,609,1279
14,14056,140560405,Juárez Celman,CORDOBA,38,54,49,67,116
14,14056,140560304,Juárez Celman,CORDOBA,59,77,81,121,202
14,14056,140560309,Juárez Celman,CORDOBA,42,54,51,64,115
14,14056,140560303,Juárez Celman,CORDOBA,64,94,96,155,251
14,14056,140560301,Juárez Celman,CORDOBA,6,15,7,9,16
14,14056,140560203,Juárez Celman,CORDOBA,9,23,9,13,22
14,14056,140560202,Juárez Celman,CORDOBA,20,37,27,27,54
14,14056,140560102,Juárez Celman,CORDOBA,67,106,88,113,201
14,14056,140560201,Juárez Celman,CORDOBA,38,52,43,72,115
14,14056,140560103,Juárez Celman,CORDOBA,56,79,89,88,177
14,14056,140560404,Juárez Celman,CORDOBA,12,30,13,23,36
14,14056,140560403,Juárez Celman,CORDOBA,11,29,12,17,29
14,14056,140560101,Juárez Celman,CORDOBA,70,89,75,114,189
14,14056,140560614,Juárez Celman,CORDOBA,22,35,28,31,59
14,14056,140560610,Juárez Celman,CORDOBA,42,59,56,77,133
14,14056,140560609,Juárez Celman,CORDOBA,82,136,117,140,257
14,14056,140560608,Juárez Celman,CORDOBA,51,65,68,88,156
14,14056,140560607,Juárez Celman,CORDOBA,28,54,42,53,95
14,14056,140560606,Juárez Celman,CORDOBA,24,41,24,46,70
14,14056,140560605,Juárez Celman,CORDOBA,30,53,40,47,87
14,14056,140560604,Juárez Celman,CORDOBA,20,42,28,34,62
14,14056,140560602,Juárez Celman,CORDOBA,38,57,51,61,112
14,14056,140560601,Juárez Celman,CORDOBA,65,84,81,110,191
14,14056,140560507,Juárez Celman,CORDOBA,58,85,57,89,146
14,14056,140560506,Juárez Celman,CORDOBA,66,77,111,109,220
14,14056,140560505,Juárez Celman,CORDOBA,10,18,11,18,29
14,14056,140560504,Juárez Celman,CORDOBA,47,65,51,83,134
14,14056,140560503,Juárez Celman,CORDOBA,17,17,20,25,45
14,14056,140560502,Juárez Celman,CORDOBA,21,48,23,37,60
14,14056,140560501,Juárez Celman,CORDOBA,26,30,28,36,64
14,14056,140560406,Juárez Celman,CORDOBA,24,40,34,49,83
14,14056,140560402,Juárez Celman,CORDOBA,46,69,52,73,125
14,14056,140560308,Juárez Celman,CORDOBA,29,42,39,47,86
14,14056,140560307,Juárez Celman,CORDOBA,11,17,12,17,29
14,14056,140560306,Juárez Celman,CORDOBA,12,22,20,22,42
14,14056,140560305,Juárez Celman,CORDOBA,38,65,57,63,120
14,14056,140560603,Juárez Celman,CORDOBA,29,42,36,51,87
14,14056,140560310,Juárez Celman,CORDOBA,48,62,101,100,201
14,14056,140560302,Juárez Celman,CORDOBA,34,53,38,58,96
14,14042,140420308,General San Martín,CORDOBA,187,232,319,313,632
14,14042,140420209,General San Martín,CORDOBA,126,160,217,247,464
14,14042,140420208,General San Martín,CORDOBA,130,168,205,266,471
14,14042,140420918,General San Martín,CORDOBA,237,277,337,311,648
14,14042,140420917,General San Martín,CORDOBA,250,323,409,370,779
14,14042,140420916,General San Martín,CORDOBA,288,317,478,443,921
14,14042,140420914,General San Martín,CORDOBA,328,408,397,330,727
14,14042,140420913,General San Martín,CORDOBA,260,361,369,300,669
14,14042,140420912,General San Martín,CORDOBA,123,233,249,167,416
14,14042,140420911,General San Martín,CORDOBA,200,275,267,212,479
14,14042,140420910,General San Martín,CORDOBA,208,296,299,280,579
14,14042,140420909,General San Martín,CORDOBA,380,474,536,435,971
14,14042,140420908,General San Martín,CORDOBA,206,254,272,254,526
14,14042,140420907,General San Martín,CORDOBA,208,229,326,331,657
14,14042,140420906,General San Martín,CORDOBA,320,362,549,513,1062
14,14042,140420905,General San Martín,CORDOBA,312,426,525,530,1055
14,14042,140420904,General San Martín,CORDOBA,242,265,443,435,878
14,14042,140420903,General San Martín,CORDOBA,252,278,331,340,671
14,14042,140420902,General San Martín,CORDOBA,305,351,441,418,859
14,14042,140420901,General San Martín,CORDOBA,238,262,472,450,922
14,14042,140420823,General San Martín,CORDOBA,242,275,358,352,710
14,14042,140420822,General San Martín,CORDOBA,196,228,378,384,762
14,14042,140420820,General San Martín,CORDOBA,205,311,281,202,483
14,14042,140420819,General San Martín,CORDOBA,416,477,742,719,1461
14,14042,140420818,General San Martín,CORDOBA,278,300,436,413,849
14,14042,140420817,General San Martín,CORDOBA,192,222,259,230,489
14,14042,140420816,General San Martín,CORDOBA,276,321,507,529,1036
14,14042,140420815,General San Martín,CORDOBA,291,329,508,499,1007
14,14042,140420814,General San Martín,CORDOBA,254,309,326,313,639
14,14042,140420813,General San Martín,CORDOBA,177,208,248,213,461
14,14042,140420812,General San Martín,CORDOBA,327,378,448,416,864
14,14042,140420811,General San Martín,CORDOBA,228,303,302,245,547
14,14042,140420810,General San Martín,CORDOBA,349,400,496,420,916
14,14042,140420809,General San Martín,CORDOBA,281,315,388,368,756
14,14042,140420808,General San Martín,CORDOBA,214,303,295,248,543
14,14042,140420807,General San Martín,CORDOBA,283,330,388,311,699
14,14042,140420806,General San Martín,CORDOBA,246,289,363,283,646
14,14042,140420805,General San Martín,CORDOBA,302,404,386,336,722
14,14042,140420804,General San Martín,CORDOBA,176,256,206,176,382
14,14042,140420803,General San Martín,CORDOBA,328,502,436,369,805
14,14042,140420802,General San Martín,CORDOBA,161,245,212,146,358
14,14042,140420801,General San Martín,CORDOBA,225,345,320,260,580
14,14042,140420715,General San Martín,CORDOBA,339,342,688,673,1361
14,14042,140420714,General San Martín,CORDOBA,168,263,235,203,438
14,14042,140420713,General San Martín,CORDOBA,249,300,393,347,740
14,14042,140420712,General San Martín,CORDOBA,256,309,403,403,806
14,14042,140420711,General San Martín,CORDOBA,587,607,1030,1053,2083
14,14042,140420710,General San Martín,CORDOBA,344,347,653,637,1290
14,14042,140420709,General San Martín,CORDOBA,348,339,549,488,1037
14,14042,140420708,General San Martín,CORDOBA,311,359,485,443,928
14,14042,140420707,General San Martín,CORDOBA,313,383,463,347,810
14,14042,140420706,General San Martín,CORDOBA,257,315,375,289,664
14,14042,140420704,General San Martín,CORDOBA,294,336,390,315,705
14,14042,140420703,General San Martín,CORDOBA,408,443,640,650,1290
14,14042,140420702,General San Martín,CORDOBA,325,360,511,469,980
14,14042,140420701,General San Martín,CORDOBA,377,366,620,663,1283
14,14042,140420621,General San Martín,CORDOBA,416,464,693,685,1378
14,14042,140420620,General San Martín,CORDOBA,178,305,226,187,413
14,14042,140420619,General San Martín,CORDOBA,178,253,270,170,440
14,14042,140420618,General San Martín,CORDOBA,204,231,297,288,585
14,14042,140420617,General San Martín,CORDOBA,298,365,414,340,754
14,14042,140420616,General San Martín,CORDOBA,382,429,630,592,1222
14,14042,140420615,General San Martín,CORDOBA,317,348,612,608,1220
14,14042,140420614,General San Martín,CORDOBA,297,476,395,309,704
14,14042,140420613,General San Martín,CORDOBA,302,552,416,302,718
14,14042,140420612,General San Martín,CORDOBA,178,302,236,191,427
14,14042,140420611,General San Martín,CORDOBA,301,518,407,328,735
14,14042,140420610,General San Martín,CORDOBA,206,306,260,230,490
14,14042,140420609,General San Martín,CORDOBA,305,360,436,392,828
14,14042,140420608,General San Martín,CORDOBA,424,519,596,530,1126
14,14042,140420607,General San Martín,CORDOBA,242,326,292,251,543
14,14042,140420606,General San Martín,CORDOBA,337,405,424,424,848
14,14042,140420605,General San Martín,CORDOBA,295,391,381,345,726
14,14042,140420604,General San Martín,CORDOBA,309,439,443,385,828
14,14042,140420603,General San Martín,CORDOBA,341,394,584,983,1567
14,14042,140420602,General San Martín,CORDOBA,243,264,359,377,736
14,14042,140420601,General San Martín,CORDOBA,265,302,458,474,932
14,14042,140420517,General San Martín,CORDOBA,318,324,509,537,1046
14,14042,140420516,General San Martín,CORDOBA,197,231,287,286,573
14,14042,140420510,General San Martín,CORDOBA,176,195,273,290,563
14,14042,140420514,General San Martín,CORDOBA,268,285,372,389,761
14,14042,140420419,General San Martín,CORDOBA,200,319,347,349,696
14,14042,140420418,General San Martín,CORDOBA,291,339,572,585,1157
14,14042,140420409,General San Martín,CORDOBA,271,290,467,468,935
14,14042,140420314,General San Martín,CORDOBA,394,447,590,571,1161
14,14042,140420313,General San Martín,CORDOBA,422,479,602,537,1139
14,14042,140420312,General San Martín,CORDOBA,121,135,197,157,354
14,14042,140420311,General San Martín,CORDOBA,266,338,407,350,757
14,14042,140420310,General San Martín,CORDOBA,326,380,501,556,1057
14,14042,140420408,General San Martín,CORDOBA,325,363,535,540,1075
14,14042,140420407,General San Martín,CORDOBA,338,361,587,565,1152
14,14042,140420406,General San Martín,CORDOBA,330,385,545,549,1094
14,14042,140420405,General San Martín,CORDOBA,377,405,575,488,1063
14,14042,140420404,General San Martín,CORDOBA,389,471,586,560,1146
14,14042,140420403,General San Martín,CORDOBA,237,257,368,366,734
14,14042,140420402,General San Martín,CORDOBA,242,265,344,357,701
14,14042,140420401,General San Martín,CORDOBA,320,362,583,564,1147
14,14042,140420513,General San Martín,CORDOBA,214,223,332,340,672
14,14042,140420512,General San Martín,CORDOBA,222,241,371,384,755
14,14042,140420112,General San Martín,CORDOBA,133,157,199,187,386
14,14042,140420111,General San Martín,CORDOBA,288,303,433,458,891
14,14042,140420110,General San Martín,CORDOBA,233,268,371,279,650
14,14042,140420109,General San Martín,CORDOBA,354,434,571,560,1131
14,14042,140420511,General San Martín,CORDOBA,175,192,246,256,502
14,14042,140420417,General San Martín,CORDOBA,225,236,426,424,850
14,14042,140420416,General San Martín,CORDOBA,211,210,347,322,669
14,14042,140420415,General San Martín,CORDOBA,388,410,739,734,1473
14,14042,140420413,General San Martín,CORDOBA,349,384,599,597,1196
14,14042,140420412,General San Martín,CORDOBA,298,307,491,460,951
14,14042,140420411,General San Martín,CORDOBA,339,374,542,479,1021
14,14042,140421113,General San Martín,CORDOBA,203,245,302,293,595
14,14042,140421112,General San Martín,CORDOBA,294,334,474,409,883
14,14042,140421111,General San Martín,CORDOBA,290,324,473,450,923
14,14042,140421110,General San Martín,CORDOBA,289,328,431,400,831
14,14042,140421109,General San Martín,CORDOBA,364,419,613,644,1257
14,14042,140421108,General San Martín,CORDOBA,401,444,689,676,1365
14,14042,140421107,General San Martín,CORDOBA,438,474,839,858,1697
14,14042,140421106,General San Martín,CORDOBA,219,249,397,373,770
14,14042,140421105,General San Martín,CORDOBA,325,401,506,536,1042
14,14042,140421104,General San Martín,CORDOBA,252,262,432,379,811
14,14042,140421103,General San Martín,CORDOBA,258,270,454,430,884
14,14042,140421102,General San Martín,CORDOBA,224,263,328,328,656
14,14042,140421101,General San Martín,CORDOBA,231,278,417,369,786
14,14042,140421016,General San Martín,CORDOBA,350,401,525,536,1061
14,14042,140421015,General San Martín,CORDOBA,270,308,382,363,745
14,14042,140421014,General San Martín,CORDOBA,213,237,310,333,643
14,14042,140421013,General San Martín,CORDOBA,216,239,341,295,636
14,14042,140421012,General San Martín,CORDOBA,278,316,378,361,739
14,14042,140421011,General San Martín,CORDOBA,184,191,240,274,514
14,14042,140421010,General San Martín,CORDOBA,236,256,368,425,793
14,14042,140421008,General San Martín,CORDOBA,226,263,331,284,615
14,14042,140420925,General San Martín,CORDOBA,221,308,287,242,529
14,14042,140420924,General San Martín,CORDOBA,213,278,286,240,526
14,14042,140420923,General San Martín,CORDOBA,189,288,258,198,456
14,14042,140420922,General San Martín,CORDOBA,200,231,249,215,464
14,14042,140420921,General San Martín,CORDOBA,268,293,469,456,925
14,14042,140420920,General San Martín,CORDOBA,256,276,448,394,842
14,14042,140420919,General San Martín,CORDOBA,289,340,480,457,937
14,14042,140420410,General San Martín,CORDOBA,292,314,478,433,911
14,14042,140421009,General San Martín,CORDOBA,275,308,440,427,867
14,14042,140420915,General San Martín,CORDOBA,253,325,351,299,650
14,14042,140420821,General San Martín,CORDOBA,184,285,221,211,432
14,14042,140420705,General San Martín,CORDOBA,374,500,511,410,921
14,14042,140420414,General San Martín,CORDOBA,242,254,426,421,847
14,14042,140420309,General San Martín,CORDOBA,277,310,426,415,841
14,14042,140420210,General San Martín,CORDOBA,225,269,350,327,677
14,14042,140420515,General San Martín,CORDOBA,187,212,303,302,605
14,14042,140421007,General San Martín,CORDOBA,27,48,35,50,85
14,14042,140421006,General San Martín,CORDOBA,26,38,36,59,95
14,14042,140421005,General San Martín,CORDOBA,39,60,59,64,123
14,14042,140421004,General San Martín,CORDOBA,27,72,45,55,100
14,14042,140421003,General San Martín,CORDOBA,3,9,2,4,6
14,14042,140421002,General San Martín,CORDOBA,46,77,76,82,158
14,14042,140421001,General San Martín,CORDOBA,52,71,78,106,184
14,14042,140420509,General San Martín,CORDOBA,55,73,98,118,216
14,14042,140420508,General San Martín,CORDOBA,80,104,112,155,267
14,14042,140420507,General San Martín,CORDOBA,40,60,58,85,143
14,14042,140420506,General San Martín,CORDOBA,33,37,47,65,112
14,14042,140420505,General San Martín,CORDOBA,30,45,57,53,110
14,14042,140420504,General San Martín,CORDOBA,43,59,59,79,138
14,14042,140420502,General San Martín,CORDOBA,24,55,44,45,89
14,14042,140420501,General San Martín,CORDOBA,26,29,36,55,91
14,14042,140420307,General San Martín,CORDOBA,165,158,267,317,584
14,14042,140420304,General San Martín,CORDOBA,53,79,85,87,172
14,14042,140420303,General San Martín,CORDOBA,58,66,98,108,206
14,14042,140420302,General San Martín,CORDOBA,80,107,153,168,321
14,14042,140420301,General San Martín,CORDOBA,97,104,135,175,310
14,14042,140420207,General San Martín,CORDOBA,44,54,56,81,137
14,14042,140420204,General San Martín,CORDOBA,31,49,48,73,121
14,14042,140420306,General San Martín,CORDOBA,10,14,11,17,28
14,14042,140420203,General San Martín,CORDOBA,48,60,69,98,167
14,14042,140420202,General San Martín,CORDOBA,64,98,103,115,218
14,14042,140420201,General San Martín,CORDOBA,35,53,54,77,131
14,14042,140420108,General San Martín,CORDOBA,85,106,131,177,308
14,14042,140420105,General San Martín,CORDOBA,96,111,153,180,333
14,14042,140420104,General San Martín,CORDOBA,36,48,57,71,128
14,14042,140420103,General San Martín,CORDOBA,59,71,89,112,201
14,14042,140420107,General San Martín,CORDOBA,64,79,102,136,238
14,14042,140420206,General San Martín,CORDOBA,30,39,45,64,109
14,14042,140420205,General San Martín,CORDOBA,90,116,139,170,309
14,14042,140420106,General San Martín,CORDOBA,41,58,63,91,154
14,14042,140420102,General San Martín,CORDOBA,30,50,53,56,109
14,14042,140420101,General San Martín,CORDOBA,42,72,58,79,137
14,14042,140420503,General San Martín,CORDOBA,22,47,26,34,60
14,14042,140420305,General San Martín,CORDOBA,56,78,85,101,186
14,14035,140350309,General Roca,CORDOBA,47,58,39,80,119
14,14035,140350307,General Roca,CORDOBA,187,220,213,309,522
14,14035,140350306,General Roca,CORDOBA,67,86,90,113,203
14,14035,140350206,General Roca,CORDOBA,103,136,164,164,328
14,14035,140350106,General Roca,CORDOBA,46,54,54,78,132
14,14035,140350513,General Roca,CORDOBA,292,324,417,396,813
14,14035,140350514,General Roca,CORDOBA,205,226,398,347,745
14,14035,140350512,General Roca,CORDOBA,381,431,597,613,1210
14,14035,140350511,General Roca,CORDOBA,259,313,388,336,724
14,14035,140350509,General Roca,CORDOBA,213,232,346,345,691
14,14035,140350508,General Roca,CORDOBA,232,271,384,366,750
14,14035,140350318,General Roca,CORDOBA,371,452,541,549,1090
14,14035,140350317,General Roca,CORDOBA,371,420,532,535,1067
14,14035,140350316,General Roca,CORDOBA,272,292,368,343,711
14,14035,140350315,General Roca,CORDOBA,295,335,503,453,956
14,14035,140350314,General Roca,CORDOBA,229,252,378,361,739
14,14035,140350313,General Roca,CORDOBA,256,298,414,398,812
14,14035,140350312,General Roca,CORDOBA,281,309,387,389,776
14,14035,140350311,General Roca,CORDOBA,300,319,476,477,953
14,14035,140350310,General Roca,CORDOBA,164,193,251,253,504
14,14035,140350406,General Roca,CORDOBA,340,382,605,554,1159
14,14035,140350214,General Roca,CORDOBA,280,320,412,389,801
14,14035,140350213,General Roca,CORDOBA,346,394,509,529,1038
14,14035,140350212,General Roca,CORDOBA,363,421,522,441,963
14,14035,140350211,General Roca,CORDOBA,217,269,374,380,754
14,14035,140350405,General Roca,CORDOBA,262,272,461,449,910
14,14035,140350107,General Roca,CORDOBA,120,166,183,190,373
14,14035,140350415,General Roca,CORDOBA,291,302,518,551,1069
14,14035,140350411,General Roca,CORDOBA,188,223,241,226,467
14,14035,140350410,General Roca,CORDOBA,204,249,304,252,556
14,14035,140350409,General Roca,CORDOBA,238,270,376,339,715
14,14035,140350408,General Roca,CORDOBA,190,238,279,225,504
14,14035,140350407,General Roca,CORDOBA,271,319,398,387,785
14,14035,140350414,General Roca,CORDOBA,295,322,518,488,1006
14,14035,140350413,General Roca,CORDOBA,248,290,364,368,732
14,14035,140350412,General Roca,CORDOBA,266,297,410,385,795
14,14035,140350510,General Roca,CORDOBA,221,250,366,357,723
14,14035,140350404,General Roca,CORDOBA,218,245,360,368,728
14,14035,140350215,General Roca,CORDOBA,320,358,493,503,996
14,14035,140350210,General Roca,CORDOBA,206,247,323,334,657
14,14035,140350110,General Roca,CORDOBA,224,264,407,441,848
14,14035,140350109,General Roca,CORDOBA,299,359,485,459,944
14,14035,140350108,General Roca,CORDOBA,365,449,612,574,1186
14,14035,140350507,General Roca,CORDOBA,17,27,13,33,46
14,14035,140350506,General Roca,CORDOBA,36,49,38,71,109
14,14035,140350505,General Roca,CORDOBA,38,67,44,64,108
14,14035,140350305,General Roca,CORDOBA,79,86,93,137,230
14,14035,140350209,General Roca,CORDOBA,22,45,17,31,48
14,14035,140350208,General Roca,CORDOBA,35,49,47,87,134
14,14035,140350207,General Roca,CORDOBA,23,40,30,37,67
14,14035,140350205,General Roca,CORDOBA,20,32,19,26,45
14,14035,140350304,General Roca,CORDOBA,74,111,94,126,220
14,14035,140350203,General Roca,CORDOBA,21,43,24,30,54
14,14035,140350403,General Roca,CORDOBA,73,140,87,119,206
14,14035,140350303,General Roca,CORDOBA,84,121,120,230,350
14,14035,140350202,General Roca,CORDOBA,34,45,34,49,83
14,14035,140350302,General Roca,CORDOBA,18,44,19,33,52
14,14035,140350301,General Roca,CORDOBA,38,64,48,75,123
14,14035,140350201,General Roca,CORDOBA,28,30,34,50,84
14,14035,140350204,General Roca,CORDOBA,18,30,22,34,56
14,14035,140350105,General Roca,CORDOBA,24,35,26,53,79
14,14035,140350104,General Roca,CORDOBA,31,58,16,53,69
14,14035,140350402,General Roca,CORDOBA,58,81,66,99,165
14,14035,140350102,General Roca,CORDOBA,14,23,11,27,38
14,14035,140350101,General Roca,CORDOBA,19,20,9,32,41
14,14035,140350103,General Roca,CORDOBA,50,68,57,94,151
14,14035,140350502,General Roca,CORDOBA,46,63,18,85,103
14,14035,140350501,General Roca,CORDOBA,13,20,3,21,24
14,14035,140350401,General Roca,CORDOBA,28,53,29,51,80
14,14035,140350504,General Roca,CORDOBA,47,68,47,74,121
14,14035,140350503,General Roca,CORDOBA,34,54,24,48,72
14,14035,140350308,General Roca,CORDOBA,43,59,55,78,133
22,22140,221400722,San Fernando,CHACO,10,16,12,13,25
22,22140,221400723,San Fernando,CHACO,251,255,534,522,1056
22,22140,221400724,San Fernando,CHACO,328,309,651,614,1265
22,22140,221400725,San Fernando,CHACO,250,219,434,415,849
22,22140,221400726,San Fernando,CHACO,243,249,471,446,917
22,22140,221400727,San Fernando,CHACO,269,272,581,592,1173
22,22140,221400728,San Fernando,CHACO,193,196,393,387,780
22,22140,221400729,San Fernando,CHACO,153,164,282,267,549
22,22140,221400801,San Fernando,CHACO,260,454,344,236,580
22,22140,221400802,San Fernando,CHACO,255,323,451,334,785
22,22140,221400803,San Fernando,CHACO,256,311,524,438,962
22,22140,221400804,San Fernando,CHACO,122,172,191,152,343
22,22140,221400805,San Fernando,CHACO,205,224,310,276,586
22,22140,221400806,San Fernando,CHACO,214,297,261,236,497
22,22140,221400807,San Fernando,CHACO,259,356,371,295,666
22,22140,221400808,San Fernando,CHACO,308,337,431,324,755
22,22140,221400809,San Fernando,CHACO,148,209,174,148,322
22,22140,221400810,San Fernando,CHACO,289,292,539,476,1015
22,22140,221400811,San Fernando,CHACO,238,218,480,445,925
22,22140,221400812,San Fernando,CHACO,177,201,228,169,397
22,22140,221400813,San Fernando,CHACO,239,266,332,269,601
22,22140,221400814,San Fernando,CHACO,293,367,432,357,789
22,22140,221400815,San Fernando,CHACO,281,349,359,275,634
22,22140,221400816,San Fernando,CHACO,120,149,183,157,340
22,22140,221400817,San Fernando,CHACO,184,244,221,208,429
22,22140,221400818,San Fernando,CHACO,167,268,138,141,279
22,22140,221400901,San Fernando,CHACO,232,308,337,314,651
22,22140,221400902,San Fernando,CHACO,397,415,847,784,1631
22,22140,221400903,San Fernando,CHACO,322,325,564,968,1532
22,22140,221400904,San Fernando,CHACO,331,325,580,530,1110
22,22140,221400905,San Fernando,CHACO,308,312,389,451,840
22,22140,221400906,San Fernando,CHACO,359,369,644,579,1223
22,22140,221400907,San Fernando,CHACO,270,284,534,509,1043
22,22140,221400908,San Fernando,CHACO,257,276,493,493,986
22,22140,221400909,San Fernando,CHACO,275,276,517,485,1002
22,22140,221400910,San Fernando,CHACO,358,384,697,617,1314
22,22140,221400911,San Fernando,CHACO,253,274,447,405,852
22,22140,221400101,San Fernando,CHACO,133,110,270,264,534
22,22140,221400102,San Fernando,CHACO,407,396,908,930,1838
22,22140,221400103,San Fernando,CHACO,174,179,291,242,533
22,22140,221400104,San Fernando,CHACO,310,332,488,429,917
22,22140,221400105,San Fernando,CHACO,237,236,390,386,776
22,22140,221400106,San Fernando,CHACO,288,274,613,641,1254
22,22140,221400107,San Fernando,CHACO,358,336,678,662,1340
22,22140,221400108,San Fernando,CHACO,123,133,186,194,380
22,22140,221400109,San Fernando,CHACO,292,302,550,568,1118
22,22140,221400110,San Fernando,CHACO,202,206,392,343,735
22,22140,221400111,San Fernando,CHACO,381,381,721,626,1347
22,22140,221400112,San Fernando,CHACO,258,264,463,449,912
22,22140,221400113,San Fernando,CHACO,239,237,454,483,937
22,22140,221400114,San Fernando,CHACO,111,124,179,191,370
22,22140,221400115,San Fernando,CHACO,230,234,406,364,770
22,22140,221400116,San Fernando,CHACO,200,206,393,397,790
22,22140,221400117,San Fernando,CHACO,238,238,491,495,986
22,22140,221400118,San Fernando,CHACO,217,216,392,391,783
22,22140,221400201,San Fernando,CHACO,237,275,396,318,714
22,22140,221400202,San Fernando,CHACO,268,304,403,314,717
22,22140,221400203,San Fernando,CHACO,294,314,520,441,961
22,22140,221400204,San Fernando,CHACO,335,350,650,571,1221
22,22140,221400205,San Fernando,CHACO,224,256,370,332,702
22,22140,221400206,San Fernando,CHACO,368,415,635,574,1209
22,22140,221400207,San Fernando,CHACO,355,360,667,687,1354
22,22140,221400208,San Fernando,CHACO,302,309,600,583,1183
22,22140,221400209,San Fernando,CHACO,219,205,397,381,778
22,22140,221400210,San Fernando,CHACO,339,348,612,577,1189
22,22140,221400211,San Fernando,CHACO,270,290,487,509,996
22,22140,221400301,San Fernando,CHACO,207,280,336,264,600
22,22140,221400302,San Fernando,CHACO,201,269,320,253,573
22,22140,221400303,San Fernando,CHACO,281,347,408,312,720
22,22140,221400304,San Fernando,CHACO,251,397,344,306,650
22,22140,221400305,San Fernando,CHACO,272,351,399,314,713
22,22140,221400306,San Fernando,CHACO,214,258,357,262,619
22,22140,221400307,San Fernando,CHACO,202,249,315,258,573
22,22140,221400308,San Fernando,CHACO,232,277,396,345,741
22,22140,221400309,San Fernando,CHACO,250,254,478,400,878
22,22140,221400310,San Fernando,CHACO,209,219,358,289,647
22,22140,221400311,San Fernando,CHACO,234,264,434,377,811
22,22140,221400312,San Fernando,CHACO,335,357,637,658,1295
22,22140,221400313,San Fernando,CHACO,367,369,786,774,1560
22,22140,221400401,San Fernando,CHACO,128,237,195,175,370
22,22140,221400402,San Fernando,CHACO,185,236,289,251,540
22,22140,221400403,San Fernando,CHACO,228,337,288,249,537
22,22140,221400404,San Fernando,CHACO,273,347,337,302,639
22,22140,221400405,San Fernando,CHACO,270,321,389,319,708
22,22140,221400406,San Fernando,CHACO,224,336,348,266,614
22,22140,221400407,San Fernando,CHACO,267,325,388,322,710
22,22140,221400408,San Fernando,CHACO,204,320,368,296,664
22,22140,221400409,San Fernando,CHACO,288,307,499,366,865
22,22140,221400410,San Fernando,CHACO,219,235,367,323,690
22,22140,221400411,San Fernando,CHACO,291,271,525,472,997
22,22140,221400412,San Fernando,CHACO,294,312,519,464,983
22,22140,221400413,San Fernando,CHACO,163,160,243,214,457
22,22140,221400414,San Fernando,CHACO,255,266,447,451,898
22,22140,221400415,San Fernando,CHACO,139,150,247,211,458
22,22140,221400416,San Fernando,CHACO,201,218,330,289,619
22,22140,221400417,San Fernando,CHACO,71,82,111,106,217
22,22140,221400418,San Fernando,CHACO,136,140,241,215,456
22,22140,221400501,San Fernando,CHACO,236,250,376,335,711
22,22140,221400502,San Fernando,CHACO,217,218,523,436,959
22,22140,221400503,San Fernando,CHACO,228,269,346,302,648
22,22140,221400504,San Fernando,CHACO,241,182,412,326,738
22,22140,221400505,San Fernando,CHACO,402,327,801,715,1516
22,22140,221400506,San Fernando,CHACO,277,242,457,428,885
22,22140,221400507,San Fernando,CHACO,296,303,502,488,990
22,22140,221400508,San Fernando,CHACO,338,336,658,672,1330
22,22140,221400509,San Fernando,CHACO,211,218,378,362,740
22,22140,221400510,San Fernando,CHACO,246,257,448,422,870
22,22140,221400511,San Fernando,CHACO,233,237,457,421,878
22,22140,221400512,San Fernando,CHACO,302,246,586,572,1158
22,22140,221400513,San Fernando,CHACO,312,307,679,657,1336
22,22140,221400514,San Fernando,CHACO,256,262,522,504,1026
22,22140,221400601,San Fernando,CHACO,377,418,727,746,1473
22,22140,221400602,San Fernando,CHACO,253,269,406,357,763
22,22140,221400603,San Fernando,CHACO,279,296,437,444,881
22,22140,221400604,San Fernando,CHACO,241,244,397,354,751
22,22140,221400605,San Fernando,CHACO,308,312,585,574,1159
22,22140,221400606,San Fernando,CHACO,387,367,740,691,1431
22,22140,221400607,San Fernando,CHACO,211,218,381,348,729
22,22140,221400608,San Fernando,CHACO,405,397,874,749,1623
22,22140,221400609,San Fernando,CHACO,375,372,737,703,1440
22,22140,221400610,San Fernando,CHACO,337,333,704,626,1330
22,22140,221400611,San Fernando,CHACO,283,282,538,511,1049
22,22140,221400612,San Fernando,CHACO,165,184,336,332,668
22,22140,221400701,San Fernando,CHACO,257,273,391,380,771
22,22140,221400702,San Fernando,CHACO,329,309,577,508,1085
22,22140,221400703,San Fernando,CHACO,299,280,477,469,946
22,22140,221400704,San Fernando,CHACO,240,230,448,436,884
22,22140,221400705,San Fernando,CHACO,234,221,439,388,827
22,22140,221400706,San Fernando,CHACO,335,295,608,536,1144
22,22140,221400707,San Fernando,CHACO,211,200,368,313,681
22,22140,221400708,San Fernando,CHACO,265,255,482,454,936
22,22140,221400709,San Fernando,CHACO,209,126,429,417,846
22,22140,221400710,San Fernando,CHACO,234,224,458,419,877
22,22140,221400711,San Fernando,CHACO,214,209,411,383,794
22,22140,221400712,San Fernando,CHACO,195,192,373,326,699
22,22140,221400713,San Fernando,CHACO,180,172,328,251,579
22,22140,221400714,San Fernando,CHACO,295,239,592,553,1145
22,22140,221400715,San Fernando,CHACO,193,206,328,298,626
22,22140,221400716,San Fernando,CHACO,287,307,544,470,1014
22,22140,221400717,San Fernando,CHACO,164,158,290,285,575
22,22140,221400718,San Fernando,CHACO,302,283,586,539,1125
22,22140,221400719,San Fernando,CHACO,219,233,454,401,855
22,22140,221400720,San Fernando,CHACO,208,215,393,424,817
22,22140,221400721,San Fernando,CHACO,255,258,461,475,936
22,22140,221400912,San Fernando,CHACO,182,184,357,307,664
22,22140,221400913,San Fernando,CHACO,352,379,641,572,1213
22,22140,221400914,San Fernando,CHACO,399,467,646,603,1249
22,22140,221400915,San Fernando,CHACO,353,380,609,563,1172
22,22140,221400916,San Fernando,CHACO,341,307,556,402,958
22,22140,221400917,San Fernando,CHACO,222,216,461,466,927
22,22140,221400918,San Fernando,CHACO,226,242,476,424,900
22,22140,221401001,San Fernando,CHACO,306,303,579,524,1103
22,22140,221401002,San Fernando,CHACO,200,198,348,338,686
22,22140,221401003,San Fernando,CHACO,283,283,544,515,1059
22,22140,221401004,San Fernando,CHACO,366,384,680,631,1311
22,22140,221401005,San Fernando,CHACO,306,341,546,440,986
22,22140,221401006,San Fernando,CHACO,329,325,610,623,1233
22,22140,221401007,San Fernando,CHACO,369,397,690,686,1376
22,22140,221401008,San Fernando,CHACO,259,261,468,455,923
22,22140,221401009,San Fernando,CHACO,386,396,766,725,1491
22,22140,221401010,San Fernando,CHACO,259,245,469,402,871
22,22140,221401011,San Fernando,CHACO,265,285,507,450,957
22,22140,221401012,San Fernando,CHACO,248,227,426,433,859
22,22140,221401013,San Fernando,CHACO,264,347,443,432,875
22,22140,221401014,San Fernando,CHACO,275,312,498,511,1009
22,22140,221401015,San Fernando,CHACO,260,275,500,510,1010
22,22140,221401017,San Fernando,CHACO,277,286,582,568,1150
22,22140,221401018,San Fernando,CHACO,263,276,530,511,1041
22,22140,221401019,San Fernando,CHACO,205,210,372,403,775
22,22140,221401020,San Fernando,CHACO,287,296,645,626,1271
22,22140,221401021,San Fernando,CHACO,220,244,440,420,860
22,22140,221401022,San Fernando,CHACO,235,259,479,466,945
22,22140,221401101,San Fernando,CHACO,261,292,333,243,576
22,22140,221401102,San Fernando,CHACO,303,335,353,275,628
22,22140,221401103,San Fernando,CHACO,266,341,373,297,670
22,22140,221401104,San Fernando,CHACO,412,413,617,559,1176
22,22140,221401105,San Fernando,CHACO,224,264,356,307,663
22,22140,221401106,San Fernando,CHACO,205,209,392,309,701
22,22140,221401107,San Fernando,CHACO,247,253,374,315,689
22,22140,221401108,San Fernando,CHACO,209,257,309,276,585
22,22140,221401109,San Fernando,CHACO,168,155,321,281,602
22,22140,221401110,San Fernando,CHACO,198,228,314,306,620
22,22140,221401111,San Fernando,CHACO,299,321,583,473,1056
22,22140,221401112,San Fernando,CHACO,285,344,371,323,694
22,22140,221401113,San Fernando,CHACO,182,211,296,244,540
22,22140,221401114,San Fernando,CHACO,220,252,351,313,664
22,22140,221401115,San Fernando,CHACO,220,221,322,295,617
22,22140,221401201,San Fernando,CHACO,178,227,252,182,434
22,22140,221401202,San Fernando,CHACO,189,278,300,233,533
22,22140,221401203,San Fernando,CHACO,224,350,330,213,543
22,22140,221401204,San Fernando,CHACO,247,322,356,283,639
22,22140,221401205,San Fernando,CHACO,206,261,369,251,620
22,22140,221401206,San Fernando,CHACO,264,343,366,305,671
22,22140,221401207,San Fernando,CHACO,249,308,378,289,667
22,22140,221401208,San Fernando,CHACO,345,376,512,388,900
22,22140,221401209,San Fernando,CHACO,159,193,270,224,494
22,22140,221401210,San Fernando,CHACO,373,470,548,427,975
22,22140,221401211,San Fernando,CHACO,349,404,605,521,1126
22,22140,221401212,San Fernando,CHACO,186,199,311,279,590
22,22140,221401213,San Fernando,CHACO,394,414,649,560,1209
22,22140,221401214,San Fernando,CHACO,210,233,384,347,731
22,22140,221401215,San Fernando,CHACO,432,454,798,735,1533
22,22140,221401216,San Fernando,CHACO,159,192,207,157,364
22,22140,221401217,San Fernando,CHACO,360,386,708,641,1349
22,22140,221401301,San Fernando,CHACO,213,229,316,306,622
22,22140,221401302,San Fernando,CHACO,265,305,409,334,743
22,22140,221401303,San Fernando,CHACO,254,285,382,314,696
22,22140,221401304,San Fernando,CHACO,250,226,413,339,752
22,22140,221401305,San Fernando,CHACO,275,266,490,468,958
22,22140,221401306,San Fernando,CHACO,212,255,338,284,622
22,22140,221401307,San Fernando,CHACO,283,296,465,385,850
22,22140,221401308,San Fernando,CHACO,393,392,682,609,1291
22,22140,221401309,San Fernando,CHACO,162,168,277,248,525
22,22140,221401310,San Fernando,CHACO,178,190,341,275,616
22,22140,221401311,San Fernando,CHACO,214,209,398,375,773
22,22140,221401312,San Fernando,CHACO,191,174,362,303,665
22,22140,221401313,San Fernando,CHACO,229,219,477,455,932
22,22140,221401314,San Fernando,CHACO,204,192,406,350,756
22,22140,221401315,San Fernando,CHACO,61,490,75,87,162
22,22140,221401401,San Fernando,CHACO,141,163,254,236,490
22,22140,221401402,San Fernando,CHACO,219,224,357,336,693
22,22140,221401403,San Fernando,CHACO,292,304,541,417,958
22,22140,221401404,San Fernando,CHACO,266,299,463,404,867
22,22140,221401405,San Fernando,CHACO,191,209,343,357,700
22,22140,221401406,San Fernando,CHACO,366,378,620,562,1182
22,22140,221401407,San Fernando,CHACO,230,194,422,379,801
22,22140,221401408,San Fernando,CHACO,214,226,398,345,743
22,22140,221401409,San Fernando,CHACO,193,206,354,270,624
22,22140,221401410,San Fernando,CHACO,181,201,326,288,614
22,22140,221401411,San Fernando,CHACO,244,198,475,452,927
22,22140,221401412,San Fernando,CHACO,101,122,198,150,348
22,22140,221401413,San Fernando,CHACO,171,181,293,257,550
22,22140,221401501,San Fernando,CHACO,312,330,523,451,974
22,22140,221401502,San Fernando,CHACO,233,110,527,394,921
22,22140,221401503,San Fernando,CHACO,304,360,470,383,853
22,22140,221401504,San Fernando,CHACO,260,268,463,387,850
22,22140,221401505,San Fernando,CHACO,197,211,328,285,613
22,22140,221401506,San Fernando,CHACO,364,390,669,562,1231
22,22140,221401507,San Fernando,CHACO,283,300,546,449,995
22,22140,221401508,San Fernando,CHACO,277,277,478,424,902
22,22140,221401509,San Fernando,CHACO,192,217,351,295,646
22,22140,221401510,San Fernando,CHACO,342,365,645,517,1162
22,22140,221401601,San Fernando,CHACO,254,267,497,532,1029
22,22140,221401602,San Fernando,CHACO,108,122,197,169,366
22,22140,221401603,San Fernando,CHACO,219,223,411,299,710
22,22140,221401604,San Fernando,CHACO,379,304,606,539,1145
22,22140,221401605,San Fernando,CHACO,302,288,525,470,995
22,22140,221401606,San Fernando,CHACO,295,283,528,505,1033
22,22140,221401607,San Fernando,CHACO,246,222,326,253,579
22,22140,221401608,San Fernando,CHACO,191,217,364,343,707
22,22140,221401609,San Fernando,CHACO,392,433,711,713,1424
22,22140,221401610,San Fernando,CHACO,277,263,502,453,955
22,22140,221401611,San Fernando,CHACO,125,134,221,204,425
22,22140,221401612,San Fernando,CHACO,220,226,422,361,783
22,22140,221401613,San Fernando,CHACO,158,177,273,258,531
22,22140,221401614,San Fernando,CHACO,129,145,269,224,493
22,22140,221401615,San Fernando,CHACO,215,237,342,306,648
22,22140,221401616,San Fernando,CHACO,285,307,530,512,1042
22,22140,221401617,San Fernando,CHACO,235,243,446,438,884
22,22140,221401618,San Fernando,CHACO,300,337,607,529,1136
22,22140,221401619,San Fernando,CHACO,258,280,504,444,948
22,22140,221401620,San Fernando,CHACO,223,232,499,478,977
22,22140,221401621,San Fernando,CHACO,284,294,560,554,1114
22,22140,221401622,San Fernando,CHACO,52,63,91,79,170
22,22140,221401623,San Fernando,CHACO,79,82,163,129,292
22,22140,221401624,San Fernando,CHACO,61,65,104,99,203
22,22140,221401625,San Fernando,CHACO,186,214,341,330,671
22,22140,221401701,San Fernando,CHACO,165,173,284,297,581
22,22140,221401702,San Fernando,CHACO,307,327,511,491,1002
22,22140,221401703,San Fernando,CHACO,370,399,696,689,1385
22,22140,221401704,San Fernando,CHACO,262,273,429,438,867
22,22140,221401705,San Fernando,CHACO,379,406,666,653,1319
22,22140,221401706,San Fernando,CHACO,347,359,780,700,1480
22,22140,221401707,San Fernando,CHACO,229,224,451,465,916
22,22140,221401708,San Fernando,CHACO,194,191,396,462,858
22,22140,221401709,San Fernando,CHACO,189,197,318,315,633
22,22140,221401710,San Fernando,CHACO,187,199,403,402,805
22,22140,221401801,San Fernando,CHACO,254,254,465,427,892
22,22140,221401802,San Fernando,CHACO,328,343,709,586,1295
22,22140,221401803,San Fernando,CHACO,215,213,467,467,934
22,22140,221401804,San Fernando,CHACO,253,244,519,519,1038
22,22140,221401805,San Fernando,CHACO,222,225,438,405,843
22,22140,221401806,San Fernando,CHACO,317,314,626,615,1241
22,22140,221401807,San Fernando,CHACO,333,329,641,550,1191
22,22140,221401808,San Fernando,CHACO,264,270,456,476,932
22,22140,221401809,San Fernando,CHACO,240,252,461,422,883
22,22140,221401810,San Fernando,CHACO,257,260,523,500,1023
22,22140,221401811,San Fernando,CHACO,239,230,507,483,990
22,22140,221401812,San Fernando,CHACO,199,189,354,343,697
22,22140,221401813,San Fernando,CHACO,234,230,416,394,810
22,22140,221401814,San Fernando,CHACO,229,220,458,386,844
22,22140,221401815,San Fernando,CHACO,203,204,395,400,795
22,22140,221401816,San Fernando,CHACO,396,395,882,874,1756
22,22140,221401817,San Fernando,CHACO,186,193,311,314,625
22,22140,221401818,San Fernando,CHACO,9,23,8,9,17
22,22140,221401819,San Fernando,CHACO,270,279,545,563,1108
22,22140,221401820,San Fernando,CHACO,250,281,438,409,847
22,22140,221401821,San Fernando,CHACO,193,207,382,362,744
22,22140,221401901,San Fernando,CHACO,386,407,709,651,1360
22,22140,221401902,San Fernando,CHACO,84,81,125,138,263
22,22140,221401903,San Fernando,CHACO,208,205,378,313,691
22,22140,221401904,San Fernando,CHACO,349,380,658,599,1257
22,22140,221401905,San Fernando,CHACO,164,196,297,248,545
22,22140,221401906,San Fernando,CHACO,213,217,389,349,738
22,22140,221401907,San Fernando,CHACO,339,357,618,545,1163
22,22140,221401908,San Fernando,CHACO,199,201,355,364,719
22,22140,221401909,San Fernando,CHACO,225,217,392,338,730
22,22140,221401910,San Fernando,CHACO,160,175,300,247,547
22,22140,221401911,San Fernando,CHACO,214,221,360,305,665
22,22140,221401912,San Fernando,CHACO,229,235,424,372,796
22,22140,221401913,San Fernando,CHACO,212,217,421,383,804
22,22140,221401914,San Fernando,CHACO,165,182,354,319,673
22,22140,221401915,San Fernando,CHACO,196,204,354,318,672
22,22140,221401916,San Fernando,CHACO,221,237,420,372,792
22,22140,221402001,San Fernando,CHACO,230,242,388,382,770
22,22140,221402002,San Fernando,CHACO,306,309,568,513,1081
22,22140,221402003,San Fernando,CHACO,195,190,346,279,625
22,22140,221402004,San Fernando,CHACO,276,278,519,491,1010
22,22140,221402005,San Fernando,CHACO,394,383,736,740,1476
22,22140,221402006,San Fernando,CHACO,359,372,675,674,1349
22,22140,221402007,San Fernando,CHACO,254,245,491,503,994
22,22140,221402008,San Fernando,CHACO,237,228,453,432,885
22,22140,221402009,San Fernando,CHACO,269,287,531,459,990
22,22140,221402010,San Fernando,CHACO,213,226,390,363,753
22,22140,221402011,San Fernando,CHACO,199,207,365,356,721
22,22140,221402101,San Fernando,CHACO,301,303,608,577,1185
22,22140,221402102,San Fernando,CHACO,266,262,492,479,971
22,22140,221402103,San Fernando,CHACO,268,273,506,460,966
22,22140,221402104,San Fernando,CHACO,144,147,254,255,509
22,22140,221402105,San Fernando,CHACO,379,385,700,693,1393
22,22140,221402106,San Fernando,CHACO,502,491,999,961,1960
22,22140,221402107,San Fernando,CHACO,64,59,129,158,287
22,22140,221402108,San Fernando,CHACO,255,277,487,520,1007
22,22140,221402109,San Fernando,CHACO,44,44,89,104,193
22,22140,221402201,San Fernando,CHACO,25,45,26,41,67
22,22140,221402202,San Fernando,CHACO,33,46,34,56,90
22,22140,221402203,San Fernando,CHACO,59,84,101,110,211
22,22140,221402204,San Fernando,CHACO,17,20,15,25,40
22,22140,221402205,San Fernando,CHACO,45,49,61,95,156
22,22140,221402206,San Fernando,CHACO,41,43,40,75,115
22,22140,221402301,San Fernando,CHACO,5,10,5,12,17
22,22140,221402302,San Fernando,CHACO,2,3,4,5,9
22,22140,221402303,San Fernando,CHACO,16,24,17,35,52
22,22140,221402304,San Fernando,CHACO,117,144,208,238,446
22,22140,221402305,San Fernando,CHACO,19,21,21,30,51
22,22140,221402401,San Fernando,CHACO,199,217,327,347,674
22,22140,221402402,San Fernando,CHACO,10,12,18,18,36
22,22140,221402403,San Fernando,CHACO,29,35,39,42,81
22,22140,221402404,San Fernando,CHACO,257,275,458,415,873
22,22140,221402405,San Fernando,CHACO,50,72,78,87,165
22,22140,221402406,San Fernando,CHACO,90,101,178,164,342
22,22140,221402407,San Fernando,CHACO,2,4,0,2,2
22,22140,221402408,San Fernando,CHACO,6,10,7,14,21
22,22140,221402409,San Fernando,CHACO,58,62,98,120,218
22,22140,221402410,San Fernando,CHACO,78,93,155,157,312
22,22140,221402411,San Fernando,CHACO,176,193,345,350,695
22,22140,221402501,San Fernando,CHACO,306,315,719,672,1391
22,22140,221402502,San Fernando,CHACO,286,308,598,528,1126
22,22140,221402503,San Fernando,CHACO,434,470,794,819,1613
22,22140,221402504,San Fernando,CHACO,355,400,651,626,1277
22,22140,221402505,San Fernando,CHACO,494,580,959,938,1897
22,22140,221402506,San Fernando,CHACO,202,230,416,483,899
22,22140,221402507,San Fernando,CHACO,87,123,110,155,265
22,22140,221402508,San Fernando,CHACO,332,325,719,743,1462
22,22140,221402509,San Fernando,CHACO,277,246,604,570,1174
22,22140,221402510,San Fernando,CHACO,340,372,664,655,1319
22,22140,221402511,San Fernando,CHACO,430,437,878,885,1763
22,22140,221402512,San Fernando,CHACO,360,402,718,715,1433
22,22140,221402513,San Fernando,CHACO,153,187,265,267,532
22,22140,221402514,San Fernando,CHACO,70,62,132,135,267
22,22140,221402515,San Fernando,CHACO,130,154,230,226,456
22,22140,221402516,San Fernando,CHACO,164,166,366,367,733
22,22140,221402517,San Fernando,CHACO,117,132,194,191,385
22,22140,221402518,San Fernando,CHACO,236,245,467,427,894
22,22140,221402601,San Fernando,CHACO,218,225,430,438,868
22,22140,221402602,San Fernando,CHACO,311,294,617,626,1243
22,22140,221402603,San Fernando,CHACO,310,311,611,570,1181
22,22140,221402604,San Fernando,CHACO,264,228,483,499,982
22,22140,221402605,San Fernando,CHACO,256,261,489,502,991
22,22140,221402606,San Fernando,CHACO,220,233,472,447,919
22,22140,221402607,San Fernando,CHACO,363,416,745,712,1457
22,22140,221402608,San Fernando,CHACO,349,369,714,676,1390
22,22140,221402609,San Fernando,CHACO,171,183,310,314,624
22,22140,221402701,San Fernando,CHACO,322,342,582,559,1141
22,22140,221402702,San Fernando,CHACO,333,358,610,547,1157
22,22140,221402703,San Fernando,CHACO,247,243,528,512,1040
22,22140,221402704,San Fernando,CHACO,291,276,643,674,1317
22,22140,221402705,San Fernando,CHACO,311,289,648,660,1308
22,22140,221402706,San Fernando,CHACO,226,207,519,505,1024
22,22140,221402707,San Fernando,CHACO,388,374,911,838,1749
22,22140,221402708,San Fernando,CHACO,264,261,599,548,1147
22,22140,221402709,San Fernando,CHACO,233,244,530,504,1034
22,22140,221402710,San Fernando,CHACO,179,189,344,282,626
22,22140,221402711,San Fernando,CHACO,322,321,618,615,1233
22,22140,221402712,San Fernando,CHACO,243,264,454,398,852
22,22140,221402713,San Fernando,CHACO,242,252,481,437,918
22,22140,221402714,San Fernando,CHACO,466,463,977,897,1874
22,22140,221402715,San Fernando,CHACO,316,296,653,562,1215
22,22140,221402716,San Fernando,CHACO,371,378,816,730,1546
22,22140,221402717,San Fernando,CHACO,352,363,670,666,1336
22,22140,221402718,San Fernando,CHACO,334,347,645,609,1254
22,22140,221402719,San Fernando,CHACO,356,352,741,707,1448
22,22140,221402720,San Fernando,CHACO,255,288,419,455,874
22,22140,221402721,San Fernando,CHACO,242,263,462,432,894
22,22140,221402722,San Fernando,CHACO,284,355,489,505,994
22,22140,221402723,San Fernando,CHACO,219,240,390,414,804
22,22140,221402724,San Fernando,CHACO,152,138,278,277,555
22,22140,221402725,San Fernando,CHACO,199,246,341,318,659
22,22140,221402726,San Fernando,CHACO,205,180,405,424,829
22,22140,221402801,San Fernando,CHACO,331,359,628,559,1187
22,22140,221402802,San Fernando,CHACO,316,296,612,533,1145
22,22140,221402803,San Fernando,CHACO,217,230,397,369,766
22,22140,221402804,San Fernando,CHACO,285,261,526,455,981
22,22140,221402805,San Fernando,CHACO,392,421,792,718,1510
22,22140,221402806,San Fernando,CHACO,202,243,365,364,729
22,22140,221402807,San Fernando,CHACO,134,137,333,292,625
22,22140,221402808,San Fernando,CHACO,405,389,963,879,1842
22,22140,221402809,San Fernando,CHACO,249,263,502,464,966
22,22140,221402810,San Fernando,CHACO,359,392,659,571,1230
22,22140,221402811,San Fernando,CHACO,300,300,622,538,1160
22,22140,221402901,San Fernando,CHACO,186,192,341,332,673
22,22140,221402902,San Fernando,CHACO,223,258,399,402,801
22,22140,221402903,San Fernando,CHACO,251,275,440,477,917
22,22140,221402904,San Fernando,CHACO,280,294,542,528,1070
22,22140,221402905,San Fernando,CHACO,270,291,486,500,986
22,22140,221402906,San Fernando,CHACO,281,286,541,1033,1574
22,22140,221402907,San Fernando,CHACO,118,139,218,234,452
22,22140,221402908,San Fernando,CHACO,289,310,587,523,1110
22,22140,221402909,San Fernando,CHACO,339,342,681,583,1264
22,22140,221402910,San Fernando,CHACO,386,411,811,746,1557
22,22140,221402911,San Fernando,CHACO,321,329,625,605,1230
22,22140,221402912,San Fernando,CHACO,161,175,321,284,605
22,22140,221402913,San Fernando,CHACO,249,266,486,425,911
22,22140,221402914,San Fernando,CHACO,289,265,559,505,1064
22,22140,221402915,San Fernando,CHACO,272,288,544,556,1100
22,22140,221402916,San Fernando,CHACO,207,166,385,380,765
22,22140,221402919,San Fernando,CHACO,188,160,336,336,672
22,22140,221402920,San Fernando,CHACO,224,222,416,414,830
22,22140,221403001,San Fernando,CHACO,242,269,452,436,888
22,22140,221403002,San Fernando,CHACO,227,230,411,407,818
22,22140,221403003,San Fernando,CHACO,381,357,750,828,1578
22,22140,221403004,San Fernando,CHACO,221,222,483,439,922
22,22140,221403005,San Fernando,CHACO,396,390,852,823,1675
22,22140,221403006,San Fernando,CHACO,163,185,312,263,575
22,22140,221403007,San Fernando,CHACO,402,430,762,667,1429
22,22140,221403008,San Fernando,CHACO,117,115,216,226,442
22,22140,221403009,San Fernando,CHACO,337,326,635,695,1330
22,22140,221403010,San Fernando,CHACO,145,152,291,274,565
22,22140,221403011,San Fernando,CHACO,232,240,524,499,1023
22,22140,221403012,San Fernando,CHACO,198,202,380,377,757
22,22140,221403013,San Fernando,CHACO,130,156,257,267,524
02,02013,020131502,Comuna 13,CIUDAD DE BUENOS AIRES,360,357,418,294,712
02,02013,020131411,Comuna 13,CIUDAD DE BUENOS AIRES,284,268,449,357,806
02,02013,020131607,Comuna 13,CIUDAD DE BUENOS AIRES,369,365,442,323,765
02,02013,020131501,Comuna 13,CIUDAD DE BUENOS AIRES,350,350,413,332,745
02,02013,020131609,Comuna 13,CIUDAD DE BUENOS AIRES,380,373,466,361,827
02,02013,020131410,Comuna 13,CIUDAD DE BUENOS AIRES,298,297,410,317,727
02,02013,020131702,Comuna 13,CIUDAD DE BUENOS AIRES,472,464,599,484,1083
02,02013,020131309,Comuna 13,CIUDAD DE BUENOS AIRES,287,273,442,338,780
02,02013,020131611,Comuna 13,CIUDAD DE BUENOS AIRES,381,379,425,299,724
02,02013,020131312,Comuna 13,CIUDAD DE BUENOS AIRES,327,324,562,435,997
02,02013,020132105,Comuna 13,CIUDAD DE BUENOS AIRES,291,286,454,396,850
02,02013,020131608,Comuna 13,CIUDAD DE BUENOS AIRES,352,347,390,281,671
02,02013,020131409,Comuna 13,CIUDAD DE BUENOS AIRES,238,234,309,225,534
02,02013,020132208,Comuna 13,CIUDAD DE BUENOS AIRES,377,361,421,376,797
02,02013,020131503,Comuna 13,CIUDAD DE BUENOS AIRES,349,347,453,293,746
02,02013,020131310,Comuna 13,CIUDAD DE BUENOS AIRES,358,346,531,388,919
02,02013,020131612,Comuna 13,CIUDAD DE BUENOS AIRES,347,339,415,315,730
02,02013,020132104,Comuna 13,CIUDAD DE BUENOS AIRES,319,319,473,388,861
02,02013,020131408,Comuna 13,CIUDAD DE BUENOS AIRES,254,249,322,282,604
02,02013,020130302,Comuna 13,CIUDAD DE BUENOS AIRES,270,265,342,312,654
02,02013,020131101,Comuna 13,CIUDAD DE BUENOS AIRES,172,170,272,296,568
02,02013,020130104,Comuna 13,CIUDAD DE BUENOS AIRES,367,355,384,379,763
02,02013,020130103,Comuna 13,CIUDAD DE BUENOS AIRES,258,254,326,286,612
02,02013,020130102,Comuna 13,CIUDAD DE BUENOS AIRES,343,340,397,373,770
02,02013,020130105,Comuna 13,CIUDAD DE BUENOS AIRES,421,393,433,402,835
02,02013,020130101,Comuna 13,CIUDAD DE BUENOS AIRES,296,294,417,316,733
02,02013,020130104,Comuna 13,CIUDAD DE BUENOS AIRES,0,355,384,379,763
02,02013,020130107,Comuna 13,CIUDAD DE BUENOS AIRES,185,181,269,240,509
02,02013,020130110,Comuna 13,CIUDAD DE BUENOS AIRES,314,304,368,341,709
02,02013,020130106,Comuna 13,CIUDAD DE BUENOS AIRES,386,356,452,430,882
02,02013,020130109,Comuna 13,CIUDAD DE BUENOS AIRES,217,197,237,220,457
02,02013,020130111,Comuna 13,CIUDAD DE BUENOS AIRES,300,259,375,285,660
02,02013,020130108,Comuna 13,CIUDAD DE BUENOS AIRES,241,238,278,260,538
02,02013,020130205,Comuna 13,CIUDAD DE BUENOS AIRES,330,323,392,394,786
02,02013,020130112,Comuna 13,CIUDAD DE BUENOS AIRES,246,242,289,255,544
02,02013,020130113,Comuna 13,CIUDAD DE BUENOS AIRES,245,239,339,283,622
02,02013,020130211,Comuna 13,CIUDAD DE BUENOS AIRES,293,292,308,305,613
02,02013,020130204,Comuna 13,CIUDAD DE BUENOS AIRES,239,234,344,322,666
02,02013,020130202,Comuna 13,CIUDAD DE BUENOS AIRES,359,329,452,408,860
02,02013,020130114,Comuna 13,CIUDAD DE BUENOS AIRES,283,262,385,262,647
02,02013,020130206,Comuna 13,CIUDAD DE BUENOS AIRES,470,460,484,465,949
02,02013,020130207,Comuna 13,CIUDAD DE BUENOS AIRES,300,291,345,322,667
02,02013,020130201,Comuna 13,CIUDAD DE BUENOS AIRES,545,514,576,497,1073
02,02013,020130210,Comuna 13,CIUDAD DE BUENOS AIRES,468,436,608,494,1102
02,02013,020130203,Comuna 13,CIUDAD DE BUENOS AIRES,259,255,319,272,591
02,02013,020130208,Comuna 13,CIUDAD DE BUENOS AIRES,253,252,355,263,618
02,02013,020131102,Comuna 13,CIUDAD DE BUENOS AIRES,241,239,402,344,746
02,02013,020130209,Comuna 13,CIUDAD DE BUENOS AIRES,396,390,559,496,1055
02,02013,020130304,Comuna 13,CIUDAD DE BUENOS AIRES,433,429,560,509,1069
02,02013,020130303,Comuna 13,CIUDAD DE BUENOS AIRES,353,331,418,363,781
02,02013,020130301,Comuna 13,CIUDAD DE BUENOS AIRES,377,373,458,375,833
02,02013,020130402,Comuna 13,CIUDAD DE BUENOS AIRES,350,338,433,344,777
02,02013,020130305,Comuna 13,CIUDAD DE BUENOS AIRES,312,309,406,392,798
02,02013,020131205,Comuna 13,CIUDAD DE BUENOS AIRES,218,212,373,334,707
02,02013,020130401,Comuna 13,CIUDAD DE BUENOS AIRES,291,284,339,271,610
02,02013,020130403,Comuna 13,CIUDAD DE BUENOS AIRES,304,300,338,341,679
02,02013,020130306,Comuna 13,CIUDAD DE BUENOS AIRES,271,270,357,294,651
02,02013,020131103,Comuna 13,CIUDAD DE BUENOS AIRES,207,194,315,264,579
02,02013,020130404,Comuna 13,CIUDAD DE BUENOS AIRES,430,423,549,446,995
02,02013,020130310,Comuna 13,CIUDAD DE BUENOS AIRES,448,442,518,454,972
02,02013,020130503,Comuna 13,CIUDAD DE BUENOS AIRES,530,525,650,539,1189
02,02013,020131106,Comuna 13,CIUDAD DE BUENOS AIRES,408,373,560,521,1081
02,02013,020130406,Comuna 13,CIUDAD DE BUENOS AIRES,400,396,497,382,879
02,02013,020130309,Comuna 13,CIUDAD DE BUENOS AIRES,354,331,489,461,950
02,02013,020131104,Comuna 13,CIUDAD DE BUENOS AIRES,229,226,312,245,557
02,02013,020130504,Comuna 13,CIUDAD DE BUENOS AIRES,478,473,567,441,1008
02,02013,020130408,Comuna 13,CIUDAD DE BUENOS AIRES,265,264,344,280,624
02,02013,020131105,Comuna 13,CIUDAD DE BUENOS AIRES,222,215,313,278,591
02,02013,020131107,Comuna 13,CIUDAD DE BUENOS AIRES,284,265,383,343,726
02,02013,020130307,Comuna 13,CIUDAD DE BUENOS AIRES,290,283,362,301,663
02,02013,020130502,Comuna 13,CIUDAD DE BUENOS AIRES,403,397,700,496,1196
02,02013,020130407,Comuna 13,CIUDAD DE BUENOS AIRES,296,290,379,351,730
02,02013,020131003,Comuna 13,CIUDAD DE BUENOS AIRES,427,401,516,448,964
02,02013,020130405,Comuna 13,CIUDAD DE BUENOS AIRES,363,358,422,336,758
02,02013,020130506,Comuna 13,CIUDAD DE BUENOS AIRES,437,418,528,425,953
02,02013,020130308,Comuna 13,CIUDAD DE BUENOS AIRES,278,277,347,278,625
02,02013,020131204,Comuna 13,CIUDAD DE BUENOS AIRES,352,350,456,404,860
02,02013,020130412,Comuna 13,CIUDAD DE BUENOS AIRES,613,583,768,632,1400
02,02013,020130505,Comuna 13,CIUDAD DE BUENOS AIRES,359,341,482,406,888
02,02013,020130507,Comuna 13,CIUDAD DE BUENOS AIRES,327,324,425,352,777
02,02013,020131202,Comuna 13,CIUDAD DE BUENOS AIRES,320,312,458,439,897
02,02013,020130501,Comuna 13,CIUDAD DE BUENOS AIRES,344,335,384,360,744
02,02013,020130409,Comuna 13,CIUDAD DE BUENOS AIRES,341,334,383,331,714
02,02013,020130411,Comuna 13,CIUDAD DE BUENOS AIRES,370,316,446,378,824
02,02013,020131002,Comuna 13,CIUDAD DE BUENOS AIRES,404,344,464,436,900
02,02013,020131005,Comuna 13,CIUDAD DE BUENOS AIRES,252,232,298,270,568
02,02013,020130508,Comuna 13,CIUDAD DE BUENOS AIRES,417,407,476,407,883
02,02013,020131004,Comuna 13,CIUDAD DE BUENOS AIRES,417,413,577,533,1110
02,02013,020130601,Comuna 13,CIUDAD DE BUENOS AIRES,283,282,374,314,688
02,02013,020131001,Comuna 13,CIUDAD DE BUENOS AIRES,415,413,422,376,798
02,02013,020130410,Comuna 13,CIUDAD DE BUENOS AIRES,237,229,254,186,440
02,02013,020130804,Comuna 13,CIUDAD DE BUENOS AIRES,388,378,468,411,879
02,02013,020131206,Comuna 13,CIUDAD DE BUENOS AIRES,240,235,303,267,570
02,02013,020130413,Comuna 13,CIUDAD DE BUENOS AIRES,337,321,402,305,707
02,02013,020131203,Comuna 13,CIUDAD DE BUENOS AIRES,237,236,315,309,624
02,02013,020130605,Comuna 13,CIUDAD DE BUENOS AIRES,454,445,527,412,939
02,02013,020131201,Comuna 13,CIUDAD DE BUENOS AIRES,277,276,374,329,703
02,02013,020130414,Comuna 13,CIUDAD DE BUENOS AIRES,327,324,439,319,758
02,02013,020130604,Comuna 13,CIUDAD DE BUENOS AIRES,419,397,493,411,904
02,02013,020130803,Comuna 13,CIUDAD DE BUENOS AIRES,411,407,502,427,929
02,02013,020131210,Comuna 13,CIUDAD DE BUENOS AIRES,249,244,283,281,564
02,02013,020130602,Comuna 13,CIUDAD DE BUENOS AIRES,425,396,582,479,1061
02,02013,020130805,Comuna 13,CIUDAD DE BUENOS AIRES,452,450,516,439,955
02,02013,020130802,Comuna 13,CIUDAD DE BUENOS AIRES,275,271,315,248,563
02,02013,020131006,Comuna 13,CIUDAD DE BUENOS AIRES,388,378,460,440,900
02,02013,020130606,Comuna 13,CIUDAD DE BUENOS AIRES,368,348,500,364,864
02,02013,020130603,Comuna 13,CIUDAD DE BUENOS AIRES,368,359,503,429,932
02,02013,020131207,Comuna 13,CIUDAD DE BUENOS AIRES,341,339,479,417,896
02,02013,020130607,Comuna 13,CIUDAD DE BUENOS AIRES,425,391,532,445,977
02,02013,020130801,Comuna 13,CIUDAD DE BUENOS AIRES,314,311,372,268,640
02,02013,020131011,Comuna 13,CIUDAD DE BUENOS AIRES,314,306,349,267,616
02,02013,020131007,Comuna 13,CIUDAD DE BUENOS AIRES,321,312,369,292,661
02,02013,020130806,Comuna 13,CIUDAD DE BUENOS AIRES,295,291,359,317,676
02,02013,020131208,Comuna 13,CIUDAD DE BUENOS AIRES,282,272,347,282,629
02,02013,020130809,Comuna 13,CIUDAD DE BUENOS AIRES,326,326,399,309,708
02,02013,020130703,Comuna 13,CIUDAD DE BUENOS AIRES,457,453,569,447,1016
02,02013,020131010,Comuna 13,CIUDAD DE BUENOS AIRES,424,400,504,389,893
02,02013,020130807,Comuna 13,CIUDAD DE BUENOS AIRES,364,338,454,354,808
02,02013,020130810,Comuna 13,CIUDAD DE BUENOS AIRES,292,289,361,289,650
02,02013,020130901,Comuna 13,CIUDAD DE BUENOS AIRES,287,283,366,307,673
02,02013,020130704,Comuna 13,CIUDAD DE BUENOS AIRES,344,340,409,344,753
02,02013,020131209,Comuna 13,CIUDAD DE BUENOS AIRES,384,378,472,473,945
02,02013,020131303,Comuna 13,CIUDAD DE BUENOS AIRES,322,319,407,330,737
02,02013,020130808,Comuna 13,CIUDAD DE BUENOS AIRES,439,411,565,428,993
02,02013,020130608,Comuna 13,CIUDAD DE BUENOS AIRES,339,335,440,354,794
02,02013,020130906,Comuna 13,CIUDAD DE BUENOS AIRES,320,318,374,311,685
02,02013,020130902,Comuna 13,CIUDAD DE BUENOS AIRES,303,294,395,304,699
02,02013,020131009,Comuna 13,CIUDAD DE BUENOS AIRES,325,313,404,297,701
02,02013,020130702,Comuna 13,CIUDAD DE BUENOS AIRES,221,220,318,268,586
02,02013,020130705,Comuna 13,CIUDAD DE BUENOS AIRES,476,473,610,438,1048
02,02013,020130706,Comuna 13,CIUDAD DE BUENOS AIRES,381,369,457,372,829
02,02013,020131305,Comuna 13,CIUDAD DE BUENOS AIRES,411,406,451,376,827
02,02013,020130907,Comuna 13,CIUDAD DE BUENOS AIRES,296,294,359,318,677
02,02013,020131302,Comuna 13,CIUDAD DE BUENOS AIRES,155,147,174,140,314
02,02013,020131603,Comuna 13,CIUDAD DE BUENOS AIRES,252,249,299,210,509
02,02013,020130707,Comuna 13,CIUDAD DE BUENOS AIRES,346,327,423,382,805
02,02013,020130905,Comuna 13,CIUDAD DE BUENOS AIRES,488,485,673,502,1175
02,02013,020130903,Comuna 13,CIUDAD DE BUENOS AIRES,247,236,293,213,506
02,02013,020130701,Comuna 13,CIUDAD DE BUENOS AIRES,271,269,444,335,779
02,02013,020131304,Comuna 13,CIUDAD DE BUENOS AIRES,394,370,472,370,842
02,02013,020131008,Comuna 13,CIUDAD DE BUENOS AIRES,432,430,564,346,910
02,02013,020130908,Comuna 13,CIUDAD DE BUENOS AIRES,344,328,451,337,788
02,02013,020130708,Comuna 13,CIUDAD DE BUENOS AIRES,309,304,430,346,776
02,02013,020131602,Comuna 13,CIUDAD DE BUENOS AIRES,430,424,500,376,876
02,02013,020131306,Comuna 13,CIUDAD DE BUENOS AIRES,132,131,143,118,261
02,02013,020131403,Comuna 13,CIUDAD DE BUENOS AIRES,367,360,371,289,660
02,02013,020130909,Comuna 13,CIUDAD DE BUENOS AIRES,363,359,511,357,868
02,02013,020131301,Comuna 13,CIUDAD DE BUENOS AIRES,376,352,567,461,1028
02,02013,020130904,Comuna 13,CIUDAD DE BUENOS AIRES,293,292,326,246,572
02,02013,020131307,Comuna 13,CIUDAD DE BUENOS AIRES,305,299,334,295,629
02,02013,020131604,Comuna 13,CIUDAD DE BUENOS AIRES,368,367,388,308,696
02,02013,020131402,Comuna 13,CIUDAD DE BUENOS AIRES,162,162,216,165,381
02,02013,020130910,Comuna 13,CIUDAD DE BUENOS AIRES,239,235,318,219,537
02,02013,020131313,Comuna 13,CIUDAD DE BUENOS AIRES,556,526,631,588,1219
02,02013,020131601,Comuna 13,CIUDAD DE BUENOS AIRES,392,388,489,365,854
02,02013,020131605,Comuna 13,CIUDAD DE BUENOS AIRES,252,251,297,229,526
02,02013,020130709,Comuna 13,CIUDAD DE BUENOS AIRES,373,363,458,360,818
02,02013,020131404,Comuna 13,CIUDAD DE BUENOS AIRES,291,288,407,327,734
02,02013,020131401,Comuna 13,CIUDAD DE BUENOS AIRES,341,327,409,367,776
02,02013,020131308,Comuna 13,CIUDAD DE BUENOS AIRES,249,248,372,277,649
02,02013,020131610,Comuna 13,CIUDAD DE BUENOS AIRES,391,385,481,358,839
02,02013,020131606,Comuna 13,CIUDAD DE BUENOS AIRES,183,169,223,189,412
02,02013,020131405,Comuna 13,CIUDAD DE BUENOS AIRES,228,228,285,246,531
02,02013,020131406,Comuna 13,CIUDAD DE BUENOS AIRES,359,355,473,373,846
02,02013,020131314,Comuna 13,CIUDAD DE BUENOS AIRES,348,342,347,330,677
02,02013,020131701,Comuna 13,CIUDAD DE BUENOS AIRES,476,471,578,487,1065
02,02013,020132209,Comuna 13,CIUDAD DE BUENOS AIRES,220,210,308,243,551
02,02013,020131509,Comuna 13,CIUDAD DE BUENOS AIRES,416,403,510,357,867
02,02013,020131703,Comuna 13,CIUDAD DE BUENOS AIRES,389,358,428,389,817
02,02013,020131705,Comuna 13,CIUDAD DE BUENOS AIRES,345,281,411,296,707
02,02013,020131311,Comuna 13,CIUDAD DE BUENOS AIRES,215,212,325,278,603
02,02013,020132206,Comuna 13,CIUDAD DE BUENOS AIRES,391,385,612,510,1122
02,02013,020132106,Comuna 13,CIUDAD DE BUENOS AIRES,312,308,426,333,759
02,02013,020131613,Comuna 13,CIUDAD DE BUENOS AIRES,223,221,293,259,552
02,02013,020132103,Comuna 13,CIUDAD DE BUENOS AIRES,233,226,303,234,537
02,02013,020131407,Comuna 13,CIUDAD DE BUENOS AIRES,165,163,212,172,384
02,02013,020131504,Comuna 13,CIUDAD DE BUENOS AIRES,199,196,295,197,492
02,02013,020132107,Comuna 13,CIUDAD DE BUENOS AIRES,450,443,628,497,1125
02,02013,020131709,Comuna 13,CIUDAD DE BUENOS AIRES,403,399,572,434,1006
02,02013,020132102,Comuna 13,CIUDAD DE BUENOS AIRES,149,148,177,132,309
02,02013,020132207,Comuna 13,CIUDAD DE BUENOS AIRES,455,453,608,493,1101
02,02013,020131704,Comuna 13,CIUDAD DE BUENOS AIRES,247,243,309,243,552
02,02013,020132205,Comuna 13,CIUDAD DE BUENOS AIRES,394,390,684,500,1184
02,02013,020131508,Comuna 13,CIUDAD DE BUENOS AIRES,372,363,389,324,713
02,02013,020132110,Comuna 13,CIUDAD DE BUENOS AIRES,342,335,534,382,916
02,02013,020131505,Comuna 13,CIUDAD DE BUENOS AIRES,391,384,441,361,802
02,02013,020132108,Comuna 13,CIUDAD DE BUENOS AIRES,345,338,406,329,735
02,02013,020132101,Comuna 13,CIUDAD DE BUENOS AIRES,244,232,344,257,601
02,02013,020131803,Comuna 13,CIUDAD DE BUENOS AIRES,397,390,517,423,940
02,02013,020131510,Comuna 13,CIUDAD DE BUENOS AIRES,331,330,388,244,632
02,02013,020132204,Comuna 13,CIUDAD DE BUENOS AIRES,327,322,500,395,895
02,02013,020131507,Comuna 13,CIUDAD DE BUENOS AIRES,383,376,457,346,803
02,02013,020131706,Comuna 13,CIUDAD DE BUENOS AIRES,360,344,430,338,768
02,02013,020131710,Comuna 13,CIUDAD DE BUENOS AIRES,398,393,513,431,944
02,02013,020132005,Comuna 13,CIUDAD DE BUENOS AIRES,312,300,352,250,602
02,02013,020131708,Comuna 13,CIUDAD DE BUENOS AIRES,316,314,386,353,739
02,02013,020131511,Comuna 13,CIUDAD DE BUENOS AIRES,369,367,430,305,735
02,02013,020131506,Comuna 13,CIUDAD DE BUENOS AIRES,281,279,365,294,659
02,02013,020131802,Comuna 13,CIUDAD DE BUENOS AIRES,407,402,476,391,867
02,02013,020132109,Comuna 13,CIUDAD DE BUENOS AIRES,360,358,438,404,842
02,02013,020131512,Comuna 13,CIUDAD DE BUENOS AIRES,328,323,382,272,654
02,02013,020131707,Comuna 13,CIUDAD DE BUENOS AIRES,386,382,467,373,840
02,02013,020131903,Comuna 13,CIUDAD DE BUENOS AIRES,295,285,385,314,699
02,02013,020132006,Comuna 13,CIUDAD DE BUENOS AIRES,428,424,488,327,815
02,02013,020131711,Comuna 13,CIUDAD DE BUENOS AIRES,247,245,331,239,570
02,02013,020132004,Comuna 13,CIUDAD DE BUENOS AIRES,316,312,418,267,685
02,02013,020132001,Comuna 13,CIUDAD DE BUENOS AIRES,301,301,364,282,646
02,02013,020132202,Comuna 13,CIUDAD DE BUENOS AIRES,221,218,292,228,520
02,02013,020131902,Comuna 13,CIUDAD DE BUENOS AIRES,397,393,506,427,933
02,02013,020132003,Comuna 13,CIUDAD DE BUENOS AIRES,175,171,222,190,412
02,02013,020132203,Comuna 13,CIUDAD DE BUENOS AIRES,222,217,253,218,471
02,02013,020132201,Comuna 13,CIUDAD DE BUENOS AIRES,251,249,358,231,589
02,02013,020132012,Comuna 13,CIUDAD DE BUENOS AIRES,277,270,332,232,564
02,02013,020131904,Comuna 13,CIUDAD DE BUENOS AIRES,227,226,270,230,500
02,02013,020131807,Comuna 13,CIUDAD DE BUENOS AIRES,383,380,507,464,971
02,02013,020131901,Comuna 13,CIUDAD DE BUENOS AIRES,340,335,454,351,805
02,02013,020132007,Comuna 13,CIUDAD DE BUENOS AIRES,372,366,465,370,835
02,02013,020131801,Comuna 13,CIUDAD DE BUENOS AIRES,334,332,485,403,888
02,02013,020131804,Comuna 13,CIUDAD DE BUENOS AIRES,294,293,395,324,719
02,02013,020132002,Comuna 13,CIUDAD DE BUENOS AIRES,394,381,537,406,943
02,02013,020132305,Comuna 13,CIUDAD DE BUENOS AIRES,236,212,268,226,494
02,02013,020131905,Comuna 13,CIUDAD DE BUENOS AIRES,366,359,523,406,929
02,02013,020132011,Comuna 13,CIUDAD DE BUENOS AIRES,261,251,327,271,598
02,02013,020132306,Comuna 13,CIUDAD DE BUENOS AIRES,368,353,436,326,762
02,02013,020131909,Comuna 13,CIUDAD DE BUENOS AIRES,332,327,384,277,661
02,02013,020131805,Comuna 13,CIUDAD DE BUENOS AIRES,282,280,387,315,702
02,02013,020132010,Comuna 13,CIUDAD DE BUENOS AIRES,272,268,327,237,564
02,02013,020132008,Comuna 13,CIUDAD DE BUENOS AIRES,386,383,442,341,783
02,02013,020132311,Comuna 13,CIUDAD DE BUENOS AIRES,424,409,486,333,819
02,02013,020132304,Comuna 13,CIUDAD DE BUENOS AIRES,294,289,354,250,604
02,02013,020131908,Comuna 13,CIUDAD DE BUENOS AIRES,329,322,427,317,744
02,02013,020132009,Comuna 13,CIUDAD DE BUENOS AIRES,258,255,317,234,551
02,02013,020132702,Comuna 13,CIUDAD DE BUENOS AIRES,399,396,497,359,856
02,02013,020131910,Comuna 13,CIUDAD DE BUENOS AIRES,312,311,378,315,693
02,02013,020132303,Comuna 13,CIUDAD DE BUENOS AIRES,538,534,619,480,1099
02,02013,020131806,Comuna 13,CIUDAD DE BUENOS AIRES,302,301,393,346,739
02,02013,020132307,Comuna 13,CIUDAD DE BUENOS AIRES,257,252,307,222,529
02,02013,020132703,Comuna 13,CIUDAD DE BUENOS AIRES,440,434,626,417,1043
02,02013,020131911,Comuna 13,CIUDAD DE BUENOS AIRES,193,160,206,199,405
02,02013,020132302,Comuna 13,CIUDAD DE BUENOS AIRES,270,243,274,241,515
02,02013,020132310,Comuna 13,CIUDAD DE BUENOS AIRES,243,239,313,249,562
02,02013,020131912,Comuna 13,CIUDAD DE BUENOS AIRES,268,266,430,323,753
02,02013,020131906,Comuna 13,CIUDAD DE BUENOS AIRES,215,211,275,222,497
02,02013,020132706,Comuna 13,CIUDAD DE BUENOS AIRES,529,521,647,473,1120
02,02013,020132308,Comuna 13,CIUDAD DE BUENOS AIRES,505,502,584,460,1044
02,02013,020132301,Comuna 13,CIUDAD DE BUENOS AIRES,545,535,656,536,1192
02,02013,020131808,Comuna 13,CIUDAD DE BUENOS AIRES,280,275,462,339,801
02,02013,020131907,Comuna 13,CIUDAD DE BUENOS AIRES,257,221,414,319,733
02,02013,020132701,Comuna 13,CIUDAD DE BUENOS AIRES,175,174,239,183,422
02,02013,020132309,Comuna 13,CIUDAD DE BUENOS AIRES,429,363,569,455,1024
02,02013,020132707,Comuna 13,CIUDAD DE BUENOS AIRES,497,494,592,466,1058
02,02013,020132704,Comuna 13,CIUDAD DE BUENOS AIRES,387,384,471,381,852
02,02013,020132709,Comuna 13,CIUDAD DE BUENOS AIRES,407,398,497,371,868
02,02013,020131809,Comuna 13,CIUDAD DE BUENOS AIRES,170,166,297,228,525
02,02013,020132802,Comuna 13,CIUDAD DE BUENOS AIRES,213,209,248,193,441
02,02013,020132404,Comuna 13,CIUDAD DE BUENOS AIRES,364,364,452,370,822
02,02013,020132705,Comuna 13,CIUDAD DE BUENOS AIRES,311,304,354,262,616
02,02013,020132803,Comuna 13,CIUDAD DE BUENOS AIRES,318,292,364,303,667
02,02013,020132405,Comuna 13,CIUDAD DE BUENOS AIRES,286,282,372,354,726
02,02013,020131810,Comuna 13,CIUDAD DE BUENOS AIRES,274,270,444,368,812
02,02013,020132410,Comuna 13,CIUDAD DE BUENOS AIRES,283,278,449,356,805
02,02013,020132809,Comuna 13,CIUDAD DE BUENOS AIRES,393,381,429,341,770
02,02013,020132708,Comuna 13,CIUDAD DE BUENOS AIRES,368,359,443,371,814
02,02013,020132408,Comuna 13,CIUDAD DE BUENOS AIRES,339,328,470,377,847
02,02013,020132801,Comuna 13,CIUDAD DE BUENOS AIRES,268,262,288,239,527
02,02013,020132403,Comuna 13,CIUDAD DE BUENOS AIRES,283,256,360,308,668
02,02013,020132808,Comuna 13,CIUDAD DE BUENOS AIRES,451,448,557,379,936
02,02013,020132603,Comuna 13,CIUDAD DE BUENOS AIRES,288,280,428,343,771
02,02013,020132810,Comuna 13,CIUDAD DE BUENOS AIRES,273,268,344,280,624
02,02013,020132804,Comuna 13,CIUDAD DE BUENOS AIRES,201,199,219,170,389
02,02013,020132806,Comuna 13,CIUDAD DE BUENOS AIRES,356,346,449,374,823
02,02013,020132406,Comuna 13,CIUDAD DE BUENOS AIRES,318,305,411,323,734
02,02013,020132602,Comuna 13,CIUDAD DE BUENOS AIRES,325,320,460,351,811
02,02013,020132409,Comuna 13,CIUDAD DE BUENOS AIRES,381,376,532,438,970
02,02013,020132807,Comuna 13,CIUDAD DE BUENOS AIRES,329,326,386,307,693
02,02013,020132402,Comuna 13,CIUDAD DE BUENOS AIRES,252,245,337,231,568
02,02013,020132805,Comuna 13,CIUDAD DE BUENOS AIRES,217,215,322,226,548
02,02013,020132610,Comuna 13,CIUDAD DE BUENOS AIRES,436,428,518,420,938
02,02013,020132604,Comuna 13,CIUDAD DE BUENOS AIRES,419,385,522,445,967
02,02013,020132611,Comuna 13,CIUDAD DE BUENOS AIRES,281,280,353,292,645
02,02013,020132401,Comuna 13,CIUDAD DE BUENOS AIRES,198,196,260,211,471
02,02013,020132905,Comuna 13,CIUDAD DE BUENOS AIRES,280,274,318,257,575
02,02013,020132407,Comuna 13,CIUDAD DE BUENOS AIRES,367,344,500,443,943
02,02013,020132501,Comuna 13,CIUDAD DE BUENOS AIRES,262,242,308,283,591
02,02013,020132605,Comuna 13,CIUDAD DE BUENOS AIRES,317,301,405,346,751
02,02013,020132601,Comuna 13,CIUDAD DE BUENOS AIRES,316,313,440,413,853
02,02013,020132906,Comuna 13,CIUDAD DE BUENOS AIRES,330,327,425,338,763
02,02013,020132904,Comuna 13,CIUDAD DE BUENOS AIRES,382,374,448,396,844
02,02013,020132502,Comuna 13,CIUDAD DE BUENOS AIRES,279,270,391,310,701
02,02013,020132609,Comuna 13,CIUDAD DE BUENOS AIRES,202,200,278,237,515
02,02013,020132503,Comuna 13,CIUDAD DE BUENOS AIRES,392,383,457,418,875
02,02013,020132504,Comuna 13,CIUDAD DE BUENOS AIRES,269,264,357,311,668
02,02013,020132606,Comuna 13,CIUDAD DE BUENOS AIRES,265,234,456,329,785
02,02013,020132903,Comuna 13,CIUDAD DE BUENOS AIRES,247,245,293,249,542
02,02013,020132911,Comuna 13,CIUDAD DE BUENOS AIRES,327,306,398,392,790
02,02013,020132908,Comuna 13,CIUDAD DE BUENOS AIRES,420,409,586,517,1103
02,02013,020132505,Comuna 13,CIUDAD DE BUENOS AIRES,221,193,324,270,594
02,02013,020132608,Comuna 13,CIUDAD DE BUENOS AIRES,214,213,253,214,467
02,02013,020132506,Comuna 13,CIUDAD DE BUENOS AIRES,274,255,372,358,730
02,02013,020132907,Comuna 13,CIUDAD DE BUENOS AIRES,355,351,489,399,888
02,02013,020132607,Comuna 13,CIUDAD DE BUENOS AIRES,189,183,275,216,491
02,02013,020132901,Comuna 13,CIUDAD DE BUENOS AIRES,274,271,395,303,698
02,02013,020132508,Comuna 13,CIUDAD DE BUENOS AIRES,364,358,431,352,783
02,02013,020132902,Comuna 13,CIUDAD DE BUENOS AIRES,281,280,333,301,634
02,02013,020132507,Comuna 13,CIUDAD DE BUENOS AIRES,504,456,646,510,1156
02,02013,020132910,Comuna 13,CIUDAD DE BUENOS AIRES,258,252,402,384,786
02,02013,020132909,Comuna 13,CIUDAD DE BUENOS AIRES,208,208,295,276,571
02,02012,020120804,Comuna 12,CIUDAD DE BUENOS AIRES,262,256,393,376,769
02,02012,020120709,Comuna 12,CIUDAD DE BUENOS AIRES,557,550,679,558,1237
02,02012,020120906,Comuna 12,CIUDAD DE BUENOS AIRES,377,365,508,452,960
02,02012,020120903,Comuna 12,CIUDAD DE BUENOS AIRES,385,377,522,483,1005
02,02012,020121004,Comuna 12,CIUDAD DE BUENOS AIRES,270,256,377,381,758
02,02012,020120710,Comuna 12,CIUDAD DE BUENOS AIRES,476,469,594,498,1092
02,02012,020120101,Comuna 12,CIUDAD DE BUENOS AIRES,191,188,318,263,581
02,02012,020120905,Comuna 12,CIUDAD DE BUENOS AIRES,358,354,496,469,965
02,02012,020120807,Comuna 12,CIUDAD DE BUENOS AIRES,364,359,487,384,871
02,02012,020122211,Comuna 12,CIUDAD DE BUENOS AIRES,371,365,533,422,955
02,02012,020120405,Comuna 12,CIUDAD DE BUENOS AIRES,249,231,323,283,606
02,02012,020120407,Comuna 12,CIUDAD DE BUENOS AIRES,499,496,595,476,1071
02,02012,020120404,Comuna 12,CIUDAD DE BUENOS AIRES,295,278,485,467,952
02,02012,020120402,Comuna 12,CIUDAD DE BUENOS AIRES,287,268,402,386,788
02,02012,020120401,Comuna 12,CIUDAD DE BUENOS AIRES,277,245,392,377,769
02,02012,020120406,Comuna 12,CIUDAD DE BUENOS AIRES,297,290,416,344,760
02,02012,020120303,Comuna 12,CIUDAD DE BUENOS AIRES,270,261,453,371,824
02,02012,020120403,Comuna 12,CIUDAD DE BUENOS AIRES,418,383,576,512,1088
02,02012,020120302,Comuna 12,CIUDAD DE BUENOS AIRES,249,225,369,329,698
02,02012,020120408,Comuna 12,CIUDAD DE BUENOS AIRES,289,281,410,376,786
02,02012,020120301,Comuna 12,CIUDAD DE BUENOS AIRES,104,104,121,111,232
02,02012,020120304,Comuna 12,CIUDAD DE BUENOS AIRES,268,259,432,373,805
02,02012,020120505,Comuna 12,CIUDAD DE BUENOS AIRES,348,345,394,300,694
02,02012,020120504,Comuna 12,CIUDAD DE BUENOS AIRES,277,275,359,298,657
02,02012,020120409,Comuna 12,CIUDAD DE BUENOS AIRES,224,222,330,264,594
02,02012,020120107,Comuna 12,CIUDAD DE BUENOS AIRES,360,328,556,533,1089
02,02012,020120305,Comuna 12,CIUDAD DE BUENOS AIRES,292,289,451,368,819
02,02012,020120108,Comuna 12,CIUDAD DE BUENOS AIRES,182,178,264,241,505
02,02012,020120106,Comuna 12,CIUDAD DE BUENOS AIRES,286,276,414,346,760
02,02012,020120410,Comuna 12,CIUDAD DE BUENOS AIRES,243,223,318,312,630
02,02012,020120506,Comuna 12,CIUDAD DE BUENOS AIRES,301,287,356,279,635
02,02012,020120308,Comuna 12,CIUDAD DE BUENOS AIRES,253,250,394,330,724
02,02012,020120105,Comuna 12,CIUDAD DE BUENOS AIRES,217,206,304,284,588
02,02012,020120503,Comuna 12,CIUDAD DE BUENOS AIRES,543,528,702,656,1358
02,02012,020120502,Comuna 12,CIUDAD DE BUENOS AIRES,283,279,356,302,658
02,02012,020120309,Comuna 12,CIUDAD DE BUENOS AIRES,223,204,344,325,669
02,02012,020120306,Comuna 12,CIUDAD DE BUENOS AIRES,451,335,930,890,1820
02,02012,020120501,Comuna 12,CIUDAD DE BUENOS AIRES,212,204,324,298,622
02,02012,020120104,Comuna 12,CIUDAD DE BUENOS AIRES,313,266,456,429,885
02,02012,020120310,Comuna 12,CIUDAD DE BUENOS AIRES,305,286,445,433,878
02,02012,020120507,Comuna 12,CIUDAD DE BUENOS AIRES,327,321,411,348,759
02,02012,020120307,Comuna 12,CIUDAD DE BUENOS AIRES,378,376,561,448,1009
02,02012,020120508,Comuna 12,CIUDAD DE BUENOS AIRES,421,413,564,433,997
02,02012,020120509,Comuna 12,CIUDAD DE BUENOS AIRES,311,302,406,363,769
02,02012,020120109,Comuna 12,CIUDAD DE BUENOS AIRES,356,349,506,468,974
02,02012,020120511,Comuna 12,CIUDAD DE BUENOS AIRES,332,315,428,365,793
02,02012,020120510,Comuna 12,CIUDAD DE BUENOS AIRES,284,276,368,327,695
02,02012,020120311,Comuna 12,CIUDAD DE BUENOS AIRES,290,278,422,363,785
02,02012,020120604,Comuna 12,CIUDAD DE BUENOS AIRES,349,325,514,436,950
02,02012,020120202,Comuna 12,CIUDAD DE BUENOS AIRES,316,309,413,325,738
02,02012,020120111,Comuna 12,CIUDAD DE BUENOS AIRES,374,365,528,510,1038
02,02012,020120110,Comuna 12,CIUDAD DE BUENOS AIRES,361,350,463,425,888
02,02012,020120103,Comuna 12,CIUDAD DE BUENOS AIRES,187,176,352,335,687
02,02012,020120201,Comuna 12,CIUDAD DE BUENOS AIRES,371,312,608,458,1066
02,02012,020120603,Comuna 12,CIUDAD DE BUENOS AIRES,257,253,367,319,686
02,02012,020120606,Comuna 12,CIUDAD DE BUENOS AIRES,380,338,541,442,983
02,02012,020120605,Comuna 12,CIUDAD DE BUENOS AIRES,387,382,520,481,1001
02,02012,020120602,Comuna 12,CIUDAD DE BUENOS AIRES,353,348,469,401,870
02,02012,020120203,Comuna 12,CIUDAD DE BUENOS AIRES,394,381,457,393,850
02,02012,020120702,Comuna 12,CIUDAD DE BUENOS AIRES,310,298,434,402,836
02,02012,020120607,Comuna 12,CIUDAD DE BUENOS AIRES,332,329,401,335,736
02,02012,020120601,Comuna 12,CIUDAD DE BUENOS AIRES,320,299,452,337,789
02,02012,020120609,Comuna 12,CIUDAD DE BUENOS AIRES,302,301,406,319,725
02,02012,020120204,Comuna 12,CIUDAD DE BUENOS AIRES,379,372,541,491,1032
02,02012,020120208,Comuna 12,CIUDAD DE BUENOS AIRES,345,335,535,468,1003
02,02012,020120608,Comuna 12,CIUDAD DE BUENOS AIRES,288,285,390,343,733
02,02012,020120701,Comuna 12,CIUDAD DE BUENOS AIRES,318,313,459,377,836
02,02012,020120703,Comuna 12,CIUDAD DE BUENOS AIRES,325,315,479,400,879
02,02012,020120205,Comuna 12,CIUDAD DE BUENOS AIRES,401,371,560,460,1020
02,02012,020120610,Comuna 12,CIUDAD DE BUENOS AIRES,316,296,413,361,774
02,02012,020120704,Comuna 12,CIUDAD DE BUENOS AIRES,359,321,500,444,944
02,02012,020120705,Comuna 12,CIUDAD DE BUENOS AIRES,290,264,395,350,745
02,02012,020120801,Comuna 12,CIUDAD DE BUENOS AIRES,548,406,728,737,1465
02,02012,020120206,Comuna 12,CIUDAD DE BUENOS AIRES,344,335,535,433,968
02,02012,020120706,Comuna 12,CIUDAD DE BUENOS AIRES,347,343,494,414,908
02,02012,020120802,Comuna 12,CIUDAD DE BUENOS AIRES,273,269,408,337,745
02,02012,020120207,Comuna 12,CIUDAD DE BUENOS AIRES,319,316,461,389,850
02,02012,020120803,Comuna 12,CIUDAD DE BUENOS AIRES,325,319,481,387,868
02,02012,020120907,Comuna 12,CIUDAD DE BUENOS AIRES,307,298,442,437,879
02,02012,020120708,Comuna 12,CIUDAD DE BUENOS AIRES,365,358,482,392,874
02,02012,020120707,Comuna 12,CIUDAD DE BUENOS AIRES,301,297,443,379,822
02,02012,020120102,Comuna 12,CIUDAD DE BUENOS AIRES,196,192,312,270,582
02,02012,020120806,Comuna 12,CIUDAD DE BUENOS AIRES,352,343,460,376,836
02,02012,020121003,Comuna 12,CIUDAD DE BUENOS AIRES,287,282,393,337,730
02,02012,020120901,Comuna 12,CIUDAD DE BUENOS AIRES,331,315,523,414,937
02,02012,020120805,Comuna 12,CIUDAD DE BUENOS AIRES,344,340,322,280,602
02,02012,020120904,Comuna 12,CIUDAD DE BUENOS AIRES,392,383,563,498,1061
02,02012,020120808,Comuna 12,CIUDAD DE BUENOS AIRES,415,408,487,440,927
02,02012,020121001,Comuna 12,CIUDAD DE BUENOS AIRES,366,321,532,462,994
02,02012,020120809,Comuna 12,CIUDAD DE BUENOS AIRES,396,387,513,462,975
02,02012,020120810,Comuna 12,CIUDAD DE BUENOS AIRES,290,269,403,328,731
02,02012,020121002,Comuna 12,CIUDAD DE BUENOS AIRES,390,378,529,465,994
02,02012,020121005,Comuna 12,CIUDAD DE BUENOS AIRES,298,292,391,347,738
02,02012,020120902,Comuna 12,CIUDAD DE BUENOS AIRES,420,400,586,541,1127
02,02012,020121006,Comuna 12,CIUDAD DE BUENOS AIRES,353,342,470,404,874
02,02012,020121704,Comuna 12,CIUDAD DE BUENOS AIRES,306,300,440,356,796
02,02012,020121701,Comuna 12,CIUDAD DE BUENOS AIRES,355,343,540,470,1010
02,02012,020121007,Comuna 12,CIUDAD DE BUENOS AIRES,295,247,415,353,768
02,02012,020120811,Comuna 12,CIUDAD DE BUENOS AIRES,262,242,356,286,642
02,02012,020121011,Comuna 12,CIUDAD DE BUENOS AIRES,345,322,463,420,883
02,02012,020121802,Comuna 12,CIUDAD DE BUENOS AIRES,323,308,484,440,924
02,02012,020121705,Comuna 12,CIUDAD DE BUENOS AIRES,437,427,596,537,1133
02,02012,020121702,Comuna 12,CIUDAD DE BUENOS AIRES,380,346,561,491,1052
02,02012,020121009,Comuna 12,CIUDAD DE BUENOS AIRES,318,307,427,415,842
02,02012,020121109,Comuna 12,CIUDAD DE BUENOS AIRES,373,370,471,398,869
02,02012,020121708,Comuna 12,CIUDAD DE BUENOS AIRES,557,545,662,590,1252
02,02012,020121806,Comuna 12,CIUDAD DE BUENOS AIRES,312,300,469,420,889
02,02012,020121108,Comuna 12,CIUDAD DE BUENOS AIRES,344,325,480,442,922
02,02012,020121703,Comuna 12,CIUDAD DE BUENOS AIRES,333,322,473,444,917
02,02012,020121010,Comuna 12,CIUDAD DE BUENOS AIRES,299,255,466,349,815
02,02012,020121803,Comuna 12,CIUDAD DE BUENOS AIRES,318,313,485,379,864
02,02012,020121801,Comuna 12,CIUDAD DE BUENOS AIRES,231,228,342,289,631
02,02012,020121106,Comuna 12,CIUDAD DE BUENOS AIRES,319,307,455,403,858
02,02012,020121107,Comuna 12,CIUDAD DE BUENOS AIRES,330,319,425,353,778
02,02012,020121008,Comuna 12,CIUDAD DE BUENOS AIRES,477,469,623,543,1166
02,02012,020121706,Comuna 12,CIUDAD DE BUENOS AIRES,414,388,527,479,1006
02,02012,020121102,Comuna 12,CIUDAD DE BUENOS AIRES,267,259,336,309,645
02,02012,020121606,Comuna 12,CIUDAD DE BUENOS AIRES,647,629,758,648,1406
02,02012,020121804,Comuna 12,CIUDAD DE BUENOS AIRES,308,296,434,383,817
02,02012,020121604,Comuna 12,CIUDAD DE BUENOS AIRES,521,448,611,532,1143
02,02012,020121901,Comuna 12,CIUDAD DE BUENOS AIRES,352,345,510,403,913
02,02012,020121103,Comuna 12,CIUDAD DE BUENOS AIRES,254,243,320,248,568
02,02012,020121805,Comuna 12,CIUDAD DE BUENOS AIRES,301,290,508,405,913
02,02012,020121101,Comuna 12,CIUDAD DE BUENOS AIRES,328,319,417,343,760
02,02012,020121605,Comuna 12,CIUDAD DE BUENOS AIRES,618,470,688,651,1339
02,02012,020121302,Comuna 12,CIUDAD DE BUENOS AIRES,389,388,482,390,872
02,02012,020121707,Comuna 12,CIUDAD DE BUENOS AIRES,373,355,523,469,992
02,02012,020121603,Comuna 12,CIUDAD DE BUENOS AIRES,359,308,480,428,908
02,02012,020121807,Comuna 12,CIUDAD DE BUENOS AIRES,336,328,465,429,894
02,02012,020121110,Comuna 12,CIUDAD DE BUENOS AIRES,283,266,449,411,860
02,02012,020121602,Comuna 12,CIUDAD DE BUENOS AIRES,363,345,474,399,873
02,02012,020121303,Comuna 12,CIUDAD DE BUENOS AIRES,721,711,858,706,1564
02,02012,020121105,Comuna 12,CIUDAD DE BUENOS AIRES,307,284,470,450,920
02,02012,020121608,Comuna 12,CIUDAD DE BUENOS AIRES,528,518,575,488,1063
02,02012,020121607,Comuna 12,CIUDAD DE BUENOS AIRES,0,0,0,0,0
02,02012,020121907,Comuna 12,CIUDAD DE BUENOS AIRES,346,339,533,465,998
02,02012,020121808,Comuna 12,CIUDAD DE BUENOS AIRES,328,314,536,444,980
02,02012,020121304,Comuna 12,CIUDAD DE BUENOS AIRES,526,489,675,582,1257
02,02012,020121104,Comuna 12,CIUDAD DE BUENOS AIRES,343,325,483,405,888
02,02012,020121301,Comuna 12,CIUDAD DE BUENOS AIRES,407,402,495,403,898
02,02012,020121609,Comuna 12,CIUDAD DE BUENOS AIRES,362,358,456,382,838
02,02012,020121601,Comuna 12,CIUDAD DE BUENOS AIRES,395,379,573,537,1110
02,02012,020121809,Comuna 12,CIUDAD DE BUENOS AIRES,290,263,422,372,794
02,02012,020121111,Comuna 12,CIUDAD DE BUENOS AIRES,278,272,414,360,774
02,02012,020121607,Comuna 12,CIUDAD DE BUENOS AIRES,338,0,0,0,0
02,02012,020121610,Comuna 12,CIUDAD DE BUENOS AIRES,330,327,357,306,663
02,02012,020121203,Comuna 12,CIUDAD DE BUENOS AIRES,509,485,638,571,1209
02,02012,020121902,Comuna 12,CIUDAD DE BUENOS AIRES,225,218,326,267,593
02,02012,020121811,Comuna 12,CIUDAD DE BUENOS AIRES,238,233,392,316,708
02,02012,020121305,Comuna 12,CIUDAD DE BUENOS AIRES,475,456,610,467,1077
02,02012,020121903,Comuna 12,CIUDAD DE BUENOS AIRES,283,250,415,349,764
02,02012,020121614,Comuna 12,CIUDAD DE BUENOS AIRES,175,170,201,152,353
02,02012,020121307,Comuna 12,CIUDAD DE BUENOS AIRES,249,221,295,198,493
02,02012,020121810,Comuna 12,CIUDAD DE BUENOS AIRES,284,272,386,361,747
02,02012,020121611,Comuna 12,CIUDAD DE BUENOS AIRES,334,333,422,374,796
02,02012,020121202,Comuna 12,CIUDAD DE BUENOS AIRES,501,494,605,493,1098
02,02012,020121504,Comuna 12,CIUDAD DE BUENOS AIRES,418,415,520,454,974
02,02012,020121204,Comuna 12,CIUDAD DE BUENOS AIRES,356,349,494,417,911
02,02012,020121306,Comuna 12,CIUDAD DE BUENOS AIRES,395,390,483,428,911
02,02012,020121612,Comuna 12,CIUDAD DE BUENOS AIRES,316,311,403,311,714
02,02012,020121205,Comuna 12,CIUDAD DE BUENOS AIRES,328,322,443,360,803
02,02012,020121402,Comuna 12,CIUDAD DE BUENOS AIRES,400,395,512,402,914
02,02012,020121906,Comuna 12,CIUDAD DE BUENOS AIRES,356,348,581,497,1078
02,02012,020121908,Comuna 12,CIUDAD DE BUENOS AIRES,351,302,487,476,963
02,02012,020121201,Comuna 12,CIUDAD DE BUENOS AIRES,272,270,376,285,661
02,02012,020121613,Comuna 12,CIUDAD DE BUENOS AIRES,202,195,268,230,498
02,02012,020121401,Comuna 12,CIUDAD DE BUENOS AIRES,373,369,607,393,1000
02,02012,020121812,Comuna 12,CIUDAD DE BUENOS AIRES,436,426,629,534,1163
02,02012,020121905,Comuna 12,CIUDAD DE BUENOS AIRES,406,366,587,502,1089
02,02012,020121909,Comuna 12,CIUDAD DE BUENOS AIRES,316,311,450,339,789
02,02012,020121208,Comuna 12,CIUDAD DE BUENOS AIRES,267,263,385,331,716
02,02012,020121407,Comuna 12,CIUDAD DE BUENOS AIRES,432,428,577,480,1057
02,02012,020121813,Comuna 12,CIUDAD DE BUENOS AIRES,306,305,429,327,756
02,02012,020121206,Comuna 12,CIUDAD DE BUENOS AIRES,260,243,319,234,553
02,02012,020121403,Comuna 12,CIUDAD DE BUENOS AIRES,308,304,418,360,778
02,02012,020121910,Comuna 12,CIUDAD DE BUENOS AIRES,360,348,573,507,1080
02,02012,020121503,Comuna 12,CIUDAD DE BUENOS AIRES,420,405,559,438,997
02,02012,020121505,Comuna 12,CIUDAD DE BUENOS AIRES,393,391,516,397,913
02,02012,020121404,Comuna 12,CIUDAD DE BUENOS AIRES,407,398,491,375,866
02,02012,020121207,Comuna 12,CIUDAD DE BUENOS AIRES,386,375,458,400,858
02,02012,020121405,Comuna 12,CIUDAD DE BUENOS AIRES,421,418,518,468,986
02,02012,020121904,Comuna 12,CIUDAD DE BUENOS AIRES,367,363,594,488,1082
02,02012,020121913,Comuna 12,CIUDAD DE BUENOS AIRES,286,272,407,306,713
02,02012,020121502,Comuna 12,CIUDAD DE BUENOS AIRES,422,419,478,366,844
02,02012,020121408,Comuna 12,CIUDAD DE BUENOS AIRES,469,463,523,448,971
02,02012,020121506,Comuna 12,CIUDAD DE BUENOS AIRES,343,339,452,377,829
02,02012,020121501,Comuna 12,CIUDAD DE BUENOS AIRES,378,365,490,394,884
02,02012,020121912,Comuna 12,CIUDAD DE BUENOS AIRES,333,315,445,388,833
02,02012,020121406,Comuna 12,CIUDAD DE BUENOS AIRES,318,314,407,371,778
02,02012,020121507,Comuna 12,CIUDAD DE BUENOS AIRES,383,379,524,397,921
02,02012,020121911,Comuna 12,CIUDAD DE BUENOS AIRES,372,334,573,509,1082
02,02012,020121410,Comuna 12,CIUDAD DE BUENOS AIRES,441,423,549,474,1023
02,02012,020121508,Comuna 12,CIUDAD DE BUENOS AIRES,364,359,529,409,938
02,02012,020121513,Comuna 12,CIUDAD DE BUENOS AIRES,262,245,389,301,690
02,02012,020121409,Comuna 12,CIUDAD DE BUENOS AIRES,324,319,425,375,800
02,02012,020122008,Comuna 12,CIUDAD DE BUENOS AIRES,365,309,486,451,937
02,02012,020121509,Comuna 12,CIUDAD DE BUENOS AIRES,426,422,540,455,995
02,02012,020122007,Comuna 12,CIUDAD DE BUENOS AIRES,346,342,494,393,887
02,02012,020122005,Comuna 12,CIUDAD DE BUENOS AIRES,382,351,519,474,993
02,02012,020121512,Comuna 12,CIUDAD DE BUENOS AIRES,284,267,421,377,798
02,02012,020121510,Comuna 12,CIUDAD DE BUENOS AIRES,297,293,422,426,848
02,02012,020122004,Comuna 12,CIUDAD DE BUENOS AIRES,391,386,539,495,1034
02,02012,020122104,Comuna 12,CIUDAD DE BUENOS AIRES,421,416,544,471,1015
02,02012,020122202,Comuna 12,CIUDAD DE BUENOS AIRES,362,355,510,444,954
02,02012,020121511,Comuna 12,CIUDAD DE BUENOS AIRES,272,265,467,377,844
02,02012,020122201,Comuna 12,CIUDAD DE BUENOS AIRES,294,284,424,364,788
02,02012,020122006,Comuna 12,CIUDAD DE BUENOS AIRES,407,402,567,447,1014
02,02012,020122001,Comuna 12,CIUDAD DE BUENOS AIRES,317,313,446,405,851
02,02012,020122103,Comuna 12,CIUDAD DE BUENOS AIRES,360,341,479,441,920
02,02012,020122203,Comuna 12,CIUDAD DE BUENOS AIRES,299,289,439,347,786
02,02012,020122003,Comuna 12,CIUDAD DE BUENOS AIRES,411,398,541,485,1026
02,02012,020122204,Comuna 12,CIUDAD DE BUENOS AIRES,299,292,466,419,885
02,02012,020122105,Comuna 12,CIUDAD DE BUENOS AIRES,297,191,430,383,813
02,02012,020122102,Comuna 12,CIUDAD DE BUENOS AIRES,476,409,592,482,1074
02,02012,020122106,Comuna 12,CIUDAD DE BUENOS AIRES,326,319,449,420,869
02,02012,020122110,Comuna 12,CIUDAD DE BUENOS AIRES,258,258,365,299,664
02,02012,020122002,Comuna 12,CIUDAD DE BUENOS AIRES,559,514,699,587,1286
02,02012,020122205,Comuna 12,CIUDAD DE BUENOS AIRES,435,360,632,575,1207
02,02012,020122101,Comuna 12,CIUDAD DE BUENOS AIRES,467,456,573,479,1052
02,02012,020122107,Comuna 12,CIUDAD DE BUENOS AIRES,340,330,498,459,957
02,02012,020122206,Comuna 12,CIUDAD DE BUENOS AIRES,448,433,602,517,1119
02,02012,020122109,Comuna 12,CIUDAD DE BUENOS AIRES,286,270,429,372,801
02,02012,020122209,Comuna 12,CIUDAD DE BUENOS AIRES,365,356,500,420,920
02,02012,020122108,Comuna 12,CIUDAD DE BUENOS AIRES,319,294,436,367,803
02,02012,020122207,Comuna 12,CIUDAD DE BUENOS AIRES,459,434,618,503,1121
02,02012,020122210,Comuna 12,CIUDAD DE BUENOS AIRES,370,355,507,457,964
02,02012,020122208,Comuna 12,CIUDAD DE BUENOS AIRES,365,332,517,465,982
02,02002,020021305,Comuna 2,CIUDAD DE BUENOS AIRES,647,605,774,597,1371
02,02002,020020504,Comuna 2,CIUDAD DE BUENOS AIRES,226,224,311,233,544
02,02002,020020307,Comuna 2,CIUDAD DE BUENOS AIRES,353,331,517,368,885
02,02002,020020803,Comuna 2,CIUDAD DE BUENOS AIRES,457,451,503,397,900
02,02002,020022403,Comuna 2,CIUDAD DE BUENOS AIRES,335,331,445,350,795
02,02002,020022204,Comuna 2,CIUDAD DE BUENOS AIRES,483,475,562,397,959
02,02002,020022202,Comuna 2,CIUDAD DE BUENOS AIRES,281,279,301,233,534
02,02002,020021307,Comuna 2,CIUDAD DE BUENOS AIRES,634,592,695,516,1211
02,02002,020020905,Comuna 2,CIUDAD DE BUENOS AIRES,488,461,597,431,1028
02,02002,020020610,Comuna 2,CIUDAD DE BUENOS AIRES,228,226,280,235,515
02,02002,020020609,Comuna 2,CIUDAD DE BUENOS AIRES,276,269,278,223,501
02,02002,020021708,Comuna 2,CIUDAD DE BUENOS AIRES,489,470,533,380,913
02,02002,020020101,Comuna 2,CIUDAD DE BUENOS AIRES,21,9,42,63,105
02,02002,020020102,Comuna 2,CIUDAD DE BUENOS AIRES,133,119,250,268,518
02,02002,020020203,Comuna 2,CIUDAD DE BUENOS AIRES,229,224,307,265,572
02,02002,020020202,Comuna 2,CIUDAD DE BUENOS AIRES,362,361,488,390,878
02,02002,020021102,Comuna 2,CIUDAD DE BUENOS AIRES,241,228,319,245,564
02,02002,020021103,Comuna 2,CIUDAD DE BUENOS AIRES,672,644,942,701,1643
02,02002,020021106,Comuna 2,CIUDAD DE BUENOS AIRES,305,302,289,238,527
02,02002,020020201,Comuna 2,CIUDAD DE BUENOS AIRES,252,229,320,267,587
02,02002,020021101,Comuna 2,CIUDAD DE BUENOS AIRES,621,600,701,495,1196
02,02002,020021104,Comuna 2,CIUDAD DE BUENOS AIRES,668,657,793,600,1393
02,02002,020021202,Comuna 2,CIUDAD DE BUENOS AIRES,402,387,484,334,818
02,02002,020020208,Comuna 2,CIUDAD DE BUENOS AIRES,282,278,394,303,697
02,02002,020020303,Comuna 2,CIUDAD DE BUENOS AIRES,100,87,152,114,266
02,02002,020021003,Comuna 2,CIUDAD DE BUENOS AIRES,209,206,239,202,441
02,02002,020020403,Comuna 2,CIUDAD DE BUENOS AIRES,149,146,221,144,365
02,02002,020020204,Comuna 2,CIUDAD DE BUENOS AIRES,205,185,308,232,540
02,02002,020020206,Comuna 2,CIUDAD DE BUENOS AIRES,197,190,265,207,472
02,02002,020021203,Comuna 2,CIUDAD DE BUENOS AIRES,457,414,552,391,943
02,02002,020021105,Comuna 2,CIUDAD DE BUENOS AIRES,169,152,176,133,309
02,02002,020021201,Comuna 2,CIUDAD DE BUENOS AIRES,435,431,568,402,970
02,02002,020020401,Comuna 2,CIUDAD DE BUENOS AIRES,313,307,467,356,823
02,02002,020020205,Comuna 2,CIUDAD DE BUENOS AIRES,259,259,344,256,600
02,02002,020021004,Comuna 2,CIUDAD DE BUENOS AIRES,344,341,434,351,785
02,02002,020021002,Comuna 2,CIUDAD DE BUENOS AIRES,366,353,371,266,637
02,02002,020020207,Comuna 2,CIUDAD DE BUENOS AIRES,141,129,165,136,301
02,02002,020020408,Comuna 2,CIUDAD DE BUENOS AIRES,427,424,532,465,997
02,02002,020021204,Comuna 2,CIUDAD DE BUENOS AIRES,704,684,721,529,1250
02,02002,020021206,Comuna 2,CIUDAD DE BUENOS AIRES,498,471,556,427,983
02,02002,020020302,Comuna 2,CIUDAD DE BUENOS AIRES,411,398,418,327,745
02,02002,020022301,Comuna 2,CIUDAD DE BUENOS AIRES,435,429,636,443,1079
02,02002,020021001,Comuna 2,CIUDAD DE BUENOS AIRES,519,515,538,437,975
02,02002,020021005,Comuna 2,CIUDAD DE BUENOS AIRES,426,421,441,371,812
02,02002,020021009,Comuna 2,CIUDAD DE BUENOS AIRES,299,277,326,285,611
02,02002,020020402,Comuna 2,CIUDAD DE BUENOS AIRES,109,109,121,112,233
02,02002,020020409,Comuna 2,CIUDAD DE BUENOS AIRES,333,314,447,365,812
02,02002,020020407,Comuna 2,CIUDAD DE BUENOS AIRES,235,226,344,273,617
02,02002,020020301,Comuna 2,CIUDAD DE BUENOS AIRES,399,397,533,362,895
02,02002,020021006,Comuna 2,CIUDAD DE BUENOS AIRES,321,315,373,322,695
02,02002,020021205,Comuna 2,CIUDAD DE BUENOS AIRES,615,567,691,551,1242
02,02002,020022302,Comuna 2,CIUDAD DE BUENOS AIRES,512,509,604,421,1025
02,02002,020021008,Comuna 2,CIUDAD DE BUENOS AIRES,443,429,498,358,856
02,02002,020021302,Comuna 2,CIUDAD DE BUENOS AIRES,418,409,504,386,890
02,02002,020020410,Comuna 2,CIUDAD DE BUENOS AIRES,430,414,519,365,884
02,02002,020022306,Comuna 2,CIUDAD DE BUENOS AIRES,203,198,228,178,406
02,02002,020020902,Comuna 2,CIUDAD DE BUENOS AIRES,218,215,454,227,681
02,02002,020021007,Comuna 2,CIUDAD DE BUENOS AIRES,483,474,502,366,868
02,02002,020020501,Comuna 2,CIUDAD DE BUENOS AIRES,256,256,360,350,710
02,02002,020020406,Comuna 2,CIUDAD DE BUENOS AIRES,212,186,313,226,539
02,02002,020021303,Comuna 2,CIUDAD DE BUENOS AIRES,516,494,564,409,973
02,02002,020020404,Comuna 2,CIUDAD DE BUENOS AIRES,195,193,289,210,499
02,02002,020022303,Comuna 2,CIUDAD DE BUENOS AIRES,441,433,544,384,928
02,02002,020020304,Comuna 2,CIUDAD DE BUENOS AIRES,188,187,210,159,369
02,02002,020021301,Comuna 2,CIUDAD DE BUENOS AIRES,595,558,670,526,1196
02,02002,020022305,Comuna 2,CIUDAD DE BUENOS AIRES,295,293,367,283,650
02,02002,020022307,Comuna 2,CIUDAD DE BUENOS AIRES,237,228,264,192,456
02,02002,020020306,Comuna 2,CIUDAD DE BUENOS AIRES,274,272,390,288,678
02,02002,020020903,Comuna 2,CIUDAD DE BUENOS AIRES,451,446,479,386,865
02,02002,020020405,Comuna 2,CIUDAD DE BUENOS AIRES,284,281,385,317,702
02,02002,020021306,Comuna 2,CIUDAD DE BUENOS AIRES,382,378,599,453,1052
02,02002,020020503,Comuna 2,CIUDAD DE BUENOS AIRES,255,248,377,284,661
02,02002,020021304,Comuna 2,CIUDAD DE BUENOS AIRES,555,529,610,502,1112
02,02002,020020901,Comuna 2,CIUDAD DE BUENOS AIRES,399,372,459,306,765
02,02002,020022308,Comuna 2,CIUDAD DE BUENOS AIRES,187,181,250,195,445
02,02002,020020305,Comuna 2,CIUDAD DE BUENOS AIRES,293,288,383,331,714
02,02002,020022304,Comuna 2,CIUDAD DE BUENOS AIRES,381,377,493,356,849
02,02002,020022203,Comuna 2,CIUDAD DE BUENOS AIRES,205,203,247,192,439
02,02002,020022402,Comuna 2,CIUDAD DE BUENOS AIRES,377,371,439,348,787
02,02002,020020904,Comuna 2,CIUDAD DE BUENOS AIRES,461,455,570,451,1021
02,02002,020020502,Comuna 2,CIUDAD DE BUENOS AIRES,319,276,493,394,887
02,02002,020022309,Comuna 2,CIUDAD DE BUENOS AIRES,463,446,548,395,943
02,02002,020022201,Comuna 2,CIUDAD DE BUENOS AIRES,368,364,401,298,699
02,02002,020022406,Comuna 2,CIUDAD DE BUENOS AIRES,468,459,573,395,968
02,02002,020020505,Comuna 2,CIUDAD DE BUENOS AIRES,324,318,450,327,777
02,02002,020020507,Comuna 2,CIUDAD DE BUENOS AIRES,329,320,470,358,828
02,02002,020020804,Comuna 2,CIUDAD DE BUENOS AIRES,478,474,646,459,1105
02,02002,020020308,Comuna 2,CIUDAD DE BUENOS AIRES,234,229,339,267,606
02,02002,020020909,Comuna 2,CIUDAD DE BUENOS AIRES,550,519,653,497,1150
02,02002,020022401,Comuna 2,CIUDAD DE BUENOS AIRES,450,444,588,424,1012
02,02002,020020802,Comuna 2,CIUDAD DE BUENOS AIRES,306,302,405,297,702
02,02002,020022205,Comuna 2,CIUDAD DE BUENOS AIRES,528,522,620,473,1093
02,02002,020021401,Comuna 2,CIUDAD DE BUENOS AIRES,248,246,419,341,760
02,02002,020020906,Comuna 2,CIUDAD DE BUENOS AIRES,441,437,531,369,900
02,02002,020022404,Comuna 2,CIUDAD DE BUENOS AIRES,464,451,604,446,1050
02,02002,020022101,Comuna 2,CIUDAD DE BUENOS AIRES,462,445,600,458,1058
02,02002,020022206,Comuna 2,CIUDAD DE BUENOS AIRES,557,556,596,420,1016
02,02002,020020908,Comuna 2,CIUDAD DE BUENOS AIRES,649,636,773,604,1377
02,02002,020020805,Comuna 2,CIUDAD DE BUENOS AIRES,413,397,498,409,907
02,02002,020020506,Comuna 2,CIUDAD DE BUENOS AIRES,328,326,472,339,811
02,02002,020020508,Comuna 2,CIUDAD DE BUENOS AIRES,328,322,396,304,700
02,02002,020020808,Comuna 2,CIUDAD DE BUENOS AIRES,357,350,485,363,848
02,02002,020021402,Comuna 2,CIUDAD DE BUENOS AIRES,306,294,345,230,575
02,02002,020022405,Comuna 2,CIUDAD DE BUENOS AIRES,506,494,551,371,922
02,02002,020020801,Comuna 2,CIUDAD DE BUENOS AIRES,347,335,409,304,713
02,02002,020020907,Comuna 2,CIUDAD DE BUENOS AIRES,472,458,556,393,949
02,02002,020021501,Comuna 2,CIUDAD DE BUENOS AIRES,266,264,335,266,601
02,02002,020022102,Comuna 2,CIUDAD DE BUENOS AIRES,442,431,566,393,959
02,02002,020022501,Comuna 2,CIUDAD DE BUENOS AIRES,312,309,333,237,570
02,02002,020022103,Comuna 2,CIUDAD DE BUENOS AIRES,369,358,423,352,775
02,02002,020021403,Comuna 2,CIUDAD DE BUENOS AIRES,175,174,214,141,355
02,02002,020021407,Comuna 2,CIUDAD DE BUENOS AIRES,348,337,366,282,648
02,02002,020020601,Comuna 2,CIUDAD DE BUENOS AIRES,175,167,246,186,432
02,02002,020020509,Comuna 2,CIUDAD DE BUENOS AIRES,271,249,370,246,616
02,02002,020020806,Comuna 2,CIUDAD DE BUENOS AIRES,625,618,733,514,1247
02,02002,020020701,Comuna 2,CIUDAD DE BUENOS AIRES,573,560,828,591,1419
02,02002,020020807,Comuna 2,CIUDAD DE BUENOS AIRES,707,681,882,613,1495
02,02002,020021502,Comuna 2,CIUDAD DE BUENOS AIRES,388,383,462,336,798
02,02002,020022502,Comuna 2,CIUDAD DE BUENOS AIRES,349,344,375,272,647
02,02002,020021404,Comuna 2,CIUDAD DE BUENOS AIRES,369,356,423,320,743
02,02002,020022504,Comuna 2,CIUDAD DE BUENOS AIRES,427,425,463,294,757
02,02002,020021406,Comuna 2,CIUDAD DE BUENOS AIRES,532,522,607,424,1031
02,02002,020021408,Comuna 2,CIUDAD DE BUENOS AIRES,380,373,423,272,695
02,02002,020021503,Comuna 2,CIUDAD DE BUENOS AIRES,630,625,775,618,1393
02,02002,020021505,Comuna 2,CIUDAD DE BUENOS AIRES,267,264,325,230,555
02,02002,020022104,Comuna 2,CIUDAD DE BUENOS AIRES,530,508,610,436,1046
02,02002,020020702,Comuna 2,CIUDAD DE BUENOS AIRES,493,473,603,470,1073
02,02002,020022503,Comuna 2,CIUDAD DE BUENOS AIRES,177,177,450,293,743
02,02002,020021405,Comuna 2,CIUDAD DE BUENOS AIRES,499,455,628,496,1124
02,02002,020022505,Comuna 2,CIUDAD DE BUENOS AIRES,469,453,519,411,930
02,02002,020021601,Comuna 2,CIUDAD DE BUENOS AIRES,321,317,463,344,807
02,02002,020021504,Comuna 2,CIUDAD DE BUENOS AIRES,310,309,343,285,628
02,02002,020022105,Comuna 2,CIUDAD DE BUENOS AIRES,508,465,567,417,984
02,02002,020020602,Comuna 2,CIUDAD DE BUENOS AIRES,572,560,766,580,1346
02,02002,020021602,Comuna 2,CIUDAD DE BUENOS AIRES,308,288,406,306,712
02,02002,020021409,Comuna 2,CIUDAD DE BUENOS AIRES,605,571,793,682,1475
02,02002,020021506,Comuna 2,CIUDAD DE BUENOS AIRES,286,284,332,273,605
02,02002,020021603,Comuna 2,CIUDAD DE BUENOS AIRES,305,301,369,329,698
02,02002,020022106,Comuna 2,CIUDAD DE BUENOS AIRES,481,455,553,373,926
02,02002,020022506,Comuna 2,CIUDAD DE BUENOS AIRES,355,348,428,331,759
02,02002,020021604,Comuna 2,CIUDAD DE BUENOS AIRES,284,278,307,227,534
02,02002,020021507,Comuna 2,CIUDAD DE BUENOS AIRES,367,362,422,334,756
02,02002,020022001,Comuna 2,CIUDAD DE BUENOS AIRES,457,441,537,422,959
02,02002,020022507,Comuna 2,CIUDAD DE BUENOS AIRES,386,373,412,356,768
02,02002,020020704,Comuna 2,CIUDAD DE BUENOS AIRES,267,264,368,304,672
02,02002,020021410,Comuna 2,CIUDAD DE BUENOS AIRES,537,523,588,418,1006
02,02002,020020703,Comuna 2,CIUDAD DE BUENOS AIRES,361,355,549,373,922
02,02002,020021901,Comuna 2,CIUDAD DE BUENOS AIRES,393,391,472,382,854
02,02002,020021508,Comuna 2,CIUDAD DE BUENOS AIRES,339,329,399,309,708
02,02002,020021607,Comuna 2,CIUDAD DE BUENOS AIRES,359,337,443,327,770
02,02002,020022002,Comuna 2,CIUDAD DE BUENOS AIRES,449,445,464,358,822
02,02002,020021801,Comuna 2,CIUDAD DE BUENOS AIRES,458,441,493,398,891
02,02002,020020604,Comuna 2,CIUDAD DE BUENOS AIRES,333,315,472,363,835
02,02002,020021606,Comuna 2,CIUDAD DE BUENOS AIRES,318,317,408,267,675
02,02002,020021605,Comuna 2,CIUDAD DE BUENOS AIRES,386,358,472,350,822
02,02002,020021902,Comuna 2,CIUDAD DE BUENOS AIRES,306,297,373,302,675
02,02002,020021802,Comuna 2,CIUDAD DE BUENOS AIRES,548,518,695,493,1188
02,02002,020021608,Comuna 2,CIUDAD DE BUENOS AIRES,196,196,238,187,425
02,02002,020020603,Comuna 2,CIUDAD DE BUENOS AIRES,226,220,343,295,638
02,02002,020022003,Comuna 2,CIUDAD DE BUENOS AIRES,372,370,473,278,751
02,02002,020020705,Comuna 2,CIUDAD DE BUENOS AIRES,244,241,292,232,524
02,02002,020022006,Comuna 2,CIUDAD DE BUENOS AIRES,356,323,350,287,637
02,02002,020020706,Comuna 2,CIUDAD DE BUENOS AIRES,271,271,333,257,590
02,02002,020021803,Comuna 2,CIUDAD DE BUENOS AIRES,397,391,465,322,787
02,02002,020021903,Comuna 2,CIUDAD DE BUENOS AIRES,305,303,410,307,717
02,02002,020022508,Comuna 2,CIUDAD DE BUENOS AIRES,523,505,636,586,1222
02,02002,020021906,Comuna 2,CIUDAD DE BUENOS AIRES,424,418,418,327,745
02,02002,020022509,Comuna 2,CIUDAD DE BUENOS AIRES,411,405,435,340,775
02,02002,020021701,Comuna 2,CIUDAD DE BUENOS AIRES,571,564,675,542,1217
02,02002,020021905,Comuna 2,CIUDAD DE BUENOS AIRES,361,352,456,334,790
02,02002,020022005,Comuna 2,CIUDAD DE BUENOS AIRES,251,243,284,220,504
02,02002,020021702,Comuna 2,CIUDAD DE BUENOS AIRES,382,366,467,371,838
02,02002,020021805,Comuna 2,CIUDAD DE BUENOS AIRES,250,243,315,234,549
02,02002,020021703,Comuna 2,CIUDAD DE BUENOS AIRES,454,445,535,396,931
02,02002,020021704,Comuna 2,CIUDAD DE BUENOS AIRES,168,162,203,136,339
02,02002,020020606,Comuna 2,CIUDAD DE BUENOS AIRES,320,313,381,299,680
02,02002,020020605,Comuna 2,CIUDAD DE BUENOS AIRES,183,178,265,223,488
02,02002,020020707,Comuna 2,CIUDAD DE BUENOS AIRES,409,400,521,412,933
02,02002,020020708,Comuna 2,CIUDAD DE BUENOS AIRES,172,154,261,174,435
02,02002,020021904,Comuna 2,CIUDAD DE BUENOS AIRES,499,487,561,436,997
02,02002,020022004,Comuna 2,CIUDAD DE BUENOS AIRES,386,369,452,389,841
02,02002,020022007,Comuna 2,CIUDAD DE BUENOS AIRES,247,243,319,250,569
02,02002,020021804,Comuna 2,CIUDAD DE BUENOS AIRES,267,262,684,501,1185
02,02002,020022510,Comuna 2,CIUDAD DE BUENOS AIRES,299,297,330,275,605
02,02002,020021806,Comuna 2,CIUDAD DE BUENOS AIRES,367,358,430,314,744
02,02002,020021907,Comuna 2,CIUDAD DE BUENOS AIRES,324,313,372,310,682
02,02002,020022511,Comuna 2,CIUDAD DE BUENOS AIRES,501,431,563,474,1037
02,02002,020022008,Comuna 2,CIUDAD DE BUENOS AIRES,301,284,367,304,671
02,02002,020021908,Comuna 2,CIUDAD DE BUENOS AIRES,377,366,474,357,831
02,02002,020020607,Comuna 2,CIUDAD DE BUENOS AIRES,175,174,213,179,392
02,02002,020021707,Comuna 2,CIUDAD DE BUENOS AIRES,577,520,648,473,1121
02,02002,020020608,Comuna 2,CIUDAD DE BUENOS AIRES,219,219,327,242,569
02,02002,020021705,Comuna 2,CIUDAD DE BUENOS AIRES,290,275,299,233,532
02,02002,020020709,Comuna 2,CIUDAD DE BUENOS AIRES,278,276,310,220,530
02,02002,020021706,Comuna 2,CIUDAD DE BUENOS AIRES,452,441,544,442,986
02,02002,020021807,Comuna 2,CIUDAD DE BUENOS AIRES,277,263,367,228,595
02,02002,020021808,Comuna 2,CIUDAD DE BUENOS AIRES,335,328,539,373,912
02,02002,020021709,Comuna 2,CIUDAD DE BUENOS AIRES,366,356,426,315,741
02,02014,020142509,Comuna 14,CIUDAD DE BUENOS AIRES,405,390,396,279,675
02,02014,020142203,Comuna 14,CIUDAD DE BUENOS AIRES,233,233,282,212,494
02,02014,020142109,Comuna 14,CIUDAD DE BUENOS AIRES,266,261,285,283,568
02,02014,020142402,Comuna 14,CIUDAD DE BUENOS AIRES,232,214,258,204,462
02,02014,020142102,Comuna 14,CIUDAD DE BUENOS AIRES,303,265,380,301,681
02,02014,020142705,Comuna 14,CIUDAD DE BUENOS AIRES,487,475,534,389,923
02,02014,020142508,Comuna 14,CIUDAD DE BUENOS AIRES,355,349,401,314,715
02,02014,020142204,Comuna 14,CIUDAD DE BUENOS AIRES,240,236,319,257,576
02,02014,020141001,Comuna 14,CIUDAD DE BUENOS AIRES,6,6,8,17,25
02,02014,020140203,Comuna 14,CIUDAD DE BUENOS AIRES,349,339,494,372,866
02,02014,020140208,Comuna 14,CIUDAD DE BUENOS AIRES,402,399,542,390,932
02,02014,020140202,Comuna 14,CIUDAD DE BUENOS AIRES,271,270,294,246,540
02,02014,020140204,Comuna 14,CIUDAD DE BUENOS AIRES,320,319,375,283,658
02,02014,020140201,Comuna 14,CIUDAD DE BUENOS AIRES,505,492,664,508,1172
02,02014,020140209,Comuna 14,CIUDAD DE BUENOS AIRES,380,371,511,398,909
02,02014,020140207,Comuna 14,CIUDAD DE BUENOS AIRES,317,308,395,309,704
02,02014,020140205,Comuna 14,CIUDAD DE BUENOS AIRES,340,324,410,310,720
02,02014,020140108,Comuna 14,CIUDAD DE BUENOS AIRES,299,291,537,415,952
02,02014,020140304,Comuna 14,CIUDAD DE BUENOS AIRES,297,297,434,347,781
02,02014,020140210,Comuna 14,CIUDAD DE BUENOS AIRES,474,470,614,521,1135
02,02014,020140206,Comuna 14,CIUDAD DE BUENOS AIRES,268,265,375,298,673
02,02014,020140109,Comuna 14,CIUDAD DE BUENOS AIRES,398,378,573,439,1012
02,02014,020140305,Comuna 14,CIUDAD DE BUENOS AIRES,407,401,494,368,862
02,02014,020140301,Comuna 14,CIUDAD DE BUENOS AIRES,758,727,900,719,1619
02,02014,020140303,Comuna 14,CIUDAD DE BUENOS AIRES,226,225,238,188,426
02,02014,020140104,Comuna 14,CIUDAD DE BUENOS AIRES,362,355,520,424,944
02,02014,020140110,Comuna 14,CIUDAD DE BUENOS AIRES,462,444,679,531,1210
02,02014,020140312,Comuna 14,CIUDAD DE BUENOS AIRES,305,299,375,302,677
02,02014,020140306,Comuna 14,CIUDAD DE BUENOS AIRES,164,162,220,190,410
02,02014,020140302,Comuna 14,CIUDAD DE BUENOS AIRES,226,222,263,235,498
02,02014,020140402,Comuna 14,CIUDAD DE BUENOS AIRES,220,220,328,282,610
02,02014,020140906,Comuna 14,CIUDAD DE BUENOS AIRES,296,295,374,320,694
02,02014,020140311,Comuna 14,CIUDAD DE BUENOS AIRES,347,346,400,308,708
02,02014,020140307,Comuna 14,CIUDAD DE BUENOS AIRES,297,289,359,279,638
02,02014,020140103,Comuna 14,CIUDAD DE BUENOS AIRES,400,388,487,375,862
02,02014,020140907,Comuna 14,CIUDAD DE BUENOS AIRES,264,257,370,284,654
02,02014,020140105,Comuna 14,CIUDAD DE BUENOS AIRES,585,574,744,612,1356
02,02014,020140101,Comuna 14,CIUDAD DE BUENOS AIRES,210,208,243,186,429
02,02014,020140905,Comuna 14,CIUDAD DE BUENOS AIRES,198,193,225,173,398
02,02014,020140403,Comuna 14,CIUDAD DE BUENOS AIRES,218,214,323,262,585
02,02014,020140106,Comuna 14,CIUDAD DE BUENOS AIRES,446,443,545,455,1000
02,02014,020140310,Comuna 14,CIUDAD DE BUENOS AIRES,308,307,371,260,631
02,02014,020140908,Comuna 14,CIUDAD DE BUENOS AIRES,391,377,420,364,784
02,02014,020140904,Comuna 14,CIUDAD DE BUENOS AIRES,537,533,666,551,1217
02,02014,020140102,Comuna 14,CIUDAD DE BUENOS AIRES,255,245,318,244,562
02,02014,020140913,Comuna 14,CIUDAD DE BUENOS AIRES,349,340,378,305,683
02,02014,020140308,Comuna 14,CIUDAD DE BUENOS AIRES,430,400,480,359,839
02,02014,020140107,Comuna 14,CIUDAD DE BUENOS AIRES,367,339,478,371,849
02,02014,020140902,Comuna 14,CIUDAD DE BUENOS AIRES,303,301,484,392,876
02,02014,020140309,Comuna 14,CIUDAD DE BUENOS AIRES,456,441,541,352,893
02,02014,020140405,Comuna 14,CIUDAD DE BUENOS AIRES,384,368,485,377,862
02,02014,020140903,Comuna 14,CIUDAD DE BUENOS AIRES,525,502,580,522,1102
02,02014,020140406,Comuna 14,CIUDAD DE BUENOS AIRES,454,451,684,619,1303
02,02014,020140401,Comuna 14,CIUDAD DE BUENOS AIRES,413,405,506,374,880
02,02014,020140901,Comuna 14,CIUDAD DE BUENOS AIRES,491,481,608,582,1190
02,02014,020140404,Comuna 14,CIUDAD DE BUENOS AIRES,293,292,362,289,651
02,02014,020140909,Comuna 14,CIUDAD DE BUENOS AIRES,363,362,432,361,793
02,02014,020140910,Comuna 14,CIUDAD DE BUENOS AIRES,462,401,504,408,912
02,02014,020140912,Comuna 14,CIUDAD DE BUENOS AIRES,418,345,502,533,1035
02,02014,020141102,Comuna 14,CIUDAD DE BUENOS AIRES,468,464,486,469,955
02,02014,020140911,Comuna 14,CIUDAD DE BUENOS AIRES,395,389,433,334,767
02,02014,020143101,Comuna 14,CIUDAD DE BUENOS AIRES,217,217,350,371,721
02,02014,020141103,Comuna 14,CIUDAD DE BUENOS AIRES,237,230,282,225,507
02,02014,020140504,Comuna 14,CIUDAD DE BUENOS AIRES,284,264,314,240,554
02,02014,020140407,Comuna 14,CIUDAD DE BUENOS AIRES,432,430,532,397,929
02,02014,020141104,Comuna 14,CIUDAD DE BUENOS AIRES,279,271,410,300,710
02,02014,020140505,Comuna 14,CIUDAD DE BUENOS AIRES,507,482,605,441,1046
02,02014,020140503,Comuna 14,CIUDAD DE BUENOS AIRES,412,407,530,442,972
02,02014,020141113,Comuna 14,CIUDAD DE BUENOS AIRES,399,393,432,344,776
02,02014,020141105,Comuna 14,CIUDAD DE BUENOS AIRES,379,375,424,375,799
02,02014,020140510,Comuna 14,CIUDAD DE BUENOS AIRES,546,517,718,550,1268
02,02014,020140409,Comuna 14,CIUDAD DE BUENOS AIRES,433,401,429,373,802
02,02014,020140506,Comuna 14,CIUDAD DE BUENOS AIRES,277,275,351,280,631
02,02014,020140509,Comuna 14,CIUDAD DE BUENOS AIRES,502,495,631,582,1213
02,02014,020141106,Comuna 14,CIUDAD DE BUENOS AIRES,353,350,476,435,911
02,02014,020140408,Comuna 14,CIUDAD DE BUENOS AIRES,482,475,633,490,1123
02,02014,020141114,Comuna 14,CIUDAD DE BUENOS AIRES,231,211,285,238,523
02,02014,020140507,Comuna 14,CIUDAD DE BUENOS AIRES,236,215,295,258,553
02,02014,020143108,Comuna 14,CIUDAD DE BUENOS AIRES,269,267,398,340,738
02,02014,020141101,Comuna 14,CIUDAD DE BUENOS AIRES,284,281,563,484,1047
02,02014,020140410,Comuna 14,CIUDAD DE BUENOS AIRES,697,671,837,645,1482
02,02014,020140502,Comuna 14,CIUDAD DE BUENOS AIRES,370,356,509,446,955
02,02014,020140601,Comuna 14,CIUDAD DE BUENOS AIRES,512,482,523,468,991
02,02014,020140501,Comuna 14,CIUDAD DE BUENOS AIRES,357,351,436,352,788
02,02014,020141107,Comuna 14,CIUDAD DE BUENOS AIRES,267,265,302,259,561
02,02014,020141601,Comuna 14,CIUDAD DE BUENOS AIRES,591,575,731,575,1306
02,02014,020140605,Comuna 14,CIUDAD DE BUENOS AIRES,387,368,461,333,794
02,02014,020143102,Comuna 14,CIUDAD DE BUENOS AIRES,327,317,444,393,837
02,02014,020141108,Comuna 14,CIUDAD DE BUENOS AIRES,529,522,566,479,1045
02,02014,020140508,Comuna 14,CIUDAD DE BUENOS AIRES,190,180,234,222,456
02,02014,020140606,Comuna 14,CIUDAD DE BUENOS AIRES,511,470,605,522,1127
02,02014,020141112,Comuna 14,CIUDAD DE BUENOS AIRES,362,357,383,344,727
02,02014,020141605,Comuna 14,CIUDAD DE BUENOS AIRES,374,359,505,424,929
02,02014,020140604,Comuna 14,CIUDAD DE BUENOS AIRES,361,349,368,354,722
02,02014,020143103,Comuna 14,CIUDAD DE BUENOS AIRES,279,279,338,278,616
02,02014,020140610,Comuna 14,CIUDAD DE BUENOS AIRES,213,212,223,172,395
02,02014,020141606,Comuna 14,CIUDAD DE BUENOS AIRES,122,122,164,135,299
02,02014,020140602,Comuna 14,CIUDAD DE BUENOS AIRES,401,345,424,397,821
02,02014,020141109,Comuna 14,CIUDAD DE BUENOS AIRES,412,395,372,322,694
02,02014,020143106,Comuna 14,CIUDAD DE BUENOS AIRES,406,376,669,551,1220
02,02014,020140609,Comuna 14,CIUDAD DE BUENOS AIRES,402,385,427,357,784
02,02014,020140607,Comuna 14,CIUDAD DE BUENOS AIRES,359,355,454,334,788
02,02014,020140805,Comuna 14,CIUDAD DE BUENOS AIRES,482,459,558,429,987
02,02014,020141706,Comuna 14,CIUDAD DE BUENOS AIRES,274,271,403,272,675
02,02014,020141604,Comuna 14,CIUDAD DE BUENOS AIRES,397,397,488,457,945
02,02014,020140806,Comuna 14,CIUDAD DE BUENOS AIRES,469,451,529,398,927
02,02014,020143104,Comuna 14,CIUDAD DE BUENOS AIRES,250,249,372,274,646
02,02014,020140603,Comuna 14,CIUDAD DE BUENOS AIRES,380,339,490,453,943
02,02014,020143109,Comuna 14,CIUDAD DE BUENOS AIRES,225,224,357,292,649
02,02014,020141110,Comuna 14,CIUDAD DE BUENOS AIRES,208,204,234,210,444
02,02014,020140804,Comuna 14,CIUDAD DE BUENOS AIRES,245,241,252,203,455
02,02014,020140608,Comuna 14,CIUDAD DE BUENOS AIRES,253,237,281,249,530
02,02014,020141607,Comuna 14,CIUDAD DE BUENOS AIRES,324,321,401,320,721
02,02014,020140807,Comuna 14,CIUDAD DE BUENOS AIRES,301,289,335,297,632
02,02014,020143107,Comuna 14,CIUDAD DE BUENOS AIRES,315,314,506,391,897
02,02014,020143001,Comuna 14,CIUDAD DE BUENOS AIRES,327,321,445,366,811
02,02014,020143105,Comuna 14,CIUDAD DE BUENOS AIRES,251,239,332,275,607
02,02014,020141705,Comuna 14,CIUDAD DE BUENOS AIRES,328,324,396,333,729
02,02014,020141201,Comuna 14,CIUDAD DE BUENOS AIRES,230,218,247,187,434
02,02014,020141111,Comuna 14,CIUDAD DE BUENOS AIRES,316,306,293,233,526
02,02014,020141603,Comuna 14,CIUDAD DE BUENOS AIRES,524,517,586,515,1101
02,02014,020140705,Comuna 14,CIUDAD DE BUENOS AIRES,260,255,386,359,745
02,02014,020140808,Comuna 14,CIUDAD DE BUENOS AIRES,306,296,377,319,696
02,02014,020143110,Comuna 14,CIUDAD DE BUENOS AIRES,195,189,308,237,545
02,02014,020140803,Comuna 14,CIUDAD DE BUENOS AIRES,169,169,190,166,356
02,02014,020141707,Comuna 14,CIUDAD DE BUENOS AIRES,316,311,435,327,762
02,02014,020140802,Comuna 14,CIUDAD DE BUENOS AIRES,290,282,305,287,592
02,02014,020141702,Comuna 14,CIUDAD DE BUENOS AIRES,390,369,510,390,900
02,02014,020140704,Comuna 14,CIUDAD DE BUENOS AIRES,402,399,534,487,1021
02,02014,020143003,Comuna 14,CIUDAD DE BUENOS AIRES,407,383,462,378,840
02,02014,020143002,Comuna 14,CIUDAD DE BUENOS AIRES,429,413,553,423,976
02,02014,020141205,Comuna 14,CIUDAD DE BUENOS AIRES,380,366,476,353,829
02,02014,020141704,Comuna 14,CIUDAD DE BUENOS AIRES,208,197,231,189,420
02,02014,020140809,Comuna 14,CIUDAD DE BUENOS AIRES,476,459,607,570,1177
02,02014,020141602,Comuna 14,CIUDAD DE BUENOS AIRES,331,329,437,353,790
02,02014,020143004,Comuna 14,CIUDAD DE BUENOS AIRES,305,300,302,272,574
02,02014,020141206,Comuna 14,CIUDAD DE BUENOS AIRES,264,260,323,228,551
02,02014,020141202,Comuna 14,CIUDAD DE BUENOS AIRES,382,374,460,381,841
02,02014,020140801,Comuna 14,CIUDAD DE BUENOS AIRES,366,297,416,427,843
02,02014,020143005,Comuna 14,CIUDAD DE BUENOS AIRES,378,375,542,410,952
02,02014,020142901,Comuna 14,CIUDAD DE BUENOS AIRES,277,269,306,239,545
02,02014,020141703,Comuna 14,CIUDAD DE BUENOS AIRES,338,329,472,348,820
02,02014,020141204,Comuna 14,CIUDAD DE BUENOS AIRES,344,343,477,290,767
02,02014,020141211,Comuna 14,CIUDAD DE BUENOS AIRES,274,269,321,285,606
02,02014,020141708,Comuna 14,CIUDAD DE BUENOS AIRES,623,611,763,572,1335
02,02014,020142902,Comuna 14,CIUDAD DE BUENOS AIRES,280,280,543,381,924
02,02014,020141701,Comuna 14,CIUDAD DE BUENOS AIRES,352,338,436,373,809
02,02014,020141203,Comuna 14,CIUDAD DE BUENOS AIRES,329,321,321,312,633
02,02014,020140703,Comuna 14,CIUDAD DE BUENOS AIRES,289,283,418,397,815
02,02014,020141801,Comuna 14,CIUDAD DE BUENOS AIRES,355,354,414,327,741
02,02014,020141302,Comuna 14,CIUDAD DE BUENOS AIRES,313,309,345,331,676
02,02014,020140706,Comuna 14,CIUDAD DE BUENOS AIRES,301,289,411,316,727
02,02014,020141207,Comuna 14,CIUDAD DE BUENOS AIRES,145,144,175,149,324
02,02014,020142907,Comuna 14,CIUDAD DE BUENOS AIRES,379,367,467,371,838
02,02014,020141503,Comuna 14,CIUDAD DE BUENOS AIRES,350,343,399,280,679
02,02014,020142903,Comuna 14,CIUDAD DE BUENOS AIRES,270,262,278,239,517
02,02014,020141210,Comuna 14,CIUDAD DE BUENOS AIRES,352,351,402,341,743
02,02014,020140707,Comuna 14,CIUDAD DE BUENOS AIRES,240,226,352,309,661
02,02014,020140702,Comuna 14,CIUDAD DE BUENOS AIRES,411,407,476,442,918
02,02014,020143008,Comuna 14,CIUDAD DE BUENOS AIRES,675,667,915,717,1632
02,02014,020142906,Comuna 14,CIUDAD DE BUENOS AIRES,448,441,469,357,826
02,02014,020143006,Comuna 14,CIUDAD DE BUENOS AIRES,233,229,275,201,476
02,02014,020141804,Comuna 14,CIUDAD DE BUENOS AIRES,391,370,513,387,900
02,02014,020142905,Comuna 14,CIUDAD DE BUENOS AIRES,280,276,289,185,474
02,02014,020141504,Comuna 14,CIUDAD DE BUENOS AIRES,379,373,483,331,814
02,02014,020141208,Comuna 14,CIUDAD DE BUENOS AIRES,188,186,187,145,332
02,02014,020141805,Comuna 14,CIUDAD DE BUENOS AIRES,466,463,559,437,996
02,02014,020143009,Comuna 14,CIUDAD DE BUENOS AIRES,579,571,740,540,1280
02,02014,020141502,Comuna 14,CIUDAD DE BUENOS AIRES,351,343,425,324,749
02,02014,020142908,Comuna 14,CIUDAD DE BUENOS AIRES,267,266,348,261,609
02,02014,020142904,Comuna 14,CIUDAD DE BUENOS AIRES,358,352,427,323,750
02,02014,020143111,Comuna 14,CIUDAD DE BUENOS AIRES,214,214,231,160,391
02,02014,020141209,Comuna 14,CIUDAD DE BUENOS AIRES,327,318,358,313,671
02,02014,020141303,Comuna 14,CIUDAD DE BUENOS AIRES,406,386,392,357,749
02,02014,020141508,Comuna 14,CIUDAD DE BUENOS AIRES,886,838,1073,831,1904
02,02014,020142909,Comuna 14,CIUDAD DE BUENOS AIRES,336,335,407,317,724
02,02014,020140709,Comuna 14,CIUDAD DE BUENOS AIRES,275,254,336,280,616
02,02014,020141803,Comuna 14,CIUDAD DE BUENOS AIRES,476,454,613,468,1081
02,02014,020143007,Comuna 14,CIUDAD DE BUENOS AIRES,204,203,217,166,383
02,02014,020143112,Comuna 14,CIUDAD DE BUENOS AIRES,260,258,358,217,575
02,02014,020142911,Comuna 14,CIUDAD DE BUENOS AIRES,281,280,370,270,640
02,02014,020141505,Comuna 14,CIUDAD DE BUENOS AIRES,443,441,521,394,915
02,02014,020140701,Comuna 14,CIUDAD DE BUENOS AIRES,375,352,457,422,879
02,02014,020141501,Comuna 14,CIUDAD DE BUENOS AIRES,319,284,402,302,704
02,02014,020141401,Comuna 14,CIUDAD DE BUENOS AIRES,460,454,488,390,878
02,02014,020141802,Comuna 14,CIUDAD DE BUENOS AIRES,314,300,436,305,741
02,02014,020141507,Comuna 14,CIUDAD DE BUENOS AIRES,348,344,365,272,637
02,02014,020141304,Comuna 14,CIUDAD DE BUENOS AIRES,242,239,320,275,595
02,02014,020142910,Comuna 14,CIUDAD DE BUENOS AIRES,366,359,456,331,787
02,02014,020141806,Comuna 14,CIUDAD DE BUENOS AIRES,354,341,468,360,828
02,02014,020141905,Comuna 14,CIUDAD DE BUENOS AIRES,652,631,821,605,1426
02,02014,020141506,Comuna 14,CIUDAD DE BUENOS AIRES,440,410,519,424,943
02,02014,020141402,Comuna 14,CIUDAD DE BUENOS AIRES,290,287,325,271,596
02,02014,020140708,Comuna 14,CIUDAD DE BUENOS AIRES,239,228,332,254,586
02,02014,020141901,Comuna 14,CIUDAD DE BUENOS AIRES,276,272,307,235,542
02,02014,020141305,Comuna 14,CIUDAD DE BUENOS AIRES,301,299,391,332,723
02,02014,020141807,Comuna 14,CIUDAD DE BUENOS AIRES,282,278,330,276,606
02,02014,020142803,Comuna 14,CIUDAD DE BUENOS AIRES,288,284,393,283,676
02,02014,020142003,Comuna 14,CIUDAD DE BUENOS AIRES,470,453,559,398,957
02,02014,020141904,Comuna 14,CIUDAD DE BUENOS AIRES,628,615,698,526,1224
02,02014,020141902,Comuna 14,CIUDAD DE BUENOS AIRES,529,516,550,419,969
02,02014,020141808,Comuna 14,CIUDAD DE BUENOS AIRES,489,473,556,356,912
02,02014,020141403,Comuna 14,CIUDAD DE BUENOS AIRES,358,355,398,328,726
02,02014,020142802,Comuna 14,CIUDAD DE BUENOS AIRES,266,263,347,270,617
02,02014,020142804,Comuna 14,CIUDAD DE BUENOS AIRES,314,306,406,287,693
02,02014,020141404,Comuna 14,CIUDAD DE BUENOS AIRES,194,194,222,195,417
02,02014,020141301,Comuna 14,CIUDAD DE BUENOS AIRES,267,249,378,319,697
02,02014,020142004,Comuna 14,CIUDAD DE BUENOS AIRES,374,345,464,336,800
02,02014,020142801,Comuna 14,CIUDAD DE BUENOS AIRES,299,280,361,269,630
02,02014,020141405,Comuna 14,CIUDAD DE BUENOS AIRES,197,159,222,194,416
02,02014,020142002,Comuna 14,CIUDAD DE BUENOS AIRES,661,653,756,550,1306
02,02014,020141903,Comuna 14,CIUDAD DE BUENOS AIRES,546,528,597,463,1060
02,02014,020142810,Comuna 14,CIUDAD DE BUENOS AIRES,381,377,464,379,843
02,02014,020142805,Comuna 14,CIUDAD DE BUENOS AIRES,228,228,296,259,555
02,02014,020141408,Comuna 14,CIUDAD DE BUENOS AIRES,462,454,534,408,942
02,02014,020142811,Comuna 14,CIUDAD DE BUENOS AIRES,392,389,534,446,980
02,02014,020141306,Comuna 14,CIUDAD DE BUENOS AIRES,278,273,303,281,584
02,02014,020142806,Comuna 14,CIUDAD DE BUENOS AIRES,413,405,546,390,936
02,02014,020142601,Comuna 14,CIUDAD DE BUENOS AIRES,526,518,614,432,1046
02,02014,020141406,Comuna 14,CIUDAD DE BUENOS AIRES,202,200,249,218,467
02,02014,020142809,Comuna 14,CIUDAD DE BUENOS AIRES,263,258,326,253,579
02,02014,020141308,Comuna 14,CIUDAD DE BUENOS AIRES,275,264,354,308,662
02,02014,020142001,Comuna 14,CIUDAD DE BUENOS AIRES,604,566,688,577,1265
02,02014,020142005,Comuna 14,CIUDAD DE BUENOS AIRES,375,372,426,339,765
02,02014,020141409,Comuna 14,CIUDAD DE BUENOS AIRES,483,476,537,445,982
02,02014,020141407,Comuna 14,CIUDAD DE BUENOS AIRES,210,169,269,254,523
02,02014,020142807,Comuna 14,CIUDAD DE BUENOS AIRES,374,362,428,312,740
02,02014,020142602,Comuna 14,CIUDAD DE BUENOS AIRES,357,351,406,322,728
02,02014,020142812,Comuna 14,CIUDAD DE BUENOS AIRES,270,267,345,233,578
02,02014,020142501,Comuna 14,CIUDAD DE BUENOS AIRES,383,370,472,377,849
02,02014,020142808,Comuna 14,CIUDAD DE BUENOS AIRES,302,298,325,200,525
02,02014,020142006,Comuna 14,CIUDAD DE BUENOS AIRES,275,274,286,221,507
02,02014,020141410,Comuna 14,CIUDAD DE BUENOS AIRES,349,340,386,298,684
02,02014,020142106,Comuna 14,CIUDAD DE BUENOS AIRES,246,238,293,266,559
02,02014,020142606,Comuna 14,CIUDAD DE BUENOS AIRES,387,379,533,406,939
02,02014,020142603,Comuna 14,CIUDAD DE BUENOS AIRES,184,183,228,183,411
02,02014,020141307,Comuna 14,CIUDAD DE BUENOS AIRES,147,138,215,170,385
02,02014,020141309,Comuna 14,CIUDAD DE BUENOS AIRES,337,304,437,332,769
02,02014,020142007,Comuna 14,CIUDAD DE BUENOS AIRES,168,163,187,133,320
02,02014,020142604,Comuna 14,CIUDAD DE BUENOS AIRES,850,784,1000,732,1732
02,02014,020142502,Comuna 14,CIUDAD DE BUENOS AIRES,216,215,251,192,443
02,02014,020142607,Comuna 14,CIUDAD DE BUENOS AIRES,532,525,662,508,1170
02,02014,020142107,Comuna 14,CIUDAD DE BUENOS AIRES,309,302,380,316,696
02,02014,020141411,Comuna 14,CIUDAD DE BUENOS AIRES,411,402,481,352,833
02,02014,020142105,Comuna 14,CIUDAD DE BUENOS AIRES,158,157,236,173,409
02,02014,020141311,Comuna 14,CIUDAD DE BUENOS AIRES,260,236,359,262,621
02,02014,020142504,Comuna 14,CIUDAD DE BUENOS AIRES,285,282,295,229,524
02,02014,020142703,Comuna 14,CIUDAD DE BUENOS AIRES,284,283,339,248,587
02,02014,020142108,Comuna 14,CIUDAD DE BUENOS AIRES,323,321,401,286,687
02,02014,020142503,Comuna 14,CIUDAD DE BUENOS AIRES,353,349,445,336,781
02,02014,020142605,Comuna 14,CIUDAD DE BUENOS AIRES,458,434,509,435,944
02,02014,020142505,Comuna 14,CIUDAD DE BUENOS AIRES,239,235,266,200,466
02,02014,020142704,Comuna 14,CIUDAD DE BUENOS AIRES,396,394,470,321,791
02,02014,020141310,Comuna 14,CIUDAD DE BUENOS AIRES,294,271,409,326,735
02,02014,020142701,Comuna 14,CIUDAD DE BUENOS AIRES,616,602,693,537,1230
02,02014,020142506,Comuna 14,CIUDAD DE BUENOS AIRES,277,266,248,212,460
02,02014,020142403,Comuna 14,CIUDAD DE BUENOS AIRES,269,256,297,217,514
02,02014,020142103,Comuna 14,CIUDAD DE BUENOS AIRES,145,142,196,136,332
02,02014,020141312,Comuna 14,CIUDAD DE BUENOS AIRES,247,238,311,248,559
02,02014,020142507,Comuna 14,CIUDAD DE BUENOS AIRES,373,371,389,332,721
02,02014,020142104,Comuna 14,CIUDAD DE BUENOS AIRES,254,251,283,246,529
02,02014,020142702,Comuna 14,CIUDAD DE BUENOS AIRES,570,558,654,471,1125
02,02014,020142401,Comuna 14,CIUDAD DE BUENOS AIRES,301,293,377,296,673
02,02014,020142101,Comuna 14,CIUDAD DE BUENOS AIRES,399,391,538,412,950
02,02014,020142707,Comuna 14,CIUDAD DE BUENOS AIRES,217,217,233,200,433
02,02014,020142404,Comuna 14,CIUDAD DE BUENOS AIRES,210,199,225,169,394
02,02014,020142202,Comuna 14,CIUDAD DE BUENOS AIRES,407,393,454,421,875
02,02014,020142301,Comuna 14,CIUDAD DE BUENOS AIRES,281,266,316,283,599
02,02014,020142706,Comuna 14,CIUDAD DE BUENOS AIRES,212,212,244,175,419
02,02014,020142405,Comuna 14,CIUDAD DE BUENOS AIRES,436,422,451,356,807
02,02014,020142407,Comuna 14,CIUDAD DE BUENOS AIRES,331,322,404,286,690
02,02014,020142110,Comuna 14,CIUDAD DE BUENOS AIRES,252,245,297,248,545
02,02014,020142302,Comuna 14,CIUDAD DE BUENOS AIRES,218,216,270,198,468
02,02014,020142205,Comuna 14,CIUDAD DE BUENOS AIRES,423,402,477,449,926
02,02014,020142408,Comuna 14,CIUDAD DE BUENOS AIRES,267,264,295,232,527
02,02014,020142406,Comuna 14,CIUDAD DE BUENOS AIRES,343,319,410,304,714
02,02014,020142111,Comuna 14,CIUDAD DE BUENOS AIRES,284,262,381,324,705
02,02014,020142206,Comuna 14,CIUDAD DE BUENOS AIRES,415,349,576,482,1058
02,02014,020142409,Comuna 14,CIUDAD DE BUENOS AIRES,348,346,391,329,720
02,02014,020142201,Comuna 14,CIUDAD DE BUENOS AIRES,368,365,486,371,857
02,02014,020142303,Comuna 14,CIUDAD DE BUENOS AIRES,243,234,293,254,547
02,02014,020142304,Comuna 14,CIUDAD DE BUENOS AIRES,368,337,401,325,726
02,02014,020142207,Comuna 14,CIUDAD DE BUENOS AIRES,322,298,417,343,760
02,02014,020142305,Comuna 14,CIUDAD DE BUENOS AIRES,516,504,554,469,1023
02,02014,020142306,Comuna 14,CIUDAD DE BUENOS AIRES,212,188,233,210,443
02,02014,020142307,Comuna 14,CIUDAD DE BUENOS AIRES,341,292,365,329,694
02,02014,020142208,Comuna 14,CIUDAD DE BUENOS AIRES,340,325,428,339,767
02,02014,020142210,Comuna 14,CIUDAD DE BUENOS AIRES,336,312,381,291,672
02,02014,020142308,Comuna 14,CIUDAD DE BUENOS AIRES,482,436,581,514,1095
02,02014,020142309,Comuna 14,CIUDAD DE BUENOS AIRES,492,423,506,448,954
02,02014,020142209,Comuna 14,CIUDAD DE BUENOS AIRES,500,495,762,613,1375
02,02014,020142310,Comuna 14,CIUDAD DE BUENOS AIRES,378,372,400,350,750
02,02014,020142311,Comuna 14,CIUDAD DE BUENOS AIRES,462,451,504,386,890
02,02011,020110201,Comuna 11,CIUDAD DE BUENOS AIRES,286,273,433,403,836
02,02011,020110203,Comuna 11,CIUDAD DE BUENOS AIRES,286,284,391,348,739
02,02011,020110110,Comuna 11,CIUDAD DE BUENOS AIRES,340,320,437,385,822
02,02011,020111004,Comuna 11,CIUDAD DE BUENOS AIRES,364,327,533,423,956
02,02011,020110903,Comuna 11,CIUDAD DE BUENOS AIRES,379,371,537,471,1008
02,02011,020111009,Comuna 11,CIUDAD DE BUENOS AIRES,319,313,381,376,757
02,02011,020110405,Comuna 11,CIUDAD DE BUENOS AIRES,308,302,417,360,777
02,02011,020110912,Comuna 11,CIUDAD DE BUENOS AIRES,297,294,372,286,658
02,02011,020110403,Comuna 11,CIUDAD DE BUENOS AIRES,221,218,431,308,739
02,02011,020110910,Comuna 11,CIUDAD DE BUENOS AIRES,352,326,368,303,671
02,02011,020111210,Comuna 11,CIUDAD DE BUENOS AIRES,261,256,331,273,604
02,02011,020110506,Comuna 11,CIUDAD DE BUENOS AIRES,319,312,452,424,876
02,02011,020110603,Comuna 11,CIUDAD DE BUENOS AIRES,347,344,453,366,819
02,02011,020110504,Comuna 11,CIUDAD DE BUENOS AIRES,252,249,356,268,624
02,02011,020110602,Comuna 11,CIUDAD DE BUENOS AIRES,351,350,506,461,967
02,02011,020110709,Comuna 11,CIUDAD DE BUENOS AIRES,296,295,426,382,808
02,02011,020111209,Comuna 11,CIUDAD DE BUENOS AIRES,240,228,337,259,596
02,02011,020112009,Comuna 11,CIUDAD DE BUENOS AIRES,260,256,444,376,820
02,02011,020111403,Comuna 11,CIUDAD DE BUENOS AIRES,365,360,518,490,1008
02,02011,020110101,Comuna 11,CIUDAD DE BUENOS AIRES,324,320,560,472,1032
02,02011,020110104,Comuna 11,CIUDAD DE BUENOS AIRES,316,312,447,399,846
02,02011,020110103,Comuna 11,CIUDAD DE BUENOS AIRES,247,239,395,325,720
02,02011,020110102,Comuna 11,CIUDAD DE BUENOS AIRES,339,314,513,420,933
02,02011,020110105,Comuna 11,CIUDAD DE BUENOS AIRES,221,216,315,272,587
02,02011,020110106,Comuna 11,CIUDAD DE BUENOS AIRES,278,270,418,384,802
02,02011,020110108,Comuna 11,CIUDAD DE BUENOS AIRES,295,268,339,336,675
02,02011,020110107,Comuna 11,CIUDAD DE BUENOS AIRES,252,248,397,323,720
02,02011,020110202,Comuna 11,CIUDAD DE BUENOS AIRES,361,321,523,450,973
02,02011,020110109,Comuna 11,CIUDAD DE BUENOS AIRES,304,301,425,356,781
02,02011,020110204,Comuna 11,CIUDAD DE BUENOS AIRES,223,221,293,262,555
02,02011,020110112,Comuna 11,CIUDAD DE BUENOS AIRES,266,266,375,301,676
02,02011,020110205,Comuna 11,CIUDAD DE BUENOS AIRES,389,377,553,513,1066
02,02011,020110111,Comuna 11,CIUDAD DE BUENOS AIRES,402,396,505,390,895
02,02011,020110206,Comuna 11,CIUDAD DE BUENOS AIRES,358,330,515,466,981
02,02011,020110303,Comuna 11,CIUDAD DE BUENOS AIRES,240,233,380,307,687
02,02011,020110306,Comuna 11,CIUDAD DE BUENOS AIRES,287,286,397,358,755
02,02011,020110308,Comuna 11,CIUDAD DE BUENOS AIRES,299,295,437,320,757
02,02011,020110302,Comuna 11,CIUDAD DE BUENOS AIRES,292,292,433,367,800
02,02011,020110307,Comuna 11,CIUDAD DE BUENOS AIRES,283,263,413,376,789
02,02011,020110211,Comuna 11,CIUDAD DE BUENOS AIRES,328,322,437,400,837
02,02011,020110207,Comuna 11,CIUDAD DE BUENOS AIRES,312,303,437,404,841
02,02011,020110304,Comuna 11,CIUDAD DE BUENOS AIRES,210,208,339,280,619
02,02011,020110301,Comuna 11,CIUDAD DE BUENOS AIRES,264,262,365,328,693
02,02011,020110309,Comuna 11,CIUDAD DE BUENOS AIRES,298,294,394,340,734
02,02011,020110907,Comuna 11,CIUDAD DE BUENOS AIRES,312,302,470,318,788
02,02011,020110908,Comuna 11,CIUDAD DE BUENOS AIRES,331,307,496,370,866
02,02011,020111001,Comuna 11,CIUDAD DE BUENOS AIRES,315,293,400,324,724
02,02011,020111002,Comuna 11,CIUDAD DE BUENOS AIRES,384,368,522,434,956
02,02011,020110208,Comuna 11,CIUDAD DE BUENOS AIRES,302,292,466,417,883
02,02011,020110404,Comuna 11,CIUDAD DE BUENOS AIRES,296,289,541,407,948
02,02011,020110906,Comuna 11,CIUDAD DE BUENOS AIRES,248,244,315,264,579
02,02011,020111006,Comuna 11,CIUDAD DE BUENOS AIRES,458,453,537,445,982
02,02011,020111008,Comuna 11,CIUDAD DE BUENOS AIRES,318,313,426,322,748
02,02011,020110305,Comuna 11,CIUDAD DE BUENOS AIRES,233,227,318,247,565
02,02011,020111003,Comuna 11,CIUDAD DE BUENOS AIRES,317,314,401,314,715
02,02011,020111005,Comuna 11,CIUDAD DE BUENOS AIRES,386,383,519,423,942
02,02011,020111007,Comuna 11,CIUDAD DE BUENOS AIRES,401,331,528,454,982
02,02011,020110905,Comuna 11,CIUDAD DE BUENOS AIRES,308,291,403,334,737
02,02011,020110310,Comuna 11,CIUDAD DE BUENOS AIRES,317,296,417,356,773
02,02011,020110210,Comuna 11,CIUDAD DE BUENOS AIRES,348,342,552,470,1022
02,02011,020111010,Comuna 11,CIUDAD DE BUENOS AIRES,281,247,369,344,713
02,02011,020110911,Comuna 11,CIUDAD DE BUENOS AIRES,258,245,330,256,586
02,02011,020110904,Comuna 11,CIUDAD DE BUENOS AIRES,255,250,347,312,659
02,02011,020110909,Comuna 11,CIUDAD DE BUENOS AIRES,246,244,301,228,529
02,02011,020110311,Comuna 11,CIUDAD DE BUENOS AIRES,254,252,415,325,740
02,02011,020110209,Comuna 11,CIUDAD DE BUENOS AIRES,238,233,353,312,665
02,02011,020111104,Comuna 11,CIUDAD DE BUENOS AIRES,102,93,153,141,294
02,02011,020111101,Comuna 11,CIUDAD DE BUENOS AIRES,293,260,451,376,827
02,02011,020111103,Comuna 11,CIUDAD DE BUENOS AIRES,325,307,482,471,953
02,02011,020111301,Comuna 11,CIUDAD DE BUENOS AIRES,346,343,418,291,709
02,02011,020111203,Comuna 11,CIUDAD DE BUENOS AIRES,360,343,525,484,1009
02,02011,020111201,Comuna 11,CIUDAD DE BUENOS AIRES,233,229,319,261,580
02,02011,020111202,Comuna 11,CIUDAD DE BUENOS AIRES,236,217,328,259,587
02,02011,020110902,Comuna 11,CIUDAD DE BUENOS AIRES,312,293,429,378,807
02,02011,020111303,Comuna 11,CIUDAD DE BUENOS AIRES,321,311,420,297,717
02,02011,020110901,Comuna 11,CIUDAD DE BUENOS AIRES,315,307,472,401,873
02,02011,020111302,Comuna 11,CIUDAD DE BUENOS AIRES,387,381,459,360,819
02,02011,020110804,Comuna 11,CIUDAD DE BUENOS AIRES,329,327,439,285,724
02,02011,020110312,Comuna 11,CIUDAD DE BUENOS AIRES,282,280,404,371,775
02,02011,020111102,Comuna 11,CIUDAD DE BUENOS AIRES,309,302,463,425,888
02,02011,020110803,Comuna 11,CIUDAD DE BUENOS AIRES,210,209,281,238,519
02,02011,020110406,Comuna 11,CIUDAD DE BUENOS AIRES,241,235,350,294,644
02,02011,020112101,Comuna 11,CIUDAD DE BUENOS AIRES,323,316,452,342,794
02,02011,020111305,Comuna 11,CIUDAD DE BUENOS AIRES,393,385,514,378,892
02,02011,020110409,Comuna 11,CIUDAD DE BUENOS AIRES,309,307,449,379,828
02,02011,020111105,Comuna 11,CIUDAD DE BUENOS AIRES,335,323,502,450,952
02,02011,020110802,Comuna 11,CIUDAD DE BUENOS AIRES,338,329,462,434,896
02,02011,020111109,Comuna 11,CIUDAD DE BUENOS AIRES,296,238,509,397,906
02,02011,020111204,Comuna 11,CIUDAD DE BUENOS AIRES,272,269,340,282,622
02,02011,020110402,Comuna 11,CIUDAD DE BUENOS AIRES,297,256,422,364,786
02,02011,020110401,Comuna 11,CIUDAD DE BUENOS AIRES,284,276,435,394,829
02,02011,020110502,Comuna 11,CIUDAD DE BUENOS AIRES,316,304,441,426,867
02,02011,020112103,Comuna 11,CIUDAD DE BUENOS AIRES,423,405,565,432,997
02,02011,020111304,Comuna 11,CIUDAD DE BUENOS AIRES,345,344,428,335,763
02,02011,020110413,Comuna 11,CIUDAD DE BUENOS AIRES,327,306,429,366,795
02,02011,020112104,Comuna 11,CIUDAD DE BUENOS AIRES,318,311,423,333,756
02,02011,020111306,Comuna 11,CIUDAD DE BUENOS AIRES,373,352,571,384,955
02,02011,020112002,Comuna 11,CIUDAD DE BUENOS AIRES,317,312,464,392,856
02,02011,020111206,Comuna 11,CIUDAD DE BUENOS AIRES,320,313,457,424,881
02,02011,020110412,Comuna 11,CIUDAD DE BUENOS AIRES,352,342,469,414,883
02,02011,020110501,Comuna 11,CIUDAD DE BUENOS AIRES,242,239,357,347,704
02,02011,020110801,Comuna 11,CIUDAD DE BUENOS AIRES,347,336,495,391,886
02,02011,020110805,Comuna 11,CIUDAD DE BUENOS AIRES,265,261,362,296,658
02,02011,020112102,Comuna 11,CIUDAD DE BUENOS AIRES,271,258,401,364,765
02,02011,020111106,Comuna 11,CIUDAD DE BUENOS AIRES,396,356,545,472,1017
02,02011,020112105,Comuna 11,CIUDAD DE BUENOS AIRES,391,383,512,410,922
02,02011,020111108,Comuna 11,CIUDAD DE BUENOS AIRES,315,301,482,385,867
02,02011,020110410,Comuna 11,CIUDAD DE BUENOS AIRES,281,275,382,309,691
02,02011,020110408,Comuna 11,CIUDAD DE BUENOS AIRES,282,278,361,339,700
02,02011,020110407,Comuna 11,CIUDAD DE BUENOS AIRES,279,275,368,359,727
02,02011,020111308,Comuna 11,CIUDAD DE BUENOS AIRES,281,276,385,327,712
02,02011,020112106,Comuna 11,CIUDAD DE BUENOS AIRES,385,351,519,450,969
02,02011,020110809,Comuna 11,CIUDAD DE BUENOS AIRES,365,359,474,349,823
02,02011,020112107,Comuna 11,CIUDAD DE BUENOS AIRES,270,260,388,323,711
02,02011,020111205,Comuna 11,CIUDAD DE BUENOS AIRES,245,230,348,307,655
02,02011,020111307,Comuna 11,CIUDAD DE BUENOS AIRES,299,296,469,344,813
02,02011,020112001,Comuna 11,CIUDAD DE BUENOS AIRES,356,344,500,395,895
02,02011,020110503,Comuna 11,CIUDAD DE BUENOS AIRES,353,314,505,472,977
02,02011,020110808,Comuna 11,CIUDAD DE BUENOS AIRES,355,349,518,455,973
02,02011,020110707,Comuna 11,CIUDAD DE BUENOS AIRES,273,267,426,370,796
02,02011,020111207,Comuna 11,CIUDAD DE BUENOS AIRES,259,250,363,301,664
02,02011,020110806,Comuna 11,CIUDAD DE BUENOS AIRES,379,363,522,470,992
02,02011,020111107,Comuna 11,CIUDAD DE BUENOS AIRES,305,296,477,401,878
02,02011,020110411,Comuna 11,CIUDAD DE BUENOS AIRES,313,309,517,414,931
02,02011,020112108,Comuna 11,CIUDAD DE BUENOS AIRES,256,249,368,344,712
02,02011,020112003,Comuna 11,CIUDAD DE BUENOS AIRES,389,359,587,549,1136
02,02011,020111208,Comuna 11,CIUDAD DE BUENOS AIRES,272,264,404,352,756
02,02011,020112111,Comuna 11,CIUDAD DE BUENOS AIRES,374,365,525,416,941
02,02011,020110807,Comuna 11,CIUDAD DE BUENOS AIRES,345,330,514,478,992
02,02011,020111901,Comuna 11,CIUDAD DE BUENOS AIRES,221,210,302,266,568
02,02011,020110601,Comuna 11,CIUDAD DE BUENOS AIRES,317,285,406,292,698
02,02011,020111402,Comuna 11,CIUDAD DE BUENOS AIRES,332,329,435,384,819
02,02011,020110505,Comuna 11,CIUDAD DE BUENOS AIRES,339,333,461,393,854
02,02011,020111309,Comuna 11,CIUDAD DE BUENOS AIRES,371,361,530,464,994
02,02011,020112004,Comuna 11,CIUDAD DE BUENOS AIRES,303,281,487,406,893
02,02011,020110708,Comuna 11,CIUDAD DE BUENOS AIRES,249,240,349,342,691
02,02011,020111902,Comuna 11,CIUDAD DE BUENOS AIRES,322,316,475,396,871
02,02011,020110706,Comuna 11,CIUDAD DE BUENOS AIRES,291,287,422,369,791
02,02011,020112109,Comuna 11,CIUDAD DE BUENOS AIRES,218,218,291,246,537
02,02011,020111310,Comuna 11,CIUDAD DE BUENOS AIRES,250,248,356,300,656
02,02011,020112005,Comuna 11,CIUDAD DE BUENOS AIRES,328,314,447,416,863
02,02011,020112110,Comuna 11,CIUDAD DE BUENOS AIRES,292,278,429,400,829
02,02011,020111903,Comuna 11,CIUDAD DE BUENOS AIRES,279,278,402,308,710
02,02011,020111401,Comuna 11,CIUDAD DE BUENOS AIRES,364,358,521,451,972
02,02011,020110705,Comuna 11,CIUDAD DE BUENOS AIRES,349,345,532,433,965
02,02011,020110507,Comuna 11,CIUDAD DE BUENOS AIRES,280,273,394,360,754
02,02011,020111507,Comuna 11,CIUDAD DE BUENOS AIRES,281,280,385,287,672
02,02011,020111311,Comuna 11,CIUDAD DE BUENOS AIRES,336,327,452,394,846
02,02011,020112010,Comuna 11,CIUDAD DE BUENOS AIRES,292,285,406,364,770
02,02011,020111405,Comuna 11,CIUDAD DE BUENOS AIRES,328,313,550,420,970
02,02011,020111904,Comuna 11,CIUDAD DE BUENOS AIRES,339,327,581,441,1022
02,02011,020112008,Comuna 11,CIUDAD DE BUENOS AIRES,191,189,262,240,502
02,02011,020110508,Comuna 11,CIUDAD DE BUENOS AIRES,307,298,449,413,862
02,02011,020110604,Comuna 11,CIUDAD DE BUENOS AIRES,333,326,459,457,916
02,02011,020112201,Comuna 11,CIUDAD DE BUENOS AIRES,345,299,502,402,904
02,02011,020111506,Comuna 11,CIUDAD DE BUENOS AIRES,313,302,443,444,887
02,02011,020110704,Comuna 11,CIUDAD DE BUENOS AIRES,325,316,503,433,936
02,02011,020110710,Comuna 11,CIUDAD DE BUENOS AIRES,292,282,445,372,817
02,02011,020111508,Comuna 11,CIUDAD DE BUENOS AIRES,372,348,440,403,843
02,02011,020111510,Comuna 11,CIUDAD DE BUENOS AIRES,331,324,508,409,917
02,02011,020112011,Comuna 11,CIUDAD DE BUENOS AIRES,252,246,395,303,698
02,02011,020110509,Comuna 11,CIUDAD DE BUENOS AIRES,292,279,461,381,842
02,02011,020111509,Comuna 11,CIUDAD DE BUENOS AIRES,337,330,435,381,816
02,02011,020112007,Comuna 11,CIUDAD DE BUENOS AIRES,232,225,358,295,653
02,02011,020112209,Comuna 11,CIUDAD DE BUENOS AIRES,269,259,405,358,763
02,02011,020110703,Comuna 11,CIUDAD DE BUENOS AIRES,297,293,413,373,786
02,02011,020111905,Comuna 11,CIUDAD DE BUENOS AIRES,306,286,438,353,791
02,02011,020111505,Comuna 11,CIUDAD DE BUENOS AIRES,329,319,415,379,794
02,02011,020111406,Comuna 11,CIUDAD DE BUENOS AIRES,409,396,569,476,1045
02,02011,020111604,Comuna 11,CIUDAD DE BUENOS AIRES,252,246,364,303,667
02,02011,020112202,Comuna 11,CIUDAD DE BUENOS AIRES,358,348,489,488,977
02,02011,020112006,Comuna 11,CIUDAD DE BUENOS AIRES,267,235,375,336,711
02,02011,020111504,Comuna 11,CIUDAD DE BUENOS AIRES,356,346,504,468,972
02,02011,020110702,Comuna 11,CIUDAD DE BUENOS AIRES,328,318,460,424,884
02,02011,020110605,Comuna 11,CIUDAD DE BUENOS AIRES,304,297,401,331,732
02,02011,020111404,Comuna 11,CIUDAD DE BUENOS AIRES,279,275,365,334,699
02,02011,020110711,Comuna 11,CIUDAD DE BUENOS AIRES,323,318,440,367,807
02,02011,020111906,Comuna 11,CIUDAD DE BUENOS AIRES,341,325,478,443,921
02,02011,020110510,Comuna 11,CIUDAD DE BUENOS AIRES,334,329,456,355,811
02,02011,020111511,Comuna 11,CIUDAD DE BUENOS AIRES,434,384,538,519,1057
02,02011,020111605,Comuna 11,CIUDAD DE BUENOS AIRES,288,278,414,355,769
02,02011,020111503,Comuna 11,CIUDAD DE BUENOS AIRES,368,352,556,469,1025
02,02011,020110701,Comuna 11,CIUDAD DE BUENOS AIRES,171,154,274,1944,2218
02,02011,020111603,Comuna 11,CIUDAD DE BUENOS AIRES,267,257,359,319,678
02,02011,020112203,Comuna 11,CIUDAD DE BUENOS AIRES,360,348,511,485,996
02,02011,020110606,Comuna 11,CIUDAD DE BUENOS AIRES,306,298,477,378,855
02,02011,020111607,Comuna 11,CIUDAD DE BUENOS AIRES,350,344,467,371,838
02,02011,020111407,Comuna 11,CIUDAD DE BUENOS AIRES,696,680,914,735,1649
02,02011,020112208,Comuna 11,CIUDAD DE BUENOS AIRES,269,264,451,414,865
02,02011,020112210,Comuna 11,CIUDAD DE BUENOS AIRES,307,298,408,369,777
02,02011,020111602,Comuna 11,CIUDAD DE BUENOS AIRES,359,352,489,400,889
02,02011,020112204,Comuna 11,CIUDAD DE BUENOS AIRES,265,259,370,324,694
02,02011,020110607,Comuna 11,CIUDAD DE BUENOS AIRES,308,286,484,411,895
02,02011,020111601,Comuna 11,CIUDAD DE BUENOS AIRES,319,310,474,423,897
02,02011,020111501,Comuna 11,CIUDAD DE BUENOS AIRES,349,342,513,477,990
02,02011,020111907,Comuna 11,CIUDAD DE BUENOS AIRES,319,305,472,444,916
02,02011,020110712,Comuna 11,CIUDAD DE BUENOS AIRES,306,291,444,410,854
02,02011,020111606,Comuna 11,CIUDAD DE BUENOS AIRES,335,308,419,391,810
02,02011,020112205,Comuna 11,CIUDAD DE BUENOS AIRES,310,301,472,421,893
02,02011,020112211,Comuna 11,CIUDAD DE BUENOS AIRES,248,236,367,334,701
02,02011,020111608,Comuna 11,CIUDAD DE BUENOS AIRES,393,378,558,458,1016
02,02011,020111502,Comuna 11,CIUDAD DE BUENOS AIRES,324,321,461,453,914
02,02011,020110610,Comuna 11,CIUDAD DE BUENOS AIRES,271,261,427,372,799
02,02011,020111908,Comuna 11,CIUDAD DE BUENOS AIRES,301,293,447,390,837
02,02011,020111702,Comuna 11,CIUDAD DE BUENOS AIRES,286,279,427,388,815
02,02011,020111609,Comuna 11,CIUDAD DE BUENOS AIRES,256,252,351,295,646
02,02011,020111806,Comuna 11,CIUDAD DE BUENOS AIRES,521,506,701,647,1348
02,02011,020110608,Comuna 11,CIUDAD DE BUENOS AIRES,284,278,404,336,740
02,02011,020111701,Comuna 11,CIUDAD DE BUENOS AIRES,290,284,430,391,821
02,02011,020112207,Comuna 11,CIUDAD DE BUENOS AIRES,345,340,485,371,856
02,02011,020112206,Comuna 11,CIUDAD DE BUENOS AIRES,409,383,545,487,1032
02,02011,020111805,Comuna 11,CIUDAD DE BUENOS AIRES,318,309,433,371,804
02,02011,020110609,Comuna 11,CIUDAD DE BUENOS AIRES,302,278,473,392,865
02,02011,020111610,Comuna 11,CIUDAD DE BUENOS AIRES,236,228,348,318,666
02,02011,020111802,Comuna 11,CIUDAD DE BUENOS AIRES,303,284,401,412,813
02,02011,020111703,Comuna 11,CIUDAD DE BUENOS AIRES,336,320,472,412,884
02,02011,020110611,Comuna 11,CIUDAD DE BUENOS AIRES,314,297,444,415,859
02,02011,020111803,Comuna 11,CIUDAD DE BUENOS AIRES,310,270,474,406,880
02,02011,020111909,Comuna 11,CIUDAD DE BUENOS AIRES,348,322,502,387,889
02,02011,020111705,Comuna 11,CIUDAD DE BUENOS AIRES,297,249,430,408,838
02,02011,020111704,Comuna 11,CIUDAD DE BUENOS AIRES,324,306,492,441,933
02,02011,020111807,Comuna 11,CIUDAD DE BUENOS AIRES,324,303,547,462,1009
02,02011,020111801,Comuna 11,CIUDAD DE BUENOS AIRES,279,228,474,380,854
02,02011,020111804,Comuna 11,CIUDAD DE BUENOS AIRES,370,324,506,397,903
02,02011,020111707,Comuna 11,CIUDAD DE BUENOS AIRES,331,308,491,425,916
02,02011,020111808,Comuna 11,CIUDAD DE BUENOS AIRES,346,328,482,425,907
02,02011,020111706,Comuna 11,CIUDAD DE BUENOS AIRES,408,384,630,545,1175
02,02011,020111809,Comuna 11,CIUDAD DE BUENOS AIRES,304,286,419,396,815
02,02011,020111708,Comuna 11,CIUDAD DE BUENOS AIRES,322,297,438,409,847
02,02015,020150101,Comuna 15,CIUDAD DE BUENOS AIRES,417,409,538,485,1023
02,02015,020150104,Comuna 15,CIUDAD DE BUENOS AIRES,237,227,347,297,644
02,02015,020150903,Comuna 15,CIUDAD DE BUENOS AIRES,230,221,256,261,517
02,02015,020150702,Comuna 15,CIUDAD DE BUENOS AIRES,244,213,379,326,705
02,02015,020151507,Comuna 15,CIUDAD DE BUENOS AIRES,361,351,453,405,858
02,02015,020151903,Comuna 15,CIUDAD DE BUENOS AIRES,310,284,380,305,685
02,02015,020150708,Comuna 15,CIUDAD DE BUENOS AIRES,328,294,514,466,980
02,02015,020151410,Comuna 15,CIUDAD DE BUENOS AIRES,272,266,370,314,684
02,02015,020151406,Comuna 15,CIUDAD DE BUENOS AIRES,286,276,299,223,522
02,02015,020152109,Comuna 15,CIUDAD DE BUENOS AIRES,392,379,473,390,863
02,02015,020151801,Comuna 15,CIUDAD DE BUENOS AIRES,257,257,316,254,570
02,02015,020151411,Comuna 15,CIUDAD DE BUENOS AIRES,376,342,539,486,1025
02,02015,020150307,Comuna 15,CIUDAD DE BUENOS AIRES,251,244,425,387,812
02,02015,020150306,Comuna 15,CIUDAD DE BUENOS AIRES,272,264,382,349,731
02,02015,020150305,Comuna 15,CIUDAD DE BUENOS AIRES,242,230,426,375,801
02,02015,020150308,Comuna 15,CIUDAD DE BUENOS AIRES,329,315,471,446,917
02,02015,020150304,Comuna 15,CIUDAD DE BUENOS AIRES,269,257,423,377,800
02,02015,020150309,Comuna 15,CIUDAD DE BUENOS AIRES,349,347,468,409,877
02,02015,020150313,Comuna 15,CIUDAD DE BUENOS AIRES,291,259,406,364,770
02,02015,020150310,Comuna 15,CIUDAD DE BUENOS AIRES,340,336,482,386,868
02,02015,020150301,Comuna 15,CIUDAD DE BUENOS AIRES,289,286,387,335,722
02,02015,020150403,Comuna 15,CIUDAD DE BUENOS AIRES,401,389,513,442,955
02,02015,020150303,Comuna 15,CIUDAD DE BUENOS AIRES,382,369,504,414,918
02,02015,020150312,Comuna 15,CIUDAD DE BUENOS AIRES,411,396,647,563,1210
02,02015,020150311,Comuna 15,CIUDAD DE BUENOS AIRES,340,335,410,345,755
02,02015,020151001,Comuna 15,CIUDAD DE BUENOS AIRES,348,300,383,336,719
02,02015,020151002,Comuna 15,CIUDAD DE BUENOS AIRES,341,333,528,579,1107
02,02015,020150402,Comuna 15,CIUDAD DE BUENOS AIRES,256,240,373,318,691
02,02015,020150302,Comuna 15,CIUDAD DE BUENOS AIRES,399,387,523,418,941
02,02015,020150404,Comuna 15,CIUDAD DE BUENOS AIRES,206,204,289,275,564
02,02015,020151003,Comuna 15,CIUDAD DE BUENOS AIRES,409,396,594,503,1097
02,02015,020150205,Comuna 15,CIUDAD DE BUENOS AIRES,208,198,271,246,517
02,02015,020150501,Comuna 15,CIUDAD DE BUENOS AIRES,303,297,412,367,779
02,02015,020150401,Comuna 15,CIUDAD DE BUENOS AIRES,337,329,458,394,852
02,02015,020151005,Comuna 15,CIUDAD DE BUENOS AIRES,277,272,406,319,725
02,02015,020150405,Comuna 15,CIUDAD DE BUENOS AIRES,230,210,338,298,636
02,02015,020150406,Comuna 15,CIUDAD DE BUENOS AIRES,270,266,444,357,801
02,02015,020151006,Comuna 15,CIUDAD DE BUENOS AIRES,216,213,269,216,485
02,02015,020150502,Comuna 15,CIUDAD DE BUENOS AIRES,358,325,537,458,995
02,02015,020150204,Comuna 15,CIUDAD DE BUENOS AIRES,208,202,299,255,554
02,02015,020151007,Comuna 15,CIUDAD DE BUENOS AIRES,402,382,460,386,846
02,02015,020150407,Comuna 15,CIUDAD DE BUENOS AIRES,308,292,427,400,827
02,02015,020151010,Comuna 15,CIUDAD DE BUENOS AIRES,257,242,312,270,582
02,02015,020150408,Comuna 15,CIUDAD DE BUENOS AIRES,297,272,419,336,755
02,02015,020150503,Comuna 15,CIUDAD DE BUENOS AIRES,278,271,401,361,762
02,02015,020150206,Comuna 15,CIUDAD DE BUENOS AIRES,268,267,371,338,709
02,02015,020150504,Comuna 15,CIUDAD DE BUENOS AIRES,235,225,308,274,582
02,02015,020150203,Comuna 15,CIUDAD DE BUENOS AIRES,292,279,423,405,828
02,02015,020151101,Comuna 15,CIUDAD DE BUENOS AIRES,308,291,409,380,789
02,02015,020151004,Comuna 15,CIUDAD DE BUENOS AIRES,337,330,416,383,799
02,02015,020150412,Comuna 15,CIUDAD DE BUENOS AIRES,353,288,435,377,812
02,02015,020151009,Comuna 15,CIUDAD DE BUENOS AIRES,297,286,421,345,766
02,02015,020150505,Comuna 15,CIUDAD DE BUENOS AIRES,301,294,419,356,775
02,02015,020150202,Comuna 15,CIUDAD DE BUENOS AIRES,300,290,430,387,817
02,02015,020151008,Comuna 15,CIUDAD DE BUENOS AIRES,324,278,404,316,720
02,02015,020151102,Comuna 15,CIUDAD DE BUENOS AIRES,358,324,381,383,764
02,02015,020150507,Comuna 15,CIUDAD DE BUENOS AIRES,281,272,385,318,703
02,02015,020150409,Comuna 15,CIUDAD DE BUENOS AIRES,264,240,344,298,642
02,02015,020150908,Comuna 15,CIUDAD DE BUENOS AIRES,727,585,1184,1140,2324
02,02015,020150411,Comuna 15,CIUDAD DE BUENOS AIRES,296,279,391,380,771
02,02015,020151011,Comuna 15,CIUDAD DE BUENOS AIRES,253,246,371,285,656
02,02015,020150207,Comuna 15,CIUDAD DE BUENOS AIRES,279,260,356,310,666
02,02015,020150506,Comuna 15,CIUDAD DE BUENOS AIRES,282,276,419,360,779
02,02015,020150201,Comuna 15,CIUDAD DE BUENOS AIRES,280,271,412,344,756
02,02015,020151103,Comuna 15,CIUDAD DE BUENOS AIRES,305,302,389,347,736
02,02015,020150413,Comuna 15,CIUDAD DE BUENOS AIRES,328,312,437,331,768
02,02015,020151104,Comuna 15,CIUDAD DE BUENOS AIRES,308,285,429,392,821
02,02015,020150208,Comuna 15,CIUDAD DE BUENOS AIRES,236,227,353,315,668
02,02015,020150410,Comuna 15,CIUDAD DE BUENOS AIRES,257,226,346,297,643
02,02015,020150509,Comuna 15,CIUDAD DE BUENOS AIRES,258,239,483,433,916
02,02015,020151012,Comuna 15,CIUDAD DE BUENOS AIRES,338,310,419,363,782
02,02015,020150111,Comuna 15,CIUDAD DE BUENOS AIRES,220,214,292,295,587
02,02015,020151105,Comuna 15,CIUDAD DE BUENOS AIRES,245,226,381,320,701
02,02015,020150209,Comuna 15,CIUDAD DE BUENOS AIRES,212,206,313,268,581
02,02015,020150512,Comuna 15,CIUDAD DE BUENOS AIRES,272,242,383,335,718
02,02015,020151109,Comuna 15,CIUDAD DE BUENOS AIRES,382,358,598,494,1092
02,02015,020150508,Comuna 15,CIUDAD DE BUENOS AIRES,334,315,470,437,907
02,02015,020150902,Comuna 15,CIUDAD DE BUENOS AIRES,209,204,267,228,495
02,02015,020150110,Comuna 15,CIUDAD DE BUENOS AIRES,340,332,498,441,939
02,02015,020151013,Comuna 15,CIUDAD DE BUENOS AIRES,364,361,602,457,1059
02,02015,020150414,Comuna 15,CIUDAD DE BUENOS AIRES,318,261,451,446,897
02,02015,020150210,Comuna 15,CIUDAD DE BUENOS AIRES,233,229,317,286,603
02,02015,020151108,Comuna 15,CIUDAD DE BUENOS AIRES,276,264,385,341,726
02,02015,020150109,Comuna 15,CIUDAD DE BUENOS AIRES,342,332,516,472,988
02,02015,020150901,Comuna 15,CIUDAD DE BUENOS AIRES,228,224,279,239,518
02,02015,020150112,Comuna 15,CIUDAD DE BUENOS AIRES,283,283,380,357,737
02,02015,020150513,Comuna 15,CIUDAD DE BUENOS AIRES,289,276,378,364,742
02,02015,020150108,Comuna 15,CIUDAD DE BUENOS AIRES,276,265,386,330,716
02,02015,020151106,Comuna 15,CIUDAD DE BUENOS AIRES,266,232,414,384,798
02,02015,020151111,Comuna 15,CIUDAD DE BUENOS AIRES,531,516,624,540,1164
02,02015,020150514,Comuna 15,CIUDAD DE BUENOS AIRES,261,247,375,347,722
02,02015,020150701,Comuna 15,CIUDAD DE BUENOS AIRES,300,285,454,446,900
02,02015,020150510,Comuna 15,CIUDAD DE BUENOS AIRES,224,204,343,318,661
02,02015,020151110,Comuna 15,CIUDAD DE BUENOS AIRES,268,261,359,311,670
02,02015,020151107,Comuna 15,CIUDAD DE BUENOS AIRES,258,245,362,317,679
02,02015,020150107,Comuna 15,CIUDAD DE BUENOS AIRES,290,289,372,327,699
02,02015,020150511,Comuna 15,CIUDAD DE BUENOS AIRES,274,247,383,366,749
02,02015,020150103,Comuna 15,CIUDAD DE BUENOS AIRES,268,266,382,309,691
02,02015,020151113,Comuna 15,CIUDAD DE BUENOS AIRES,364,354,481,442,923
02,02015,020150106,Comuna 15,CIUDAD DE BUENOS AIRES,257,255,374,366,740
02,02015,020151201,Comuna 15,CIUDAD DE BUENOS AIRES,277,221,392,389,781
02,02015,020151202,Comuna 15,CIUDAD DE BUENOS AIRES,283,278,400,365,765
02,02015,020151112,Comuna 15,CIUDAD DE BUENOS AIRES,376,372,466,399,865
02,02015,020150105,Comuna 15,CIUDAD DE BUENOS AIRES,268,259,418,364,782
02,02015,020150102,Comuna 15,CIUDAD DE BUENOS AIRES,344,341,521,425,946
02,02015,020150905,Comuna 15,CIUDAD DE BUENOS AIRES,249,230,385,375,760
02,02015,020151301,Comuna 15,CIUDAD DE BUENOS AIRES,304,294,426,423,849
02,02015,020151205,Comuna 15,CIUDAD DE BUENOS AIRES,333,331,518,409,927
02,02015,020151203,Comuna 15,CIUDAD DE BUENOS AIRES,309,290,405,347,752
02,02015,020151206,Comuna 15,CIUDAD DE BUENOS AIRES,308,294,388,338,726
02,02015,020150703,Comuna 15,CIUDAD DE BUENOS AIRES,230,226,331,316,647
02,02015,020150704,Comuna 15,CIUDAD DE BUENOS AIRES,216,192,483,459,942
02,02015,020150606,Comuna 15,CIUDAD DE BUENOS AIRES,183,171,273,243,516
02,02015,020150605,Comuna 15,CIUDAD DE BUENOS AIRES,192,182,279,247,526
02,02015,020151302,Comuna 15,CIUDAD DE BUENOS AIRES,257,252,412,330,742
02,02015,020150904,Comuna 15,CIUDAD DE BUENOS AIRES,253,226,360,374,734
02,02015,020151204,Comuna 15,CIUDAD DE BUENOS AIRES,324,308,383,310,693
02,02015,020151502,Comuna 15,CIUDAD DE BUENOS AIRES,235,226,406,353,759
02,02015,020151207,Comuna 15,CIUDAD DE BUENOS AIRES,235,231,280,217,497
02,02015,020151304,Comuna 15,CIUDAD DE BUENOS AIRES,262,255,393,293,686
02,02015,020151208,Comuna 15,CIUDAD DE BUENOS AIRES,373,331,397,344,741
02,02015,020150604,Comuna 15,CIUDAD DE BUENOS AIRES,250,246,382,340,722
02,02015,020152012,Comuna 15,CIUDAD DE BUENOS AIRES,342,320,424,314,738
02,02015,020150705,Comuna 15,CIUDAD DE BUENOS AIRES,293,277,440,448,888
02,02015,020150603,Comuna 15,CIUDAD DE BUENOS AIRES,286,271,338,303,641
02,02015,020150601,Comuna 15,CIUDAD DE BUENOS AIRES,291,289,368,310,678
02,02015,020152011,Comuna 15,CIUDAD DE BUENOS AIRES,344,327,409,319,728
02,02015,020151501,Comuna 15,CIUDAD DE BUENOS AIRES,293,290,370,326,696
02,02015,020150906,Comuna 15,CIUDAD DE BUENOS AIRES,213,210,316,296,612
02,02015,020150602,Comuna 15,CIUDAD DE BUENOS AIRES,285,266,381,300,681
02,02015,020152009,Comuna 15,CIUDAD DE BUENOS AIRES,225,218,258,233,491
02,02015,020151305,Comuna 15,CIUDAD DE BUENOS AIRES,212,209,238,188,426
02,02015,020151209,Comuna 15,CIUDAD DE BUENOS AIRES,245,244,285,235,520
02,02015,020151306,Comuna 15,CIUDAD DE BUENOS AIRES,238,233,281,217,498
02,02015,020151303,Comuna 15,CIUDAD DE BUENOS AIRES,298,298,342,292,634
02,02015,020150907,Comuna 15,CIUDAD DE BUENOS AIRES,270,245,368,362,730
02,02015,020151310,Comuna 15,CIUDAD DE BUENOS AIRES,297,295,361,291,652
02,02015,020152008,Comuna 15,CIUDAD DE BUENOS AIRES,268,242,383,276,659
02,02015,020151401,Comuna 15,CIUDAD DE BUENOS AIRES,364,339,436,412,848
02,02015,020152010,Comuna 15,CIUDAD DE BUENOS AIRES,319,308,424,380,804
02,02015,020151504,Comuna 15,CIUDAD DE BUENOS AIRES,352,313,494,494,988
02,02015,020152103,Comuna 15,CIUDAD DE BUENOS AIRES,293,264,338,293,631
02,02015,020151505,Comuna 15,CIUDAD DE BUENOS AIRES,297,286,436,413,849
02,02015,020150607,Comuna 15,CIUDAD DE BUENOS AIRES,255,238,359,297,656
02,02015,020151402,Comuna 15,CIUDAD DE BUENOS AIRES,386,385,484,415,899
02,02015,020151309,Comuna 15,CIUDAD DE BUENOS AIRES,462,458,565,487,1052
02,02015,020151503,Comuna 15,CIUDAD DE BUENOS AIRES,401,394,583,461,1044
02,02015,020152104,Comuna 15,CIUDAD DE BUENOS AIRES,343,323,424,302,726
02,02015,020151307,Comuna 15,CIUDAD DE BUENOS AIRES,292,282,369,317,686
02,02015,020150706,Comuna 15,CIUDAD DE BUENOS AIRES,321,281,523,508,1031
02,02015,020152005,Comuna 15,CIUDAD DE BUENOS AIRES,274,267,320,275,595
02,02015,020150802,Comuna 15,CIUDAD DE BUENOS AIRES,237,205,368,352,720
02,02015,020150801,Comuna 15,CIUDAD DE BUENOS AIRES,336,259,501,473,974
02,02015,020152007,Comuna 15,CIUDAD DE BUENOS AIRES,289,279,401,328,729
02,02015,020151408,Comuna 15,CIUDAD DE BUENOS AIRES,326,303,454,387,841
02,02015,020151403,Comuna 15,CIUDAD DE BUENOS AIRES,302,276,398,324,722
02,02015,020151308,Comuna 15,CIUDAD DE BUENOS AIRES,194,189,253,186,439
02,02015,020152113,Comuna 15,CIUDAD DE BUENOS AIRES,389,382,490,405,895
02,02015,020152102,Comuna 15,CIUDAD DE BUENOS AIRES,374,361,443,379,822
02,02015,020152004,Comuna 15,CIUDAD DE BUENOS AIRES,278,262,352,283,635
02,02015,020150804,Comuna 15,CIUDAD DE BUENOS AIRES,330,306,509,433,942
02,02015,020152112,Comuna 15,CIUDAD DE BUENOS AIRES,217,215,275,235,510
02,02015,020152006,Comuna 15,CIUDAD DE BUENOS AIRES,321,307,396,317,713
02,02015,020151409,Comuna 15,CIUDAD DE BUENOS AIRES,347,321,437,425,862
02,02015,020151405,Comuna 15,CIUDAD DE BUENOS AIRES,421,413,530,422,952
02,02015,020151404,Comuna 15,CIUDAD DE BUENOS AIRES,308,305,388,326,714
02,02015,020152001,Comuna 15,CIUDAD DE BUENOS AIRES,347,340,450,408,858
02,02015,020151506,Comuna 15,CIUDAD DE BUENOS AIRES,311,277,466,415,881
02,02015,020152105,Comuna 15,CIUDAD DE BUENOS AIRES,201,196,259,213,472
02,02015,020152003,Comuna 15,CIUDAD DE BUENOS AIRES,346,336,455,336,791
02,02015,020152111,Comuna 15,CIUDAD DE BUENOS AIRES,335,324,358,339,697
02,02015,020152101,Comuna 15,CIUDAD DE BUENOS AIRES,320,316,380,342,722
02,02015,020151407,Comuna 15,CIUDAD DE BUENOS AIRES,392,388,477,406,883
02,02015,020152106,Comuna 15,CIUDAD DE BUENOS AIRES,418,402,555,490,1045
02,02015,020151803,Comuna 15,CIUDAD DE BUENOS AIRES,310,301,414,300,714
02,02015,020152002,Comuna 15,CIUDAD DE BUENOS AIRES,366,361,454,351,805
02,02015,020152110,Comuna 15,CIUDAD DE BUENOS AIRES,278,274,344,269,613
02,02015,020150808,Comuna 15,CIUDAD DE BUENOS AIRES,323,317,497,434,931
02,02015,020150803,Comuna 15,CIUDAD DE BUENOS AIRES,373,364,557,451,1008
02,02015,020150707,Comuna 15,CIUDAD DE BUENOS AIRES,351,340,544,480,1024
02,02015,020151902,Comuna 15,CIUDAD DE BUENOS AIRES,335,327,443,351,794
02,02015,020151508,Comuna 15,CIUDAD DE BUENOS AIRES,260,254,326,340,666
02,02015,020151904,Comuna 15,CIUDAD DE BUENOS AIRES,343,338,409,348,757
02,02015,020150810,Comuna 15,CIUDAD DE BUENOS AIRES,382,375,495,393,888
02,02015,020152107,Comuna 15,CIUDAD DE BUENOS AIRES,175,171,228,183,411
02,02015,020150709,Comuna 15,CIUDAD DE BUENOS AIRES,283,262,413,388,801
02,02015,020151701,Comuna 15,CIUDAD DE BUENOS AIRES,323,312,402,330,732
02,02015,020151510,Comuna 15,CIUDAD DE BUENOS AIRES,413,393,518,416,934
02,02015,020151802,Comuna 15,CIUDAD DE BUENOS AIRES,213,201,259,241,500
02,02015,020151804,Comuna 15,CIUDAD DE BUENOS AIRES,209,206,257,210,467
02,02015,020151905,Comuna 15,CIUDAD DE BUENOS AIRES,383,377,465,376,841
02,02015,020150807,Comuna 15,CIUDAD DE BUENOS AIRES,357,348,534,462,996
02,02015,020151911,Comuna 15,CIUDAD DE BUENOS AIRES,383,380,442,364,806
02,02015,020151901,Comuna 15,CIUDAD DE BUENOS AIRES,230,229,253,212,465
02,02015,020151602,Comuna 15,CIUDAD DE BUENOS AIRES,327,279,442,406,848
02,02015,020152108,Comuna 15,CIUDAD DE BUENOS AIRES,261,256,333,241,574
02,02015,020150710,Comuna 15,CIUDAD DE BUENOS AIRES,379,371,504,480,984
02,02015,020151702,Comuna 15,CIUDAD DE BUENOS AIRES,271,250,335,249,584
02,02015,020151805,Comuna 15,CIUDAD DE BUENOS AIRES,215,208,272,218,490
02,02015,020151808,Comuna 15,CIUDAD DE BUENOS AIRES,218,217,333,236,569
02,02015,020151906,Comuna 15,CIUDAD DE BUENOS AIRES,338,334,436,329,765
02,02015,020151603,Comuna 15,CIUDAD DE BUENOS AIRES,388,361,582,483,1065
02,02015,020150809,Comuna 15,CIUDAD DE BUENOS AIRES,433,390,559,466,1025
02,02015,020150712,Comuna 15,CIUDAD DE BUENOS AIRES,348,309,496,475,971
02,02015,020151910,Comuna 15,CIUDAD DE BUENOS AIRES,412,380,541,423,964
02,02015,020150805,Comuna 15,CIUDAD DE BUENOS AIRES,285,271,408,341,749
02,02015,020151703,Comuna 15,CIUDAD DE BUENOS AIRES,368,362,473,381,854
02,02015,020151806,Comuna 15,CIUDAD DE BUENOS AIRES,210,209,260,257,517
02,02015,020151807,Comuna 15,CIUDAD DE BUENOS AIRES,316,276,417,354,771
02,02015,020151809,Comuna 15,CIUDAD DE BUENOS AIRES,222,222,292,200,492
02,02015,020151907,Comuna 15,CIUDAD DE BUENOS AIRES,374,370,446,297,743
02,02015,020151909,Comuna 15,CIUDAD DE BUENOS AIRES,286,283,367,294,661
02,02015,020150806,Comuna 15,CIUDAD DE BUENOS AIRES,260,243,396,324,720
02,02015,020150711,Comuna 15,CIUDAD DE BUENOS AIRES,329,315,485,406,891
02,02015,020151509,Comuna 15,CIUDAD DE BUENOS AIRES,430,408,555,482,1037
02,02015,020151704,Comuna 15,CIUDAD DE BUENOS AIRES,409,367,551,455,1006
02,02015,020151707,Comuna 15,CIUDAD DE BUENOS AIRES,333,330,415,323,738
02,02015,020151810,Comuna 15,CIUDAD DE BUENOS AIRES,240,237,319,263,582
02,02015,020151812,Comuna 15,CIUDAD DE BUENOS AIRES,244,232,304,256,560
02,02015,020151908,Comuna 15,CIUDAD DE BUENOS AIRES,294,291,331,268,599
02,02015,020151708,Comuna 15,CIUDAD DE BUENOS AIRES,270,269,334,260,594
02,02015,020151607,Comuna 15,CIUDAD DE BUENOS AIRES,316,297,450,398,848
02,02015,020151601,Comuna 15,CIUDAD DE BUENOS AIRES,355,311,459,404,863
02,02015,020151604,Comuna 15,CIUDAD DE BUENOS AIRES,293,284,409,336,745
02,02015,020151811,Comuna 15,CIUDAD DE BUENOS AIRES,294,290,366,291,657
02,02015,020151813,Comuna 15,CIUDAD DE BUENOS AIRES,254,250,304,242,546
02,02015,020151711,Comuna 15,CIUDAD DE BUENOS AIRES,356,339,438,384,822
02,02015,020151608,Comuna 15,CIUDAD DE BUENOS AIRES,354,348,455,384,839
02,02015,020151705,Comuna 15,CIUDAD DE BUENOS AIRES,349,349,473,406,879
02,02015,020151706,Comuna 15,CIUDAD DE BUENOS AIRES,308,295,416,295,711
02,02015,020151709,Comuna 15,CIUDAD DE BUENOS AIRES,266,262,372,306,678
02,02015,020151712,Comuna 15,CIUDAD DE BUENOS AIRES,302,284,398,332,730
02,02015,020151606,Comuna 15,CIUDAD DE BUENOS AIRES,308,302,441,353,794
02,02015,020151605,Comuna 15,CIUDAD DE BUENOS AIRES,276,256,363,279,642
02,02015,020151610,Comuna 15,CIUDAD DE BUENOS AIRES,337,327,420,385,805
02,02015,020151710,Comuna 15,CIUDAD DE BUENOS AIRES,342,319,530,382,912
02,02015,020151609,Comuna 15,CIUDAD DE BUENOS AIRES,306,303,412,323,735
02,02015,020151611,Comuna 15,CIUDAD DE BUENOS AIRES,307,305,428,335,763
02,02001,020010601,Comuna 1,CIUDAD DE BUENOS AIRES,326,324,504,444,948
02,02001,020010403,Comuna 1,CIUDAD DE BUENOS AIRES,469,316,667,522,1189
02,02001,020010405,Comuna 1,CIUDAD DE BUENOS AIRES,384,293,569,500,1069
02,02001,020010810,Comuna 1,CIUDAD DE BUENOS AIRES,186,181,230,215,445
02,02001,020010809,Comuna 1,CIUDAD DE BUENOS AIRES,257,257,421,270,691
02,02001,020010808,Comuna 1,CIUDAD DE BUENOS AIRES,189,188,252,194,446
02,02001,020011301,Comuna 1,CIUDAD DE BUENOS AIRES,163,162,222,364,586
02,02001,020011206,Comuna 1,CIUDAD DE BUENOS AIRES,202,184,252,220,472
02,02001,020010201,Comuna 1,CIUDAD DE BUENOS AIRES,161,134,246,232,478
02,02001,020010301,Comuna 1,CIUDAD DE BUENOS AIRES,191,158,272,322,594
02,02001,020010204,Comuna 1,CIUDAD DE BUENOS AIRES,163,110,305,297,602
02,02001,020010202,Comuna 1,CIUDAD DE BUENOS AIRES,128,114,213,188,401
02,02001,020010101,Comuna 1,CIUDAD DE BUENOS AIRES,65,38,124,212,336
02,02001,020010302,Comuna 1,CIUDAD DE BUENOS AIRES,161,145,281,283,564
02,02001,020010203,Comuna 1,CIUDAD DE BUENOS AIRES,104,98,167,170,337
02,02001,020010322,Comuna 1,CIUDAD DE BUENOS AIRES,205,188,311,359,670
02,02001,020010323,Comuna 1,CIUDAD DE BUENOS AIRES,267,260,413,424,837
02,02001,020010303,Comuna 1,CIUDAD DE BUENOS AIRES,200,162,345,314,659
02,02001,020010205,Comuna 1,CIUDAD DE BUENOS AIRES,95,81,133,174,307
02,02001,020010212,Comuna 1,CIUDAD DE BUENOS AIRES,366,320,589,636,1225
02,02001,020010206,Comuna 1,CIUDAD DE BUENOS AIRES,215,174,366,366,732
02,02001,020010304,Comuna 1,CIUDAD DE BUENOS AIRES,132,118,202,226,428
02,02001,020010319,Comuna 1,CIUDAD DE BUENOS AIRES,343,297,481,536,1017
02,02001,020010207,Comuna 1,CIUDAD DE BUENOS AIRES,151,67,221,217,438
02,02001,020010320,Comuna 1,CIUDAD DE BUENOS AIRES,115,104,194,203,397
02,02001,020010305,Comuna 1,CIUDAD DE BUENOS AIRES,412,206,595,688,1283
02,02001,020010321,Comuna 1,CIUDAD DE BUENOS AIRES,109,97,150,150,300
02,02001,020010306,Comuna 1,CIUDAD DE BUENOS AIRES,341,245,521,506,1027
02,02001,020010208,Comuna 1,CIUDAD DE BUENOS AIRES,145,132,220,266,486
02,02001,020010211,Comuna 1,CIUDAD DE BUENOS AIRES,200,169,303,308,611
02,02001,020010317,Comuna 1,CIUDAD DE BUENOS AIRES,182,164,294,277,571
02,02001,020010318,Comuna 1,CIUDAD DE BUENOS AIRES,231,172,372,411,783
02,02001,020010307,Comuna 1,CIUDAD DE BUENOS AIRES,148,106,202,201,403
02,02001,020010213,Comuna 1,CIUDAD DE BUENOS AIRES,162,119,242,234,476
02,02001,020010210,Comuna 1,CIUDAD DE BUENOS AIRES,88,56,182,145,327
02,02001,020010316,Comuna 1,CIUDAD DE BUENOS AIRES,254,198,341,385,726
02,02001,020010209,Comuna 1,CIUDAD DE BUENOS AIRES,156,97,252,259,511
02,02001,020010314,Comuna 1,CIUDAD DE BUENOS AIRES,147,130,222,249,471
02,02001,020010315,Comuna 1,CIUDAD DE BUENOS AIRES,310,244,403,440,843
02,02001,020010214,Comuna 1,CIUDAD DE BUENOS AIRES,261,165,357,331,688
02,02001,020010313,Comuna 1,CIUDAD DE BUENOS AIRES,118,91,176,205,381
02,02001,020010218,Comuna 1,CIUDAD DE BUENOS AIRES,148,122,241,239,480
02,02001,020010215,Comuna 1,CIUDAD DE BUENOS AIRES,278,144,380,377,757
02,02001,020010217,Comuna 1,CIUDAD DE BUENOS AIRES,227,150,365,347,712
02,02001,020010219,Comuna 1,CIUDAD DE BUENOS AIRES,200,93,270,277,547
02,02001,020010309,Comuna 1,CIUDAD DE BUENOS AIRES,380,339,564,528,1092
02,02001,020010308,Comuna 1,CIUDAD DE BUENOS AIRES,257,233,423,374,797
02,02001,020010216,Comuna 1,CIUDAD DE BUENOS AIRES,444,363,558,570,1128
02,02001,020010312,Comuna 1,CIUDAD DE BUENOS AIRES,181,159,292,269,561
02,02001,020010310,Comuna 1,CIUDAD DE BUENOS AIRES,261,228,378,367,745
02,02001,020010311,Comuna 1,CIUDAD DE BUENOS AIRES,267,204,368,377,745
02,02001,020010401,Comuna 1,CIUDAD DE BUENOS AIRES,663,588,816,656,1472
02,02001,020010402,Comuna 1,CIUDAD DE BUENOS AIRES,616,513,715,584,1299
02,02001,020010404,Comuna 1,CIUDAD DE BUENOS AIRES,604,436,887,658,1545
02,02001,020010603,Comuna 1,CIUDAD DE BUENOS AIRES,426,408,617,543,1160
02,02001,020010406,Comuna 1,CIUDAD DE BUENOS AIRES,486,363,791,480,1271
02,02001,020010408,Comuna 1,CIUDAD DE BUENOS AIRES,451,337,659,469,1128
02,02001,020010604,Comuna 1,CIUDAD DE BUENOS AIRES,397,392,439,350,789
02,02001,020010702,Comuna 1,CIUDAD DE BUENOS AIRES,117,110,340,430,770
02,02001,020010407,Comuna 1,CIUDAD DE BUENOS AIRES,549,419,758,635,1393
02,02001,020010602,Comuna 1,CIUDAD DE BUENOS AIRES,210,210,350,291,641
02,02001,020010501,Comuna 1,CIUDAD DE BUENOS AIRES,257,236,370,261,631
02,02001,020010713,Comuna 1,CIUDAD DE BUENOS AIRES,64,64,503,922,1425
02,02001,020010605,Comuna 1,CIUDAD DE BUENOS AIRES,169,167,186,146,332
02,02001,020010504,Comuna 1,CIUDAD DE BUENOS AIRES,490,483,703,497,1200
02,02001,020010503,Comuna 1,CIUDAD DE BUENOS AIRES,405,385,566,362,928
02,02001,020010502,Comuna 1,CIUDAD DE BUENOS AIRES,240,239,301,232,533
02,02001,020010609,Comuna 1,CIUDAD DE BUENOS AIRES,419,410,584,462,1046
02,02001,020010608,Comuna 1,CIUDAD DE BUENOS AIRES,296,292,376,354,730
02,02001,020010606,Comuna 1,CIUDAD DE BUENOS AIRES,252,235,324,245,569
02,02001,020010703,Comuna 1,CIUDAD DE BUENOS AIRES,126,124,119,142,261
02,02001,020010610,Comuna 1,CIUDAD DE BUENOS AIRES,193,182,231,184,415
02,02001,020010607,Comuna 1,CIUDAD DE BUENOS AIRES,227,224,278,220,498
02,02001,020010507,Comuna 1,CIUDAD DE BUENOS AIRES,270,270,344,253,597
02,02001,020010506,Comuna 1,CIUDAD DE BUENOS AIRES,365,353,453,435,888
02,02001,020010505,Comuna 1,CIUDAD DE BUENOS AIRES,242,237,362,275,637
02,02001,020010701,Comuna 1,CIUDAD DE BUENOS AIRES,264,260,343,326,669
02,02001,020010804,Comuna 1,CIUDAD DE BUENOS AIRES,295,292,343,249,592
02,02001,020010803,Comuna 1,CIUDAD DE BUENOS AIRES,448,438,584,520,1104
02,02001,020011314,Comuna 1,CIUDAD DE BUENOS AIRES,659,561,952,1008,1960
02,02001,020010802,Comuna 1,CIUDAD DE BUENOS AIRES,567,562,725,599,1324
02,02001,020010801,Comuna 1,CIUDAD DE BUENOS AIRES,188,187,204,148,352
02,02001,020010704,Comuna 1,CIUDAD DE BUENOS AIRES,278,268,295,265,560
02,02001,020010706,Comuna 1,CIUDAD DE BUENOS AIRES,80,80,152,148,300
02,02001,020010705,Comuna 1,CIUDAD DE BUENOS AIRES,147,147,203,200,403
02,02001,020010707,Comuna 1,CIUDAD DE BUENOS AIRES,249,243,328,264,592
02,02001,020010708,Comuna 1,CIUDAD DE BUENOS AIRES,240,236,316,281,597
02,02001,020010805,Comuna 1,CIUDAD DE BUENOS AIRES,214,214,323,266,589
02,02001,020010806,Comuna 1,CIUDAD DE BUENOS AIRES,572,564,632,512,1144
02,02001,020010807,Comuna 1,CIUDAD DE BUENOS AIRES,561,546,791,543,1334
02,02001,020010712,Comuna 1,CIUDAD DE BUENOS AIRES,175,173,239,268,507
02,02001,020010711,Comuna 1,CIUDAD DE BUENOS AIRES,140,135,103,110,213
02,02001,020010710,Comuna 1,CIUDAD DE BUENOS AIRES,232,229,205,179,384
02,02001,020010709,Comuna 1,CIUDAD DE BUENOS AIRES,183,183,183,147,330
02,02001,020010913,Comuna 1,CIUDAD DE BUENOS AIRES,201,191,283,307,590
02,02001,020010911,Comuna 1,CIUDAD DE BUENOS AIRES,116,116,180,242,422
02,02001,020010910,Comuna 1,CIUDAD DE BUENOS AIRES,108,106,184,185,369
02,02001,020010909,Comuna 1,CIUDAD DE BUENOS AIRES,237,224,281,347,628
02,02001,020010908,Comuna 1,CIUDAD DE BUENOS AIRES,149,145,129,132,261
02,02001,020010907,Comuna 1,CIUDAD DE BUENOS AIRES,288,280,306,282,588
02,02001,020010904,Comuna 1,CIUDAD DE BUENOS AIRES,134,133,137,119,256
02,02001,020010903,Comuna 1,CIUDAD DE BUENOS AIRES,195,189,198,251,449
02,02001,020010901,Comuna 1,CIUDAD DE BUENOS AIRES,161,161,167,125,292
02,02001,020011302,Comuna 1,CIUDAD DE BUENOS AIRES,60,59,68,60,128
02,02001,020011001,Comuna 1,CIUDAD DE BUENOS AIRES,120,118,186,132,318
02,02001,020011002,Comuna 1,CIUDAD DE BUENOS AIRES,278,273,284,220,504
02,02001,020011003,Comuna 1,CIUDAD DE BUENOS AIRES,515,506,532,448,980
02,02001,020011004,Comuna 1,CIUDAD DE BUENOS AIRES,223,222,256,171,427
02,02001,020010912,Comuna 1,CIUDAD DE BUENOS AIRES,76,74,182,196,378
02,02001,020010906,Comuna 1,CIUDAD DE BUENOS AIRES,175,173,186,168,354
02,02001,020010905,Comuna 1,CIUDAD DE BUENOS AIRES,192,187,204,205,409
02,02001,020010902,Comuna 1,CIUDAD DE BUENOS AIRES,193,189,219,169,388
02,02001,020011008,Comuna 1,CIUDAD DE BUENOS AIRES,153,152,139,140,279
02,02001,020011007,Comuna 1,CIUDAD DE BUENOS AIRES,159,126,163,149,312
02,02001,020011006,Comuna 1,CIUDAD DE BUENOS AIRES,265,265,285,256,541
02,02001,020010914,Comuna 1,CIUDAD DE BUENOS AIRES,148,121,125,128,253
02,02001,020011005,Comuna 1,CIUDAD DE BUENOS AIRES,236,233,270,237,507
02,02001,020011303,Comuna 1,CIUDAD DE BUENOS AIRES,20,20,18,27,45
02,02001,020010915,Comuna 1,CIUDAD DE BUENOS AIRES,118,100,114,124,238
02,02001,020010916,Comuna 1,CIUDAD DE BUENOS AIRES,337,276,484,513,997
02,02001,020011009,Comuna 1,CIUDAD DE BUENOS AIRES,161,160,171,170,341
02,02001,020011010,Comuna 1,CIUDAD DE BUENOS AIRES,296,287,376,304,680
02,02001,020011011,Comuna 1,CIUDAD DE BUENOS AIRES,351,345,343,269,612
02,02001,020010919,Comuna 1,CIUDAD DE BUENOS AIRES,61,58,64,55,119
02,02001,020010918,Comuna 1,CIUDAD DE BUENOS AIRES,169,161,186,209,395
02,02001,020010917,Comuna 1,CIUDAD DE BUENOS AIRES,207,206,190,170,360
02,02001,020011014,Comuna 1,CIUDAD DE BUENOS AIRES,111,110,109,109,218
02,02001,020011013,Comuna 1,CIUDAD DE BUENOS AIRES,339,334,378,300,678
02,02001,020011012,Comuna 1,CIUDAD DE BUENOS AIRES,291,275,313,271,584
02,02001,020011211,Comuna 1,CIUDAD DE BUENOS AIRES,136,132,234,294,528
02,02001,020011210,Comuna 1,CIUDAD DE BUENOS AIRES,101,97,134,162,296
02,02001,020011212,Comuna 1,CIUDAD DE BUENOS AIRES,90,89,244,255,499
02,02001,020011209,Comuna 1,CIUDAD DE BUENOS AIRES,342,327,706,650,1356
02,02001,020011203,Comuna 1,CIUDAD DE BUENOS AIRES,314,310,349,374,723
02,02001,020011202,Comuna 1,CIUDAD DE BUENOS AIRES,129,129,128,101,229
02,02001,020011201,Comuna 1,CIUDAD DE BUENOS AIRES,116,114,157,184,341
02,02001,020011104,Comuna 1,CIUDAD DE BUENOS AIRES,336,306,344,323,667
02,02001,020011103,Comuna 1,CIUDAD DE BUENOS AIRES,198,195,167,187,354
02,02001,020011102,Comuna 1,CIUDAD DE BUENOS AIRES,284,258,225,203,428
02,02001,020011101,Comuna 1,CIUDAD DE BUENOS AIRES,219,202,273,239,512
02,02001,020011306,Comuna 1,CIUDAD DE BUENOS AIRES,100,95,89,103,192
02,02001,020011304,Comuna 1,CIUDAD DE BUENOS AIRES,136,136,276,449,725
02,02001,020011204,Comuna 1,CIUDAD DE BUENOS AIRES,209,166,225,168,393
02,02001,020011205,Comuna 1,CIUDAD DE BUENOS AIRES,275,257,336,264,600
02,02001,020011105,Comuna 1,CIUDAD DE BUENOS AIRES,251,210,275,254,529
02,02001,020011106,Comuna 1,CIUDAD DE BUENOS AIRES,209,206,248,199,447
02,02001,020011107,Comuna 1,CIUDAD DE BUENOS AIRES,296,282,272,253,525
02,02001,020011111,Comuna 1,CIUDAD DE BUENOS AIRES,126,115,155,111,266
02,02001,020011110,Comuna 1,CIUDAD DE BUENOS AIRES,272,267,313,308,621
02,02001,020011109,Comuna 1,CIUDAD DE BUENOS AIRES,219,193,246,209,455
02,02001,020011108,Comuna 1,CIUDAD DE BUENOS AIRES,353,348,435,382,817
02,02001,020011402,Comuna 1,CIUDAD DE BUENOS AIRES,226,210,469,627,1096
02,02001,020011208,Comuna 1,CIUDAD DE BUENOS AIRES,129,129,167,162,329
02,02001,020011207,Comuna 1,CIUDAD DE BUENOS AIRES,347,342,405,381,786
02,02001,020011112,Comuna 1,CIUDAD DE BUENOS AIRES,407,375,519,414,933
02,02001,020011113,Comuna 1,CIUDAD DE BUENOS AIRES,291,284,342,324,666
02,02001,020011114,Comuna 1,CIUDAD DE BUENOS AIRES,289,286,452,322,774
02,02001,020011401,Comuna 1,CIUDAD DE BUENOS AIRES,247,193,297,325,622
02,02001,020011502,Comuna 1,CIUDAD DE BUENOS AIRES,249,242,340,322,662
02,02001,020011501,Comuna 1,CIUDAD DE BUENOS AIRES,170,165,352,345,697
02,02001,020011305,Comuna 1,CIUDAD DE BUENOS AIRES,154,150,155,140,295
02,02001,020011601,Comuna 1,CIUDAD DE BUENOS AIRES,189,186,264,274,538
02,02001,020011603,Comuna 1,CIUDAD DE BUENOS AIRES,413,404,479,466,945
02,02001,020011607,Comuna 1,CIUDAD DE BUENOS AIRES,475,447,585,489,1074
02,02001,020011609,Comuna 1,CIUDAD DE BUENOS AIRES,160,156,206,176,382
02,02001,020011604,Comuna 1,CIUDAD DE BUENOS AIRES,348,331,286,287,573
02,02001,020011307,Comuna 1,CIUDAD DE BUENOS AIRES,241,236,243,262,505
02,02001,020011602,Comuna 1,CIUDAD DE BUENOS AIRES,164,163,162,164,326
02,02001,020011605,Comuna 1,CIUDAD DE BUENOS AIRES,208,200,275,202,477
02,02001,020011606,Comuna 1,CIUDAD DE BUENOS AIRES,228,194,296,263,559
02,02001,020011608,Comuna 1,CIUDAD DE BUENOS AIRES,220,215,294,252,546
02,02001,020011503,Comuna 1,CIUDAD DE BUENOS AIRES,200,199,242,176,418
02,02001,020011308,Comuna 1,CIUDAD DE BUENOS AIRES,156,155,155,153,308
02,02001,020011702,Comuna 1,CIUDAD DE BUENOS AIRES,303,281,329,328,657
02,02001,020011701,Comuna 1,CIUDAD DE BUENOS AIRES,389,356,431,457,888
02,02001,020011612,Comuna 1,CIUDAD DE BUENOS AIRES,139,132,202,162,364
02,02001,020011611,Comuna 1,CIUDAD DE BUENOS AIRES,217,213,257,207,464
02,02001,020011610,Comuna 1,CIUDAD DE BUENOS AIRES,291,281,339,252,591
02,02001,020011403,Comuna 1,CIUDAD DE BUENOS AIRES,196,175,198,185,383
02,02001,020011310,Comuna 1,CIUDAD DE BUENOS AIRES,235,229,302,312,614
02,02001,020011404,Comuna 1,CIUDAD DE BUENOS AIRES,39,37,42,28,70
02,02001,020011405,Comuna 1,CIUDAD DE BUENOS AIRES,226,193,231,253,484
02,02001,020011504,Comuna 1,CIUDAD DE BUENOS AIRES,335,319,393,366,759
02,02001,020011309,Comuna 1,CIUDAD DE BUENOS AIRES,157,154,215,211,426
02,02001,020011703,Comuna 1,CIUDAD DE BUENOS AIRES,324,294,391,329,720
02,02001,020011704,Comuna 1,CIUDAD DE BUENOS AIRES,287,280,334,252,586
02,02001,020011706,Comuna 1,CIUDAD DE BUENOS AIRES,367,350,404,355,759
02,02001,020011707,Comuna 1,CIUDAD DE BUENOS AIRES,323,318,321,294,615
02,02001,020011313,Comuna 1,CIUDAD DE BUENOS AIRES,104,102,132,226,358
02,02001,020011803,Comuna 1,CIUDAD DE BUENOS AIRES,292,278,328,314,642
02,02001,020011407,Comuna 1,CIUDAD DE BUENOS AIRES,215,208,244,232,476
02,02001,020011802,Comuna 1,CIUDAD DE BUENOS AIRES,357,348,417,318,735
02,02001,020011801,Comuna 1,CIUDAD DE BUENOS AIRES,442,349,436,406,842
02,02001,020011406,Comuna 1,CIUDAD DE BUENOS AIRES,293,289,354,344,698
02,02001,020011505,Comuna 1,CIUDAD DE BUENOS AIRES,187,155,232,232,464
02,02001,020011705,Comuna 1,CIUDAD DE BUENOS AIRES,256,251,316,261,577
02,02001,020011708,Comuna 1,CIUDAD DE BUENOS AIRES,267,243,349,248,597
02,02001,020011804,Comuna 1,CIUDAD DE BUENOS AIRES,341,337,414,316,730
02,02001,020011408,Comuna 1,CIUDAD DE BUENOS AIRES,196,188,182,229,411
02,02001,020011805,Comuna 1,CIUDAD DE BUENOS AIRES,274,265,402,296,698
02,02001,020011409,Comuna 1,CIUDAD DE BUENOS AIRES,246,246,275,246,521
02,02001,020011507,Comuna 1,CIUDAD DE BUENOS AIRES,270,245,290,287,577
02,02001,020011506,Comuna 1,CIUDAD DE BUENOS AIRES,305,300,389,415,804
02,02001,020011711,Comuna 1,CIUDAD DE BUENOS AIRES,218,215,261,213,474
02,02001,020011710,Comuna 1,CIUDAD DE BUENOS AIRES,279,274,310,264,574
02,02001,020011709,Comuna 1,CIUDAD DE BUENOS AIRES,239,238,235,204,439
02,02001,020011410,Comuna 1,CIUDAD DE BUENOS AIRES,220,212,224,207,431
02,02001,020011411,Comuna 1,CIUDAD DE BUENOS AIRES,253,253,268,254,522
02,02001,020011312,Comuna 1,CIUDAD DE BUENOS AIRES,138,138,142,150,292
02,02001,020011412,Comuna 1,CIUDAD DE BUENOS AIRES,217,216,270,241,511
02,02001,020011508,Comuna 1,CIUDAD DE BUENOS AIRES,310,306,424,394,818
02,02001,020011509,Comuna 1,CIUDAD DE BUENOS AIRES,352,330,483,389,872
02,02001,020011905,Comuna 1,CIUDAD DE BUENOS AIRES,271,251,350,293,643
02,02001,020011904,Comuna 1,CIUDAD DE BUENOS AIRES,303,287,364,356,720
02,02001,020011903,Comuna 1,CIUDAD DE BUENOS AIRES,145,140,202,172,374
02,02001,020011902,Comuna 1,CIUDAD DE BUENOS AIRES,498,488,581,485,1066
02,02001,020011901,Comuna 1,CIUDAD DE BUENOS AIRES,424,419,480,412,892
02,02001,020011807,Comuna 1,CIUDAD DE BUENOS AIRES,317,308,403,331,734
02,02001,020011806,Comuna 1,CIUDAD DE BUENOS AIRES,507,476,669,511,1180
02,02001,020012402,Comuna 1,CIUDAD DE BUENOS AIRES,145,141,147,140,287
02,02001,020012401,Comuna 1,CIUDAD DE BUENOS AIRES,113,113,123,125,248
02,02001,020012304,Comuna 1,CIUDAD DE BUENOS AIRES,131,131,196,174,370
02,02001,020012305,Comuna 1,CIUDAD DE BUENOS AIRES,228,219,255,246,501
02,02001,020012303,Comuna 1,CIUDAD DE BUENOS AIRES,373,369,402,388,790
02,02001,020012301,Comuna 1,CIUDAD DE BUENOS AIRES,272,261,332,275,607
02,02001,020011311,Comuna 1,CIUDAD DE BUENOS AIRES,142,137,146,146,292
02,02001,020011511,Comuna 1,CIUDAD DE BUENOS AIRES,281,237,278,276,554
02,02001,020011510,Comuna 1,CIUDAD DE BUENOS AIRES,291,270,343,282,625
02,02001,020011906,Comuna 1,CIUDAD DE BUENOS AIRES,216,202,217,214,431
02,02001,020011907,Comuna 1,CIUDAD DE BUENOS AIRES,325,317,376,370,746
02,02001,020011909,Comuna 1,CIUDAD DE BUENOS AIRES,223,219,286,221,507
02,02001,020011908,Comuna 1,CIUDAD DE BUENOS AIRES,160,156,210,240,450
02,02001,020011808,Comuna 1,CIUDAD DE BUENOS AIRES,301,297,350,324,674
02,02001,020011809,Comuna 1,CIUDAD DE BUENOS AIRES,303,297,343,307,650
02,02001,020012403,Comuna 1,CIUDAD DE BUENOS AIRES,200,159,238,296,534
02,02001,020012307,Comuna 1,CIUDAD DE BUENOS AIRES,265,249,286,282,568
02,02001,020012306,Comuna 1,CIUDAD DE BUENOS AIRES,214,208,274,210,484
02,02001,020012302,Comuna 1,CIUDAD DE BUENOS AIRES,219,210,267,258,525
02,02001,020012202,Comuna 1,CIUDAD DE BUENOS AIRES,422,417,458,352,810
02,02001,020012201,Comuna 1,CIUDAD DE BUENOS AIRES,261,228,302,265,567
02,02001,020012102,Comuna 1,CIUDAD DE BUENOS AIRES,266,249,323,317,640
02,02001,020012101,Comuna 1,CIUDAD DE BUENOS AIRES,266,265,352,275,627
02,02001,020012002,Comuna 1,CIUDAD DE BUENOS AIRES,298,296,407,331,738
02,02001,020012001,Comuna 1,CIUDAD DE BUENOS AIRES,259,255,342,285,627
02,02001,020011315,Comuna 1,CIUDAD DE BUENOS AIRES,0,0,0,0,0
02,02001,020012103,Comuna 1,CIUDAD DE BUENOS AIRES,170,126,208,192,400
02,02001,020012405,Comuna 1,CIUDAD DE BUENOS AIRES,168,161,192,153,345
02,02001,020012203,Comuna 1,CIUDAD DE BUENOS AIRES,371,354,447,370,817
02,02001,020012104,Comuna 1,CIUDAD DE BUENOS AIRES,500,462,608,552,1160
02,02001,020012404,Comuna 1,CIUDAD DE BUENOS AIRES,168,166,159,169,328
02,02001,020012105,Comuna 1,CIUDAD DE BUENOS AIRES,275,271,370,354,724
02,02001,020012310,Comuna 1,CIUDAD DE BUENOS AIRES,150,145,185,177,362
02,02001,020012308,Comuna 1,CIUDAD DE BUENOS AIRES,315,286,355,326,681
02,02001,020012309,Comuna 1,CIUDAD DE BUENOS AIRES,405,400,475,423,898
02,02001,020012106,Comuna 1,CIUDAD DE BUENOS AIRES,264,257,328,274,602
02,02001,020012003,Comuna 1,CIUDAD DE BUENOS AIRES,238,234,313,254,567
02,02001,020012004,Comuna 1,CIUDAD DE BUENOS AIRES,343,342,456,313,769
02,02001,020012005,Comuna 1,CIUDAD DE BUENOS AIRES,352,346,396,304,700
02,02001,020012406,Comuna 1,CIUDAD DE BUENOS AIRES,365,346,389,331,720
02,02001,020012407,Comuna 1,CIUDAD DE BUENOS AIRES,261,256,285,281,566
02,02001,020012503,Comuna 1,CIUDAD DE BUENOS AIRES,221,221,288,225,513
02,02001,020012502,Comuna 1,CIUDAD DE BUENOS AIRES,179,174,198,190,388
02,02001,020012501,Comuna 1,CIUDAD DE BUENOS AIRES,175,171,226,198,424
02,02001,020012110,Comuna 1,CIUDAD DE BUENOS AIRES,376,357,425,391,816
02,02001,020012205,Comuna 1,CIUDAD DE BUENOS AIRES,186,184,269,178,447
02,02001,020012602,Comuna 1,CIUDAD DE BUENOS AIRES,320,298,388,289,677
02,02001,020012108,Comuna 1,CIUDAD DE BUENOS AIRES,240,238,310,243,553
02,02001,020012204,Comuna 1,CIUDAD DE BUENOS AIRES,207,196,243,203,446
02,02001,020012601,Comuna 1,CIUDAD DE BUENOS AIRES,249,241,327,312,639
02,02001,020012107,Comuna 1,CIUDAD DE BUENOS AIRES,332,325,410,375,785
02,02001,020012008,Comuna 1,CIUDAD DE BUENOS AIRES,218,216,314,249,563
02,02001,020012007,Comuna 1,CIUDAD DE BUENOS AIRES,207,205,270,211,481
02,02001,020012006,Comuna 1,CIUDAD DE BUENOS AIRES,336,311,436,349,785
02,02001,020012505,Comuna 1,CIUDAD DE BUENOS AIRES,226,220,261,216,477
02,02001,020012603,Comuna 1,CIUDAD DE BUENOS AIRES,217,213,251,189,440
02,02001,020012207,Comuna 1,CIUDAD DE BUENOS AIRES,268,257,279,283,562
02,02001,020012604,Comuna 1,CIUDAD DE BUENOS AIRES,244,239,304,249,553
02,02001,020012206,Comuna 1,CIUDAD DE BUENOS AIRES,259,242,331,247,578
02,02001,020012109,Comuna 1,CIUDAD DE BUENOS AIRES,328,322,390,319,709
02,02001,020012009,Comuna 1,CIUDAD DE BUENOS AIRES,247,237,297,275,572
02,02001,020012010,Comuna 1,CIUDAD DE BUENOS AIRES,316,306,462,398,860
02,02001,020012504,Comuna 1,CIUDAD DE BUENOS AIRES,430,409,463,449,912
02,02001,020012606,Comuna 1,CIUDAD DE BUENOS AIRES,214,214,271,194,465
02,02001,020012605,Comuna 1,CIUDAD DE BUENOS AIRES,310,299,367,316,683
02,02001,020012208,Comuna 1,CIUDAD DE BUENOS AIRES,276,272,279,254,533
02,02001,020012209,Comuna 1,CIUDAD DE BUENOS AIRES,377,368,467,413,880
02,02001,020012807,Comuna 1,CIUDAD DE BUENOS AIRES,314,293,379,348,727
02,02001,020012805,Comuna 1,CIUDAD DE BUENOS AIRES,354,348,432,373,805
02,02001,020012804,Comuna 1,CIUDAD DE BUENOS AIRES,280,271,380,281,661
02,02001,020012801,Comuna 1,CIUDAD DE BUENOS AIRES,220,214,286,226,512
02,02001,020012408,Comuna 1,CIUDAD DE BUENOS AIRES,184,179,226,202,428
02,02001,020012507,Comuna 1,CIUDAD DE BUENOS AIRES,193,191,231,187,418
02,02001,020012506,Comuna 1,CIUDAD DE BUENOS AIRES,351,336,387,365,752
02,02001,020012607,Comuna 1,CIUDAD DE BUENOS AIRES,142,141,185,128,313
02,02001,020012806,Comuna 1,CIUDAD DE BUENOS AIRES,281,273,328,304,632
02,02001,020012210,Comuna 1,CIUDAD DE BUENOS AIRES,582,574,630,601,1231
02,02001,020012803,Comuna 1,CIUDAD DE BUENOS AIRES,241,232,369,308,677
02,02001,020012903,Comuna 1,CIUDAD DE BUENOS AIRES,276,273,426,391,817
02,02001,020012904,Comuna 1,CIUDAD DE BUENOS AIRES,272,242,382,341,723
02,02001,020012905,Comuna 1,CIUDAD DE BUENOS AIRES,306,258,419,385,804
02,02001,020012802,Comuna 1,CIUDAD DE BUENOS AIRES,345,340,388,365,753
02,02001,020012508,Comuna 1,CIUDAD DE BUENOS AIRES,321,316,327,285,612
02,02001,020012509,Comuna 1,CIUDAD DE BUENOS AIRES,212,150,326,332,658
02,02001,020012510,Comuna 1,CIUDAD DE BUENOS AIRES,227,211,288,254,542
02,02001,020012608,Comuna 1,CIUDAD DE BUENOS AIRES,213,212,240,209,449
02,02001,020012808,Comuna 1,CIUDAD DE BUENOS AIRES,110,93,145,161,306
02,02001,020012809,Comuna 1,CIUDAD DE BUENOS AIRES,262,255,365,376,741
02,02001,020012810,Comuna 1,CIUDAD DE BUENOS AIRES,353,337,474,435,909
02,02001,020012811,Comuna 1,CIUDAD DE BUENOS AIRES,249,236,300,310,610
02,02001,020012812,Comuna 1,CIUDAD DE BUENOS AIRES,235,229,297,276,573
02,02001,020012813,Comuna 1,CIUDAD DE BUENOS AIRES,261,241,322,330,652
02,02001,020012710,Comuna 1,CIUDAD DE BUENOS AIRES,248,241,271,242,513
02,02001,020012511,Comuna 1,CIUDAD DE BUENOS AIRES,252,249,286,271,557
02,02001,020012609,Comuna 1,CIUDAD DE BUENOS AIRES,316,311,414,325,739
02,02001,020012709,Comuna 1,CIUDAD DE BUENOS AIRES,324,300,370,353,723
02,02001,020012708,Comuna 1,CIUDAD DE BUENOS AIRES,255,244,362,332,694
02,02001,020012701,Comuna 1,CIUDAD DE BUENOS AIRES,234,230,339,257,596
02,02001,020012702,Comuna 1,CIUDAD DE BUENOS AIRES,275,138,351,429,780
02,02001,020012902,Comuna 1,CIUDAD DE BUENOS AIRES,266,226,312,312,624
02,02001,020012901,Comuna 1,CIUDAD DE BUENOS AIRES,420,395,599,524,1123
02,02001,020012707,Comuna 1,CIUDAD DE BUENOS AIRES,265,228,426,440,866
02,02001,020012706,Comuna 1,CIUDAD DE BUENOS AIRES,359,354,492,437,929
02,02001,020012703,Comuna 1,CIUDAD DE BUENOS AIRES,293,271,475,413,888
02,02001,020012704,Comuna 1,CIUDAD DE BUENOS AIRES,325,316,442,360,802
02,02001,020012909,Comuna 1,CIUDAD DE BUENOS AIRES,376,342,489,434,923
02,02001,020012908,Comuna 1,CIUDAD DE BUENOS AIRES,260,224,348,300,648
02,02001,020012705,Comuna 1,CIUDAD DE BUENOS AIRES,288,282,343,298,641
02,02001,020012906,Comuna 1,CIUDAD DE BUENOS AIRES,323,319,497,493,990
02,02001,020012907,Comuna 1,CIUDAD DE BUENOS AIRES,328,324,511,405,916
02,02003,020030103,Comuna 3,CIUDAD DE BUENOS AIRES,467,443,565,395,960
02,02003,020030201,Comuna 3,CIUDAD DE BUENOS AIRES,323,320,410,332,742
02,02003,020030202,Comuna 3,CIUDAD DE BUENOS AIRES,333,331,394,320,714
02,02003,020030301,Comuna 3,CIUDAD DE BUENOS AIRES,476,452,616,485,1101
02,02003,020030302,Comuna 3,CIUDAD DE BUENOS AIRES,373,367,462,398,860
02,02003,020030706,Comuna 3,CIUDAD DE BUENOS AIRES,283,279,321,263,584
02,02003,020030707,Comuna 3,CIUDAD DE BUENOS AIRES,504,468,506,416,922
02,02003,020030908,Comuna 3,CIUDAD DE BUENOS AIRES,312,210,375,365,740
02,02003,020030708,Comuna 3,CIUDAD DE BUENOS AIRES,159,159,233,162,395
02,02003,020030709,Comuna 3,CIUDAD DE BUENOS AIRES,404,390,534,397,931
02,02003,020030806,Comuna 3,CIUDAD DE BUENOS AIRES,203,197,263,215,478
02,02003,020030807,Comuna 3,CIUDAD DE BUENOS AIRES,166,165,233,194,427
02,02003,020030808,Comuna 3,CIUDAD DE BUENOS AIRES,207,197,278,246,524
02,02003,020030809,Comuna 3,CIUDAD DE BUENOS AIRES,304,295,385,333,718
02,02003,020030907,Comuna 3,CIUDAD DE BUENOS AIRES,292,214,383,393,776
02,02003,020030810,Comuna 3,CIUDAD DE BUENOS AIRES,256,214,295,252,547
02,02003,020030906,Comuna 3,CIUDAD DE BUENOS AIRES,196,193,259,238,497
02,02003,020030101,Comuna 3,CIUDAD DE BUENOS AIRES,488,474,573,453,1026
02,02003,020030102,Comuna 3,CIUDAD DE BUENOS AIRES,419,409,493,410,903
02,02003,020030303,Comuna 3,CIUDAD DE BUENOS AIRES,260,244,343,271,614
02,02003,020030401,Comuna 3,CIUDAD DE BUENOS AIRES,354,308,419,317,736
02,02003,020030104,Comuna 3,CIUDAD DE BUENOS AIRES,248,241,270,220,490
02,02003,020030403,Comuna 3,CIUDAD DE BUENOS AIRES,279,273,388,293,681
02,02003,020030204,Comuna 3,CIUDAD DE BUENOS AIRES,288,283,393,341,734
02,02003,020030203,Comuna 3,CIUDAD DE BUENOS AIRES,336,316,380,296,676
02,02003,020030501,Comuna 3,CIUDAD DE BUENOS AIRES,373,369,422,380,802
02,02003,020030306,Comuna 3,CIUDAD DE BUENOS AIRES,302,293,460,363,823
02,02003,020030507,Comuna 3,CIUDAD DE BUENOS AIRES,368,350,436,332,768
02,02003,020030506,Comuna 3,CIUDAD DE BUENOS AIRES,215,203,243,198,441
02,02003,020030505,Comuna 3,CIUDAD DE BUENOS AIRES,330,324,354,256,610
02,02003,020030305,Comuna 3,CIUDAD DE BUENOS AIRES,245,234,304,275,579
02,02003,020030304,Comuna 3,CIUDAD DE BUENOS AIRES,213,205,286,230,516
02,02003,020030402,Comuna 3,CIUDAD DE BUENOS AIRES,216,208,275,224,499
02,02003,020030106,Comuna 3,CIUDAD DE BUENOS AIRES,262,252,357,358,715
02,02003,020030105,Comuna 3,CIUDAD DE BUENOS AIRES,374,361,506,403,909
02,02003,020030205,Comuna 3,CIUDAD DE BUENOS AIRES,369,336,473,399,872
02,02003,020030307,Comuna 3,CIUDAD DE BUENOS AIRES,308,300,447,355,802
02,02003,020030308,Comuna 3,CIUDAD DE BUENOS AIRES,263,260,407,319,726
02,02003,020030309,Comuna 3,CIUDAD DE BUENOS AIRES,159,154,149,136,285
02,02003,020030504,Comuna 3,CIUDAD DE BUENOS AIRES,262,248,310,232,542
02,02003,020030206,Comuna 3,CIUDAD DE BUENOS AIRES,367,349,530,397,927
02,02003,020030404,Comuna 3,CIUDAD DE BUENOS AIRES,326,286,413,359,772
02,02003,020030503,Comuna 3,CIUDAD DE BUENOS AIRES,469,449,538,432,970
02,02003,020030502,Comuna 3,CIUDAD DE BUENOS AIRES,291,283,367,281,648
02,02003,020030107,Comuna 3,CIUDAD DE BUENOS AIRES,347,328,417,430,847
02,02003,020030207,Comuna 3,CIUDAD DE BUENOS AIRES,420,394,565,456,1021
02,02003,020030109,Comuna 3,CIUDAD DE BUENOS AIRES,227,217,283,247,530
02,02003,020030310,Comuna 3,CIUDAD DE BUENOS AIRES,393,263,480,470,950
02,02003,020030405,Comuna 3,CIUDAD DE BUENOS AIRES,288,266,356,327,683
02,02003,020030603,Comuna 3,CIUDAD DE BUENOS AIRES,312,293,329,288,617
02,02003,020030602,Comuna 3,CIUDAD DE BUENOS AIRES,175,141,182,169,351
02,02003,020030406,Comuna 3,CIUDAD DE BUENOS AIRES,308,295,352,303,655
02,02003,020030601,Comuna 3,CIUDAD DE BUENOS AIRES,354,351,406,310,716
02,02003,020030108,Comuna 3,CIUDAD DE BUENOS AIRES,188,169,244,247,491
02,02003,020030210,Comuna 3,CIUDAD DE BUENOS AIRES,193,168,253,174,427
02,02003,020030209,Comuna 3,CIUDAD DE BUENOS AIRES,311,275,458,378,836
02,02003,020030208,Comuna 3,CIUDAD DE BUENOS AIRES,354,338,475,391,866
02,02003,020030604,Comuna 3,CIUDAD DE BUENOS AIRES,320,297,336,274,610
02,02003,020030311,Comuna 3,CIUDAD DE BUENOS AIRES,305,305,524,345,869
02,02003,020030605,Comuna 3,CIUDAD DE BUENOS AIRES,329,303,490,376,866
02,02003,020030607,Comuna 3,CIUDAD DE BUENOS AIRES,312,304,383,300,683
02,02003,020030606,Comuna 3,CIUDAD DE BUENOS AIRES,255,250,296,226,522
02,02003,020030407,Comuna 3,CIUDAD DE BUENOS AIRES,270,264,359,315,674
02,02003,020030408,Comuna 3,CIUDAD DE BUENOS AIRES,271,234,371,353,724
02,02003,020030110,Comuna 3,CIUDAD DE BUENOS AIRES,192,174,227,211,438
02,02003,020030111,Comuna 3,CIUDAD DE BUENOS AIRES,230,222,236,226,462
02,02003,020030211,Comuna 3,CIUDAD DE BUENOS AIRES,257,253,305,297,602
02,02003,020030212,Comuna 3,CIUDAD DE BUENOS AIRES,365,298,461,384,845
02,02003,020030801,Comuna 3,CIUDAD DE BUENOS AIRES,321,314,353,294,647
02,02003,020030704,Comuna 3,CIUDAD DE BUENOS AIRES,369,356,502,412,914
02,02003,020030703,Comuna 3,CIUDAD DE BUENOS AIRES,453,432,517,450,967
02,02003,020030702,Comuna 3,CIUDAD DE BUENOS AIRES,415,384,476,388,864
02,02003,020030803,Comuna 3,CIUDAD DE BUENOS AIRES,341,329,455,384,839
02,02003,020030701,Comuna 3,CIUDAD DE BUENOS AIRES,136,133,172,138,310
02,02003,020030805,Comuna 3,CIUDAD DE BUENOS AIRES,216,197,259,237,496
02,02003,020030804,Comuna 3,CIUDAD DE BUENOS AIRES,217,210,296,242,538
02,02003,020030901,Comuna 3,CIUDAD DE BUENOS AIRES,388,380,485,375,860
02,02003,020030902,Comuna 3,CIUDAD DE BUENOS AIRES,206,199,265,221,486
02,02003,020030903,Comuna 3,CIUDAD DE BUENOS AIRES,342,329,421,341,762
02,02003,020030904,Comuna 3,CIUDAD DE BUENOS AIRES,414,375,544,482,1026
02,02003,020030905,Comuna 3,CIUDAD DE BUENOS AIRES,222,206,310,284,594
02,02003,020030802,Comuna 3,CIUDAD DE BUENOS AIRES,212,206,307,245,552
02,02003,020030705,Comuna 3,CIUDAD DE BUENOS AIRES,268,264,308,271,579
02,02003,020031104,Comuna 3,CIUDAD DE BUENOS AIRES,386,360,657,556,1213
02,02003,020031103,Comuna 3,CIUDAD DE BUENOS AIRES,384,338,499,399,898
02,02003,020031102,Comuna 3,CIUDAD DE BUENOS AIRES,454,432,514,420,934
02,02003,020031101,Comuna 3,CIUDAD DE BUENOS AIRES,367,345,454,355,809
02,02003,020031004,Comuna 3,CIUDAD DE BUENOS AIRES,298,278,402,331,733
02,02003,020031003,Comuna 3,CIUDAD DE BUENOS AIRES,257,231,503,449,952
02,02003,020031002,Comuna 3,CIUDAD DE BUENOS AIRES,323,320,441,379,820
02,02003,020031001,Comuna 3,CIUDAD DE BUENOS AIRES,377,376,445,341,786
02,02003,020031105,Comuna 3,CIUDAD DE BUENOS AIRES,316,314,389,315,704
02,02003,020031106,Comuna 3,CIUDAD DE BUENOS AIRES,415,396,492,424,916
02,02003,020031107,Comuna 3,CIUDAD DE BUENOS AIRES,437,426,506,337,843
02,02003,020031108,Comuna 3,CIUDAD DE BUENOS AIRES,284,265,330,254,584
02,02003,020031005,Comuna 3,CIUDAD DE BUENOS AIRES,202,199,277,192,469
02,02003,020031006,Comuna 3,CIUDAD DE BUENOS AIRES,390,371,531,445,976
02,02003,020031007,Comuna 3,CIUDAD DE BUENOS AIRES,340,329,418,324,742
02,02003,020031008,Comuna 3,CIUDAD DE BUENOS AIRES,274,270,358,300,658
02,02003,020030910,Comuna 3,CIUDAD DE BUENOS AIRES,326,291,427,360,787
02,02003,020030909,Comuna 3,CIUDAD DE BUENOS AIRES,371,355,435,368,803
02,02003,020031206,Comuna 3,CIUDAD DE BUENOS AIRES,66,49,120,149,269
02,02003,020031205,Comuna 3,CIUDAD DE BUENOS AIRES,491,473,560,411,971
02,02003,020031204,Comuna 3,CIUDAD DE BUENOS AIRES,249,227,238,253,491
02,02003,020031203,Comuna 3,CIUDAD DE BUENOS AIRES,310,264,357,221,578
02,02003,020031202,Comuna 3,CIUDAD DE BUENOS AIRES,428,396,524,380,904
02,02003,020031201,Comuna 3,CIUDAD DE BUENOS AIRES,350,350,385,294,679
02,02003,020031509,Comuna 3,CIUDAD DE BUENOS AIRES,116,113,173,102,275
02,02003,020031506,Comuna 3,CIUDAD DE BUENOS AIRES,362,352,434,371,805
02,02003,020031505,Comuna 3,CIUDAD DE BUENOS AIRES,382,370,391,364,755
02,02003,020031504,Comuna 3,CIUDAD DE BUENOS AIRES,334,322,427,361,788
02,02003,020031501,Comuna 3,CIUDAD DE BUENOS AIRES,282,268,369,314,683
02,02003,020031604,Comuna 3,CIUDAD DE BUENOS AIRES,178,174,247,217,464
02,02003,020031603,Comuna 3,CIUDAD DE BUENOS AIRES,388,338,475,406,881
02,02003,020031602,Comuna 3,CIUDAD DE BUENOS AIRES,504,486,596,525,1121
02,02003,020031601,Comuna 3,CIUDAD DE BUENOS AIRES,375,366,508,383,891
02,02003,020031207,Comuna 3,CIUDAD DE BUENOS AIRES,466,431,503,425,928
02,02003,020031208,Comuna 3,CIUDAD DE BUENOS AIRES,291,285,320,226,546
02,02003,020031209,Comuna 3,CIUDAD DE BUENOS AIRES,214,205,247,231,478
02,02003,020031210,Comuna 3,CIUDAD DE BUENOS AIRES,363,298,468,377,845
02,02003,020031508,Comuna 3,CIUDAD DE BUENOS AIRES,617,587,726,555,1281
02,02003,020031507,Comuna 3,CIUDAD DE BUENOS AIRES,600,586,683,565,1248
02,02003,020031503,Comuna 3,CIUDAD DE BUENOS AIRES,271,269,362,304,666
02,02003,020031502,Comuna 3,CIUDAD DE BUENOS AIRES,399,367,502,407,909
02,02003,020031605,Comuna 3,CIUDAD DE BUENOS AIRES,267,235,316,348,664
02,02003,020031606,Comuna 3,CIUDAD DE BUENOS AIRES,275,262,361,380,741
02,02003,020031307,Comuna 3,CIUDAD DE BUENOS AIRES,251,248,355,267,622
02,02003,020031306,Comuna 3,CIUDAD DE BUENOS AIRES,323,313,409,326,735
02,02003,020031607,Comuna 3,CIUDAD DE BUENOS AIRES,312,306,404,383,787
02,02003,020031305,Comuna 3,CIUDAD DE BUENOS AIRES,329,321,358,275,633
02,02003,020031304,Comuna 3,CIUDAD DE BUENOS AIRES,208,206,267,249,516
02,02003,020031303,Comuna 3,CIUDAD DE BUENOS AIRES,393,369,447,370,817
02,02003,020031302,Comuna 3,CIUDAD DE BUENOS AIRES,356,327,423,348,771
02,02003,020031405,Comuna 3,CIUDAD DE BUENOS AIRES,365,361,457,387,844
02,02003,020031404,Comuna 3,CIUDAD DE BUENOS AIRES,299,286,431,371,802
02,02003,020031403,Comuna 3,CIUDAD DE BUENOS AIRES,454,446,568,484,1052
02,02003,020031402,Comuna 3,CIUDAD DE BUENOS AIRES,418,385,509,439,948
02,02003,020031401,Comuna 3,CIUDAD DE BUENOS AIRES,346,335,456,424,880
02,02003,020031608,Comuna 3,CIUDAD DE BUENOS AIRES,339,322,406,368,774
02,02003,020031308,Comuna 3,CIUDAD DE BUENOS AIRES,241,238,268,230,498
02,02003,020031309,Comuna 3,CIUDAD DE BUENOS AIRES,369,345,420,303,723
02,02003,020031310,Comuna 3,CIUDAD DE BUENOS AIRES,315,162,348,345,693
02,02003,020031311,Comuna 3,CIUDAD DE BUENOS AIRES,267,260,485,411,896
02,02003,020031301,Comuna 3,CIUDAD DE BUENOS AIRES,305,298,392,352,744
02,02003,020031406,Comuna 3,CIUDAD DE BUENOS AIRES,514,505,601,513,1114
02,02003,020031407,Comuna 3,CIUDAD DE BUENOS AIRES,259,246,345,288,633
02,02003,020031408,Comuna 3,CIUDAD DE BUENOS AIRES,316,308,398,322,720
02,02003,020031409,Comuna 3,CIUDAD DE BUENOS AIRES,43,32,55,48,103
02,02003,020031410,Comuna 3,CIUDAD DE BUENOS AIRES,313,303,494,404,898
02,02003,020031609,Comuna 3,CIUDAD DE BUENOS AIRES,507,492,598,555,1153
02,02003,020032003,Comuna 3,CIUDAD DE BUENOS AIRES,315,312,346,267,613
02,02003,020032002,Comuna 3,CIUDAD DE BUENOS AIRES,444,404,505,375,880
02,02003,020032001,Comuna 3,CIUDAD DE BUENOS AIRES,318,275,331,272,603
02,02003,020031903,Comuna 3,CIUDAD DE BUENOS AIRES,310,293,378,287,665
02,02003,020031902,Comuna 3,CIUDAD DE BUENOS AIRES,152,138,161,140,301
02,02003,020031901,Comuna 3,CIUDAD DE BUENOS AIRES,516,473,653,528,1181
02,02003,020031805,Comuna 3,CIUDAD DE BUENOS AIRES,171,169,217,179,396
02,02003,020031804,Comuna 3,CIUDAD DE BUENOS AIRES,377,354,445,385,830
02,02003,020031803,Comuna 3,CIUDAD DE BUENOS AIRES,189,186,264,222,486
02,02003,020031802,Comuna 3,CIUDAD DE BUENOS AIRES,302,289,399,362,761
02,02003,020031703,Comuna 3,CIUDAD DE BUENOS AIRES,208,202,262,190,452
02,02003,020031904,Comuna 3,CIUDAD DE BUENOS AIRES,295,289,402,325,727
02,02003,020031702,Comuna 3,CIUDAD DE BUENOS AIRES,325,320,423,399,822
02,02003,020032004,Comuna 3,CIUDAD DE BUENOS AIRES,290,286,347,269,616
02,02003,020032005,Comuna 3,CIUDAD DE BUENOS AIRES,232,225,277,205,482
02,02003,020031905,Comuna 3,CIUDAD DE BUENOS AIRES,344,298,405,407,812
02,02003,020031701,Comuna 3,CIUDAD DE BUENOS AIRES,267,257,389,349,738
02,02003,020032006,Comuna 3,CIUDAD DE BUENOS AIRES,189,185,238,247,485
02,02003,020031807,Comuna 3,CIUDAD DE BUENOS AIRES,275,272,368,341,709
02,02003,020031806,Comuna 3,CIUDAD DE BUENOS AIRES,255,242,347,297,644
02,02003,020031808,Comuna 3,CIUDAD DE BUENOS AIRES,254,245,293,245,538
02,02003,020032008,Comuna 3,CIUDAD DE BUENOS AIRES,380,253,422,381,803
02,02003,020032007,Comuna 3,CIUDAD DE BUENOS AIRES,349,333,436,366,802
02,02003,020031801,Comuna 3,CIUDAD DE BUENOS AIRES,256,249,306,267,573
02,02003,020031907,Comuna 3,CIUDAD DE BUENOS AIRES,413,309,493,456,949
02,02003,020031704,Comuna 3,CIUDAD DE BUENOS AIRES,332,325,465,440,905
02,02003,020031705,Comuna 3,CIUDAD DE BUENOS AIRES,324,261,419,392,811
02,02003,020031906,Comuna 3,CIUDAD DE BUENOS AIRES,336,323,422,359,781
02,02003,020031706,Comuna 3,CIUDAD DE BUENOS AIRES,327,318,405,321,726
02,02003,020031810,Comuna 3,CIUDAD DE BUENOS AIRES,208,194,313,268,581
02,02003,020031809,Comuna 3,CIUDAD DE BUENOS AIRES,395,381,485,410,895
02,02003,020032009,Comuna 3,CIUDAD DE BUENOS AIRES,458,453,549,425,974
02,02003,020032010,Comuna 3,CIUDAD DE BUENOS AIRES,287,286,356,270,626
02,02003,020032011,Comuna 3,CIUDAD DE BUENOS AIRES,239,238,284,195,479
02,02003,020031908,Comuna 3,CIUDAD DE BUENOS AIRES,499,453,630,530,1160
02,02003,020031909,Comuna 3,CIUDAD DE BUENOS AIRES,304,292,355,334,689
02,02003,020031709,Comuna 3,CIUDAD DE BUENOS AIRES,281,242,381,326,707
02,02003,020031910,Comuna 3,CIUDAD DE BUENOS AIRES,236,231,275,245,520
02,02003,020031811,Comuna 3,CIUDAD DE BUENOS AIRES,249,240,335,262,597
02,02003,020031708,Comuna 3,CIUDAD DE BUENOS AIRES,383,349,634,548,1182
02,02003,020032101,Comuna 3,CIUDAD DE BUENOS AIRES,376,374,515,444,959
02,02003,020032202,Comuna 3,CIUDAD DE BUENOS AIRES,294,291,353,305,658
02,02003,020032201,Comuna 3,CIUDAD DE BUENOS AIRES,342,289,442,345,787
02,02003,020032302,Comuna 3,CIUDAD DE BUENOS AIRES,347,329,456,347,803
02,02003,020032301,Comuna 3,CIUDAD DE BUENOS AIRES,330,303,443,356,799
02,02003,020031707,Comuna 3,CIUDAD DE BUENOS AIRES,344,338,468,412,880
02,02003,020032403,Comuna 3,CIUDAD DE BUENOS AIRES,276,272,376,275,651
02,02003,020032402,Comuna 3,CIUDAD DE BUENOS AIRES,336,289,463,388,851
02,02003,020032401,Comuna 3,CIUDAD DE BUENOS AIRES,303,292,385,307,692
02,02003,020032503,Comuna 3,CIUDAD DE BUENOS AIRES,207,176,294,255,549
02,02003,020032103,Comuna 3,CIUDAD DE BUENOS AIRES,308,284,411,328,739
02,02003,020032102,Comuna 3,CIUDAD DE BUENOS AIRES,397,386,493,419,912
02,02003,020032203,Comuna 3,CIUDAD DE BUENOS AIRES,181,173,214,193,407
02,02003,020032502,Comuna 3,CIUDAD DE BUENOS AIRES,295,259,368,341,709
02,02003,020032303,Comuna 3,CIUDAD DE BUENOS AIRES,367,344,428,382,810
02,02003,020032404,Comuna 3,CIUDAD DE BUENOS AIRES,311,301,373,328,701
02,02003,020032504,Comuna 3,CIUDAD DE BUENOS AIRES,272,258,373,323,696
02,02003,020032501,Comuna 3,CIUDAD DE BUENOS AIRES,510,507,673,548,1221
02,02003,020032104,Comuna 3,CIUDAD DE BUENOS AIRES,347,339,415,353,768
02,02003,020032204,Comuna 3,CIUDAD DE BUENOS AIRES,246,208,261,252,513
02,02003,020032205,Comuna 3,CIUDAD DE BUENOS AIRES,359,357,444,365,809
02,02003,020032505,Comuna 3,CIUDAD DE BUENOS AIRES,296,202,443,386,829
02,02003,020032304,Comuna 3,CIUDAD DE BUENOS AIRES,191,185,237,211,448
02,02003,020032405,Comuna 3,CIUDAD DE BUENOS AIRES,225,220,284,233,517
02,02003,020032406,Comuna 3,CIUDAD DE BUENOS AIRES,375,359,598,476,1074
02,02003,020032506,Comuna 3,CIUDAD DE BUENOS AIRES,337,317,515,444,959
02,02003,020032105,Comuna 3,CIUDAD DE BUENOS AIRES,219,208,273,234,507
02,02003,020032106,Comuna 3,CIUDAD DE BUENOS AIRES,387,366,448,349,797
02,02003,020032206,Comuna 3,CIUDAD DE BUENOS AIRES,302,221,402,351,753
02,02003,020032306,Comuna 3,CIUDAD DE BUENOS AIRES,242,224,321,289,610
02,02003,020032305,Comuna 3,CIUDAD DE BUENOS AIRES,291,291,346,268,614
02,02003,020032409,Comuna 3,CIUDAD DE BUENOS AIRES,185,183,243,215,458
02,02003,020032408,Comuna 3,CIUDAD DE BUENOS AIRES,320,299,416,337,753
02,02003,020032601,Comuna 3,CIUDAD DE BUENOS AIRES,398,362,516,384,900
02,02003,020032407,Comuna 3,CIUDAD DE BUENOS AIRES,297,292,351,323,674
02,02003,020032602,Comuna 3,CIUDAD DE BUENOS AIRES,440,405,590,572,1162
02,02003,020032507,Comuna 3,CIUDAD DE BUENOS AIRES,228,223,275,252,527
02,02003,020032107,Comuna 3,CIUDAD DE BUENOS AIRES,199,198,232,173,405
02,02003,020032508,Comuna 3,CIUDAD DE BUENOS AIRES,716,694,888,665,1553
02,02003,020032207,Comuna 3,CIUDAD DE BUENOS AIRES,330,305,409,328,737
02,02003,020032208,Comuna 3,CIUDAD DE BUENOS AIRES,375,363,488,443,931
02,02003,020032307,Comuna 3,CIUDAD DE BUENOS AIRES,274,243,353,308,661
02,02003,020032509,Comuna 3,CIUDAD DE BUENOS AIRES,319,312,415,331,746
02,02003,020032308,Comuna 3,CIUDAD DE BUENOS AIRES,336,332,480,400,880
02,02003,020032703,Comuna 3,CIUDAD DE BUENOS AIRES,355,322,461,445,906
02,02003,020032702,Comuna 3,CIUDAD DE BUENOS AIRES,330,286,446,396,842
02,02003,020032108,Comuna 3,CIUDAD DE BUENOS AIRES,314,304,392,298,690
02,02003,020032701,Comuna 3,CIUDAD DE BUENOS AIRES,400,374,523,443,966
02,02003,020032605,Comuna 3,CIUDAD DE BUENOS AIRES,341,322,452,382,834
02,02003,020032604,Comuna 3,CIUDAD DE BUENOS AIRES,227,223,273,244,517
02,02003,020032603,Comuna 3,CIUDAD DE BUENOS AIRES,334,327,457,346,803
02,02003,020032704,Comuna 3,CIUDAD DE BUENOS AIRES,313,304,432,402,834
02,02003,020032110,Comuna 3,CIUDAD DE BUENOS AIRES,416,400,534,438,972
02,02003,020032109,Comuna 3,CIUDAD DE BUENOS AIRES,188,186,239,177,416
02,02003,020032209,Comuna 3,CIUDAD DE BUENOS AIRES,373,368,498,441,939
02,02003,020032705,Comuna 3,CIUDAD DE BUENOS AIRES,317,296,423,358,781
02,02003,020032310,Comuna 3,CIUDAD DE BUENOS AIRES,397,362,547,497,1044
02,02003,020032309,Comuna 3,CIUDAD DE BUENOS AIRES,342,314,495,477,972
02,02003,020032606,Comuna 3,CIUDAD DE BUENOS AIRES,246,221,323,282,605
02,02003,020032608,Comuna 3,CIUDAD DE BUENOS AIRES,246,240,310,276,586
02,02003,020032707,Comuna 3,CIUDAD DE BUENOS AIRES,367,318,506,426,932
02,02003,020032607,Comuna 3,CIUDAD DE BUENOS AIRES,312,296,427,388,815
02,02003,020032706,Comuna 3,CIUDAD DE BUENOS AIRES,306,256,428,410,838
02,02003,020032609,Comuna 3,CIUDAD DE BUENOS AIRES,292,264,414,376,790
02,02005,020050101,Comuna 5,CIUDAD DE BUENOS AIRES,253,250,325,228,553
02,02005,020050106,Comuna 5,CIUDAD DE BUENOS AIRES,209,205,313,185,498
02,02005,020050104,Comuna 5,CIUDAD DE BUENOS AIRES,314,307,376,307,683
02,02005,020050105,Comuna 5,CIUDAD DE BUENOS AIRES,472,448,620,483,1103
02,02005,020050103,Comuna 5,CIUDAD DE BUENOS AIRES,361,325,409,366,775
02,02005,020050201,Comuna 5,CIUDAD DE BUENOS AIRES,336,320,504,371,875
02,02005,020050102,Comuna 5,CIUDAD DE BUENOS AIRES,411,370,491,388,879
02,02005,020050203,Comuna 5,CIUDAD DE BUENOS AIRES,325,297,389,334,723
02,02005,020050204,Comuna 5,CIUDAD DE BUENOS AIRES,461,427,519,422,941
02,02005,020050205,Comuna 5,CIUDAD DE BUENOS AIRES,222,220,353,215,568
02,02005,020050107,Comuna 5,CIUDAD DE BUENOS AIRES,302,302,342,283,625
02,02005,020050109,Comuna 5,CIUDAD DE BUENOS AIRES,349,344,383,308,691
02,02005,020050202,Comuna 5,CIUDAD DE BUENOS AIRES,270,262,328,288,616
02,02005,020050206,Comuna 5,CIUDAD DE BUENOS AIRES,258,225,323,287,610
02,02005,020050108,Comuna 5,CIUDAD DE BUENOS AIRES,323,316,395,347,742
02,02005,020050211,Comuna 5,CIUDAD DE BUENOS AIRES,394,383,466,375,841
02,02005,020050501,Comuna 5,CIUDAD DE BUENOS AIRES,348,335,448,336,784
02,02005,020050209,Comuna 5,CIUDAD DE BUENOS AIRES,339,324,438,399,837
02,02005,020050504,Comuna 5,CIUDAD DE BUENOS AIRES,288,287,405,322,727
02,02005,020050210,Comuna 5,CIUDAD DE BUENOS AIRES,301,291,349,326,675
02,02005,020050506,Comuna 5,CIUDAD DE BUENOS AIRES,315,313,399,317,716
02,02005,020050110,Comuna 5,CIUDAD DE BUENOS AIRES,312,300,390,283,673
02,02005,020050207,Comuna 5,CIUDAD DE BUENOS AIRES,246,240,322,250,572
02,02005,020050507,Comuna 5,CIUDAD DE BUENOS AIRES,422,419,504,386,890
02,02005,020050401,Comuna 5,CIUDAD DE BUENOS AIRES,420,409,602,428,1030
02,02005,020050402,Comuna 5,CIUDAD DE BUENOS AIRES,347,342,409,317,726
02,02005,020050502,Comuna 5,CIUDAD DE BUENOS AIRES,592,563,745,608,1353
02,02005,020050403,Comuna 5,CIUDAD DE BUENOS AIRES,319,283,385,318,703
02,02005,020050503,Comuna 5,CIUDAD DE BUENOS AIRES,370,350,420,323,743
02,02005,020050404,Comuna 5,CIUDAD DE BUENOS AIRES,341,275,382,317,699
02,02005,020050208,Comuna 5,CIUDAD DE BUENOS AIRES,433,431,544,523,1067
02,02005,020050505,Comuna 5,CIUDAD DE BUENOS AIRES,244,240,336,257,593
02,02005,020050508,Comuna 5,CIUDAD DE BUENOS AIRES,324,322,388,322,710
02,02005,020050301,Comuna 5,CIUDAD DE BUENOS AIRES,320,313,409,348,757
02,02005,020050409,Comuna 5,CIUDAD DE BUENOS AIRES,337,330,437,341,778
02,02005,020050408,Comuna 5,CIUDAD DE BUENOS AIRES,516,495,602,492,1094
02,02005,020050302,Comuna 5,CIUDAD DE BUENOS AIRES,507,479,586,559,1145
02,02005,020050407,Comuna 5,CIUDAD DE BUENOS AIRES,253,250,311,242,553
02,02005,020050601,Comuna 5,CIUDAD DE BUENOS AIRES,304,301,410,330,740
02,02005,020050602,Comuna 5,CIUDAD DE BUENOS AIRES,437,405,539,452,991
02,02005,020050603,Comuna 5,CIUDAD DE BUENOS AIRES,438,435,508,369,877
02,02005,020050406,Comuna 5,CIUDAD DE BUENOS AIRES,504,501,550,477,1027
02,02005,020050604,Comuna 5,CIUDAD DE BUENOS AIRES,660,647,804,677,1481
02,02005,020050405,Comuna 5,CIUDAD DE BUENOS AIRES,331,330,396,327,723
02,02005,020050605,Comuna 5,CIUDAD DE BUENOS AIRES,558,542,640,494,1134
02,02005,020050702,Comuna 5,CIUDAD DE BUENOS AIRES,222,208,311,227,538
02,02005,020050701,Comuna 5,CIUDAD DE BUENOS AIRES,529,514,675,531,1206
02,02005,020050801,Comuna 5,CIUDAD DE BUENOS AIRES,547,545,646,525,1171
02,02005,020050802,Comuna 5,CIUDAD DE BUENOS AIRES,320,317,396,307,703
02,02005,020050303,Comuna 5,CIUDAD DE BUENOS AIRES,177,138,193,176,369
02,02005,020050803,Comuna 5,CIUDAD DE BUENOS AIRES,504,493,656,524,1180
02,02005,020050703,Comuna 5,CIUDAD DE BUENOS AIRES,276,269,366,274,640
02,02005,020050901,Comuna 5,CIUDAD DE BUENOS AIRES,472,451,607,475,1082
02,02005,020050902,Comuna 5,CIUDAD DE BUENOS AIRES,287,275,346,255,601
02,02005,020050306,Comuna 5,CIUDAD DE BUENOS AIRES,303,297,369,300,669
02,02005,020050608,Comuna 5,CIUDAD DE BUENOS AIRES,385,376,498,424,922
02,02005,020050305,Comuna 5,CIUDAD DE BUENOS AIRES,336,318,383,344,727
02,02005,020050606,Comuna 5,CIUDAD DE BUENOS AIRES,407,364,479,428,907
02,02005,020050304,Comuna 5,CIUDAD DE BUENOS AIRES,235,227,340,242,582
02,02005,020050704,Comuna 5,CIUDAD DE BUENOS AIRES,605,591,762,602,1364
02,02005,020050705,Comuna 5,CIUDAD DE BUENOS AIRES,618,598,739,556,1295
02,02005,020050904,Comuna 5,CIUDAD DE BUENOS AIRES,232,231,310,216,526
02,02005,020050706,Comuna 5,CIUDAD DE BUENOS AIRES,300,291,359,268,627
02,02005,020050903,Comuna 5,CIUDAD DE BUENOS AIRES,268,265,316,259,575
02,02005,020050805,Comuna 5,CIUDAD DE BUENOS AIRES,175,172,209,192,401
02,02005,020050607,Comuna 5,CIUDAD DE BUENOS AIRES,418,394,476,418,894
02,02005,020050804,Comuna 5,CIUDAD DE BUENOS AIRES,454,446,572,418,990
02,02005,020050307,Comuna 5,CIUDAD DE BUENOS AIRES,297,293,329,234,563
02,02005,020050308,Comuna 5,CIUDAD DE BUENOS AIRES,163,162,192,165,357
02,02005,020050905,Comuna 5,CIUDAD DE BUENOS AIRES,260,257,308,268,576
02,02005,020050906,Comuna 5,CIUDAD DE BUENOS AIRES,245,240,306,266,572
02,02005,020050907,Comuna 5,CIUDAD DE BUENOS AIRES,220,218,270,215,485
02,02005,020050310,Comuna 5,CIUDAD DE BUENOS AIRES,241,225,295,240,535
02,02005,020051102,Comuna 5,CIUDAD DE BUENOS AIRES,389,377,477,417,894
02,02005,020051101,Comuna 5,CIUDAD DE BUENOS AIRES,536,514,633,511,1144
02,02005,020050707,Comuna 5,CIUDAD DE BUENOS AIRES,196,196,477,417,894
02,02005,020050309,Comuna 5,CIUDAD DE BUENOS AIRES,309,303,325,285,610
02,02005,020050806,Comuna 5,CIUDAD DE BUENOS AIRES,394,385,532,364,896
02,02005,020050807,Comuna 5,CIUDAD DE BUENOS AIRES,399,393,493,362,855
02,02005,020050909,Comuna 5,CIUDAD DE BUENOS AIRES,438,424,485,439,924
02,02005,020051103,Comuna 5,CIUDAD DE BUENOS AIRES,281,272,370,324,694
02,02005,020050908,Comuna 5,CIUDAD DE BUENOS AIRES,454,453,525,416,941
02,02005,020050311,Comuna 5,CIUDAD DE BUENOS AIRES,386,383,440,399,839
02,02005,020050708,Comuna 5,CIUDAD DE BUENOS AIRES,394,370,516,393,909
02,02005,020050809,Comuna 5,CIUDAD DE BUENOS AIRES,333,326,441,326,767
02,02005,020050808,Comuna 5,CIUDAD DE BUENOS AIRES,353,348,459,375,834
02,02005,020050910,Comuna 5,CIUDAD DE BUENOS AIRES,341,333,445,361,806
02,02005,020051006,Comuna 5,CIUDAD DE BUENOS AIRES,314,305,426,365,791
02,02005,020051003,Comuna 5,CIUDAD DE BUENOS AIRES,164,154,229,187,416
02,02005,020051004,Comuna 5,CIUDAD DE BUENOS AIRES,254,242,302,255,557
02,02005,020051002,Comuna 5,CIUDAD DE BUENOS AIRES,548,530,605,477,1082
02,02005,020051005,Comuna 5,CIUDAD DE BUENOS AIRES,269,264,419,330,749
02,02005,020051001,Comuna 5,CIUDAD DE BUENOS AIRES,538,521,652,508,1160
02,02005,020051107,Comuna 5,CIUDAD DE BUENOS AIRES,470,453,599,460,1059
02,02005,020051104,Comuna 5,CIUDAD DE BUENOS AIRES,331,317,386,296,682
02,02005,020051106,Comuna 5,CIUDAD DE BUENOS AIRES,315,310,398,349,747
02,02005,020051105,Comuna 5,CIUDAD DE BUENOS AIRES,321,296,406,358,764
02,02005,020051007,Comuna 5,CIUDAD DE BUENOS AIRES,548,538,659,566,1225
02,02005,020051008,Comuna 5,CIUDAD DE BUENOS AIRES,309,297,381,279,660
02,02005,020051009,Comuna 5,CIUDAD DE BUENOS AIRES,344,316,462,323,785
02,02005,020051010,Comuna 5,CIUDAD DE BUENOS AIRES,256,252,295,245,540
02,02005,020051207,Comuna 5,CIUDAD DE BUENOS AIRES,336,324,460,437,897
02,02005,020051108,Comuna 5,CIUDAD DE BUENOS AIRES,321,316,422,369,791
02,02005,020051109,Comuna 5,CIUDAD DE BUENOS AIRES,459,451,565,461,1026
02,02005,020051501,Comuna 5,CIUDAD DE BUENOS AIRES,521,488,604,500,1104
02,02005,020051206,Comuna 5,CIUDAD DE BUENOS AIRES,769,727,895,680,1575
02,02005,020051502,Comuna 5,CIUDAD DE BUENOS AIRES,530,507,650,449,1099
02,02005,020051201,Comuna 5,CIUDAD DE BUENOS AIRES,293,250,306,300,606
02,02005,020051503,Comuna 5,CIUDAD DE BUENOS AIRES,267,238,322,264,586
02,02005,020051404,Comuna 5,CIUDAD DE BUENOS AIRES,421,415,532,399,931
02,02005,020051403,Comuna 5,CIUDAD DE BUENOS AIRES,540,532,659,494,1153
02,02005,020051402,Comuna 5,CIUDAD DE BUENOS AIRES,347,342,398,274,672
02,02005,020051110,Comuna 5,CIUDAD DE BUENOS AIRES,354,347,484,371,855
02,02005,020051205,Comuna 5,CIUDAD DE BUENOS AIRES,198,187,270,165,435
02,02005,020051505,Comuna 5,CIUDAD DE BUENOS AIRES,454,450,534,388,922
02,02005,020051504,Comuna 5,CIUDAD DE BUENOS AIRES,568,548,649,537,1186
02,02005,020051401,Comuna 5,CIUDAD DE BUENOS AIRES,274,268,370,289,659
02,02005,020051204,Comuna 5,CIUDAD DE BUENOS AIRES,328,307,404,331,735
02,02005,020051405,Comuna 5,CIUDAD DE BUENOS AIRES,787,697,901,691,1592
02,02005,020051303,Comuna 5,CIUDAD DE BUENOS AIRES,365,348,430,329,759
02,02005,020051203,Comuna 5,CIUDAD DE BUENOS AIRES,426,405,535,414,949
02,02005,020051506,Comuna 5,CIUDAD DE BUENOS AIRES,330,275,470,393,863
02,02005,020051406,Comuna 5,CIUDAD DE BUENOS AIRES,538,512,698,531,1229
02,02005,020051302,Comuna 5,CIUDAD DE BUENOS AIRES,321,319,383,327,710
02,02005,020051202,Comuna 5,CIUDAD DE BUENOS AIRES,840,823,1035,786,1821
02,02005,020051407,Comuna 5,CIUDAD DE BUENOS AIRES,168,165,258,196,454
02,02005,020051507,Comuna 5,CIUDAD DE BUENOS AIRES,313,285,402,321,723
02,02005,020051304,Comuna 5,CIUDAD DE BUENOS AIRES,330,276,411,320,731
02,02005,020051301,Comuna 5,CIUDAD DE BUENOS AIRES,396,392,491,365,856
02,02005,020051409,Comuna 5,CIUDAD DE BUENOS AIRES,426,358,503,404,907
02,02005,020051509,Comuna 5,CIUDAD DE BUENOS AIRES,168,161,214,192,406
02,02005,020051408,Comuna 5,CIUDAD DE BUENOS AIRES,275,267,361,289,650
02,02005,020051508,Comuna 5,CIUDAD DE BUENOS AIRES,331,212,419,356,775
02,02005,020051306,Comuna 5,CIUDAD DE BUENOS AIRES,377,363,472,378,850
02,02005,020051307,Comuna 5,CIUDAD DE BUENOS AIRES,323,316,413,326,739
02,02005,020051308,Comuna 5,CIUDAD DE BUENOS AIRES,421,417,531,409,940
02,02005,020051604,Comuna 5,CIUDAD DE BUENOS AIRES,389,372,576,449,1025
02,02005,020051603,Comuna 5,CIUDAD DE BUENOS AIRES,214,205,336,296,632
02,02005,020051602,Comuna 5,CIUDAD DE BUENOS AIRES,286,273,350,278,628
02,02005,020051601,Comuna 5,CIUDAD DE BUENOS AIRES,404,333,425,408,833
02,02005,020051305,Comuna 5,CIUDAD DE BUENOS AIRES,332,302,441,354,795
02,02005,020051701,Comuna 5,CIUDAD DE BUENOS AIRES,290,282,382,324,706
02,02005,020051702,Comuna 5,CIUDAD DE BUENOS AIRES,353,345,433,382,815
02,02005,020051607,Comuna 5,CIUDAD DE BUENOS AIRES,249,231,308,296,604
02,02005,020051309,Comuna 5,CIUDAD DE BUENOS AIRES,422,412,557,465,1022
02,02005,020051605,Comuna 5,CIUDAD DE BUENOS AIRES,376,357,466,380,846
02,02005,020051606,Comuna 5,CIUDAD DE BUENOS AIRES,309,292,400,315,715
02,02005,020051703,Comuna 5,CIUDAD DE BUENOS AIRES,317,273,415,339,754
02,02005,020051704,Comuna 5,CIUDAD DE BUENOS AIRES,298,285,438,404,842
02,02005,020051705,Comuna 5,CIUDAD DE BUENOS AIRES,309,306,430,317,747
02,02005,020051610,Comuna 5,CIUDAD DE BUENOS AIRES,388,384,493,430,923
02,02005,020051609,Comuna 5,CIUDAD DE BUENOS AIRES,394,377,509,409,918
02,02005,020051608,Comuna 5,CIUDAD DE BUENOS AIRES,376,370,545,485,1030
02,02005,020051708,Comuna 5,CIUDAD DE BUENOS AIRES,385,334,497,441,938
02,02005,020051707,Comuna 5,CIUDAD DE BUENOS AIRES,329,325,491,415,906
02,02005,020051706,Comuna 5,CIUDAD DE BUENOS AIRES,341,325,430,345,775
02,02005,020051611,Comuna 5,CIUDAD DE BUENOS AIRES,424,400,576,487,1063
02,02005,020051709,Comuna 5,CIUDAD DE BUENOS AIRES,253,247,290,268,558
02,02005,020051710,Comuna 5,CIUDAD DE BUENOS AIRES,280,272,388,369,757
02,02005,020051711,Comuna 5,CIUDAD DE BUENOS AIRES,428,389,462,417,879
02,02005,020051906,Comuna 5,CIUDAD DE BUENOS AIRES,330,321,437,371,808
02,02005,020051904,Comuna 5,CIUDAD DE BUENOS AIRES,397,387,559,435,994
02,02005,020051903,Comuna 5,CIUDAD DE BUENOS AIRES,407,395,514,415,929
02,02005,020051901,Comuna 5,CIUDAD DE BUENOS AIRES,344,335,456,400,856
02,02005,020051806,Comuna 5,CIUDAD DE BUENOS AIRES,242,239,381,303,684
02,02005,020051805,Comuna 5,CIUDAD DE BUENOS AIRES,336,328,449,379,828
02,02005,020051803,Comuna 5,CIUDAD DE BUENOS AIRES,343,337,442,410,852
02,02005,020051801,Comuna 5,CIUDAD DE BUENOS AIRES,423,404,512,431,943
02,02005,020051905,Comuna 5,CIUDAD DE BUENOS AIRES,334,320,422,346,768
02,02005,020051902,Comuna 5,CIUDAD DE BUENOS AIRES,282,275,383,309,692
02,02005,020051911,Comuna 5,CIUDAD DE BUENOS AIRES,437,326,548,498,1046
02,02005,020051804,Comuna 5,CIUDAD DE BUENOS AIRES,277,254,413,375,788
02,02005,020051802,Comuna 5,CIUDAD DE BUENOS AIRES,375,319,493,407,900
02,02005,020051909,Comuna 5,CIUDAD DE BUENOS AIRES,294,291,334,271,605
02,02005,020051907,Comuna 5,CIUDAD DE BUENOS AIRES,199,195,234,212,446
02,02005,020051910,Comuna 5,CIUDAD DE BUENOS AIRES,364,351,435,363,798
02,02005,020051908,Comuna 5,CIUDAD DE BUENOS AIRES,429,406,505,417,922
02,02005,020052111,Comuna 5,CIUDAD DE BUENOS AIRES,245,241,368,326,694
02,02005,020052108,Comuna 5,CIUDAD DE BUENOS AIRES,248,240,368,360,728
02,02005,020052006,Comuna 5,CIUDAD DE BUENOS AIRES,288,274,440,406,846
02,02005,020051807,Comuna 5,CIUDAD DE BUENOS AIRES,309,304,396,328,724
02,02005,020051808,Comuna 5,CIUDAD DE BUENOS AIRES,149,147,210,198,408
02,02005,020051809,Comuna 5,CIUDAD DE BUENOS AIRES,267,266,358,331,689
02,02005,020051810,Comuna 5,CIUDAD DE BUENOS AIRES,344,321,469,349,818
02,02005,020052002,Comuna 5,CIUDAD DE BUENOS AIRES,410,399,491,439,930
02,02005,020052001,Comuna 5,CIUDAD DE BUENOS AIRES,316,308,413,351,764
02,02005,020052105,Comuna 5,CIUDAD DE BUENOS AIRES,266,264,355,285,640
02,02005,020052104,Comuna 5,CIUDAD DE BUENOS AIRES,370,335,485,429,914
02,02005,020051811,Comuna 5,CIUDAD DE BUENOS AIRES,315,304,427,291,718
02,02005,020052103,Comuna 5,CIUDAD DE BUENOS AIRES,209,208,303,228,531
02,02005,020052102,Comuna 5,CIUDAD DE BUENOS AIRES,350,338,461,396,857
02,02005,020052101,Comuna 5,CIUDAD DE BUENOS AIRES,378,372,470,390,860
02,02005,020052003,Comuna 5,CIUDAD DE BUENOS AIRES,385,360,578,487,1065
02,02005,020052106,Comuna 5,CIUDAD DE BUENOS AIRES,337,324,398,319,717
02,02005,020052107,Comuna 5,CIUDAD DE BUENOS AIRES,257,241,353,366,719
02,02005,020052109,Comuna 5,CIUDAD DE BUENOS AIRES,236,231,371,355,726
02,02005,020052110,Comuna 5,CIUDAD DE BUENOS AIRES,253,228,337,262,599
02,02005,020052004,Comuna 5,CIUDAD DE BUENOS AIRES,314,306,429,375,804
02,02005,020052204,Comuna 5,CIUDAD DE BUENOS AIRES,362,351,499,437,936
02,02005,020052203,Comuna 5,CIUDAD DE BUENOS AIRES,260,232,353,276,629
02,02005,020052005,Comuna 5,CIUDAD DE BUENOS AIRES,332,320,460,441,901
02,02005,020052202,Comuna 5,CIUDAD DE BUENOS AIRES,292,284,437,390,827
02,02005,020052201,Comuna 5,CIUDAD DE BUENOS AIRES,260,248,391,347,738
02,02005,020052007,Comuna 5,CIUDAD DE BUENOS AIRES,315,279,469,443,912
02,02005,020052206,Comuna 5,CIUDAD DE BUENOS AIRES,332,276,481,457,938
02,02005,020052205,Comuna 5,CIUDAD DE BUENOS AIRES,277,274,423,378,801
02,02005,020052008,Comuna 5,CIUDAD DE BUENOS AIRES,317,265,468,439,907
02,02005,020052207,Comuna 5,CIUDAD DE BUENOS AIRES,724,711,874,722,1596
02,02005,020052210,Comuna 5,CIUDAD DE BUENOS AIRES,296,266,465,393,858
02,02005,020052012,Comuna 5,CIUDAD DE BUENOS AIRES,297,238,450,455,905
02,02005,020052009,Comuna 5,CIUDAD DE BUENOS AIRES,326,305,453,408,861
02,02005,020052209,Comuna 5,CIUDAD DE BUENOS AIRES,278,264,484,417,901
02,02005,020052010,Comuna 5,CIUDAD DE BUENOS AIRES,380,376,516,446,962
02,02005,020052208,Comuna 5,CIUDAD DE BUENOS AIRES,246,210,381,332,713
02,02005,020052011,Comuna 5,CIUDAD DE BUENOS AIRES,302,272,432,398,830
02,02005,020052211,Comuna 5,CIUDAD DE BUENOS AIRES,320,293,470,424,894
02,02005,020052213,Comuna 5,CIUDAD DE BUENOS AIRES,218,211,383,295,678
02,02005,020052212,Comuna 5,CIUDAD DE BUENOS AIRES,326,278,485,424,909
02,02006,020060101,Comuna 6,CIUDAD DE BUENOS AIRES,242,202,355,322,677
02,02006,020060108,Comuna 6,CIUDAD DE BUENOS AIRES,310,307,492,379,871
02,02006,020060308,Comuna 6,CIUDAD DE BUENOS AIRES,305,297,419,313,732
02,02006,020060504,Comuna 6,CIUDAD DE BUENOS AIRES,293,291,329,308,637
02,02006,020060502,Comuna 6,CIUDAD DE BUENOS AIRES,453,449,569,446,1015
02,02006,020060309,Comuna 6,CIUDAD DE BUENOS AIRES,451,426,612,530,1142
02,02006,020060701,Comuna 6,CIUDAD DE BUENOS AIRES,280,280,329,264,593
02,02006,020060703,Comuna 6,CIUDAD DE BUENOS AIRES,278,277,516,438,954
02,02006,020060702,Comuna 6,CIUDAD DE BUENOS AIRES,343,335,444,359,803
02,02006,020060103,Comuna 6,CIUDAD DE BUENOS AIRES,347,337,488,400,888
02,02006,020060104,Comuna 6,CIUDAD DE BUENOS AIRES,274,267,382,316,698
02,02006,020060706,Comuna 6,CIUDAD DE BUENOS AIRES,260,256,359,323,682
02,02006,020060102,Comuna 6,CIUDAD DE BUENOS AIRES,345,305,440,384,824
02,02006,020060105,Comuna 6,CIUDAD DE BUENOS AIRES,431,422,625,499,1124
02,02006,020060505,Comuna 6,CIUDAD DE BUENOS AIRES,392,375,503,436,939
02,02006,020060106,Comuna 6,CIUDAD DE BUENOS AIRES,348,340,499,439,938
02,02006,020060107,Comuna 6,CIUDAD DE BUENOS AIRES,260,244,376,316,692
02,02006,020060307,Comuna 6,CIUDAD DE BUENOS AIRES,370,360,480,396,876
02,02006,020060704,Comuna 6,CIUDAD DE BUENOS AIRES,372,359,479,390,869
02,02006,020060503,Comuna 6,CIUDAD DE BUENOS AIRES,372,366,430,344,774
02,02006,020060302,Comuna 6,CIUDAD DE BUENOS AIRES,303,297,481,393,874
02,02006,020060705,Comuna 6,CIUDAD DE BUENOS AIRES,359,357,428,356,784
02,02006,020060306,Comuna 6,CIUDAD DE BUENOS AIRES,356,347,481,399,880
02,02006,020060310,Comuna 6,CIUDAD DE BUENOS AIRES,393,383,457,407,864
02,02006,020060109,Comuna 6,CIUDAD DE BUENOS AIRES,227,199,362,353,715
02,02006,020060501,Comuna 6,CIUDAD DE BUENOS AIRES,383,375,441,300,741
02,02006,020060507,Comuna 6,CIUDAD DE BUENOS AIRES,334,303,425,324,749
02,02006,020060506,Comuna 6,CIUDAD DE BUENOS AIRES,304,300,362,327,689
02,02006,020060301,Comuna 6,CIUDAD DE BUENOS AIRES,367,348,535,427,962
02,02006,020060303,Comuna 6,CIUDAD DE BUENOS AIRES,349,315,464,445,909
02,02006,020060508,Comuna 6,CIUDAD DE BUENOS AIRES,205,203,254,212,466
02,02006,020060111,Comuna 6,CIUDAD DE BUENOS AIRES,253,245,366,309,675
02,02006,020060305,Comuna 6,CIUDAD DE BUENOS AIRES,260,256,374,346,720
02,02006,020060511,Comuna 6,CIUDAD DE BUENOS AIRES,416,403,529,407,936
02,02006,020060512,Comuna 6,CIUDAD DE BUENOS AIRES,159,158,213,156,369
02,02006,020060707,Comuna 6,CIUDAD DE BUENOS AIRES,399,390,636,515,1151
02,02006,020060710,Comuna 6,CIUDAD DE BUENOS AIRES,326,312,426,352,778
02,02006,020060711,Comuna 6,CIUDAD DE BUENOS AIRES,293,259,317,296,613
02,02006,020060712,Comuna 6,CIUDAD DE BUENOS AIRES,286,260,356,296,652
02,02006,020060404,Comuna 6,CIUDAD DE BUENOS AIRES,319,312,429,344,773
02,02006,020060510,Comuna 6,CIUDAD DE BUENOS AIRES,407,383,515,463,978
02,02006,020060110,Comuna 6,CIUDAD DE BUENOS AIRES,145,142,348,272,620
02,02006,020060304,Comuna 6,CIUDAD DE BUENOS AIRES,243,243,354,281,635
02,02006,020060709,Comuna 6,CIUDAD DE BUENOS AIRES,320,317,415,354,769
02,02006,020060509,Comuna 6,CIUDAD DE BUENOS AIRES,237,236,314,255,569
02,02006,020060403,Comuna 6,CIUDAD DE BUENOS AIRES,339,328,440,391,831
02,02006,020060406,Comuna 6,CIUDAD DE BUENOS AIRES,322,308,409,365,774
02,02006,020060405,Comuna 6,CIUDAD DE BUENOS AIRES,288,285,388,343,731
02,02006,020060713,Comuna 6,CIUDAD DE BUENOS AIRES,236,231,279,212,491
02,02006,020060708,Comuna 6,CIUDAD DE BUENOS AIRES,307,285,409,331,740
02,02006,020060603,Comuna 6,CIUDAD DE BUENOS AIRES,509,502,618,489,1107
02,02006,020060203,Comuna 6,CIUDAD DE BUENOS AIRES,243,232,316,275,591
02,02006,020060801,Comuna 6,CIUDAD DE BUENOS AIRES,355,352,433,399,832
02,02006,020060402,Comuna 6,CIUDAD DE BUENOS AIRES,227,223,350,308,658
02,02006,020060602,Comuna 6,CIUDAD DE BUENOS AIRES,792,781,1005,831,1836
02,02006,020060112,Comuna 6,CIUDAD DE BUENOS AIRES,292,248,349,273,622
02,02006,020060809,Comuna 6,CIUDAD DE BUENOS AIRES,266,253,279,232,511
02,02006,020060401,Comuna 6,CIUDAD DE BUENOS AIRES,208,199,297,257,554
02,02006,020060802,Comuna 6,CIUDAD DE BUENOS AIRES,457,447,547,476,1023
02,02006,020060601,Comuna 6,CIUDAD DE BUENOS AIRES,546,537,610,508,1118
02,02006,020060202,Comuna 6,CIUDAD DE BUENOS AIRES,334,326,462,437,899
02,02006,020060808,Comuna 6,CIUDAD DE BUENOS AIRES,509,391,768,565,1333
02,02006,020060408,Comuna 6,CIUDAD DE BUENOS AIRES,370,354,492,391,883
02,02006,020060810,Comuna 6,CIUDAD DE BUENOS AIRES,334,325,380,297,677
02,02006,020060205,Comuna 6,CIUDAD DE BUENOS AIRES,226,220,335,299,634
02,02006,020060803,Comuna 6,CIUDAD DE BUENOS AIRES,260,234,350,290,640
02,02006,020060407,Comuna 6,CIUDAD DE BUENOS AIRES,242,234,340,333,673
02,02006,020060604,Comuna 6,CIUDAD DE BUENOS AIRES,226,225,274,208,482
02,02006,020060606,Comuna 6,CIUDAD DE BUENOS AIRES,333,329,426,360,786
02,02006,020060204,Comuna 6,CIUDAD DE BUENOS AIRES,247,244,358,309,667
02,02006,020060605,Comuna 6,CIUDAD DE BUENOS AIRES,201,199,384,293,677
02,02006,020060804,Comuna 6,CIUDAD DE BUENOS AIRES,300,288,355,271,626
02,02006,020060409,Comuna 6,CIUDAD DE BUENOS AIRES,322,313,647,433,1080
02,02006,020060807,Comuna 6,CIUDAD DE BUENOS AIRES,319,304,368,296,664
02,02006,020060201,Comuna 6,CIUDAD DE BUENOS AIRES,387,373,554,527,1081
02,02006,020060806,Comuna 6,CIUDAD DE BUENOS AIRES,533,500,723,597,1320
02,02006,020060910,Comuna 6,CIUDAD DE BUENOS AIRES,324,319,409,326,735
02,02006,020060411,Comuna 6,CIUDAD DE BUENOS AIRES,345,342,419,343,762
02,02006,020060805,Comuna 6,CIUDAD DE BUENOS AIRES,251,226,292,219,511
02,02006,020060608,Comuna 6,CIUDAD DE BUENOS AIRES,408,405,559,450,1009
02,02006,020060609,Comuna 6,CIUDAD DE BUENOS AIRES,356,352,435,326,761
02,02006,020060907,Comuna 6,CIUDAD DE BUENOS AIRES,249,246,308,232,540
02,02006,020060410,Comuna 6,CIUDAD DE BUENOS AIRES,339,336,413,391,804
02,02006,020060909,Comuna 6,CIUDAD DE BUENOS AIRES,362,360,475,363,838
02,02006,020060607,Comuna 6,CIUDAD DE BUENOS AIRES,350,348,419,322,741
02,02006,020060908,Comuna 6,CIUDAD DE BUENOS AIRES,196,193,242,159,401
02,02006,020060906,Comuna 6,CIUDAD DE BUENOS AIRES,381,377,469,395,864
02,02006,020061807,Comuna 6,CIUDAD DE BUENOS AIRES,526,495,658,495,1153
02,02006,020060206,Comuna 6,CIUDAD DE BUENOS AIRES,342,329,510,395,905
02,02006,020060209,Comuna 6,CIUDAD DE BUENOS AIRES,252,250,369,291,660
02,02006,020061101,Comuna 6,CIUDAD DE BUENOS AIRES,429,421,575,478,1053
02,02006,020060905,Comuna 6,CIUDAD DE BUENOS AIRES,170,168,278,160,438
02,02006,020060207,Comuna 6,CIUDAD DE BUENOS AIRES,346,345,432,305,737
02,02006,020061102,Comuna 6,CIUDAD DE BUENOS AIRES,242,234,287,263,550
02,02006,020061806,Comuna 6,CIUDAD DE BUENOS AIRES,454,425,580,503,1083
02,02006,020061103,Comuna 6,CIUDAD DE BUENOS AIRES,368,365,463,413,876
02,02006,020061106,Comuna 6,CIUDAD DE BUENOS AIRES,309,299,390,337,727
02,02006,020061108,Comuna 6,CIUDAD DE BUENOS AIRES,369,364,428,351,779
02,02006,020061105,Comuna 6,CIUDAD DE BUENOS AIRES,249,247,301,280,581
02,02006,020061003,Comuna 6,CIUDAD DE BUENOS AIRES,383,376,439,352,791
02,02006,020060901,Comuna 6,CIUDAD DE BUENOS AIRES,297,295,361,239,600
02,02006,020061805,Comuna 6,CIUDAD DE BUENOS AIRES,390,380,476,336,812
02,02006,020060904,Comuna 6,CIUDAD DE BUENOS AIRES,430,427,570,442,1012
02,02006,020061107,Comuna 6,CIUDAD DE BUENOS AIRES,357,325,401,354,755
02,02006,020060902,Comuna 6,CIUDAD DE BUENOS AIRES,260,258,337,261,598
02,02006,020061104,Comuna 6,CIUDAD DE BUENOS AIRES,343,341,423,359,782
02,02006,020061804,Comuna 6,CIUDAD DE BUENOS AIRES,309,306,402,320,722
02,02006,020060210,Comuna 6,CIUDAD DE BUENOS AIRES,334,319,459,458,917
02,02006,020060208,Comuna 6,CIUDAD DE BUENOS AIRES,368,354,592,497,1089
02,02006,020061109,Comuna 6,CIUDAD DE BUENOS AIRES,288,275,399,324,723
02,02006,020060903,Comuna 6,CIUDAD DE BUENOS AIRES,293,278,364,289,653
02,02006,020061004,Comuna 6,CIUDAD DE BUENOS AIRES,337,325,407,305,712
02,02006,020060211,Comuna 6,CIUDAD DE BUENOS AIRES,508,415,705,622,1327
02,02006,020061808,Comuna 6,CIUDAD DE BUENOS AIRES,512,504,601,470,1071
02,02006,020061809,Comuna 6,CIUDAD DE BUENOS AIRES,395,392,457,362,819
02,02006,020061201,Comuna 6,CIUDAD DE BUENOS AIRES,256,256,287,235,522
02,02006,020061005,Comuna 6,CIUDAD DE BUENOS AIRES,461,450,538,421,959
02,02006,020061203,Comuna 6,CIUDAD DE BUENOS AIRES,288,279,343,286,629
02,02006,020061110,Comuna 6,CIUDAD DE BUENOS AIRES,240,227,298,238,536
02,02006,020061006,Comuna 6,CIUDAD DE BUENOS AIRES,455,449,556,400,956
02,02006,020061001,Comuna 6,CIUDAD DE BUENOS AIRES,303,299,348,256,604
02,02006,020061002,Comuna 6,CIUDAD DE BUENOS AIRES,288,285,342,222,564
02,02006,020061801,Comuna 6,CIUDAD DE BUENOS AIRES,263,259,373,250,623
02,02006,020061904,Comuna 6,CIUDAD DE BUENOS AIRES,453,432,567,443,1010
02,02006,020061903,Comuna 6,CIUDAD DE BUENOS AIRES,603,597,814,606,1420
02,02006,020061007,Comuna 6,CIUDAD DE BUENOS AIRES,335,307,349,243,592
02,02006,020061902,Comuna 6,CIUDAD DE BUENOS AIRES,641,632,838,630,1468
02,02006,020061703,Comuna 6,CIUDAD DE BUENOS AIRES,309,304,397,311,708
02,02006,020061901,Comuna 6,CIUDAD DE BUENOS AIRES,385,381,510,377,887
02,02006,020061803,Comuna 6,CIUDAD DE BUENOS AIRES,313,252,356,292,648
02,02006,020061008,Comuna 6,CIUDAD DE BUENOS AIRES,568,553,703,540,1243
02,02006,020061802,Comuna 6,CIUDAD DE BUENOS AIRES,256,242,352,259,611
02,02006,020061702,Comuna 6,CIUDAD DE BUENOS AIRES,419,417,534,365,899
02,02006,020061905,Comuna 6,CIUDAD DE BUENOS AIRES,305,303,433,315,748
02,02006,020061204,Comuna 6,CIUDAD DE BUENOS AIRES,193,191,207,153,360
02,02006,020061906,Comuna 6,CIUDAD DE BUENOS AIRES,439,432,570,447,1017
02,02006,020061009,Comuna 6,CIUDAD DE BUENOS AIRES,246,245,265,236,501
02,02006,020061907,Comuna 6,CIUDAD DE BUENOS AIRES,444,440,554,412,966
02,02006,020061704,Comuna 6,CIUDAD DE BUENOS AIRES,360,355,434,313,747
02,02006,020061202,Comuna 6,CIUDAD DE BUENOS AIRES,228,203,299,257,556
02,02006,020061010,Comuna 6,CIUDAD DE BUENOS AIRES,463,457,544,399,943
02,02006,020061908,Comuna 6,CIUDAD DE BUENOS AIRES,431,422,504,403,907
02,02006,020061705,Comuna 6,CIUDAD DE BUENOS AIRES,839,800,980,750,1730
02,02006,020062005,Comuna 6,CIUDAD DE BUENOS AIRES,384,375,484,352,836
02,02006,020062004,Comuna 6,CIUDAD DE BUENOS AIRES,256,255,289,243,532
02,02006,020061205,Comuna 6,CIUDAD DE BUENOS AIRES,384,382,482,359,841
02,02006,020061701,Comuna 6,CIUDAD DE BUENOS AIRES,416,416,487,351,838
02,02006,020061206,Comuna 6,CIUDAD DE BUENOS AIRES,243,241,320,251,571
02,02006,020062010,Comuna 6,CIUDAD DE BUENOS AIRES,385,379,508,356,864
02,02006,020062009,Comuna 6,CIUDAD DE BUENOS AIRES,317,315,419,351,770
02,02006,020062008,Comuna 6,CIUDAD DE BUENOS AIRES,483,475,669,525,1194
02,02006,020062001,Comuna 6,CIUDAD DE BUENOS AIRES,214,208,265,226,491
02,02006,020061502,Comuna 6,CIUDAD DE BUENOS AIRES,770,751,959,708,1667
02,02006,020061207,Comuna 6,CIUDAD DE BUENOS AIRES,349,337,389,296,685
02,02006,020062007,Comuna 6,CIUDAD DE BUENOS AIRES,254,254,330,273,603
02,02006,020062006,Comuna 6,CIUDAD DE BUENOS AIRES,380,358,456,368,824
02,02006,020062003,Comuna 6,CIUDAD DE BUENOS AIRES,447,444,540,430,970
02,02006,020061707,Comuna 6,CIUDAD DE BUENOS AIRES,277,273,343,263,606
02,02006,020061208,Comuna 6,CIUDAD DE BUENOS AIRES,303,301,406,335,741
02,02006,020061706,Comuna 6,CIUDAD DE BUENOS AIRES,507,507,614,433,1047
02,02006,020061501,Comuna 6,CIUDAD DE BUENOS AIRES,284,282,367,304,671
02,02006,020062002,Comuna 6,CIUDAD DE BUENOS AIRES,258,253,316,242,558
02,02006,020061209,Comuna 6,CIUDAD DE BUENOS AIRES,362,348,427,346,773
02,02006,020062106,Comuna 6,CIUDAD DE BUENOS AIRES,231,229,302,221,523
02,02006,020061404,Comuna 6,CIUDAD DE BUENOS AIRES,531,525,588,471,1059
02,02006,020062105,Comuna 6,CIUDAD DE BUENOS AIRES,330,325,422,362,784
02,02006,020061210,Comuna 6,CIUDAD DE BUENOS AIRES,236,235,289,247,536
02,02006,020062104,Comuna 6,CIUDAD DE BUENOS AIRES,262,260,336,278,614
02,02006,020061503,Comuna 6,CIUDAD DE BUENOS AIRES,358,356,449,367,816
02,02006,020061601,Comuna 6,CIUDAD DE BUENOS AIRES,283,281,380,292,672
02,02006,020062103,Comuna 6,CIUDAD DE BUENOS AIRES,454,446,562,465,1027
02,02006,020061603,Comuna 6,CIUDAD DE BUENOS AIRES,393,384,513,432,945
02,02006,020061403,Comuna 6,CIUDAD DE BUENOS AIRES,384,375,456,394,850
02,02006,020061211,Comuna 6,CIUDAD DE BUENOS AIRES,372,365,451,363,814
02,02006,020061604,Comuna 6,CIUDAD DE BUENOS AIRES,310,303,379,317,696
02,02006,020062102,Comuna 6,CIUDAD DE BUENOS AIRES,452,450,561,431,992
02,02006,020061605,Comuna 6,CIUDAD DE BUENOS AIRES,393,359,536,440,976
02,02006,020061401,Comuna 6,CIUDAD DE BUENOS AIRES,382,377,513,383,896
02,02006,020061405,Comuna 6,CIUDAD DE BUENOS AIRES,407,401,563,468,1031
02,02006,020062107,Comuna 6,CIUDAD DE BUENOS AIRES,378,369,536,427,963
02,02006,020061602,Comuna 6,CIUDAD DE BUENOS AIRES,284,276,379,299,678
02,02006,020061504,Comuna 6,CIUDAD DE BUENOS AIRES,270,266,364,318,682
02,02006,020061302,Comuna 6,CIUDAD DE BUENOS AIRES,586,584,745,557,1302
02,02006,020061212,Comuna 6,CIUDAD DE BUENOS AIRES,208,201,294,225,519
02,02006,020061505,Comuna 6,CIUDAD DE BUENOS AIRES,320,320,422,338,760
02,02006,020062108,Comuna 6,CIUDAD DE BUENOS AIRES,465,454,651,572,1223
02,02006,020061402,Comuna 6,CIUDAD DE BUENOS AIRES,250,249,356,269,625
02,02006,020062109,Comuna 6,CIUDAD DE BUENOS AIRES,294,289,395,345,740
02,02006,020062101,Comuna 6,CIUDAD DE BUENOS AIRES,293,289,354,266,620
02,02006,020061606,Comuna 6,CIUDAD DE BUENOS AIRES,415,411,530,449,979
02,02006,020061406,Comuna 6,CIUDAD DE BUENOS AIRES,484,483,617,544,1161
02,02006,020061301,Comuna 6,CIUDAD DE BUENOS AIRES,307,303,398,291,689
02,02006,020061608,Comuna 6,CIUDAD DE BUENOS AIRES,560,507,732,674,1406
02,02006,020061303,Comuna 6,CIUDAD DE BUENOS AIRES,302,293,426,338,764
02,02006,020061506,Comuna 6,CIUDAD DE BUENOS AIRES,283,279,442,361,803
02,02006,020061407,Comuna 6,CIUDAD DE BUENOS AIRES,237,232,296,243,539
02,02006,020062111,Comuna 6,CIUDAD DE BUENOS AIRES,387,378,555,453,1008
02,02006,020061304,Comuna 6,CIUDAD DE BUENOS AIRES,497,456,700,540,1240
02,02006,020061307,Comuna 6,CIUDAD DE BUENOS AIRES,369,363,470,392,862
02,02006,020061611,Comuna 6,CIUDAD DE BUENOS AIRES,390,384,495,391,886
02,02006,020061607,Comuna 6,CIUDAD DE BUENOS AIRES,388,381,551,489,1040
02,02006,020061408,Comuna 6,CIUDAD DE BUENOS AIRES,218,216,287,253,540
02,02006,020062110,Comuna 6,CIUDAD DE BUENOS AIRES,368,362,436,389,825
02,02006,020061306,Comuna 6,CIUDAD DE BUENOS AIRES,267,266,323,212,535
02,02006,020061507,Comuna 6,CIUDAD DE BUENOS AIRES,335,330,457,402,859
02,02006,020061508,Comuna 6,CIUDAD DE BUENOS AIRES,445,439,521,438,959
02,02006,020061305,Comuna 6,CIUDAD DE BUENOS AIRES,361,354,495,378,873
02,02006,020061509,Comuna 6,CIUDAD DE BUENOS AIRES,227,224,267,250,517
02,02006,020061610,Comuna 6,CIUDAD DE BUENOS AIRES,499,489,624,531,1155
02,02006,020061409,Comuna 6,CIUDAD DE BUENOS AIRES,309,305,418,376,794
02,02006,020061609,Comuna 6,CIUDAD DE BUENOS AIRES,418,409,567,520,1087
02,02006,020061308,Comuna 6,CIUDAD DE BUENOS AIRES,497,469,649,572,1221
02,02006,020061309,Comuna 6,CIUDAD DE BUENOS AIRES,426,409,476,420,896
02,02006,020061510,Comuna 6,CIUDAD DE BUENOS AIRES,305,299,367,349,716
02,02006,020061410,Comuna 6,CIUDAD DE BUENOS AIRES,392,386,489,423,912
26,26007,260070101,Biedma,CHUBUT,29,29,16,59,75
26,26007,260070201,Biedma,CHUBUT,42,65,36,91,127
26,26007,260070202,Biedma,CHUBUT,156,153,257,308,565
26,26007,260070301,Biedma,CHUBUT,56,36,23,83,106
26,26007,260070302,Biedma,CHUBUT,11,21,1,14,15
26,26007,260070303,Biedma,CHUBUT,27,71,24,30,54
26,26007,260070304,Biedma,CHUBUT,203,200,306,320,626
26,26007,260070401,Biedma,CHUBUT,295,504,589,497,1086
26,26007,260070402,Biedma,CHUBUT,235,253,338,374,712
26,26007,260070403,Biedma,CHUBUT,268,302,335,358,693
26,26007,260070404,Biedma,CHUBUT,275,277,421,432,853
26,26007,260070405,Biedma,CHUBUT,336,345,558,572,1130
26,26007,260070406,Biedma,CHUBUT,227,209,443,447,890
26,26007,260070407,Biedma,CHUBUT,433,488,739,760,1499
26,26007,260070408,Biedma,CHUBUT,106,119,185,187,372
26,26007,260070409,Biedma,CHUBUT,235,259,364,362,726
26,26007,260070410,Biedma,CHUBUT,210,261,332,307,639
26,26007,260070411,Biedma,CHUBUT,200,184,315,292,607
26,26007,260070412,Biedma,CHUBUT,362,401,684,634,1318
26,26007,260070413,Biedma,CHUBUT,30,90,22,46,68
26,26007,260070414,Biedma,CHUBUT,11,34,14,15,29
26,26007,260070501,Biedma,CHUBUT,327,293,665,701,1366
26,26007,260070502,Biedma,CHUBUT,285,282,516,523,1039
26,26007,260070503,Biedma,CHUBUT,324,288,686,676,1362
26,26007,260070504,Biedma,CHUBUT,206,224,370,370,740
26,26007,260070505,Biedma,CHUBUT,231,186,521,496,1017
26,26007,260070506,Biedma,CHUBUT,238,253,486,482,968
26,26007,260070507,Biedma,CHUBUT,249,255,533,486,1019
26,26007,260070508,Biedma,CHUBUT,272,250,571,590,1161
26,26007,260070509,Biedma,CHUBUT,266,239,474,504,978
26,26007,260070510,Biedma,CHUBUT,391,365,771,794,1565
26,26007,260070511,Biedma,CHUBUT,275,256,535,524,1059
26,26007,260070601,Biedma,CHUBUT,356,356,646,623,1269
26,26007,260070602,Biedma,CHUBUT,229,251,379,338,717
26,26007,260070603,Biedma,CHUBUT,285,291,402,451,853
26,26007,260070604,Biedma,CHUBUT,377,406,644,617,1261
26,26007,260070605,Biedma,CHUBUT,397,410,717,734,1451
26,26007,260070606,Biedma,CHUBUT,225,205,407,377,784
26,26007,260070607,Biedma,CHUBUT,306,308,598,585,1183
26,26007,260070608,Biedma,CHUBUT,340,340,653,652,1305
26,26007,260070609,Biedma,CHUBUT,389,366,676,671,1347
26,26007,260070610,Biedma,CHUBUT,344,385,623,588,1211
26,26007,260070611,Biedma,CHUBUT,136,130,251,255,506
26,26007,260070612,Biedma,CHUBUT,403,484,629,584,1213
26,26007,260070613,Biedma,CHUBUT,185,320,366,295,661
26,26007,260070614,Biedma,CHUBUT,307,397,427,392,819
26,26007,260070615,Biedma,CHUBUT,364,398,554,542,1096
26,26007,260070701,Biedma,CHUBUT,75,86,131,133,264
26,26007,260070702,Biedma,CHUBUT,232,240,458,416,874
26,26007,260070703,Biedma,CHUBUT,255,257,577,579,1156
26,26007,260070704,Biedma,CHUBUT,348,346,703,753,1456
26,26007,260070705,Biedma,CHUBUT,287,313,549,539,1088
26,26007,260070706,Biedma,CHUBUT,193,224,379,395,774
26,26007,260070707,Biedma,CHUBUT,354,362,701,767,1468
26,26007,260070708,Biedma,CHUBUT,343,364,759,763,1522
26,26007,260070709,Biedma,CHUBUT,324,318,642,656,1298
26,26007,260070710,Biedma,CHUBUT,281,280,638,567,1205
26,26007,260070711,Biedma,CHUBUT,239,242,511,483,994
26,26007,260070712,Biedma,CHUBUT,249,273,418,493,911
26,26007,260070801,Biedma,CHUBUT,260,303,413,388,801
26,26007,260070802,Biedma,CHUBUT,455,487,758,705,1463
26,26007,260070803,Biedma,CHUBUT,250,293,395,405,800
26,26007,260070804,Biedma,CHUBUT,330,383,549,574,1123
26,26007,260070805,Biedma,CHUBUT,294,339,496,513,1009
26,26007,260070806,Biedma,CHUBUT,457,505,715,769,1484
26,26007,260070807,Biedma,CHUBUT,206,216,341,352,693
26,26007,260070808,Biedma,CHUBUT,218,267,334,379,713
26,26007,260070809,Biedma,CHUBUT,210,245,347,367,714
26,26007,260070810,Biedma,CHUBUT,217,291,360,363,723
26,26007,260070811,Biedma,CHUBUT,422,477,693,678,1371
26,26007,260070812,Biedma,CHUBUT,339,373,656,631,1287
26,26007,260070813,Biedma,CHUBUT,271,296,424,428,852
26,26007,260070901,Biedma,CHUBUT,335,406,496,437,933
26,26007,260070902,Biedma,CHUBUT,319,405,431,387,818
26,26007,260070903,Biedma,CHUBUT,445,512,681,614,1295
26,26007,260070904,Biedma,CHUBUT,301,342,441,414,855
26,26007,260070905,Biedma,CHUBUT,315,368,421,365,786
26,26007,260070906,Biedma,CHUBUT,280,336,374,351,725
26,26007,260070907,Biedma,CHUBUT,320,415,452,459,911
26,26007,260070908,Biedma,CHUBUT,317,431,476,457,933
26,26007,260070909,Biedma,CHUBUT,156,223,235,223,458
26,26007,260070910,Biedma,CHUBUT,214,265,331,321,652
26,26007,260071001,Biedma,CHUBUT,88,186,149,151,300
26,26007,260071002,Biedma,CHUBUT,345,520,460,436,896
26,26007,260071003,Biedma,CHUBUT,133,265,143,139,282
26,26007,260071004,Biedma,CHUBUT,182,277,292,269,561
26,26007,260071005,Biedma,CHUBUT,253,329,335,318,653
26,26007,260071006,Biedma,CHUBUT,249,295,345,331,676
26,26007,260071007,Biedma,CHUBUT,283,370,390,336,726
26,26007,260071008,Biedma,CHUBUT,211,321,313,280,593
26,26007,260071009,Biedma,CHUBUT,231,313,361,317,678
26,26007,260071010,Biedma,CHUBUT,376,476,597,562,1159
26,26007,260071011,Biedma,CHUBUT,233,327,297,294,591
26,26007,260071012,Biedma,CHUBUT,182,242,274,244,518
26,26007,260071013,Biedma,CHUBUT,140,208,354,347,701
26,26014,260140101,Cushamen,CHUBUT,47,49,18,49,67
26,26014,260140102,Cushamen,CHUBUT,37,41,31,45,76
26,26014,260140103,Cushamen,CHUBUT,74,103,134,119,253
26,26014,260140104,Cushamen,CHUBUT,237,268,409,390,799
26,26014,260140105,Cushamen,CHUBUT,286,329,463,425,888
26,26014,260140106,Cushamen,CHUBUT,246,293,439,402,841
26,26014,260140107,Cushamen,CHUBUT,197,212,399,384,783
26,26014,260140108,Cushamen,CHUBUT,237,292,356,344,700
26,26014,260140201,Cushamen,CHUBUT,3,7,5,6,11
26,26014,260140202,Cushamen,CHUBUT,22,19,41,75,116
26,26014,260140203,Cushamen,CHUBUT,7,10,7,11,18
26,26014,260140204,Cushamen,CHUBUT,6,6,1,6,7
26,26014,260140205,Cushamen,CHUBUT,3,8,1,4,5
26,26014,260140206,Cushamen,CHUBUT,1,5,3,0,3
26,26014,260140207,Cushamen,CHUBUT,10,10,4,10,14
26,26014,260140208,Cushamen,CHUBUT,4,10,4,5,9
26,26014,260140209,Cushamen,CHUBUT,5,7,5,10,15
26,26014,260140301,Cushamen,CHUBUT,77,93,91,126,217
26,26014,260140302,Cushamen,CHUBUT,46,51,58,68,126
26,26014,260140303,Cushamen,CHUBUT,227,289,386,354,740
26,26014,260140304,Cushamen,CHUBUT,26,37,25,27,52
26,26014,260140305,Cushamen,CHUBUT,55,79,68,79,147
26,26014,260140306,Cushamen,CHUBUT,42,62,42,53,95
26,26014,260140307,Cushamen,CHUBUT,45,46,76,73,149
26,26014,260140401,Cushamen,CHUBUT,55,84,49,71,120
26,26014,260140501,Cushamen,CHUBUT,10,31,13,12,25
26,26014,260140601,Cushamen,CHUBUT,18,15,12,27,39
26,26014,260140701,Cushamen,CHUBUT,21,36,17,25,42
26,26014,260140702,Cushamen,CHUBUT,50,64,46,63,109
26,26014,260140703,Cushamen,CHUBUT,3,5,4,6,10
26,26014,260140704,Cushamen,CHUBUT,43,40,39,51,90
26,26014,260140705,Cushamen,CHUBUT,373,454,608,575,1183
26,26014,260140801,Cushamen,CHUBUT,189,283,258,312,570
26,26014,260140802,Cushamen,CHUBUT,28,52,16,50,66
26,26014,260140803,Cushamen,CHUBUT,268,352,456,457,913
26,26014,260140804,Cushamen,CHUBUT,247,311,380,365,745
26,26014,260140901,Cushamen,CHUBUT,945,839,1429,1480,2909
26,26014,260140902,Cushamen,CHUBUT,27,36,31,63,94
26,26014,260140903,Cushamen,CHUBUT,230,262,408,386,794
26,26014,260140904,Cushamen,CHUBUT,254,328,412,391,803
26,26014,260140905,Cushamen,CHUBUT,236,299,357,354,711
26,26014,260140906,Cushamen,CHUBUT,255,350,422,399,821
26,26014,260141001,Cushamen,CHUBUT,65,112,76,114,190
26,26014,260141002,Cushamen,CHUBUT,47,59,51,67,118
26,26014,260141003,Cushamen,CHUBUT,145,131,185,207,392
26,26014,260141004,Cushamen,CHUBUT,327,288,545,493,1038
26,26014,260141101,Cushamen,CHUBUT,25,21,35,24,59
26,26014,260141102,Cushamen,CHUBUT,462,603,705,765,1470
26,26014,260141103,Cushamen,CHUBUT,272,344,421,425,846
26,26014,260141104,Cushamen,CHUBUT,179,230,316,315,631
26,26021,260210101,Escalante,CHUBUT,32,53,7,53,60
26,26021,260210102,Escalante,CHUBUT,22,28,36,29,65
26,26021,260210103,Escalante,CHUBUT,27,33,13,61,74
26,26021,260210104,Escalante,CHUBUT,13,90,9,16,25
26,26021,260210201,Escalante,CHUBUT,26,15,33,34,67
26,26021,260210202,Escalante,CHUBUT,50,63,12,67,79
26,26021,260210203,Escalante,CHUBUT,13,13,5,16,21
26,26021,260210204,Escalante,CHUBUT,375,392,645,672,1317
26,26021,260210301,Escalante,CHUBUT,29,42,14,103,117
26,26021,260210302,Escalante,CHUBUT,9,15,2,14,16
26,26021,260210401,Escalante,CHUBUT,2,7,0,2,2
26,26021,260210402,Escalante,CHUBUT,67,93,116,109,225
26,26021,260210403,Escalante,CHUBUT,82,137,136,125,261
26,26021,260210404,Escalante,CHUBUT,281,324,452,455,907
26,26021,260210405,Escalante,CHUBUT,274,349,434,419,853
26,26021,260210406,Escalante,CHUBUT,317,382,487,475,962
26,26021,260210407,Escalante,CHUBUT,347,359,638,605,1243
26,26021,260210408,Escalante,CHUBUT,220,267,370,371,741
26,26021,260210409,Escalante,CHUBUT,241,262,367,368,735
26,26021,260210410,Escalante,CHUBUT,245,309,375,353,728
26,26021,260210411,Escalante,CHUBUT,196,258,261,261,522
26,26021,260210412,Escalante,CHUBUT,193,233,292,297,589
26,26021,260210413,Escalante,CHUBUT,232,327,324,325,649
26,26021,260210414,Escalante,CHUBUT,215,249,342,341,683
26,26021,260210501,Escalante,CHUBUT,12,13,9,16,25
26,26021,260210502,Escalante,CHUBUT,228,237,424,428,852
26,26021,260210503,Escalante,CHUBUT,111,123,199,216,415
26,26021,260210504,Escalante,CHUBUT,2,2,2,5,7
26,26021,260210505,Escalante,CHUBUT,312,319,554,552,1106
26,26021,260210506,Escalante,CHUBUT,288,326,479,446,925
26,26021,260210507,Escalante,CHUBUT,245,252,369,373,742
26,26021,260210508,Escalante,CHUBUT,133,153,208,199,407
26,26021,260210509,Escalante,CHUBUT,207,235,404,378,782
26,26021,260210510,Escalante,CHUBUT,248,249,474,491,965
26,26021,260210511,Escalante,CHUBUT,276,276,586,501,1087
26,26021,260210512,Escalante,CHUBUT,320,349,620,598,1218
26,26021,260210513,Escalante,CHUBUT,442,456,752,762,1514
26,26021,260210514,Escalante,CHUBUT,473,462,819,807,1626
26,26021,260210515,Escalante,CHUBUT,407,416,637,774,1411
26,26021,260210516,Escalante,CHUBUT,237,241,496,453,949
26,26021,260210517,Escalante,CHUBUT,242,247,501,476,977
26,26021,260210518,Escalante,CHUBUT,293,335,543,572,1115
26,26021,260210601,Escalante,CHUBUT,108,135,159,182,341
26,26021,260210602,Escalante,CHUBUT,194,372,268,329,597
26,26021,260210603,Escalante,CHUBUT,73,77,130,191,321
26,26021,260210604,Escalante,CHUBUT,277,303,483,475,958
26,26021,260210605,Escalante,CHUBUT,367,397,563,612,1175
26,26021,260210606,Escalante,CHUBUT,279,300,474,488,962
26,26021,260210607,Escalante,CHUBUT,334,374,580,557,1137
26,26021,260210608,Escalante,CHUBUT,449,505,809,813,1622
26,26021,260210609,Escalante,CHUBUT,336,345,655,697,1352
26,26021,260210610,Escalante,CHUBUT,384,378,707,709,1416
26,26021,260210611,Escalante,CHUBUT,351,394,501,530,1031
26,26021,260210612,Escalante,CHUBUT,279,335,399,401,800
26,26021,260210613,Escalante,CHUBUT,196,241,306,284,590
26,26021,260210614,Escalante,CHUBUT,267,325,399,391,790
26,26021,260210615,Escalante,CHUBUT,251,467,338,351,689
26,26021,260210701,Escalante,CHUBUT,39,36,32,48,80
26,26021,260210702,Escalante,CHUBUT,241,315,289,382,671
26,26021,260210703,Escalante,CHUBUT,83,79,137,154,291
26,26021,260210704,Escalante,CHUBUT,440,465,770,796,1566
26,26021,260210705,Escalante,CHUBUT,106,123,173,186,359
26,26021,260210706,Escalante,CHUBUT,230,233,380,391,771
26,26021,260210707,Escalante,CHUBUT,251,255,455,421,876
26,26021,260210708,Escalante,CHUBUT,220,247,369,412,781
26,26021,260210709,Escalante,CHUBUT,337,303,608,627,1235
26,26021,260210710,Escalante,CHUBUT,278,282,505,530,1035
26,26021,260210711,Escalante,CHUBUT,178,178,311,318,629
26,26021,260210712,Escalante,CHUBUT,271,268,492,468,960
26,26021,260210801,Escalante,CHUBUT,30,35,48,41,89
26,26021,260210802,Escalante,CHUBUT,442,484,635,613,1248
26,26021,260210803,Escalante,CHUBUT,48,56,76,64,140
26,26021,260210804,Escalante,CHUBUT,141,166,262,261,523
26,26021,260210805,Escalante,CHUBUT,225,229,329,315,644
26,26021,260210806,Escalante,CHUBUT,207,242,298,276,574
26,26021,260210807,Escalante,CHUBUT,372,438,487,495,982
26,26021,260210808,Escalante,CHUBUT,267,329,378,354,732
26,26021,260210809,Escalante,CHUBUT,147,180,241,231,472
26,26021,260210810,Escalante,CHUBUT,301,352,460,482,942
26,26021,260210811,Escalante,CHUBUT,53,40,149,185,334
26,26021,260210812,Escalante,CHUBUT,321,318,530,520,1050
26,26021,260210813,Escalante,CHUBUT,114,128,193,189,382
26,26021,260210814,Escalante,CHUBUT,390,443,655,611,1266
26,26021,260210815,Escalante,CHUBUT,402,418,637,612,1249
26,26021,260210901,Escalante,CHUBUT,307,306,422,445,867
26,26021,260210902,Escalante,CHUBUT,212,267,253,210,463
26,26021,260210903,Escalante,CHUBUT,215,317,292,288,580
26,26021,260210904,Escalante,CHUBUT,126,259,146,138,284
26,26021,260210905,Escalante,CHUBUT,186,269,280,247,527
26,26021,260210906,Escalante,CHUBUT,152,234,183,145,328
26,26021,260210907,Escalante,CHUBUT,203,300,265,235,500
26,26021,260210908,Escalante,CHUBUT,256,379,291,288,579
26,26021,260210909,Escalante,CHUBUT,223,272,368,377,745
26,26021,260210910,Escalante,CHUBUT,147,201,211,189,400
26,26021,260210911,Escalante,CHUBUT,287,381,368,363,731
26,26021,260210912,Escalante,CHUBUT,154,187,211,200,411
26,26021,260210913,Escalante,CHUBUT,128,180,175,152,327
26,26021,260210914,Escalante,CHUBUT,185,249,241,228,469
26,26021,260211001,Escalante,CHUBUT,336,454,399,463,862
26,26021,260211002,Escalante,CHUBUT,272,443,293,331,624
26,26021,260211003,Escalante,CHUBUT,326,448,384,372,756
26,26021,260211004,Escalante,CHUBUT,235,310,286,290,576
26,26021,260211005,Escalante,CHUBUT,149,164,209,187,396
26,26021,260211006,Escalante,CHUBUT,190,194,298,258,556
26,26021,260211007,Escalante,CHUBUT,177,210,250,274,524
26,26021,260211008,Escalante,CHUBUT,206,245,285,286,571
26,26021,260211009,Escalante,CHUBUT,170,214,221,242,463
26,26021,260211010,Escalante,CHUBUT,215,262,312,304,616
26,26021,260211011,Escalante,CHUBUT,105,147,222,184,406
26,26021,260211012,Escalante,CHUBUT,476,637,534,536,1070
26,26021,260211013,Escalante,CHUBUT,316,368,400,414,814
26,26021,260211101,Escalante,CHUBUT,140,174,258,285,543
26,26021,260211102,Escalante,CHUBUT,264,269,437,415,852
26,26021,260211103,Escalante,CHUBUT,138,140,183,186,369
26,26021,260211104,Escalante,CHUBUT,371,346,552,715,1267
26,26021,260211105,Escalante,CHUBUT,179,186,269,259,528
26,26021,260211106,Escalante,CHUBUT,215,212,374,345,719
26,26021,260211107,Escalante,CHUBUT,327,345,583,607,1190
26,26021,260211108,Escalante,CHUBUT,396,382,648,603,1251
26,26021,260211109,Escalante,CHUBUT,303,332,477,412,889
26,26021,260211110,Escalante,CHUBUT,315,340,484,492,976
26,26021,260211111,Escalante,CHUBUT,279,299,435,434,869
26,26021,260211112,Escalante,CHUBUT,181,226,260,250,510
26,26021,260211113,Escalante,CHUBUT,322,276,500,503,1003
26,26021,260211114,Escalante,CHUBUT,235,258,361,340,701
26,26021,260211115,Escalante,CHUBUT,188,201,308,302,610
26,26021,260211116,Escalante,CHUBUT,245,289,388,360,748
26,26021,260211117,Escalante,CHUBUT,219,240,331,312,643
26,26021,260211201,Escalante,CHUBUT,323,280,618,656,1274
26,26021,260211202,Escalante,CHUBUT,231,212,422,421,843
26,26021,260211203,Escalante,CHUBUT,334,308,586,620,1206
26,26021,260211204,Escalante,CHUBUT,367,385,615,635,1250
26,26021,260211205,Escalante,CHUBUT,178,161,288,317,605
26,26021,260211206,Escalante,CHUBUT,341,308,561,545,1106
26,26021,260211207,Escalante,CHUBUT,347,332,569,547,1116
26,26021,260211208,Escalante,CHUBUT,277,305,442,483,925
26,26021,260211209,Escalante,CHUBUT,319,263,504,540,1044
26,26021,260211210,Escalante,CHUBUT,170,149,230,261,491
26,26021,260211301,Escalante,CHUBUT,325,339,517,544,1061
26,26021,260211302,Escalante,CHUBUT,410,354,725,745,1470
26,26021,260211303,Escalante,CHUBUT,236,238,389,378,767
26,26021,260211304,Escalante,CHUBUT,231,248,385,353,738
26,26021,260211305,Escalante,CHUBUT,379,341,613,621,1234
26,26021,260211306,Escalante,CHUBUT,265,254,368,386,754
26,26021,260211307,Escalante,CHUBUT,194,182,317,314,631
26,26021,260211308,Escalante,CHUBUT,218,227,373,337,710
26,26021,260211309,Escalante,CHUBUT,271,266,436,477,913
26,26021,260211310,Escalante,CHUBUT,271,252,386,412,798
26,26021,260211311,Escalante,CHUBUT,209,193,304,318,622
26,26021,260211312,Escalante,CHUBUT,424,432,632,612,1244
26,26021,260211401,Escalante,CHUBUT,397,429,606,566,1172
26,26021,260211402,Escalante,CHUBUT,297,316,454,384,838
26,26021,260211403,Escalante,CHUBUT,232,248,360,344,704
26,26021,260211404,Escalante,CHUBUT,356,379,515,533,1048
26,26021,260211405,Escalante,CHUBUT,240,279,360,354,714
26,26021,260211406,Escalante,CHUBUT,332,343,460,408,868
26,26021,260211407,Escalante,CHUBUT,419,497,647,567,1214
26,26021,260211408,Escalante,CHUBUT,244,269,357,301,658
26,26021,260211409,Escalante,CHUBUT,235,274,400,393,793
26,26021,260211410,Escalante,CHUBUT,178,203,269,254,523
26,26021,260211411,Escalante,CHUBUT,255,269,373,373,746
26,26021,260211412,Escalante,CHUBUT,298,368,432,390,822
26,26021,260211413,Escalante,CHUBUT,339,334,492,555,1047
26,26021,260211501,Escalante,CHUBUT,234,219,387,382,769
26,26021,260211502,Escalante,CHUBUT,321,292,579,569,1148
26,26021,260211503,Escalante,CHUBUT,331,329,559,558,1117
26,26021,260211504,Escalante,CHUBUT,306,292,518,454,972
26,26021,260211505,Escalante,CHUBUT,236,181,418,408,826
26,26021,260211506,Escalante,CHUBUT,284,272,504,475,979
26,26021,260211507,Escalante,CHUBUT,239,223,380,360,740
26,26021,260211508,Escalante,CHUBUT,233,228,403,372,775
26,26021,260211509,Escalante,CHUBUT,225,227,341,339,680
26,26021,260211510,Escalante,CHUBUT,287,293,574,604,1178
26,26021,260211511,Escalante,CHUBUT,340,262,680,693,1373
26,26021,260211601,Escalante,CHUBUT,352,360,665,709,1374
26,26021,260211602,Escalante,CHUBUT,111,112,194,197,391
26,26021,260211603,Escalante,CHUBUT,198,192,340,365,705
26,26021,260211604,Escalante,CHUBUT,203,170,366,384,750
26,26021,260211605,Escalante,CHUBUT,335,281,601,618,1219
26,26021,260211606,Escalante,CHUBUT,257,207,441,504,945
26,26021,260211607,Escalante,CHUBUT,289,284,453,496,949
26,26021,260211608,Escalante,CHUBUT,285,271,515,570,1085
26,26021,260211609,Escalante,CHUBUT,324,315,665,643,1308
26,26021,260211610,Escalante,CHUBUT,381,399,750,752,1502
26,26021,260211611,Escalante,CHUBUT,256,281,451,409,860
26,26021,260211612,Escalante,CHUBUT,210,235,364,376,740
26,26021,260211613,Escalante,CHUBUT,391,398,722,728,1450
26,26021,260211614,Escalante,CHUBUT,190,190,361,350,711
26,26021,260211615,Escalante,CHUBUT,216,272,401,424,825
26,26021,260211701,Escalante,CHUBUT,77,109,108,133,241
26,26021,260211702,Escalante,CHUBUT,309,339,572,636,1208
26,26021,260211703,Escalante,CHUBUT,179,211,263,318,581
26,26021,260211704,Escalante,CHUBUT,261,299,466,494,960
26,26021,260211705,Escalante,CHUBUT,286,282,578,574,1152
26,26021,260211706,Escalante,CHUBUT,294,336,520,504,1024
26,26021,260211707,Escalante,CHUBUT,210,244,398,384,782
26,26021,260211708,Escalante,CHUBUT,303,342,618,615,1233
26,26021,260211709,Escalante,CHUBUT,407,372,804,812,1616
26,26021,260211710,Escalante,CHUBUT,264,309,525,490,1015
26,26021,260211711,Escalante,CHUBUT,420,387,710,810,1520
26,26021,260211712,Escalante,CHUBUT,295,280,575,602,1177
26,26021,260211713,Escalante,CHUBUT,157,167,321,359,680
26,26021,260211714,Escalante,CHUBUT,327,328,633,593,1226
26,26021,260211801,Escalante,CHUBUT,188,353,250,299,549
26,26021,260211802,Escalante,CHUBUT,219,325,330,378,708
26,26021,260211803,Escalante,CHUBUT,265,325,512,523,1035
26,26021,260211804,Escalante,CHUBUT,280,285,538,510,1048
26,26021,260211805,Escalante,CHUBUT,246,239,497,514,1011
26,26021,260211806,Escalante,CHUBUT,191,166,362,397,759
26,26021,260211807,Escalante,CHUBUT,183,192,321,347,668
26,26021,260211808,Escalante,CHUBUT,304,262,571,598,1169
26,26021,260211809,Escalante,CHUBUT,375,403,622,632,1254
26,26021,260211810,Escalante,CHUBUT,231,249,341,364,705
26,26021,260211811,Escalante,CHUBUT,302,317,452,443,895
26,26021,260211812,Escalante,CHUBUT,221,260,366,368,734
26,26021,260211813,Escalante,CHUBUT,223,245,355,348,703
26,26021,260211901,Escalante,CHUBUT,196,212,283,319,602
26,26021,260211902,Escalante,CHUBUT,303,314,471,435,906
26,26021,260211903,Escalante,CHUBUT,373,398,558,628,1186
26,26021,260211904,Escalante,CHUBUT,185,219,301,256,557
26,26021,260211905,Escalante,CHUBUT,257,276,444,456,900
26,26021,260211906,Escalante,CHUBUT,237,255,357,363,720
26,26021,260211907,Escalante,CHUBUT,252,270,415,346,761
26,26021,260211908,Escalante,CHUBUT,262,264,428,481,909
26,26021,260211909,Escalante,CHUBUT,259,262,397,471,868
26,26021,260211910,Escalante,CHUBUT,260,269,472,398,870
26,26021,260211911,Escalante,CHUBUT,278,279,446,478,924
26,26021,260211912,Escalante,CHUBUT,320,336,610,612,1222
26,26021,260211913,Escalante,CHUBUT,301,284,567,572,1139
26,26021,260211914,Escalante,CHUBUT,170,216,240,334,574
26,26021,260211915,Escalante,CHUBUT,268,307,455,456,911
26,26021,260211916,Escalante,CHUBUT,227,249,336,386,722
26,26028,260280101,Florentino Ameghino,CHUBUT,25,24,14,49,63
26,26028,260280102,Florentino Ameghino,CHUBUT,4,11,1,9,10
26,26028,260280201,Florentino Ameghino,CHUBUT,33,40,18,117,135
26,26028,260280301,Florentino Ameghino,CHUBUT,13,13,5,69,74
26,26028,260280302,Florentino Ameghino,CHUBUT,24,29,9,40,49
26,26028,260280303,Florentino Ameghino,CHUBUT,380,531,657,639,1296
26,26035,260350101,Futaleufú,CHUBUT,51,51,58,87,145
26,26035,260350102,Futaleufú,CHUBUT,25,35,28,60,88
26,26035,260350201,Futaleufú,CHUBUT,127,137,122,248,370
26,26035,260350202,Futaleufú,CHUBUT,31,48,9,36,45
26,26035,260350301,Futaleufú,CHUBUT,138,178,217,239,456
26,26035,260350302,Futaleufú,CHUBUT,190,211,316,286,602
26,26035,260350303,Futaleufú,CHUBUT,217,226,365,345,710
26,26035,260350304,Futaleufú,CHUBUT,246,281,369,353,722
26,26035,260350305,Futaleufú,CHUBUT,249,289,355,333,688
26,26035,260350306,Futaleufú,CHUBUT,211,251,329,261,590
26,26035,260350307,Futaleufú,CHUBUT,273,335,384,325,709
26,26035,260350308,Futaleufú,CHUBUT,137,168,206,172,378
26,26035,260350309,Futaleufú,CHUBUT,311,368,445,356,801
26,26035,260350310,Futaleufú,CHUBUT,140,155,211,198,409
26,26035,260350311,Futaleufú,CHUBUT,371,415,528,459,987
26,26035,260350312,Futaleufú,CHUBUT,242,258,424,438,862
26,26035,260350313,Futaleufú,CHUBUT,216,230,392,410,802
26,26035,260350401,Futaleufú,CHUBUT,7,11,3,7,10
26,26035,260350402,Futaleufú,CHUBUT,32,26,15,41,56
26,26035,260350403,Futaleufú,CHUBUT,88,29,134,133,267
26,26035,260350404,Futaleufú,CHUBUT,587,657,887,933,1820
26,26035,260350405,Futaleufú,CHUBUT,21,8,3,21,24
26,26035,260350501,Futaleufú,CHUBUT,9,15,10,8,18
26,26035,260350502,Futaleufú,CHUBUT,56,120,64,80,144
26,26035,260350503,Futaleufú,CHUBUT,29,37,27,45,72
26,26035,260350504,Futaleufú,CHUBUT,32,40,14,40,54
26,26035,260350505,Futaleufú,CHUBUT,187,125,257,246,503
26,26035,260350506,Futaleufú,CHUBUT,34,54,29,51,80
26,26035,260350507,Futaleufú,CHUBUT,150,194,241,218,459
26,26035,260350508,Futaleufú,CHUBUT,83,113,91,134,225
26,26035,260350509,Futaleufú,CHUBUT,273,314,481,427,908
26,26035,260350510,Futaleufú,CHUBUT,409,462,644,602,1246
26,26035,260350511,Futaleufú,CHUBUT,163,212,239,238,477
26,26035,260350512,Futaleufú,CHUBUT,179,225,281,280,561
26,26035,260350513,Futaleufú,CHUBUT,280,347,458,479,937
26,26035,260350514,Futaleufú,CHUBUT,291,296,471,438,909
26,26035,260350515,Futaleufú,CHUBUT,318,349,677,638,1315
26,26035,260350601,Futaleufú,CHUBUT,330,338,577,518,1095
26,26035,260350602,Futaleufú,CHUBUT,252,258,435,405,840
26,26035,260350603,Futaleufú,CHUBUT,265,268,480,448,928
26,26035,260350604,Futaleufú,CHUBUT,193,218,331,320,651
26,26035,260350605,Futaleufú,CHUBUT,220,236,402,350,752
26,26035,260350606,Futaleufú,CHUBUT,181,190,296,263,559
26,26035,260350607,Futaleufú,CHUBUT,182,212,247,215,462
26,26035,260350608,Futaleufú,CHUBUT,214,289,347,274,621
26,26035,260350609,Futaleufú,CHUBUT,174,217,239,187,426
26,26035,260350610,Futaleufú,CHUBUT,236,260,300,267,567
26,26035,260350611,Futaleufú,CHUBUT,260,304,375,319,694
26,26035,260350612,Futaleufú,CHUBUT,234,263,312,278,590
26,26035,260350613,Futaleufú,CHUBUT,207,239,317,390,707
26,26035,260350614,Futaleufú,CHUBUT,215,251,321,305,626
26,26035,260350615,Futaleufú,CHUBUT,284,310,458,393,851
26,26035,260350701,Futaleufú,CHUBUT,300,321,449,409,858
26,26035,260350702,Futaleufú,CHUBUT,293,299,543,518,1061
26,26035,260350703,Futaleufú,CHUBUT,366,376,689,717,1406
26,26035,260350704,Futaleufú,CHUBUT,247,280,373,374,747
26,26035,260350705,Futaleufú,CHUBUT,348,401,517,513,1030
26,26035,260350706,Futaleufú,CHUBUT,244,268,381,317,698
26,26035,260350707,Futaleufú,CHUBUT,386,377,636,566,1202
26,26035,260350708,Futaleufú,CHUBUT,331,348,684,600,1284
26,26035,260350709,Futaleufú,CHUBUT,317,333,673,624,1297
26,26035,260350710,Futaleufú,CHUBUT,349,385,652,631,1283
26,26035,260350711,Futaleufú,CHUBUT,173,204,258,241,499
26,26035,260350712,Futaleufú,CHUBUT,363,394,710,720,1430
26,26035,260350713,Futaleufú,CHUBUT,173,211,247,216,463
26,26042,260420101,Gaiman,CHUBUT,14,22,4,20,24
26,26042,260420102,Gaiman,CHUBUT,26,45,12,50,62
26,26042,260420103,Gaiman,CHUBUT,9,10,1,43,44
26,26042,260420201,Gaiman,CHUBUT,37,32,4,58,62
26,26042,260420301,Gaiman,CHUBUT,59,78,67,96,163
26,26042,260420302,Gaiman,CHUBUT,17,14,19,33,52
26,26042,260420401,Gaiman,CHUBUT,1,2,1,2,3
26,26042,260420402,Gaiman,CHUBUT,5,10,3,7,10
26,26042,260420403,Gaiman,CHUBUT,110,139,175,192,367
26,26042,260420404,Gaiman,CHUBUT,33,57,147,166,313
26,26042,260420405,Gaiman,CHUBUT,37,57,45,62,107
26,26042,260420406,Gaiman,CHUBUT,46,97,37,68,105
26,26042,260420407,Gaiman,CHUBUT,57,89,80,79,159
26,26042,260420408,Gaiman,CHUBUT,53,93,68,88,156
26,26042,260420409,Gaiman,CHUBUT,130,196,160,205,365
26,26042,260420410,Gaiman,CHUBUT,312,269,588,542,1130
26,26042,260420411,Gaiman,CHUBUT,153,208,214,253,467
26,26042,260420412,Gaiman,CHUBUT,68,102,97,123,220
26,26042,260420413,Gaiman,CHUBUT,528,645,767,845,1612
26,26042,260420414,Gaiman,CHUBUT,397,441,646,629,1275
26,26042,260420415,Gaiman,CHUBUT,392,412,714,751,1465
26,26042,260420416,Gaiman,CHUBUT,296,341,417,380,797
26,26042,260420417,Gaiman,CHUBUT,336,362,527,532,1059
26,26042,260420418,Gaiman,CHUBUT,392,481,573,551,1124
26,26049,260490101,Gastre,CHUBUT,39,52,26,53,79
26,26049,260490102,Gastre,CHUBUT,25,52,14,74,88
26,26049,260490103,Gastre,CHUBUT,49,73,59,73,132
26,26049,260490104,Gastre,CHUBUT,37,44,27,44,71
26,26049,260490105,Gastre,CHUBUT,88,107,118,135,253
26,26049,260490106,Gastre,CHUBUT,181,248,291,311,602
26,26049,260490201,Gastre,CHUBUT,5,7,4,9,13
26,26049,260490202,Gastre,CHUBUT,28,27,15,36,51
26,26049,260490203,Gastre,CHUBUT,60,53,52,86,138
26,26056,260560101,Languiñeo,CHUBUT,36,40,34,46,80
26,26056,260560102,Languiñeo,CHUBUT,18,30,10,17,27
26,26056,260560103,Languiñeo,CHUBUT,20,17,9,24,33
26,26056,260560104,Languiñeo,CHUBUT,101,151,103,148,251
26,26056,260560105,Languiñeo,CHUBUT,28,52,13,30,43
26,26056,260560106,Languiñeo,CHUBUT,33,41,24,42,66
26,26056,260560107,Languiñeo,CHUBUT,90,82,124,144,268
26,26056,260560108,Languiñeo,CHUBUT,157,188,234,238,472
26,26056,260560201,Languiñeo,CHUBUT,18,27,11,36,47
26,26056,260560202,Languiñeo,CHUBUT,49,74,40,96,136
26,26056,260560203,Languiñeo,CHUBUT,5,13,2,6,8
26,26056,260560204,Languiñeo,CHUBUT,12,14,7,16,23
26,26056,260560205,Languiñeo,CHUBUT,14,26,10,54,64
26,26056,260560206,Languiñeo,CHUBUT,392,448,592,645,1237
26,26056,260560301,Languiñeo,CHUBUT,100,134,164,166,330
26,26063,260630101,Mártires,CHUBUT,8,11,8,27,35
26,26063,260630102,Mártires,CHUBUT,13,30,5,33,38
26,26063,260630103,Mártires,CHUBUT,21,36,24,33,57
26,26063,260630201,Mártires,CHUBUT,26,27,18,41,59
26,26063,260630202,Mártires,CHUBUT,25,38,10,34,44
26,26063,260630203,Mártires,CHUBUT,160,191,246,234,480
26,26063,260630301,Mártires,CHUBUT,17,30,5,30,35
26,26063,260630401,Mártires,CHUBUT,17,24,2,28,30
26,26070,260700101,Paso de Indios,CHUBUT,26,29,28,42,70
26,26070,260700102,Paso de Indios,CHUBUT,25,30,5,60,65
26,26070,260700103,Paso de Indios,CHUBUT,15,25,1,24,25
26,26070,260700104,Paso de Indios,CHUBUT,106,172,86,172,258
26,26070,260700105,Paso de Indios,CHUBUT,29,43,12,38,50
26,26070,260700106,Paso de Indios,CHUBUT,18,33,12,23,35
26,26070,260700107,Paso de Indios,CHUBUT,10,18,4,13,17
26,26070,260700108,Paso de Indios,CHUBUT,377,470,641,623,1264
26,26070,260700201,Paso de Indios,CHUBUT,18,28,7,21,28
26,26070,260700202,Paso de Indios,CHUBUT,25,49,9,46,55
26,26077,260770101,Rawson,CHUBUT,3,4,22,107,129
26,26077,260770102,Rawson,CHUBUT,13,27,5,12,17
26,26077,260770103,Rawson,CHUBUT,10,18,4,11,15
26,26077,260770104,Rawson,CHUBUT,18,41,4,24,28
26,26077,260770201,Rawson,CHUBUT,22,44,9,27,36
26,26077,260770202,Rawson,CHUBUT,2,8,1,2,3
26,26077,260770203,Rawson,CHUBUT,51,286,26,50,76
26,26077,260770204,Rawson,CHUBUT,58,68,101,105,206
26,26077,260770301,Rawson,CHUBUT,115,187,157,151,308
26,26077,260770302,Rawson,CHUBUT,231,442,283,267,550
26,26077,260770303,Rawson,CHUBUT,171,279,231,237,468
26,26077,260770304,Rawson,CHUBUT,208,212,458,400,858
26,26077,260770305,Rawson,CHUBUT,295,381,535,491,1026
26,26077,260770306,Rawson,CHUBUT,215,284,357,319,676
26,26077,260770307,Rawson,CHUBUT,174,296,216,198,414
26,26077,260770308,Rawson,CHUBUT,106,249,149,118,267
26,26077,260770309,Rawson,CHUBUT,75,223,83,99,182
26,26077,260770310,Rawson,CHUBUT,132,236,174,166,340
26,26077,260770311,Rawson,CHUBUT,108,219,131,141,272
26,26077,260770312,Rawson,CHUBUT,105,205,135,122,257
26,26077,260770313,Rawson,CHUBUT,123,252,139,140,279
26,26077,260770314,Rawson,CHUBUT,109,247,137,140,277
26,26077,260770315,Rawson,CHUBUT,146,307,168,187,355
26,26077,260770316,Rawson,CHUBUT,88,128,107,139,246
26,26077,260770401,Rawson,CHUBUT,113,233,150,170,320
26,26077,260770402,Rawson,CHUBUT,60,84,81,94,175
26,26077,260770403,Rawson,CHUBUT,167,241,229,274,503
26,26077,260770404,Rawson,CHUBUT,211,302,267,343,610
26,26077,260770405,Rawson,CHUBUT,83,122,94,133,227
26,26077,260770501,Rawson,CHUBUT,3,2,14,525,539
26,26077,260770502,Rawson,CHUBUT,285,294,576,608,1184
26,26077,260770503,Rawson,CHUBUT,202,193,428,391,819
26,26077,260770504,Rawson,CHUBUT,219,228,452,477,929
26,26077,260770505,Rawson,CHUBUT,252,267,471,504,975
26,26077,260770506,Rawson,CHUBUT,250,262,469,472,941
26,26077,260770507,Rawson,CHUBUT,229,239,416,410,826
26,26077,260770508,Rawson,CHUBUT,171,185,352,317,669
26,26077,260770509,Rawson,CHUBUT,214,207,383,389,772
26,26077,260770510,Rawson,CHUBUT,321,335,536,513,1049
26,26077,260770511,Rawson,CHUBUT,214,224,352,343,695
26,26077,260770512,Rawson,CHUBUT,199,185,333,353,686
26,26077,260770513,Rawson,CHUBUT,183,185,315,327,642
26,26077,260770514,Rawson,CHUBUT,228,245,382,365,747
26,26077,260770515,Rawson,CHUBUT,232,256,374,359,733
26,26077,260770516,Rawson,CHUBUT,213,234,336,337,673
26,26077,260770517,Rawson,CHUBUT,201,188,333,320,653
26,26077,260770518,Rawson,CHUBUT,239,277,432,462,894
26,26077,260770519,Rawson,CHUBUT,184,181,344,358,702
26,26077,260770520,Rawson,CHUBUT,116,188,171,176,347
26,26077,260770601,Rawson,CHUBUT,202,238,245,246,491
26,26077,260770602,Rawson,CHUBUT,273,308,345,328,673
26,26077,260770603,Rawson,CHUBUT,275,310,400,346,746
26,26077,260770604,Rawson,CHUBUT,181,197,313,266,579
26,26077,260770605,Rawson,CHUBUT,326,335,523,566,1089
26,26077,260770606,Rawson,CHUBUT,323,335,571,479,1050
26,26077,260770607,Rawson,CHUBUT,170,182,284,283,567
26,26077,260770608,Rawson,CHUBUT,317,373,477,511,988
26,26077,260770609,Rawson,CHUBUT,281,362,381,375,756
26,26077,260770610,Rawson,CHUBUT,170,214,299,269,568
26,26077,260770611,Rawson,CHUBUT,267,295,421,381,802
26,26077,260770612,Rawson,CHUBUT,214,231,340,283,623
26,26077,260770701,Rawson,CHUBUT,482,522,825,758,1583
26,26077,260770702,Rawson,CHUBUT,298,299,533,490,1023
26,26077,260770703,Rawson,CHUBUT,397,425,773,684,1457
26,26077,260770704,Rawson,CHUBUT,465,519,925,868,1793
26,26077,260770705,Rawson,CHUBUT,299,308,557,571,1128
26,26077,260770706,Rawson,CHUBUT,211,226,445,430,875
26,26077,260770707,Rawson,CHUBUT,350,293,682,655,1337
26,26077,260770708,Rawson,CHUBUT,212,237,407,397,804
26,26077,260770709,Rawson,CHUBUT,403,387,687,737,1424
26,26077,260770710,Rawson,CHUBUT,317,309,526,533,1059
26,26077,260770711,Rawson,CHUBUT,188,178,314,322,636
26,26077,260770712,Rawson,CHUBUT,346,331,608,546,1154
26,26077,260770713,Rawson,CHUBUT,306,314,524,485,1009
26,26077,260770714,Rawson,CHUBUT,223,216,404,373,777
26,26077,260770715,Rawson,CHUBUT,198,208,303,276,579
26,26077,260770801,Rawson,CHUBUT,319,342,531,597,1128
26,26077,260770802,Rawson,CHUBUT,307,317,552,521,1073
26,26077,260770803,Rawson,CHUBUT,393,381,738,663,1401
26,26077,260770804,Rawson,CHUBUT,265,285,422,371,793
26,26077,260770805,Rawson,CHUBUT,255,269,435,361,796
26,26077,260770806,Rawson,CHUBUT,403,424,637,599,1236
26,26077,260770807,Rawson,CHUBUT,160,164,245,220,465
26,26077,260770808,Rawson,CHUBUT,363,281,611,574,1185
26,26077,260770809,Rawson,CHUBUT,277,249,454,439,893
26,26077,260770810,Rawson,CHUBUT,277,272,449,386,835
26,26077,260770811,Rawson,CHUBUT,168,237,221,202,423
26,26077,260770812,Rawson,CHUBUT,224,259,300,267,567
26,26077,260770813,Rawson,CHUBUT,322,352,457,438,895
26,26077,260770814,Rawson,CHUBUT,215,231,342,371,713
26,26077,260770815,Rawson,CHUBUT,330,335,513,538,1051
26,26077,260770901,Rawson,CHUBUT,390,404,841,757,1598
26,26077,260770902,Rawson,CHUBUT,325,349,606,670,1276
26,26077,260770903,Rawson,CHUBUT,428,445,864,899,1763
26,26077,260770904,Rawson,CHUBUT,285,297,401,434,835
26,26077,260770905,Rawson,CHUBUT,350,374,555,518,1073
26,26077,260770906,Rawson,CHUBUT,355,373,568,569,1137
26,26077,260770907,Rawson,CHUBUT,240,242,378,379,757
26,26077,260770908,Rawson,CHUBUT,264,238,455,438,893
26,26077,260770909,Rawson,CHUBUT,238,241,427,443,870
26,26077,260770910,Rawson,CHUBUT,344,340,638,629,1267
26,26077,260770911,Rawson,CHUBUT,360,346,702,724,1426
26,26077,260770912,Rawson,CHUBUT,435,436,832,808,1640
26,26077,260771001,Rawson,CHUBUT,245,267,397,421,818
26,26077,260771002,Rawson,CHUBUT,246,270,335,321,656
26,26077,260771003,Rawson,CHUBUT,158,176,201,174,375
26,26077,260771004,Rawson,CHUBUT,237,287,329,311,640
26,26077,260771005,Rawson,CHUBUT,306,344,418,367,785
26,26077,260771006,Rawson,CHUBUT,140,185,189,168,357
26,26077,260771007,Rawson,CHUBUT,189,285,288,209,497
26,26077,260771008,Rawson,CHUBUT,188,253,226,284,510
26,26077,260771009,Rawson,CHUBUT,205,296,253,225,478
26,26077,260771010,Rawson,CHUBUT,213,295,284,230,514
26,26077,260771011,Rawson,CHUBUT,154,197,181,139,320
26,26077,260771012,Rawson,CHUBUT,158,231,222,224,446
26,26077,260771013,Rawson,CHUBUT,315,358,434,376,810
26,26077,260771014,Rawson,CHUBUT,328,365,433,383,816
26,26077,260771015,Rawson,CHUBUT,312,342,498,464,962
26,26077,260771016,Rawson,CHUBUT,488,508,816,758,1574
26,26077,260771017,Rawson,CHUBUT,375,406,618,622,1240
26,26077,260771018,Rawson,CHUBUT,218,246,366,386,752
26,26077,260771101,Rawson,CHUBUT,158,157,346,309,655
26,26077,260771102,Rawson,CHUBUT,425,424,849,791,1640
26,26077,260771103,Rawson,CHUBUT,366,382,679,643,1322
26,26077,260771104,Rawson,CHUBUT,222,227,437,427,864
26,26077,260771105,Rawson,CHUBUT,293,303,534,535,1069
26,26077,260771106,Rawson,CHUBUT,288,285,511,443,954
26,26077,260771107,Rawson,CHUBUT,366,333,530,541,1071
26,26077,260771108,Rawson,CHUBUT,215,253,308,268,576
26,26077,260771109,Rawson,CHUBUT,189,231,304,257,561
26,26077,260771110,Rawson,CHUBUT,163,256,172,144,316
26,26077,260771111,Rawson,CHUBUT,143,203,223,193,416
26,26077,260771112,Rawson,CHUBUT,271,366,336,293,629
26,26077,260771113,Rawson,CHUBUT,339,383,488,450,938
26,26077,260771114,Rawson,CHUBUT,193,197,345,305,650
26,26077,260771201,Rawson,CHUBUT,449,463,844,740,1584
26,26077,260771202,Rawson,CHUBUT,283,307,507,462,969
26,26077,260771203,Rawson,CHUBUT,392,409,572,543,1115
26,26077,260771204,Rawson,CHUBUT,285,314,437,383,820
26,26077,260771205,Rawson,CHUBUT,336,378,494,453,947
26,26077,260771206,Rawson,CHUBUT,319,385,435,406,841
26,26077,260771207,Rawson,CHUBUT,356,417,500,441,941
26,26077,260771208,Rawson,CHUBUT,323,394,422,362,784
26,26077,260771209,Rawson,CHUBUT,207,236,274,237,511
26,26077,260771210,Rawson,CHUBUT,320,385,400,364,764
26,26077,260771211,Rawson,CHUBUT,389,436,548,448,996
26,26077,260771212,Rawson,CHUBUT,349,385,495,454,949
26,26077,260771213,Rawson,CHUBUT,281,338,378,375,753
26,26077,260771214,Rawson,CHUBUT,378,387,696,661,1357
26,26077,260771215,Rawson,CHUBUT,363,476,666,623,1289
26,26077,260771301,Rawson,CHUBUT,336,430,649,561,1210
26,26077,260771302,Rawson,CHUBUT,446,493,845,790,1635
26,26077,260771303,Rawson,CHUBUT,364,469,463,437,900
26,26077,260771304,Rawson,CHUBUT,395,460,597,516,1113
26,26077,260771305,Rawson,CHUBUT,392,467,558,501,1059
26,26077,260771306,Rawson,CHUBUT,443,489,646,597,1243
26,26077,260771307,Rawson,CHUBUT,351,391,556,458,1014
26,26077,260771308,Rawson,CHUBUT,378,384,641,571,1212
26,26077,260771309,Rawson,CHUBUT,449,499,773,703,1476
26,26077,260771310,Rawson,CHUBUT,241,253,336,330,666
26,26077,260771311,Rawson,CHUBUT,293,335,456,423,879
26,26077,260771312,Rawson,CHUBUT,268,302,429,409,838
26,26077,260771313,Rawson,CHUBUT,212,262,349,331,680
26,26077,260771314,Rawson,CHUBUT,130,190,193,210,403
26,26084,260840101,Río Senguer,CHUBUT,6,15,3,6,9
26,26084,260840102,Río Senguer,CHUBUT,33,71,12,36,48
26,26084,260840103,Río Senguer,CHUBUT,42,94,16,53,69
26,26084,260840104,Río Senguer,CHUBUT,4,29,5,28,33
26,26084,260840105,Río Senguer,CHUBUT,5,12,3,9,12
26,26084,260840106,Río Senguer,CHUBUT,43,44,64,62,126
26,26084,260840107,Río Senguer,CHUBUT,218,294,303,321,624
26,26084,260840108,Río Senguer,CHUBUT,281,345,462,484,946
26,26084,260840201,Río Senguer,CHUBUT,68,46,19,104,123
26,26084,260840202,Río Senguer,CHUBUT,62,94,83,102,185
26,26084,260840301,Río Senguer,CHUBUT,12,10,8,18,26
26,26084,260840302,Río Senguer,CHUBUT,9,14,5,19,24
26,26084,260840303,Río Senguer,CHUBUT,11,14,6,15,21
26,26084,260840304,Río Senguer,CHUBUT,39,49,9,48,57
26,26084,260840305,Río Senguer,CHUBUT,466,531,807,821,1628
26,26084,260840306,Río Senguer,CHUBUT,270,338,387,373,760
26,26084,260840307,Río Senguer,CHUBUT,103,135,152,251,403
26,26084,260840401,Río Senguer,CHUBUT,21,26,14,42,56
26,26084,260840402,Río Senguer,CHUBUT,29,23,6,28,34
26,26084,260840403,Río Senguer,CHUBUT,65,115,96,98,194
26,26084,260840501,Río Senguer,CHUBUT,10,23,5,14,19
26,26084,260840502,Río Senguer,CHUBUT,18,25,4,32,36
26,26084,260840503,Río Senguer,CHUBUT,22,27,12,57,69
26,26084,260840504,Río Senguer,CHUBUT,24,35,16,66,82
26,26084,260840505,Río Senguer,CHUBUT,70,114,101,118,219
26,26084,260840506,Río Senguer,CHUBUT,53,82,82,94,176
26,26091,260910101,Sarmiento,CHUBUT,25,44,7,26,33
26,26091,260910102,Sarmiento,CHUBUT,34,68,54,51,105
26,26091,260910201,Sarmiento,CHUBUT,27,48,24,33,57
26,26091,260910301,Sarmiento,CHUBUT,7,11,4,8,12
26,26091,260910302,Sarmiento,CHUBUT,9,10,7,9,16
26,26091,260910303,Sarmiento,CHUBUT,36,21,8,41,49
26,26091,260910304,Sarmiento,CHUBUT,102,98,119,147,266
26,26091,260910305,Sarmiento,CHUBUT,4,10,11,194,205
26,26091,260910306,Sarmiento,CHUBUT,3,11,291,272,563
26,26091,260910401,Sarmiento,CHUBUT,212,272,320,369,689
26,26091,260910402,Sarmiento,CHUBUT,152,172,271,292,563
26,26091,260910403,Sarmiento,CHUBUT,114,190,189,230,419
26,26091,260910404,Sarmiento,CHUBUT,283,308,513,572,1085
26,26091,260910405,Sarmiento,CHUBUT,321,354,626,630,1256
26,26091,260910406,Sarmiento,CHUBUT,153,183,265,268,533
26,26091,260910407,Sarmiento,CHUBUT,180,213,263,254,517
26,26091,260910408,Sarmiento,CHUBUT,176,214,269,271,540
26,26091,260910409,Sarmiento,CHUBUT,294,352,420,417,837
26,26091,260910410,Sarmiento,CHUBUT,273,337,387,377,764
26,26091,260910411,Sarmiento,CHUBUT,176,201,279,248,527
26,26091,260910412,Sarmiento,CHUBUT,221,257,351,347,698
26,26091,260910413,Sarmiento,CHUBUT,232,249,427,424,851
26,26091,260910414,Sarmiento,CHUBUT,228,267,393,418,811
26,26098,260980101,Tehuelches,CHUBUT,15,15,1,17,18
26,26098,260980102,Tehuelches,CHUBUT,27,35,10,33,43
26,26098,260980103,Tehuelches,CHUBUT,234,302,377,373,750
26,26098,260980104,Tehuelches,CHUBUT,275,350,425,437,862
26,26098,260980201,Tehuelches,CHUBUT,20,28,3,23,26
26,26098,260980202,Tehuelches,CHUBUT,24,42,3,38,41
26,26098,260980203,Tehuelches,CHUBUT,19,29,5,51,56
26,26098,260980204,Tehuelches,CHUBUT,0,5,0,0,0
26,26098,260980205,Tehuelches,CHUBUT,432,504,660,668,1328
26,26098,260980206,Tehuelches,CHUBUT,317,358,448,475,923
26,26098,260980301,Tehuelches,CHUBUT,0,3,0,0,0
26,26098,260980302,Tehuelches,CHUBUT,1,4,0,2,2
26,26098,260980303,Tehuelches,CHUBUT,11,11,4,17,21
26,26098,260980304,Tehuelches,CHUBUT,22,25,9,27,36
26,26098,260980305,Tehuelches,CHUBUT,56,74,78,151,229
26,26098,260980306,Tehuelches,CHUBUT,340,432,522,533,1055
26,26105,261050101,Telsen,CHUBUT,28,43,23,41,64
26,26105,261050102,Telsen,CHUBUT,14,25,8,19,27
26,26105,261050103,Telsen,CHUBUT,49,73,16,68,84
26,26105,261050104,Telsen,CHUBUT,26,42,19,20,39
26,26105,261050105,Telsen,CHUBUT,205,286,270,274,544
26,26105,261050201,Telsen,CHUBUT,27,42,8,34,42
26,26105,261050202,Telsen,CHUBUT,10,15,7,16,23
26,26105,261050203,Telsen,CHUBUT,8,16,7,9,16
26,26105,261050204,Telsen,CHUBUT,53,51,68,76,144
26,26105,261050205,Telsen,CHUBUT,212,289,342,319,661
10,10007,100070101,Ambato,CATAMARCA,15,52,20,22,42
10,10007,100070102,Ambato,CATAMARCA,51,118,97,91,188
10,10007,100070103,Ambato,CATAMARCA,26,44,43,40,83
10,10007,100070104,Ambato,CATAMARCA,92,252,135,160,295
10,10007,100070105,Ambato,CATAMARCA,120,276,207,204,411
10,10007,100070201,Ambato,CATAMARCA,160,230,314,299,613
10,10007,100070202,Ambato,CATAMARCA,83,138,148,160,308
10,10007,100070203,Ambato,CATAMARCA,34,44,50,61,111
10,10007,100070204,Ambato,CATAMARCA,89,144,146,143,289
10,10007,100070301,Ambato,CATAMARCA,113,166,212,248,460
10,10007,100070302,Ambato,CATAMARCA,36,42,62,65,127
10,10007,100070401,Ambato,CATAMARCA,23,42,33,44,77
10,10007,100070402,Ambato,CATAMARCA,31,71,39,56,95
10,10007,100070403,Ambato,CATAMARCA,3,7,6,7,13
10,10007,100070404,Ambato,CATAMARCA,106,312,140,164,304
10,10007,100070405,Ambato,CATAMARCA,13,62,11,29,40
10,10007,100070406,Ambato,CATAMARCA,84,259,140,159,299
10,10007,100070407,Ambato,CATAMARCA,83,242,146,151,297
10,10007,100070408,Ambato,CATAMARCA,82,310,131,118,249
10,10007,100070409,Ambato,CATAMARCA,50,282,62,100,162
10,10014,100140101,Ancasti,CATAMARCA,97,121,207,182,389
10,10014,100140102,Ancasti,CATAMARCA,23,29,33,46,79
10,10014,100140103,Ancasti,CATAMARCA,24,31,38,51,89
10,10014,100140104,Ancasti,CATAMARCA,19,21,38,40,78
10,10014,100140201,Ancasti,CATAMARCA,92,163,178,193,371
10,10014,100140202,Ancasti,CATAMARCA,32,44,54,60,114
10,10014,100140301,Ancasti,CATAMARCA,34,53,59,78,137
10,10014,100140302,Ancasti,CATAMARCA,10,12,10,20,30
10,10014,100140303,Ancasti,CATAMARCA,9,10,17,19,36
10,10014,100140401,Ancasti,CATAMARCA,27,56,39,48,87
10,10014,100140402,Ancasti,CATAMARCA,27,30,36,46,82
10,10014,100140501,Ancasti,CATAMARCA,24,44,41,39,80
10,10014,100140502,Ancasti,CATAMARCA,39,39,55,73,128
10,10014,100140503,Ancasti,CATAMARCA,46,66,62,80,142
10,10014,100140601,Ancasti,CATAMARCA,29,40,62,69,131
10,10014,100140602,Ancasti,CATAMARCA,25,27,50,58,108
10,10014,100140701,Ancasti,CATAMARCA,59,89,110,133,243
10,10014,100140702,Ancasti,CATAMARCA,19,22,25,32,57
10,10014,100140801,Ancasti,CATAMARCA,32,38,47,55,102
10,10014,100140802,Ancasti,CATAMARCA,31,44,44,67,111
10,10014,100140803,Ancasti,CATAMARCA,29,34,52,51,103
10,10014,100140901,Ancasti,CATAMARCA,29,29,41,51,92
10,10014,100140902,Ancasti,CATAMARCA,30,33,56,72,128
10,10021,100210101,Andalgalá,CATAMARCA,95,119,185,193,378
10,10021,100210102,Andalgalá,CATAMARCA,4,10,7,9,16
10,10021,100210103,Andalgalá,CATAMARCA,436,457,907,857,1764
10,10021,100210104,Andalgalá,CATAMARCA,321,370,623,592,1215
10,10021,100210105,Andalgalá,CATAMARCA,313,365,514,502,1016
10,10021,100210106,Andalgalá,CATAMARCA,268,283,474,427,901
10,10021,100210107,Andalgalá,CATAMARCA,330,341,685,651,1336
10,10021,100210108,Andalgalá,CATAMARCA,253,289,429,410,839
10,10021,100210109,Andalgalá,CATAMARCA,241,272,438,434,872
10,10021,100210110,Andalgalá,CATAMARCA,317,352,542,514,1056
10,10021,100210111,Andalgalá,CATAMARCA,325,385,662,654,1316
10,10021,100210112,Andalgalá,CATAMARCA,236,275,481,420,901
10,10021,100210113,Andalgalá,CATAMARCA,217,252,479,512,991
10,10021,100210114,Andalgalá,CATAMARCA,90,184,198,195,393
10,10021,100210201,Andalgalá,CATAMARCA,6,17,9,11,20
10,10021,100210202,Andalgalá,CATAMARCA,273,311,552,544,1096
10,10021,100210301,Andalgalá,CATAMARCA,71,121,103,136,239
10,10021,100210401,Andalgalá,CATAMARCA,103,152,184,223,407
10,10021,100210501,Andalgalá,CATAMARCA,27,39,26,65,91
10,10021,100210601,Andalgalá,CATAMARCA,16,31,22,54,76
10,10021,100210701,Andalgalá,CATAMARCA,48,56,74,90,164
10,10021,100210801,Andalgalá,CATAMARCA,51,94,114,156,270
10,10021,100210901,Andalgalá,CATAMARCA,25,35,43,97,140
10,10021,100210902,Andalgalá,CATAMARCA,53,70,87,89,176
10,10021,100211001,Andalgalá,CATAMARCA,153,236,337,345,682
10,10021,100211002,Andalgalá,CATAMARCA,73,135,144,158,302
10,10021,100211003,Andalgalá,CATAMARCA,90,199,165,201,366
10,10021,100211004,Andalgalá,CATAMARCA,91,216,165,210,375
10,10021,100211005,Andalgalá,CATAMARCA,99,251,216,216,432
10,10021,100211006,Andalgalá,CATAMARCA,72,286,154,148,302
10,10028,100280101,Antofagasta de la Sierra,CATAMARCA,75,145,131,153,284
10,10028,100280201,Antofagasta de la Sierra,CATAMARCA,49,116,79,228,307
10,10028,100280202,Antofagasta de la Sierra,CATAMARCA,199,371,350,380,730
10,10028,100280301,Antofagasta de la Sierra,CATAMARCA,18,44,23,27,50
10,10028,100280302,Antofagasta de la Sierra,CATAMARCA,24,60,30,35,65
10,10035,100350101,Belén,CATAMARCA,275,336,581,595,1176
10,10035,100350102,Belén,CATAMARCA,20,35,49,43,92
10,10035,100350103,Belén,CATAMARCA,281,341,543,507,1050
10,10035,100350104,Belén,CATAMARCA,203,247,382,353,735
10,10035,100350105,Belén,CATAMARCA,357,363,656,613,1269
10,10035,100350106,Belén,CATAMARCA,314,407,545,458,1003
10,10035,100350107,Belén,CATAMARCA,196,232,360,296,656
10,10035,100350108,Belén,CATAMARCA,265,272,491,472,963
10,10035,100350109,Belén,CATAMARCA,218,257,402,369,771
10,10035,100350110,Belén,CATAMARCA,240,229,433,391,824
10,10035,100350111,Belén,CATAMARCA,204,253,384,353,737
10,10035,100350112,Belén,CATAMARCA,329,353,695,656,1351
10,10035,100350113,Belén,CATAMARCA,276,306,542,476,1018
10,10035,100350114,Belén,CATAMARCA,201,219,470,419,889
10,10035,100350115,Belén,CATAMARCA,242,256,541,449,990
10,10035,100350201,Belén,CATAMARCA,82,109,174,157,331
10,10035,100350202,Belén,CATAMARCA,29,34,50,50,100
10,10035,100350203,Belén,CATAMARCA,27,32,53,69,122
10,10035,100350204,Belén,CATAMARCA,303,375,587,577,1164
10,10035,100350205,Belén,CATAMARCA,177,223,323,326,649
10,10035,100350206,Belén,CATAMARCA,173,222,321,322,643
10,10035,100350301,Belén,CATAMARCA,73,87,152,125,277
10,10035,100350302,Belén,CATAMARCA,34,52,83,69,152
10,10035,100350303,Belén,CATAMARCA,75,102,135,140,275
10,10035,100350304,Belén,CATAMARCA,55,81,98,104,202
10,10035,100350305,Belén,CATAMARCA,70,58,119,143,262
10,10035,100350306,Belén,CATAMARCA,160,211,347,380,727
10,10035,100350307,Belén,CATAMARCA,82,116,130,157,287
10,10035,100350401,Belén,CATAMARCA,110,146,204,217,421
10,10035,100350402,Belén,CATAMARCA,43,51,93,100,193
10,10035,100350501,Belén,CATAMARCA,117,156,236,231,467
10,10035,100350502,Belén,CATAMARCA,143,188,287,288,575
10,10035,100350503,Belén,CATAMARCA,190,238,382,403,785
10,10035,100350504,Belén,CATAMARCA,13,23,27,24,51
10,10035,100350505,Belén,CATAMARCA,43,46,94,94,188
10,10035,100350506,Belén,CATAMARCA,58,81,143,128,271
10,10035,100350507,Belén,CATAMARCA,13,23,39,44,83
10,10035,100350508,Belén,CATAMARCA,284,285,628,576,1204
10,10035,100350601,Belén,CATAMARCA,63,102,178,1390,1568
10,10035,100350602,Belén,CATAMARCA,49,60,89,91,180
10,10035,100350603,Belén,CATAMARCA,58,104,112,110,222
10,10035,100350604,Belén,CATAMARCA,59,78,123,118,241
10,10035,100350605,Belén,CATAMARCA,108,164,236,220,456
10,10035,100350606,Belén,CATAMARCA,138,149,252,293,545
10,10035,100350607,Belén,CATAMARCA,119,133,351,340,691
10,10035,100350608,Belén,CATAMARCA,248,307,481,506,987
10,10042,100420101,Capayán,CATAMARCA,25,44,34,46,80
10,10042,100420102,Capayán,CATAMARCA,58,71,104,138,242
10,10042,100420103,Capayán,CATAMARCA,178,209,381,386,767
10,10042,100420104,Capayán,CATAMARCA,193,218,428,395,823
10,10042,100420105,Capayán,CATAMARCA,228,277,496,475,971
10,10042,100420106,Capayán,CATAMARCA,254,311,535,535,1070
10,10042,100420107,Capayán,CATAMARCA,233,282,480,420,900
10,10042,100420201,Capayán,CATAMARCA,44,73,67,72,139
10,10042,100420202,Capayán,CATAMARCA,165,206,319,318,637
10,10042,100420203,Capayán,CATAMARCA,16,26,20,29,49
10,10042,100420204,Capayán,CATAMARCA,85,84,60,162,222
10,10042,100420205,Capayán,CATAMARCA,78,93,174,178,352
10,10042,100420206,Capayán,CATAMARCA,217,311,473,473,946
10,10042,100420207,Capayán,CATAMARCA,358,400,742,728,1470
10,10042,100420301,Capayán,CATAMARCA,172,227,311,342,653
10,10042,100420302,Capayán,CATAMARCA,194,226,401,439,840
10,10042,100420303,Capayán,CATAMARCA,323,426,591,1059,1650
10,10042,100420304,Capayán,CATAMARCA,51,67,82,104,186
10,10042,100420305,Capayán,CATAMARCA,225,259,463,478,941
10,10042,100420306,Capayán,CATAMARCA,254,315,494,516,1010
10,10042,100420307,Capayán,CATAMARCA,28,33,46,31,77
10,10042,100420401,Capayán,CATAMARCA,100,170,158,214,372
10,10042,100420402,Capayán,CATAMARCA,110,218,190,213,403
10,10042,100420501,Capayán,CATAMARCA,21,62,39,52,91
10,10042,100420502,Capayán,CATAMARCA,85,161,138,158,296
10,10042,100420601,Capayán,CATAMARCA,12,26,16,23,39
10,10042,100420602,Capayán,CATAMARCA,118,160,227,219,446
10,10042,100420603,Capayán,CATAMARCA,39,48,73,74,147
10,10042,100420604,Capayán,CATAMARCA,63,69,129,137,266
10,10049,100490101,Capital,CATAMARCA,65,74,108,108,216
10,10049,100490102,Capital,CATAMARCA,462,419,1004,937,1941
10,10049,100490103,Capital,CATAMARCA,298,305,678,590,1268
10,10049,100490104,Capital,CATAMARCA,172,242,362,316,678
10,10049,100490105,Capital,CATAMARCA,328,342,649,605,1254
10,10049,100490106,Capital,CATAMARCA,274,291,592,551,1143
10,10049,100490107,Capital,CATAMARCA,222,231,470,461,931
10,10049,100490108,Capital,CATAMARCA,243,245,613,561,1174
10,10049,100490109,Capital,CATAMARCA,197,212,446,394,840
10,10049,100490110,Capital,CATAMARCA,397,437,829,749,1578
10,10049,100490111,Capital,CATAMARCA,462,633,858,846,1704
10,10049,100490112,Capital,CATAMARCA,393,382,851,696,1547
10,10049,100490113,Capital,CATAMARCA,442,404,1045,957,2002
10,10049,100490114,Capital,CATAMARCA,370,375,912,866,1778
10,10049,100490115,Capital,CATAMARCA,299,323,590,531,1121
10,10049,100490201,Capital,CATAMARCA,282,285,557,564,1121
10,10049,100490202,Capital,CATAMARCA,262,275,538,485,1023
10,10049,100490203,Capital,CATAMARCA,304,319,613,576,1189
10,10049,100490204,Capital,CATAMARCA,273,274,488,435,923
10,10049,100490205,Capital,CATAMARCA,269,320,500,450,950
10,10049,100490206,Capital,CATAMARCA,198,242,327,313,640
10,10049,100490207,Capital,CATAMARCA,384,436,634,553,1187
10,10049,100490208,Capital,CATAMARCA,371,397,684,644,1328
10,10049,100490209,Capital,CATAMARCA,292,299,486,423,909
10,10049,100490210,Capital,CATAMARCA,229,254,405,347,752
10,10049,100490211,Capital,CATAMARCA,187,233,352,322,674
10,10049,100490212,Capital,CATAMARCA,210,211,475,405,880
10,10049,100490213,Capital,CATAMARCA,183,194,368,310,678
10,10049,100490214,Capital,CATAMARCA,219,235,430,344,774
10,10049,100490215,Capital,CATAMARCA,203,227,359,301,660
10,10049,100490216,Capital,CATAMARCA,391,433,638,520,1158
10,10049,100490217,Capital,CATAMARCA,290,300,470,376,846
10,10049,100490218,Capital,CATAMARCA,224,256,396,373,769
10,10049,100490219,Capital,CATAMARCA,302,306,481,509,990
10,10049,100490220,Capital,CATAMARCA,147,211,268,254,522
10,10049,100490221,Capital,CATAMARCA,182,225,324,288,612
10,10049,100490301,Capital,CATAMARCA,356,375,748,671,1419
10,10049,100490302,Capital,CATAMARCA,265,272,590,537,1127
10,10049,100490303,Capital,CATAMARCA,306,333,634,597,1231
10,10049,100490304,Capital,CATAMARCA,277,291,533,525,1058
10,10049,100490305,Capital,CATAMARCA,258,254,578,585,1163
10,10049,100490306,Capital,CATAMARCA,255,236,510,541,1051
10,10049,100490307,Capital,CATAMARCA,227,227,523,544,1067
10,10049,100490308,Capital,CATAMARCA,317,316,707,717,1424
10,10049,100490309,Capital,CATAMARCA,425,430,880,864,1744
10,10049,100490310,Capital,CATAMARCA,209,192,382,364,746
10,10049,100490311,Capital,CATAMARCA,385,379,623,558,1181
10,10049,100490312,Capital,CATAMARCA,252,237,397,363,760
10,10049,100490313,Capital,CATAMARCA,204,203,340,316,656
10,10049,100490314,Capital,CATAMARCA,266,284,480,477,957
10,10049,100490315,Capital,CATAMARCA,274,288,536,462,998
10,10049,100490316,Capital,CATAMARCA,187,237,330,248,578
10,10049,100490317,Capital,CATAMARCA,374,449,589,501,1090
10,10049,100490318,Capital,CATAMARCA,197,250,326,278,604
10,10049,100490319,Capital,CATAMARCA,292,376,486,395,881
10,10049,100490320,Capital,CATAMARCA,320,400,531,445,976
10,10049,100490321,Capital,CATAMARCA,175,257,282,220,502
10,10049,100490322,Capital,CATAMARCA,136,197,180,135,315
10,10049,100490323,Capital,CATAMARCA,176,236,243,181,424
10,10049,100490324,Capital,CATAMARCA,232,265,435,364,799
10,10049,100490401,Capital,CATAMARCA,216,220,405,378,783
10,10049,100490402,Capital,CATAMARCA,204,219,379,356,735
10,10049,100490403,Capital,CATAMARCA,242,260,425,393,818
10,10049,100490404,Capital,CATAMARCA,355,368,836,817,1653
10,10049,100490405,Capital,CATAMARCA,302,263,691,684,1375
10,10049,100490406,Capital,CATAMARCA,324,323,715,704,1419
10,10049,100490407,Capital,CATAMARCA,378,370,855,859,1714
10,10049,100490408,Capital,CATAMARCA,235,199,484,445,929
10,10049,100490409,Capital,CATAMARCA,384,429,721,666,1387
10,10049,100490410,Capital,CATAMARCA,274,305,520,473,993
10,10049,100490411,Capital,CATAMARCA,289,326,534,514,1048
10,10049,100490412,Capital,CATAMARCA,261,270,503,430,933
10,10049,100490413,Capital,CATAMARCA,245,271,477,406,883
10,10049,100490414,Capital,CATAMARCA,246,269,497,450,947
10,10049,100490415,Capital,CATAMARCA,286,317,579,585,1164
10,10049,100490416,Capital,CATAMARCA,372,404,698,633,1331
10,10049,100490417,Capital,CATAMARCA,216,220,490,407,897
10,10049,100490418,Capital,CATAMARCA,289,307,532,529,1061
10,10049,100490419,Capital,CATAMARCA,329,322,594,570,1164
10,10049,100490501,Capital,CATAMARCA,244,348,415,358,773
10,10049,100490502,Capital,CATAMARCA,207,246,306,256,562
10,10049,100490503,Capital,CATAMARCA,209,232,376,379,755
10,10049,100490504,Capital,CATAMARCA,208,235,376,332,708
10,10049,100490505,Capital,CATAMARCA,262,276,547,514,1061
10,10049,100490506,Capital,CATAMARCA,212,194,408,412,820
10,10049,100490507,Capital,CATAMARCA,211,230,422,340,762
10,10049,100490508,Capital,CATAMARCA,296,337,494,374,868
10,10049,100490509,Capital,CATAMARCA,236,277,400,303,703
10,10049,100490510,Capital,CATAMARCA,344,332,709,653,1362
10,10049,100490511,Capital,CATAMARCA,217,210,413,375,788
10,10049,100490512,Capital,CATAMARCA,398,370,853,822,1675
10,10049,100490513,Capital,CATAMARCA,439,409,942,890,1832
10,10049,100490514,Capital,CATAMARCA,176,161,298,282,580
10,10049,100490515,Capital,CATAMARCA,422,389,885,922,1807
10,10049,100490516,Capital,CATAMARCA,403,459,813,828,1641
10,10049,100490517,Capital,CATAMARCA,167,163,370,358,728
10,10049,100490601,Capital,CATAMARCA,293,345,439,413,852
10,10049,100490602,Capital,CATAMARCA,204,268,324,270,594
10,10049,100490603,Capital,CATAMARCA,211,286,340,236,576
10,10049,100490604,Capital,CATAMARCA,177,263,273,202,475
10,10049,100490605,Capital,CATAMARCA,207,259,376,285,661
10,10049,100490606,Capital,CATAMARCA,264,272,419,362,781
10,10049,100490607,Capital,CATAMARCA,321,297,602,536,1138
10,10049,100490608,Capital,CATAMARCA,153,173,264,230,494
10,10049,100490609,Capital,CATAMARCA,284,312,497,467,964
10,10049,100490610,Capital,CATAMARCA,239,256,406,384,790
10,10049,100490611,Capital,CATAMARCA,305,305,590,578,1168
10,10049,100490612,Capital,CATAMARCA,228,210,457,466,923
10,10049,100490613,Capital,CATAMARCA,367,366,700,621,1321
10,10049,100490614,Capital,CATAMARCA,230,247,397,383,780
10,10049,100490615,Capital,CATAMARCA,369,325,731,735,1466
10,10049,100490616,Capital,CATAMARCA,289,292,629,619,1248
10,10049,100490617,Capital,CATAMARCA,192,192,436,401,837
10,10049,100490618,Capital,CATAMARCA,292,268,591,573,1164
10,10049,100490619,Capital,CATAMARCA,225,213,453,402,855
10,10049,100490701,Capital,CATAMARCA,290,333,536,527,1063
10,10049,100490702,Capital,CATAMARCA,204,261,404,347,751
10,10049,100490703,Capital,CATAMARCA,251,306,453,419,872
10,10049,100490704,Capital,CATAMARCA,241,243,461,411,872
10,10049,100490705,Capital,CATAMARCA,187,207,338,319,657
10,10049,100490706,Capital,CATAMARCA,378,383,770,723,1493
10,10049,100490707,Capital,CATAMARCA,437,420,864,795,1659
10,10049,100490708,Capital,CATAMARCA,277,274,563,529,1092
10,10049,100490709,Capital,CATAMARCA,279,288,582,549,1131
10,10049,100490710,Capital,CATAMARCA,287,269,583,598,1181
10,10049,100490711,Capital,CATAMARCA,311,281,621,601,1222
10,10049,100490712,Capital,CATAMARCA,387,419,782,720,1502
10,10049,100490801,Capital,CATAMARCA,168,168,397,342,739
10,10049,100490802,Capital,CATAMARCA,260,249,568,536,1104
10,10049,100490803,Capital,CATAMARCA,347,333,762,688,1450
10,10049,100490804,Capital,CATAMARCA,233,231,508,454,962
10,10049,100490805,Capital,CATAMARCA,288,269,580,577,1157
10,10049,100490806,Capital,CATAMARCA,219,182,436,434,870
10,10049,100490807,Capital,CATAMARCA,284,312,596,525,1121
10,10049,100490808,Capital,CATAMARCA,420,425,958,917,1875
10,10049,100490809,Capital,CATAMARCA,249,275,511,507,1018
10,10049,100490810,Capital,CATAMARCA,350,308,702,742,1444
10,10049,100490811,Capital,CATAMARCA,268,251,597,598,1195
10,10049,100490812,Capital,CATAMARCA,191,196,435,458,893
10,10049,100490813,Capital,CATAMARCA,438,460,967,832,1799
10,10049,100490901,Capital,CATAMARCA,91,158,140,138,278
10,10049,100490902,Capital,CATAMARCA,114,119,213,229,442
10,10049,100490903,Capital,CATAMARCA,230,241,439,440,879
10,10049,100490904,Capital,CATAMARCA,256,244,617,537,1154
10,10049,100490905,Capital,CATAMARCA,148,141,330,306,636
10,10049,100490906,Capital,CATAMARCA,423,434,957,857,1814
10,10049,100490907,Capital,CATAMARCA,282,336,581,602,1183
10,10049,100490908,Capital,CATAMARCA,235,210,581,500,1081
10,10049,100490909,Capital,CATAMARCA,325,374,720,711,1431
10,10049,100490910,Capital,CATAMARCA,253,291,479,487,966
10,10049,100490911,Capital,CATAMARCA,219,203,453,427,880
10,10049,100490912,Capital,CATAMARCA,303,322,665,599,1264
10,10049,100490913,Capital,CATAMARCA,269,252,583,551,1134
10,10049,100490914,Capital,CATAMARCA,306,428,621,561,1182
10,10056,100560101,El Alto,CATAMARCA,10,34,12,17,29
10,10056,100560102,El Alto,CATAMARCA,115,293,185,191,376
10,10056,100560103,El Alto,CATAMARCA,38,67,40,67,107
10,10056,100560104,El Alto,CATAMARCA,11,25,14,21,35
10,10056,100560201,El Alto,CATAMARCA,21,39,26,39,65
10,10056,100560202,El Alto,CATAMARCA,18,25,30,27,57
10,10056,100560203,El Alto,CATAMARCA,24,40,37,42,79
10,10056,100560204,El Alto,CATAMARCA,11,22,18,19,37
10,10056,100560205,El Alto,CATAMARCA,212,312,361,393,754
10,10056,100560301,El Alto,CATAMARCA,20,27,18,31,49
10,10056,100560302,El Alto,CATAMARCA,53,76,89,89,178
10,10056,100560303,El Alto,CATAMARCA,46,75,54,74,128
10,10056,100560304,El Alto,CATAMARCA,31,47,42,48,90
10,10056,100560401,El Alto,CATAMARCA,39,50,64,56,120
10,10056,100560402,El Alto,CATAMARCA,15,27,22,35,57
10,10056,100560403,El Alto,CATAMARCA,41,67,66,87,153
10,10056,100560501,El Alto,CATAMARCA,14,13,34,30,64
10,10056,100560502,El Alto,CATAMARCA,92,137,163,178,341
10,10056,100560503,El Alto,CATAMARCA,74,98,151,144,295
10,10056,100560504,El Alto,CATAMARCA,56,62,93,127,220
10,10056,100560601,El Alto,CATAMARCA,35,42,59,59,118
10,10056,100560602,El Alto,CATAMARCA,6,8,2,9,11
10,10056,100560603,El Alto,CATAMARCA,22,32,33,37,70
10,10056,100560701,El Alto,CATAMARCA,38,48,57,80,137
10,10063,100630101,Fray Mamerto Esquiú,CATAMARCA,185,220,372,387,759
10,10063,100630102,Fray Mamerto Esquiú,CATAMARCA,64,82,118,129,247
10,10063,100630103,Fray Mamerto Esquiú,CATAMARCA,73,112,120,134,254
10,10063,100630201,Fray Mamerto Esquiú,CATAMARCA,98,133,193,182,375
10,10063,100630202,Fray Mamerto Esquiú,CATAMARCA,203,223,433,444,877
10,10063,100630203,Fray Mamerto Esquiú,CATAMARCA,163,200,311,287,598
10,10063,100630204,Fray Mamerto Esquiú,CATAMARCA,228,270,434,445,879
10,10063,100630205,Fray Mamerto Esquiú,CATAMARCA,267,300,604,542,1146
10,10063,100630206,Fray Mamerto Esquiú,CATAMARCA,189,199,428,403,831
10,10063,100630207,Fray Mamerto Esquiú,CATAMARCA,197,194,398,386,784
10,10063,100630208,Fray Mamerto Esquiú,CATAMARCA,204,236,365,332,697
10,10063,100630209,Fray Mamerto Esquiú,CATAMARCA,220,263,387,390,777
10,10063,100630210,Fray Mamerto Esquiú,CATAMARCA,202,235,384,385,769
10,10063,100630211,Fray Mamerto Esquiú,CATAMARCA,193,203,385,401,786
10,10063,100630212,Fray Mamerto Esquiú,CATAMARCA,223,241,425,423,848
10,10063,100630213,Fray Mamerto Esquiú,CATAMARCA,305,362,598,652,1250
10,10063,100630214,Fray Mamerto Esquiú,CATAMARCA,5,5,8,11,19
10,10063,100630215,Fray Mamerto Esquiú,CATAMARCA,0,1,0,0,0
10,10063,100630216,Fray Mamerto Esquiú,CATAMARCA,0,1,0,0,0
10,10063,100630217,Fray Mamerto Esquiú,CATAMARCA,0,1,0,0,0
10,10063,100630218,Fray Mamerto Esquiú,CATAMARCA,0,1,0,0,0
10,10070,100700101,La Paz,CATAMARCA,36,34,33,73,106
10,10070,100700102,La Paz,CATAMARCA,42,59,57,91,148
10,10070,100700103,La Paz,CATAMARCA,378,469,744,735,1479
10,10070,100700104,La Paz,CATAMARCA,291,345,495,537,1032
10,10070,100700105,La Paz,CATAMARCA,275,316,508,441,949
10,10070,100700106,La Paz,CATAMARCA,233,243,430,453,883
10,10070,100700107,La Paz,CATAMARCA,307,327,672,611,1283
10,10070,100700108,La Paz,CATAMARCA,285,299,629,608,1237
10,10070,100700109,La Paz,CATAMARCA,243,273,397,372,769
10,10070,100700110,La Paz,CATAMARCA,387,432,667,669,1336
10,10070,100700111,La Paz,CATAMARCA,296,325,543,534,1077
10,10070,100700112,La Paz,CATAMARCA,290,341,548,510,1058
10,10070,100700113,La Paz,CATAMARCA,191,241,378,366,744
10,10070,100700201,La Paz,CATAMARCA,132,179,233,271,504
10,10070,100700202,La Paz,CATAMARCA,90,126,139,184,323
10,10070,100700203,La Paz,CATAMARCA,273,358,492,527,1019
10,10070,100700204,La Paz,CATAMARCA,210,257,361,422,783
10,10070,100700205,La Paz,CATAMARCA,114,165,243,250,493
10,10070,100700301,La Paz,CATAMARCA,266,336,422,496,918
10,10070,100700302,La Paz,CATAMARCA,72,94,120,141,261
10,10070,100700303,La Paz,CATAMARCA,132,172,180,192,372
10,10070,100700304,La Paz,CATAMARCA,24,38,36,63,99
10,10070,100700305,La Paz,CATAMARCA,278,370,501,507,1008
10,10070,100700306,La Paz,CATAMARCA,262,322,420,455,875
10,10070,100700307,La Paz,CATAMARCA,269,292,522,544,1066
10,10070,100700308,La Paz,CATAMARCA,204,265,389,380,769
10,10070,100700309,La Paz,CATAMARCA,53,71,76,109,185
10,10070,100700401,La Paz,CATAMARCA,60,83,92,105,197
10,10070,100700402,La Paz,CATAMARCA,50,67,70,102,172
10,10070,100700403,La Paz,CATAMARCA,72,93,151,186,337
10,10070,100700404,La Paz,CATAMARCA,278,372,591,565,1156
10,10077,100770101,Paclín,CATAMARCA,15,25,12,25,37
10,10077,100770102,Paclín,CATAMARCA,74,88,171,151,322
10,10077,100770103,Paclín,CATAMARCA,52,81,87,103,190
10,10077,100770104,Paclín,CATAMARCA,194,232,359,367,726
10,10077,100770105,Paclín,CATAMARCA,215,277,387,392,779
10,10077,100770201,Paclín,CATAMARCA,45,75,80,103,183
10,10077,100770202,Paclín,CATAMARCA,75,123,128,158,286
10,10077,100770203,Paclín,CATAMARCA,25,45,45,52,97
10,10077,100770301,Paclín,CATAMARCA,58,76,97,127,224
10,10077,100770401,Paclín,CATAMARCA,61,102,99,137,236
10,10077,100770402,Paclín,CATAMARCA,29,36,55,58,113
10,10077,100770501,Paclín,CATAMARCA,22,21,34,33,67
10,10077,100770502,Paclín,CATAMARCA,73,96,113,153,266
10,10077,100770601,Paclín,CATAMARCA,96,283,147,160,307
10,10077,100770602,Paclín,CATAMARCA,43,141,55,87,142
10,10077,100770603,Paclín,CATAMARCA,75,282,92,118,210
10,10084,100840101,Pomán,CATAMARCA,174,204,290,371,661
10,10084,100840102,Pomán,CATAMARCA,12,22,11,26,37
10,10084,100840103,Pomán,CATAMARCA,200,238,379,392,771
10,10084,100840104,Pomán,CATAMARCA,190,222,338,334,672
10,10084,100840105,Pomán,CATAMARCA,185,221,320,361,681
10,10084,100840106,Pomán,CATAMARCA,190,225,368,364,732
10,10084,100840107,Pomán,CATAMARCA,7,16,2,12,14
10,10084,100840201,Pomán,CATAMARCA,24,30,30,53,83
10,10084,100840202,Pomán,CATAMARCA,138,213,232,246,478
10,10084,100840203,Pomán,CATAMARCA,155,222,288,295,583
10,10084,100840204,Pomán,CATAMARCA,137,194,245,247,492
10,10084,100840301,Pomán,CATAMARCA,12,22,19,21,40
10,10084,100840302,Pomán,CATAMARCA,30,40,61,76,137
10,10084,100840303,Pomán,CATAMARCA,139,207,264,259,523
10,10084,100840304,Pomán,CATAMARCA,287,367,552,617,1169
10,10084,100840305,Pomán,CATAMARCA,127,136,292,252,544
10,10084,100840306,Pomán,CATAMARCA,204,238,396,413,809
10,10084,100840307,Pomán,CATAMARCA,246,270,488,527,1015
10,10084,100840401,Pomán,CATAMARCA,176,230,387,467,854
10,10084,100840402,Pomán,CATAMARCA,18,32,21,32,53
10,10084,100840403,Pomán,CATAMARCA,95,110,218,210,428
10,10091,100910101,Santa María,CATAMARCA,5,8,4,6,10
10,10091,100910102,Santa María,CATAMARCA,81,69,172,160,332
10,10091,100910103,Santa María,CATAMARCA,236,246,447,435,882
10,10091,100910104,Santa María,CATAMARCA,263,264,460,443,903
10,10091,100910105,Santa María,CATAMARCA,273,317,456,433,889
10,10091,100910106,Santa María,CATAMARCA,201,234,348,268,616
10,10091,100910107,Santa María,CATAMARCA,275,307,533,494,1027
10,10091,100910108,Santa María,CATAMARCA,386,435,834,782,1616
10,10091,100910109,Santa María,CATAMARCA,317,351,619,506,1125
10,10091,100910110,Santa María,CATAMARCA,273,301,494,461,955
10,10091,100910111,Santa María,CATAMARCA,293,297,601,572,1173
10,10091,100910112,Santa María,CATAMARCA,203,245,424,382,806
10,10091,100910113,Santa María,CATAMARCA,208,241,415,400,815
10,10091,100910114,Santa María,CATAMARCA,216,280,468,491,959
10,10091,100910115,Santa María,CATAMARCA,136,245,304,254,558
10,10091,100910201,Santa María,CATAMARCA,125,179,241,234,475
10,10091,100910202,Santa María,CATAMARCA,53,81,118,114,232
10,10091,100910301,Santa María,CATAMARCA,1,6,2,1,3
10,10091,100910302,Santa María,CATAMARCA,215,278,424,425,849
10,10091,100910303,Santa María,CATAMARCA,219,258,431,456,887
10,10091,100910401,Santa María,CATAMARCA,7,15,11,19,30
10,10091,100910402,Santa María,CATAMARCA,0,1,0,0,0
10,10091,100910403,Santa María,CATAMARCA,379,441,790,757,1547
10,10091,100910404,Santa María,CATAMARCA,117,164,202,210,412
10,10091,100910405,Santa María,CATAMARCA,11,18,12,15,27
10,10091,100910501,Santa María,CATAMARCA,161,301,291,298,589
10,10091,100910502,Santa María,CATAMARCA,182,265,374,349,723
10,10091,100910503,Santa María,CATAMARCA,162,208,326,280,606
10,10091,100910504,Santa María,CATAMARCA,172,219,338,301,639
10,10091,100910505,Santa María,CATAMARCA,257,350,479,454,933
10,10091,100910506,Santa María,CATAMARCA,33,53,62,67,129
10,10091,100910507,Santa María,CATAMARCA,111,213,201,208,409
10,10091,100910508,Santa María,CATAMARCA,76,117,118,134,252
10,10091,100910509,Santa María,CATAMARCA,69,129,113,121,234
10,10091,100910510,Santa María,CATAMARCA,19,53,33,35,68
10,10091,100910511,Santa María,CATAMARCA,1,5,1,1,2
10,10091,100910601,Santa María,CATAMARCA,55,69,82,105,187
10,10091,100910602,Santa María,CATAMARCA,26,33,43,38,81
10,10091,100910603,Santa María,CATAMARCA,44,55,63,70,133
10,10091,100910604,Santa María,CATAMARCA,21,40,42,49,91
10,10091,100910701,Santa María,CATAMARCA,15,40,24,30,54
10,10091,100910702,Santa María,CATAMARCA,62,105,110,110,220
10,10091,100910703,Santa María,CATAMARCA,23,37,32,38,70
10,10098,100980101,Santa Rosa,CATAMARCA,102,140,165,180,345
10,10098,100980102,Santa Rosa,CATAMARCA,210,238,388,404,792
10,10098,100980103,Santa Rosa,CATAMARCA,8,11,10,10,20
10,10098,100980104,Santa Rosa,CATAMARCA,68,85,103,136,239
10,10098,100980201,Santa Rosa,CATAMARCA,34,43,52,76,128
10,10098,100980202,Santa Rosa,CATAMARCA,27,42,34,56,90
10,10098,100980203,Santa Rosa,CATAMARCA,200,237,390,440,830
10,10098,100980204,Santa Rosa,CATAMARCA,51,62,74,102,176
10,10098,100980205,Santa Rosa,CATAMARCA,165,200,276,285,561
10,10098,100980206,Santa Rosa,CATAMARCA,152,210,257,278,535
10,10098,100980207,Santa Rosa,CATAMARCA,70,85,112,171,283
10,10098,100980208,Santa Rosa,CATAMARCA,44,58,75,82,157
10,10098,100980301,Santa Rosa,CATAMARCA,49,47,98,113,211
10,10098,100980302,Santa Rosa,CATAMARCA,31,30,54,47,101
10,10098,100980303,Santa Rosa,CATAMARCA,123,128,226,316,542
10,10098,100980401,Santa Rosa,CATAMARCA,74,81,134,178,312
10,10098,100980402,Santa Rosa,CATAMARCA,225,246,420,419,839
10,10098,100980403,Santa Rosa,CATAMARCA,191,216,413,440,853
10,10098,100980404,Santa Rosa,CATAMARCA,390,451,763,780,1543
10,10098,100980405,Santa Rosa,CATAMARCA,309,275,602,653,1255
10,10098,100980406,Santa Rosa,CATAMARCA,19,25,24,32,56
10,10098,100980407,Santa Rosa,CATAMARCA,169,208,348,374,722
10,10098,100980408,Santa Rosa,CATAMARCA,194,230,365,428,793
10,10098,100980409,Santa Rosa,CATAMARCA,177,226,306,297,603
10,10098,100980410,Santa Rosa,CATAMARCA,14,31,22,26,48
10,10105,101050101,Tinogasta,CATAMARCA,38,81,47,56,103
10,10105,101050102,Tinogasta,CATAMARCA,195,239,363,375,738
10,10105,101050103,Tinogasta,CATAMARCA,147,232,296,285,581
10,10105,101050104,Tinogasta,CATAMARCA,300,393,510,482,992
10,10105,101050105,Tinogasta,CATAMARCA,267,314,513,472,985
10,10105,101050106,Tinogasta,CATAMARCA,179,205,347,363,710
10,10105,101050107,Tinogasta,CATAMARCA,256,318,449,424,873
10,10105,101050108,Tinogasta,CATAMARCA,179,199,323,302,625
10,10105,101050109,Tinogasta,CATAMARCA,263,304,457,384,841
10,10105,101050110,Tinogasta,CATAMARCA,157,206,255,240,495
10,10105,101050111,Tinogasta,CATAMARCA,260,324,407,432,839
10,10105,101050112,Tinogasta,CATAMARCA,272,330,560,506,1066
10,10105,101050113,Tinogasta,CATAMARCA,153,206,290,302,592
10,10105,101050114,Tinogasta,CATAMARCA,306,376,524,485,1009
10,10105,101050115,Tinogasta,CATAMARCA,288,341,620,519,1139
10,10105,101050201,Tinogasta,CATAMARCA,63,89,131,139,270
10,10105,101050202,Tinogasta,CATAMARCA,195,272,343,352,695
10,10105,101050301,Tinogasta,CATAMARCA,8,27,15,28,43
10,10105,101050302,Tinogasta,CATAMARCA,215,347,457,430,887
10,10105,101050303,Tinogasta,CATAMARCA,243,349,452,454,906
10,10105,101050304,Tinogasta,CATAMARCA,265,315,523,506,1029
10,10105,101050305,Tinogasta,CATAMARCA,177,233,297,320,617
10,10105,101050306,Tinogasta,CATAMARCA,181,226,363,347,710
10,10105,101050307,Tinogasta,CATAMARCA,140,199,268,276,544
10,10105,101050401,Tinogasta,CATAMARCA,120,168,197,235,432
10,10105,101050402,Tinogasta,CATAMARCA,58,75,113,133,246
10,10105,101050501,Tinogasta,CATAMARCA,66,95,106,132,238
10,10105,101050502,Tinogasta,CATAMARCA,18,38,24,27,51
10,10105,101050601,Tinogasta,CATAMARCA,2,5,4,3,7
10,10105,101050602,Tinogasta,CATAMARCA,167,216,298,392,690
10,10105,101050701,Tinogasta,CATAMARCA,87,132,184,216,400
10,10105,101050702,Tinogasta,CATAMARCA,241,346,448,551,999
10,10105,101050703,Tinogasta,CATAMARCA,52,43,80,103,183
10,10105,101050704,Tinogasta,CATAMARCA,25,44,39,50,89
10,10105,101050705,Tinogasta,CATAMARCA,44,88,52,64,116
10,10105,101050706,Tinogasta,CATAMARCA,42,81,64,69,133
10,10105,101050707,Tinogasta,CATAMARCA,82,108,183,163,346
10,10105,101050708,Tinogasta,CATAMARCA,133,208,222,238,460
10,10105,101050709,Tinogasta,CATAMARCA,139,194,266,266,532
10,10105,101050801,Tinogasta,CATAMARCA,34,53,53,72,125
10,10105,101050802,Tinogasta,CATAMARCA,9,19,10,14,24
10,10112,101120101,Valle Viejo,CATAMARCA,118,147,214,209,423
10,10112,101120201,Valle Viejo,CATAMARCA,42,66,65,72,137
10,10112,101120202,Valle Viejo,CATAMARCA,63,83,83,94,177
10,10112,101120301,Valle Viejo,CATAMARCA,30,33,44,62,106
10,10112,101120302,Valle Viejo,CATAMARCA,99,113,186,201,387
10,10112,101120303,Valle Viejo,CATAMARCA,49,64,81,94,175
10,10112,101120401,Valle Viejo,CATAMARCA,26,39,55,47,102
10,10112,101120402,Valle Viejo,CATAMARCA,199,212,377,344,721
10,10112,101120403,Valle Viejo,CATAMARCA,389,427,863,766,1629
10,10112,101120404,Valle Viejo,CATAMARCA,339,359,637,586,1223
10,10112,101120405,Valle Viejo,CATAMARCA,342,362,705,673,1378
10,10112,101120406,Valle Viejo,CATAMARCA,337,356,727,743,1470
10,10112,101120407,Valle Viejo,CATAMARCA,236,273,473,443,916
10,10112,101120408,Valle Viejo,CATAMARCA,335,357,743,688,1431
10,10112,101120409,Valle Viejo,CATAMARCA,318,368,686,594,1280
10,10112,101120410,Valle Viejo,CATAMARCA,239,272,448,393,841
10,10112,101120411,Valle Viejo,CATAMARCA,196,224,352,325,677
10,10112,101120501,Valle Viejo,CATAMARCA,17,18,29,32,61
10,10112,101120502,Valle Viejo,CATAMARCA,223,241,394,392,786
10,10112,101120503,Valle Viejo,CATAMARCA,282,272,530,529,1059
10,10112,101120504,Valle Viejo,CATAMARCA,240,260,492,480,972
10,10112,101120505,Valle Viejo,CATAMARCA,233,251,498,486,984
10,10112,101120506,Valle Viejo,CATAMARCA,285,253,605,617,1222
10,10112,101120507,Valle Viejo,CATAMARCA,252,280,495,528,1023
10,10112,101120508,Valle Viejo,CATAMARCA,214,242,414,420,834
10,10112,101120509,Valle Viejo,CATAMARCA,307,362,634,600,1234
10,10112,101120510,Valle Viejo,CATAMARCA,285,334,580,587,1167
10,10112,101120511,Valle Viejo,CATAMARCA,255,255,567,480,1047
10,10112,101120512,Valle Viejo,CATAMARCA,220,256,439,426,865
10,10112,101120513,Valle Viejo,CATAMARCA,293,309,595,654,1249
10,10112,101120514,Valle Viejo,CATAMARCA,196,202,425,393,818
10,10112,101120515,Valle Viejo,CATAMARCA,223,247,441,407,848
22,22007,220070101,Almirante Brown,CHACO,375,413,802,741,1543
22,22007,220070102,Almirante Brown,CHACO,451,532,953,920,1873
22,22007,220070103,Almirante Brown,CHACO,271,341,579,553,1132
22,22007,220070104,Almirante Brown,CHACO,209,234,411,392,803
22,22007,220070201,Almirante Brown,CHACO,81,107,156,143,299
22,22007,220070202,Almirante Brown,CHACO,37,66,43,57,100
22,22007,220070203,Almirante Brown,CHACO,48,63,57,95,152
22,22007,220070204,Almirante Brown,CHACO,109,101,167,217,384
22,22007,220070205,Almirante Brown,CHACO,32,36,63,76,139
22,22007,220070206,Almirante Brown,CHACO,77,77,118,153,271
22,22007,220070207,Almirante Brown,CHACO,82,83,170,180,350
22,22007,220070208,Almirante Brown,CHACO,410,344,936,870,1806
22,22007,220070209,Almirante Brown,CHACO,136,172,311,323,634
22,22007,220070301,Almirante Brown,CHACO,32,32,48,70,118
22,22007,220070302,Almirante Brown,CHACO,68,69,61,108,169
22,22007,220070303,Almirante Brown,CHACO,29,29,38,59,97
22,22007,220070304,Almirante Brown,CHACO,99,117,169,183,352
22,22007,220070401,Almirante Brown,CHACO,42,50,50,85,135
22,22007,220070402,Almirante Brown,CHACO,29,35,27,51,78
22,22007,220070403,Almirante Brown,CHACO,28,31,11,38,49
22,22007,220070404,Almirante Brown,CHACO,27,41,23,61,84
22,22007,220070501,Almirante Brown,CHACO,100,112,158,230,388
22,22007,220070502,Almirante Brown,CHACO,194,238,406,437,843
22,22007,220070503,Almirante Brown,CHACO,174,188,345,282,627
22,22007,220070504,Almirante Brown,CHACO,59,72,78,122,200
22,22007,220070505,Almirante Brown,CHACO,58,77,93,118,211
22,22007,220070506,Almirante Brown,CHACO,270,353,610,580,1190
22,22007,220070507,Almirante Brown,CHACO,184,239,361,355,716
22,22007,220070508,Almirante Brown,CHACO,354,390,766,792,1558
22,22007,220070509,Almirante Brown,CHACO,326,390,733,696,1429
22,22007,220070601,Almirante Brown,CHACO,117,112,143,190,333
22,22007,220070602,Almirante Brown,CHACO,89,108,142,170,312
22,22007,220070603,Almirante Brown,CHACO,131,103,217,310,527
22,22007,220070604,Almirante Brown,CHACO,52,61,93,108,201
22,22007,220070701,Almirante Brown,CHACO,288,388,575,593,1168
22,22007,220070702,Almirante Brown,CHACO,338,472,659,665,1324
22,22007,220070703,Almirante Brown,CHACO,147,151,243,260,503
22,22007,220070704,Almirante Brown,CHACO,221,254,343,315,658
22,22007,220070705,Almirante Brown,CHACO,388,441,745,687,1432
22,22007,220070706,Almirante Brown,CHACO,290,349,499,496,995
22,22007,220070707,Almirante Brown,CHACO,242,237,460,489,949
22,22007,220070708,Almirante Brown,CHACO,385,447,797,781,1578
22,22007,220070801,Almirante Brown,CHACO,89,108,93,171,264
22,22007,220070802,Almirante Brown,CHACO,53,61,88,134,222
22,22007,220070803,Almirante Brown,CHACO,67,89,117,138,255
22,22007,220070804,Almirante Brown,CHACO,44,53,52,106,158
22,22007,220070805,Almirante Brown,CHACO,16,18,13,50,63
22,22007,220070806,Almirante Brown,CHACO,34,44,36,58,94
22,22007,220070807,Almirante Brown,CHACO,233,303,501,527,1028
22,22007,220070901,Almirante Brown,CHACO,274,321,523,512,1035
22,22007,220070902,Almirante Brown,CHACO,229,276,429,440,869
22,22007,220070903,Almirante Brown,CHACO,87,89,152,166,318
22,22007,220070904,Almirante Brown,CHACO,203,215,397,381,778
22,22007,220070905,Almirante Brown,CHACO,322,391,651,630,1281
22,22014,220140101,Bermejo,CHACO,6,6,14,12,26
22,22014,220140102,Bermejo,CHACO,88,77,136,150,286
22,22014,220140103,Bermejo,CHACO,168,175,314,324,638
22,22014,220140201,Bermejo,CHACO,5,5,6,7,13
22,22014,220140202,Bermejo,CHACO,18,26,28,28,56
22,22014,220140203,Bermejo,CHACO,25,34,35,33,68
22,22014,220140301,Bermejo,CHACO,9,24,5,18,23
22,22014,220140302,Bermejo,CHACO,4,8,2,11,13
22,22014,220140303,Bermejo,CHACO,8,19,8,13,21
22,22014,220140304,Bermejo,CHACO,4,9,3,6,9
22,22014,220140305,Bermejo,CHACO,38,38,41,45,86
22,22014,220140306,Bermejo,CHACO,27,37,31,42,73
22,22014,220140307,Bermejo,CHACO,276,318,430,470,900
22,22014,220140308,Bermejo,CHACO,261,309,420,413,833
22,22014,220140401,Bermejo,CHACO,305,357,504,486,990
22,22014,220140402,Bermejo,CHACO,187,198,377,368,745
22,22014,220140403,Bermejo,CHACO,56,74,114,124,238
22,22014,220140404,Bermejo,CHACO,67,80,104,136,240
22,22014,220140405,Bermejo,CHACO,337,299,663,628,1291
22,22014,220140406,Bermejo,CHACO,96,114,149,191,340
22,22014,220140407,Bermejo,CHACO,71,77,132,135,267
22,22014,220140408,Bermejo,CHACO,258,291,430,427,857
22,22014,220140409,Bermejo,CHACO,168,204,331,347,678
22,22014,220140410,Bermejo,CHACO,281,313,521,502,1023
22,22014,220140411,Bermejo,CHACO,190,206,339,318,657
22,22014,220140412,Bermejo,CHACO,341,351,687,684,1371
22,22014,220140501,Bermejo,CHACO,280,320,518,485,1003
22,22014,220140502,Bermejo,CHACO,381,415,635,620,1255
22,22014,220140503,Bermejo,CHACO,292,317,485,443,928
22,22014,220140504,Bermejo,CHACO,315,348,536,541,1077
22,22014,220140505,Bermejo,CHACO,168,190,345,306,651
22,22014,220140601,Bermejo,CHACO,331,361,561,528,1089
22,22014,220140602,Bermejo,CHACO,218,245,334,304,638
22,22014,220140603,Bermejo,CHACO,248,275,411,345,756
22,22014,220140604,Bermejo,CHACO,404,420,772,740,1512
22,22014,220140605,Bermejo,CHACO,167,178,272,238,510
22,22014,220140701,Bermejo,CHACO,31,40,38,49,87
22,22014,220140702,Bermejo,CHACO,105,117,189,246,435
22,22014,220140703,Bermejo,CHACO,51,90,64,78,142
22,22014,220140704,Bermejo,CHACO,253,298,455,495,950
22,22014,220140705,Bermejo,CHACO,219,268,398,410,808
22,22014,220140801,Bermejo,CHACO,68,83,128,160,288
22,22014,220140802,Bermejo,CHACO,54,64,116,126,242
22,22014,220140803,Bermejo,CHACO,96,88,171,213,384
22,22014,220140804,Bermejo,CHACO,21,28,29,48,77
22,22014,220140805,Bermejo,CHACO,92,98,172,179,351
22,22014,220140901,Bermejo,CHACO,16,27,12,25,37
22,22014,220140902,Bermejo,CHACO,24,26,40,50,90
22,22021,220210101,Comandante Fernández,CHACO,33,42,54,69,123
22,22021,220210102,Comandante Fernández,CHACO,43,57,70,90,160
22,22021,220210201,Comandante Fernández,CHACO,45,69,72,78,150
22,22021,220210202,Comandante Fernández,CHACO,34,37,67,75,142
22,22021,220210301,Comandante Fernández,CHACO,18,27,33,34,67
22,22021,220210302,Comandante Fernández,CHACO,54,54,97,113,210
22,22021,220210303,Comandante Fernández,CHACO,33,36,62,70,132
22,22021,220210401,Comandante Fernández,CHACO,64,68,119,159,278
22,22021,220210402,Comandante Fernández,CHACO,10,19,10,12,22
22,22021,220210403,Comandante Fernández,CHACO,169,168,325,338,663
22,22021,220210501,Comandante Fernández,CHACO,47,48,70,101,171
22,22021,220210502,Comandante Fernández,CHACO,114,130,217,239,456
22,22021,220210503,Comandante Fernández,CHACO,169,177,289,328,617
22,22021,220210504,Comandante Fernández,CHACO,203,223,342,282,624
22,22021,220210505,Comandante Fernández,CHACO,230,244,537,541,1078
22,22021,220210506,Comandante Fernández,CHACO,256,306,477,479,956
22,22021,220210507,Comandante Fernández,CHACO,314,338,669,618,1287
22,22021,220210508,Comandante Fernández,CHACO,348,370,711,704,1415
22,22021,220210601,Comandante Fernández,CHACO,155,164,271,457,728
22,22021,220210602,Comandante Fernández,CHACO,47,49,93,99,192
22,22021,220210603,Comandante Fernández,CHACO,92,94,166,194,360
22,22021,220210604,Comandante Fernández,CHACO,124,128,253,252,505
22,22021,220210605,Comandante Fernández,CHACO,247,375,586,575,1161
22,22021,220210606,Comandante Fernández,CHACO,165,139,294,333,627
22,22021,220210607,Comandante Fernández,CHACO,265,300,546,560,1106
22,22021,220210608,Comandante Fernández,CHACO,279,302,599,672,1271
22,22021,220210701,Comandante Fernández,CHACO,294,361,668,598,1266
22,22021,220210702,Comandante Fernández,CHACO,196,166,320,291,611
22,22021,220210703,Comandante Fernández,CHACO,140,154,258,210,468
22,22021,220210704,Comandante Fernández,CHACO,571,521,1161,1116,2277
22,22021,220210705,Comandante Fernández,CHACO,248,292,407,367,774
22,22021,220210706,Comandante Fernández,CHACO,174,186,307,260,567
22,22021,220210707,Comandante Fernández,CHACO,178,191,358,284,642
22,22021,220210708,Comandante Fernández,CHACO,332,403,542,487,1029
22,22021,220210709,Comandante Fernández,CHACO,312,341,579,495,1074
22,22021,220210710,Comandante Fernández,CHACO,243,142,525,485,1010
22,22021,220210711,Comandante Fernández,CHACO,214,268,342,258,600
22,22021,220210712,Comandante Fernández,CHACO,165,188,236,186,422
22,22021,220210713,Comandante Fernández,CHACO,346,393,519,630,1149
22,22021,220210714,Comandante Fernández,CHACO,254,298,392,330,722
22,22021,220210715,Comandante Fernández,CHACO,237,184,381,312,693
22,22021,220210716,Comandante Fernández,CHACO,182,223,257,206,463
22,22021,220210717,Comandante Fernández,CHACO,151,187,208,182,390
22,22021,220210718,Comandante Fernández,CHACO,223,245,396,351,747
22,22021,220210719,Comandante Fernández,CHACO,391,416,765,679,1444
22,22021,220210720,Comandante Fernández,CHACO,179,225,316,271,587
22,22021,220210721,Comandante Fernández,CHACO,246,255,489,483,972
22,22021,220210722,Comandante Fernández,CHACO,113,119,288,211,499
22,22021,220210723,Comandante Fernández,CHACO,164,184,299,271,570
22,22021,220210801,Comandante Fernández,CHACO,376,430,748,667,1415
22,22021,220210802,Comandante Fernández,CHACO,268,290,653,654,1307
22,22021,220210803,Comandante Fernández,CHACO,299,320,660,689,1349
22,22021,220210804,Comandante Fernández,CHACO,287,313,522,461,983
22,22021,220210805,Comandante Fernández,CHACO,143,156,207,182,389
22,22021,220210806,Comandante Fernández,CHACO,291,306,525,477,1002
22,22021,220210807,Comandante Fernández,CHACO,249,275,395,278,673
22,22021,220210808,Comandante Fernández,CHACO,328,349,613,586,1199
22,22021,220210809,Comandante Fernández,CHACO,255,274,479,465,944
22,22021,220210810,Comandante Fernández,CHACO,198,217,328,276,604
22,22021,220210811,Comandante Fernández,CHACO,240,249,522,554,1076
22,22021,220210812,Comandante Fernández,CHACO,217,226,440,440,880
22,22021,220210813,Comandante Fernández,CHACO,239,253,495,484,979
22,22021,220210814,Comandante Fernández,CHACO,296,303,677,646,1323
22,22021,220210815,Comandante Fernández,CHACO,207,228,502,515,1017
22,22021,220210816,Comandante Fernández,CHACO,204,209,401,387,788
22,22021,220210901,Comandante Fernández,CHACO,19,25,27,37,64
22,22021,220210902,Comandante Fernández,CHACO,37,38,69,86,155
22,22021,220210903,Comandante Fernández,CHACO,47,72,79,89,168
22,22021,220211001,Comandante Fernández,CHACO,38,38,70,91,161
22,22021,220211002,Comandante Fernández,CHACO,48,51,88,95,183
22,22021,220211003,Comandante Fernández,CHACO,35,35,62,52,114
22,22021,220211101,Comandante Fernández,CHACO,51,67,86,107,193
22,22021,220211102,Comandante Fernández,CHACO,18,40,32,31,63
22,22021,220211103,Comandante Fernández,CHACO,40,57,66,74,140
22,22021,220211201,Comandante Fernández,CHACO,41,53,49,67,116
22,22021,220211202,Comandante Fernández,CHACO,64,74,116,145,261
22,22021,220211301,Comandante Fernández,CHACO,30,39,73,70,143
22,22021,220211302,Comandante Fernández,CHACO,45,65,73,109,182
22,22021,220211401,Comandante Fernández,CHACO,35,43,51,57,108
22,22021,220211402,Comandante Fernández,CHACO,34,56,53,58,111
22,22021,220211501,Comandante Fernández,CHACO,214,248,297,237,534
22,22021,220211502,Comandante Fernández,CHACO,185,241,270,243,513
22,22021,220211503,Comandante Fernández,CHACO,174,220,241,196,437
22,22021,220211504,Comandante Fernández,CHACO,294,325,472,471,943
22,22021,220211505,Comandante Fernández,CHACO,277,311,472,430,902
22,22021,220211506,Comandante Fernández,CHACO,800,841,1586,1623,3209
22,22021,220211507,Comandante Fernández,CHACO,221,245,364,353,717
22,22021,220211508,Comandante Fernández,CHACO,407,423,731,631,1362
22,22021,220211509,Comandante Fernández,CHACO,282,296,517,484,1001
22,22021,220211510,Comandante Fernández,CHACO,290,323,567,478,1045
22,22021,220211511,Comandante Fernández,CHACO,369,384,743,656,1399
22,22021,220211512,Comandante Fernández,CHACO,260,296,545,540,1085
22,22021,220211513,Comandante Fernández,CHACO,146,173,173,142,315
22,22021,220211601,Comandante Fernández,CHACO,300,260,647,593,1240
22,22021,220211602,Comandante Fernández,CHACO,287,301,473,446,919
22,22021,220211603,Comandante Fernández,CHACO,158,192,258,207,465
22,22021,220211604,Comandante Fernández,CHACO,212,219,363,314,677
22,22021,220211605,Comandante Fernández,CHACO,369,326,790,724,1514
22,22021,220211606,Comandante Fernández,CHACO,182,182,312,255,567
22,22021,220211607,Comandante Fernández,CHACO,293,338,370,276,646
22,22021,220211608,Comandante Fernández,CHACO,262,324,409,368,777
22,22021,220211609,Comandante Fernández,CHACO,200,199,400,369,769
22,22021,220211610,Comandante Fernández,CHACO,288,307,575,577,1152
22,22021,220211611,Comandante Fernández,CHACO,331,313,624,565,1189
22,22021,220211612,Comandante Fernández,CHACO,242,207,394,282,676
22,22021,220211613,Comandante Fernández,CHACO,307,287,415,364,779
22,22021,220211614,Comandante Fernández,CHACO,260,288,537,521,1058
22,22021,220211615,Comandante Fernández,CHACO,247,262,547,503,1050
22,22021,220211616,Comandante Fernández,CHACO,287,260,367,267,634
22,22021,220211617,Comandante Fernández,CHACO,198,205,445,422,867
22,22021,220211618,Comandante Fernández,CHACO,330,361,671,651,1322
22,22021,220211701,Comandante Fernández,CHACO,213,203,328,292,620
22,22021,220211702,Comandante Fernández,CHACO,157,200,237,183,420
22,22021,220211703,Comandante Fernández,CHACO,237,268,406,344,750
22,22021,220211704,Comandante Fernández,CHACO,144,209,212,172,384
22,22021,220211705,Comandante Fernández,CHACO,224,233,309,283,592
22,22021,220211706,Comandante Fernández,CHACO,291,305,443,394,837
22,22021,220211707,Comandante Fernández,CHACO,293,287,536,503,1039
22,22021,220211708,Comandante Fernández,CHACO,211,214,426,373,799
22,22021,220211709,Comandante Fernández,CHACO,360,385,650,603,1253
22,22021,220211710,Comandante Fernández,CHACO,314,331,523,528,1051
22,22021,220211711,Comandante Fernández,CHACO,270,413,390,327,717
22,22021,220211712,Comandante Fernández,CHACO,317,334,636,626,1262
22,22021,220211713,Comandante Fernández,CHACO,266,272,540,503,1043
22,22021,220211714,Comandante Fernández,CHACO,344,370,766,755,1521
22,22021,220211715,Comandante Fernández,CHACO,193,205,308,266,574
22,22021,220211716,Comandante Fernández,CHACO,248,269,458,436,894
22,22021,220211717,Comandante Fernández,CHACO,211,211,425,437,862
22,22021,220211718,Comandante Fernández,CHACO,245,265,486,510,996
22,22028,220280101,Chacabuco,CHACO,275,277,500,501,1001
22,22028,220280102,Chacabuco,CHACO,444,483,852,753,1605
22,22028,220280103,Chacabuco,CHACO,272,296,430,404,834
22,22028,220280104,Chacabuco,CHACO,303,326,500,463,963
22,22028,220280105,Chacabuco,CHACO,391,432,626,596,1222
22,22028,220280106,Chacabuco,CHACO,313,321,600,519,1119
22,22028,220280107,Chacabuco,CHACO,285,308,460,350,810
22,22028,220280108,Chacabuco,CHACO,231,267,392,317,709
22,22028,220280109,Chacabuco,CHACO,297,307,508,507,1015
22,22028,220280110,Chacabuco,CHACO,293,297,540,574,1114
22,22028,220280111,Chacabuco,CHACO,179,216,262,208,470
22,22028,220280112,Chacabuco,CHACO,255,299,407,356,763
22,22028,220280113,Chacabuco,CHACO,352,329,652,632,1284
22,22028,220280114,Chacabuco,CHACO,330,381,521,494,1015
22,22028,220280115,Chacabuco,CHACO,342,345,628,589,1217
22,22028,220280116,Chacabuco,CHACO,336,338,763,734,1497
22,22028,220280117,Chacabuco,CHACO,362,416,674,615,1289
22,22028,220280118,Chacabuco,CHACO,316,312,615,578,1193
22,22028,220280201,Chacabuco,CHACO,171,167,335,381,716
22,22028,220280202,Chacabuco,CHACO,63,63,127,145,272
22,22028,220280203,Chacabuco,CHACO,168,184,305,363,668
22,22028,220280301,Chacabuco,CHACO,178,151,342,357,699
22,22028,220280302,Chacabuco,CHACO,141,147,248,262,510
22,22028,220280303,Chacabuco,CHACO,44,54,66,97,163
22,22028,220280304,Chacabuco,CHACO,55,60,109,109,218
22,22028,220280305,Chacabuco,CHACO,68,76,117,132,249
22,22028,220280306,Chacabuco,CHACO,207,228,408,390,798
22,22028,220280307,Chacabuco,CHACO,279,307,524,438,962
22,22028,220280308,Chacabuco,CHACO,233,244,405,423,828
22,22028,220280309,Chacabuco,CHACO,385,425,778,699,1477
22,22028,220280310,Chacabuco,CHACO,320,375,727,684,1411
22,22028,220280311,Chacabuco,CHACO,329,354,717,719,1436
22,22028,220280401,Chacabuco,CHACO,42,41,56,76,132
22,22028,220280402,Chacabuco,CHACO,29,28,46,67,113
22,22028,220280403,Chacabuco,CHACO,42,49,53,74,127
22,22028,220280501,Chacabuco,CHACO,106,124,236,245,481
22,22028,220280502,Chacabuco,CHACO,18,19,25,32,57
22,22028,220280503,Chacabuco,CHACO,40,43,69,84,153
22,22036,220360101,12 de Octubre,CHACO,267,317,554,536,1090
22,22036,220360102,12 de Octubre,CHACO,291,333,589,523,1112
22,22036,220360103,12 de Octubre,CHACO,113,126,195,156,351
22,22036,220360104,12 de Octubre,CHACO,182,212,342,292,634
22,22036,220360105,12 de Octubre,CHACO,316,374,549,538,1087
22,22036,220360106,12 de Octubre,CHACO,385,441,682,626,1308
22,22036,220360107,12 de Octubre,CHACO,237,318,342,308,650
22,22036,220360108,12 de Octubre,CHACO,253,279,453,443,896
22,22036,220360109,12 de Octubre,CHACO,174,212,337,317,654
22,22036,220360110,12 de Octubre,CHACO,303,333,619,605,1224
22,22036,220360111,12 de Octubre,CHACO,217,236,433,399,832
22,22036,220360112,12 de Octubre,CHACO,293,322,514,518,1032
22,22036,220360113,12 de Octubre,CHACO,284,310,651,596,1247
22,22036,220360114,12 de Octubre,CHACO,232,253,441,484,925
22,22036,220360201,12 de Octubre,CHACO,61,61,96,131,227
22,22036,220360202,12 de Octubre,CHACO,79,85,171,189,360
22,22036,220360203,12 de Octubre,CHACO,69,73,131,138,269
22,22036,220360204,12 de Octubre,CHACO,26,31,40,49,89
22,22036,220360301,12 de Octubre,CHACO,2,2,1,2,3
22,22036,220360302,12 de Octubre,CHACO,159,167,311,345,656
22,22036,220360303,12 de Octubre,CHACO,35,31,65,73,138
22,22036,220360304,12 de Octubre,CHACO,145,143,274,354,628
22,22036,220360305,12 de Octubre,CHACO,64,69,100,123,223
22,22036,220360401,12 de Octubre,CHACO,28,39,34,52,86
22,22036,220360402,12 de Octubre,CHACO,20,23,32,40,72
22,22036,220360403,12 de Octubre,CHACO,87,100,155,178,333
22,22036,220360404,12 de Octubre,CHACO,26,29,49,48,97
22,22036,220360405,12 de Octubre,CHACO,118,144,215,208,423
22,22036,220360406,12 de Octubre,CHACO,31,34,40,45,85
22,22036,220360501,12 de Octubre,CHACO,17,25,15,30,45
22,22036,220360502,12 de Octubre,CHACO,41,33,47,56,103
22,22036,220360601,12 de Octubre,CHACO,31,37,32,75,107
22,22036,220360602,12 de Octubre,CHACO,26,26,27,43,70
22,22036,220360603,12 de Octubre,CHACO,124,125,215,239,454
22,22036,220360604,12 de Octubre,CHACO,35,43,31,56,87
22,22036,220360701,12 de Octubre,CHACO,29,29,19,82,101
22,22036,220360702,12 de Octubre,CHACO,25,28,23,36,59
22,22036,220360801,12 de Octubre,CHACO,16,16,3,19,22
22,22036,220360802,12 de Octubre,CHACO,4,5,1,4,5
22,22036,220360803,12 de Octubre,CHACO,6,13,2,12,14
22,22036,220360804,12 de Octubre,CHACO,7,8,7,9,16
22,22036,220360805,12 de Octubre,CHACO,2,6,3,5,8
22,22036,220360901,12 de Octubre,CHACO,446,502,786,823,1609
22,22036,220360902,12 de Octubre,CHACO,145,156,320,329,649
22,22036,220360903,12 de Octubre,CHACO,4,4,7,5,12
22,22036,220360904,12 de Octubre,CHACO,25,31,50,53,103
22,22036,220360905,12 de Octubre,CHACO,23,29,20,40,60
22,22036,220360906,12 de Octubre,CHACO,189,240,358,368,726
22,22036,220360907,12 de Octubre,CHACO,329,360,644,656,1300
22,22039,220390101,2 de Abril,CHACO,110,160,221,220,441
22,22039,220390102,2 de Abril,CHACO,50,79,77,100,177
22,22039,220390103,2 de Abril,CHACO,14,21,18,25,43
22,22039,220390104,2 de Abril,CHACO,14,18,19,18,37
22,22039,220390105,2 de Abril,CHACO,138,176,255,258,513
22,22039,220390106,2 de Abril,CHACO,277,311,561,521,1082
22,22039,220390107,2 de Abril,CHACO,234,248,320,313,633
22,22039,220390108,2 de Abril,CHACO,192,169,440,415,855
22,22039,220390109,2 de Abril,CHACO,298,332,541,551,1092
22,22039,220390110,2 de Abril,CHACO,221,245,347,287,634
22,22039,220390111,2 de Abril,CHACO,218,247,379,376,755
22,22039,220390201,2 de Abril,CHACO,31,37,57,64,121
22,22039,220390202,2 de Abril,CHACO,34,47,49,64,113
22,22039,220390203,2 de Abril,CHACO,32,38,47,70,117
22,22039,220390204,2 de Abril,CHACO,51,57,80,85,165
22,22039,220390301,2 de Abril,CHACO,26,29,30,40,70
22,22039,220390302,2 de Abril,CHACO,9,9,4,13,17
22,22039,220390303,2 de Abril,CHACO,43,57,66,83,149
22,22039,220390304,2 de Abril,CHACO,34,42,59,65,124
22,22039,220390305,2 de Abril,CHACO,95,98,124,170,294
22,22043,220430101,Fray Justo Santa María de Oro,CHACO,262,278,416,383,799
22,22043,220430102,Fray Justo Santa María de Oro,CHACO,208,224,317,273,590
22,22043,220430103,Fray Justo Santa María de Oro,CHACO,312,399,614,620,1234
22,22043,220430104,Fray Justo Santa María de Oro,CHACO,239,255,495,493,988
22,22043,220430105,Fray Justo Santa María de Oro,CHACO,240,266,399,416,815
22,22043,220430106,Fray Justo Santa María de Oro,CHACO,268,284,413,426,839
22,22043,220430201,Fray Justo Santa María de Oro,CHACO,142,155,308,267,575
22,22043,220430202,Fray Justo Santa María de Oro,CHACO,82,106,126,164,290
22,22043,220430203,Fray Justo Santa María de Oro,CHACO,100,120,176,231,407
22,22043,220430204,Fray Justo Santa María de Oro,CHACO,45,72,71,87,158
22,22043,220430205,Fray Justo Santa María de Oro,CHACO,351,394,768,744,1512
22,22043,220430301,Fray Justo Santa María de Oro,CHACO,16,19,24,27,51
22,22043,220430302,Fray Justo Santa María de Oro,CHACO,146,145,241,291,532
22,22043,220430303,Fray Justo Santa María de Oro,CHACO,152,118,291,302,593
22,22043,220430304,Fray Justo Santa María de Oro,CHACO,175,177,303,356,659
22,22043,220430305,Fray Justo Santa María de Oro,CHACO,237,272,421,536,957
22,22043,220430401,Fray Justo Santa María de Oro,CHACO,18,26,27,29,56
22,22043,220430402,Fray Justo Santa María de Oro,CHACO,92,82,106,170,276
22,22043,220430403,Fray Justo Santa María de Oro,CHACO,37,38,51,85,136
22,22043,220430501,Fray Justo Santa María de Oro,CHACO,31,31,44,55,99
22,22043,220430502,Fray Justo Santa María de Oro,CHACO,58,68,81,120,201
22,22043,220430503,Fray Justo Santa María de Oro,CHACO,18,25,31,28,59
22,22049,220490101,General Belgrano,CHACO,266,280,438,396,834
22,22049,220490102,General Belgrano,CHACO,268,290,539,517,1056
22,22049,220490103,General Belgrano,CHACO,302,341,599,553,1152
22,22049,220490104,General Belgrano,CHACO,283,318,463,468,931
22,22049,220490201,General Belgrano,CHACO,23,22,33,38,71
22,22049,220490202,General Belgrano,CHACO,24,32,26,44,70
22,22049,220490203,General Belgrano,CHACO,4,19,3,9,12
22,22049,220490301,General Belgrano,CHACO,40,44,74,103,177
22,22049,220490302,General Belgrano,CHACO,44,51,72,98,170
22,22049,220490303,General Belgrano,CHACO,43,53,66,68,134
22,22049,220490304,General Belgrano,CHACO,454,532,991,1009,2000
22,22049,220490305,General Belgrano,CHACO,21,31,48,44,92
22,22049,220490306,General Belgrano,CHACO,25,39,32,53,85
22,22049,220490307,General Belgrano,CHACO,180,194,413,377,790
22,22049,220490308,General Belgrano,CHACO,145,160,232,251,483
22,22049,220490309,General Belgrano,CHACO,282,318,552,559,1111
22,22049,220490310,General Belgrano,CHACO,174,208,407,369,776
22,22049,220490311,General Belgrano,CHACO,407,483,872,881,1753
22,22049,220490401,General Belgrano,CHACO,29,48,43,64,107
22,22049,220490402,General Belgrano,CHACO,16,24,15,25,40
22,22049,220490403,General Belgrano,CHACO,48,67,54,90,144
22,22056,220560101,General Donovan,CHACO,401,439,715,656,1371
22,22056,220560102,General Donovan,CHACO,456,484,862,853,1715
22,22056,220560201,General Donovan,CHACO,329,400,617,619,1236
22,22056,220560202,General Donovan,CHACO,27,38,27,53,80
22,22056,220560203,General Donovan,CHACO,38,55,51,84,135
22,22056,220560204,General Donovan,CHACO,2,3,7,5,12
22,22056,220560301,General Donovan,CHACO,49,59,77,99,176
22,22056,220560302,General Donovan,CHACO,52,55,92,122,214
22,22056,220560303,General Donovan,CHACO,88,103,161,189,350
22,22056,220560304,General Donovan,CHACO,52,59,119,108,227
22,22056,220560305,General Donovan,CHACO,241,251,467,421,888
22,22056,220560306,General Donovan,CHACO,265,272,456,455,911
22,22056,220560307,General Donovan,CHACO,19,20,31,32,63
22,22056,220560308,General Donovan,CHACO,11,14,12,24,36
22,22056,220560309,General Donovan,CHACO,227,252,433,476,909
22,22056,220560310,General Donovan,CHACO,284,307,471,502,973
22,22056,220560311,General Donovan,CHACO,322,326,614,631,1245
22,22056,220560312,General Donovan,CHACO,105,103,185,187,372
22,22056,220560313,General Donovan,CHACO,385,419,719,707,1426
22,22056,220560314,General Donovan,CHACO,314,324,529,540,1069
22,22056,220560401,General Donovan,CHACO,14,17,18,24,42
22,22056,220560402,General Donovan,CHACO,17,23,11,29,40
22,22063,220630101,General Güemes,CHACO,262,294,480,455,935
22,22063,220630102,General Güemes,CHACO,301,353,486,426,912
22,22063,220630103,General Güemes,CHACO,200,232,351,282,633
22,22063,220630104,General Güemes,CHACO,243,260,394,349,743
22,22063,220630105,General Güemes,CHACO,242,271,421,346,767
22,22063,220630106,General Güemes,CHACO,250,273,445,373,818
22,22063,220630107,General Güemes,CHACO,297,334,472,448,920
22,22063,220630108,General Güemes,CHACO,283,326,492,496,988
22,22063,220630109,General Güemes,CHACO,230,239,381,313,694
22,22063,220630202,General Güemes,CHACO,365,392,615,686,1301
22,22063,220630203,General Güemes,CHACO,283,286,502,608,1110
22,22063,220630204,General Güemes,CHACO,126,131,270,302,572
22,22063,220630205,General Güemes,CHACO,19,22,47,38,85
22,22063,220630206,General Güemes,CHACO,84,88,143,186,329
22,22063,220630207,General Güemes,CHACO,56,62,108,144,252
22,22063,220630208,General Güemes,CHACO,266,247,497,609,1106
22,22063,220630209,General Güemes,CHACO,87,89,184,244,428
22,22063,220630210,General Güemes,CHACO,273,397,505,452,957
22,22063,220630211,General Güemes,CHACO,64,65,139,210,349
22,22063,220630212,General Güemes,CHACO,218,197,403,452,855
22,22063,220630213,General Güemes,CHACO,71,73,143,193,336
22,22063,220630214,General Güemes,CHACO,367,464,764,727,1491
22,22063,220630215,General Güemes,CHACO,257,389,550,493,1043
22,22063,220630216,General Güemes,CHACO,76,278,132,129,261
22,22063,220630301,General Güemes,CHACO,208,212,343,462,805
22,22063,220630302,General Güemes,CHACO,192,241,322,414,736
22,22063,220630303,General Güemes,CHACO,94,94,192,213,405
22,22063,220630304,General Güemes,CHACO,203,202,399,467,866
22,22063,220630305,General Güemes,CHACO,209,191,441,495,936
22,22063,220630306,General Güemes,CHACO,277,276,543,573,1116
22,22063,220630307,General Güemes,CHACO,155,155,230,283,513
22,22063,220630308,General Güemes,CHACO,114,124,199,255,454
22,22063,220630309,General Güemes,CHACO,427,501,803,765,1568
22,22063,220630310,General Güemes,CHACO,433,573,844,909,1753
22,22063,220630311,General Güemes,CHACO,394,426,708,708,1416
22,22063,220630401,General Güemes,CHACO,362,221,686,792,1478
22,22063,220630402,General Güemes,CHACO,46,46,62,81,143
22,22063,220630403,General Güemes,CHACO,81,95,90,157,247
22,22063,220630404,General Güemes,CHACO,337,505,697,679,1376
22,22063,220630501,General Güemes,CHACO,69,69,143,160,303
22,22063,220630502,General Güemes,CHACO,54,22,120,128,248
22,22063,220630503,General Güemes,CHACO,152,95,373,416,789
22,22063,220630504,General Güemes,CHACO,103,107,199,260,459
22,22063,220630505,General Güemes,CHACO,200,194,408,479,887
22,22063,220630506,General Güemes,CHACO,169,201,347,426,773
22,22063,220630507,General Güemes,CHACO,156,153,357,358,715
22,22063,220630508,General Güemes,CHACO,424,482,878,907,1785
22,22063,220630509,General Güemes,CHACO,346,355,751,838,1589
22,22063,220630601,General Güemes,CHACO,16,19,49,45,94
22,22063,220630602,General Güemes,CHACO,254,276,556,655,1211
22,22063,220630603,General Güemes,CHACO,223,231,415,486,901
22,22063,220630604,General Güemes,CHACO,3,3,6,6,12
22,22063,220630605,General Güemes,CHACO,331,354,635,626,1261
22,22063,220630701,General Güemes,CHACO,149,193,292,251,543
22,22063,220630702,General Güemes,CHACO,510,319,923,948,1871
22,22063,220630703,General Güemes,CHACO,132,149,230,289,519
22,22063,220630704,General Güemes,CHACO,16,15,24,23,47
22,22063,220630705,General Güemes,CHACO,469,558,839,798,1637
22,22063,220630801,General Güemes,CHACO,384,415,861,877,1738
22,22063,220630814,General Güemes,CHACO,221,244,389,382,771
22,22063,220630816,General Güemes,CHACO,323,385,676,687,1363
22,22063,220630817,General Güemes,CHACO,336,376,636,603,1239
22,22063,220630818,General Güemes,CHACO,144,174,293,241,534
22,22063,220630824,General Güemes,CHACO,208,246,387,460,847
22,22063,220630825,General Güemes,CHACO,170,197,299,284,583
22,22063,220630826,General Güemes,CHACO,122,156,230,189,419
22,22063,220630827,General Güemes,CHACO,148,172,277,275,552
22,22063,220630915,General Güemes,CHACO,360,396,748,706,1454
22,22063,220630919,General Güemes,CHACO,357,394,751,787,1538
22,22063,220630920,General Güemes,CHACO,345,385,734,707,1441
22,22063,220630921,General Güemes,CHACO,385,460,773,737,1510
22,22063,220630922,General Güemes,CHACO,163,182,324,271,595
22,22063,220630923,General Güemes,CHACO,261,307,531,525,1056
22,22063,220630928,General Güemes,CHACO,180,190,342,308,650
22,22063,220630929,General Güemes,CHACO,191,226,347,361,708
22,22063,220630930,General Güemes,CHACO,209,230,421,409,830
22,22063,220630931,General Güemes,CHACO,283,306,539,511,1050
22,22063,220630932,General Güemes,CHACO,225,256,454,459,913
22,22070,220700101,Independencia,CHACO,291,335,571,501,1072
22,22070,220700102,Independencia,CHACO,262,299,433,463,896
22,22070,220700103,Independencia,CHACO,366,400,836,791,1627
22,22070,220700104,Independencia,CHACO,365,394,698,716,1414
22,22070,220700105,Independencia,CHACO,251,274,504,498,1002
22,22070,220700201,Independencia,CHACO,49,62,97,109,206
22,22070,220700202,Independencia,CHACO,350,419,753,755,1508
22,22070,220700203,Independencia,CHACO,28,30,53,50,103
22,22070,220700204,Independencia,CHACO,25,31,30,53,83
22,22070,220700205,Independencia,CHACO,142,182,324,325,649
22,22070,220700206,Independencia,CHACO,386,428,974,943,1917
22,22070,220700301,Independencia,CHACO,296,335,703,641,1344
22,22070,220700302,Independencia,CHACO,64,145,134,133,267
22,22070,220700303,Independencia,CHACO,53,49,78,120,198
22,22070,220700304,Independencia,CHACO,56,60,58,127,185
22,22070,220700305,Independencia,CHACO,48,47,117,132,249
22,22070,220700306,Independencia,CHACO,68,77,112,188,300
22,22070,220700307,Independencia,CHACO,332,377,739,705,1444
22,22070,220700308,Independencia,CHACO,250,294,487,451,938
22,22070,220700309,Independencia,CHACO,217,239,421,387,808
22,22070,220700310,Independencia,CHACO,130,150,325,291,616
22,22070,220700311,Independencia,CHACO,194,230,462,433,895
22,22070,220700401,Independencia,CHACO,298,288,701,620,1321
22,22070,220700402,Independencia,CHACO,63,85,126,129,255
22,22070,220700403,Independencia,CHACO,73,85,124,135,259
22,22070,220700404,Independencia,CHACO,33,45,50,51,101
22,22070,220700405,Independencia,CHACO,72,78,119,147,266
22,22070,220700406,Independencia,CHACO,356,455,697,643,1340
22,22070,220700501,Independencia,CHACO,67,83,111,149,260
22,22070,220700502,Independencia,CHACO,33,43,46,72,118
22,22070,220700503,Independencia,CHACO,14,17,27,36,63
22,22070,220700504,Independencia,CHACO,9,13,23,19,42
22,22070,220700601,Independencia,CHACO,63,76,98,140,238
22,22070,220700602,Independencia,CHACO,40,42,61,86,147
22,22070,220700603,Independencia,CHACO,73,87,128,152,280
22,22077,220770101,Libertad,CHACO,282,290,532,516,1048
22,22077,220770102,Libertad,CHACO,166,166,326,272,598
22,22077,220770103,Libertad,CHACO,405,429,821,751,1572
22,22077,220770104,Libertad,CHACO,260,285,483,498,981
22,22077,220770105,Libertad,CHACO,248,261,467,422,889
22,22077,220770106,Libertad,CHACO,218,229,435,378,813
22,22077,220770107,Libertad,CHACO,296,309,603,627,1230
22,22077,220770201,Libertad,CHACO,75,105,113,136,249
22,22077,220770202,Libertad,CHACO,216,257,367,422,789
22,22077,220770203,Libertad,CHACO,47,51,80,94,174
22,22077,220770204,Libertad,CHACO,24,32,46,39,85
22,22077,220770205,Libertad,CHACO,33,42,49,49,98
22,22077,220770206,Libertad,CHACO,116,122,208,221,429
22,22077,220770207,Libertad,CHACO,37,48,57,60,117
22,22077,220770208,Libertad,CHACO,78,116,118,147,265
22,22077,220770301,Libertad,CHACO,71,80,121,129,250
22,22077,220770302,Libertad,CHACO,266,270,574,528,1102
22,22077,220770303,Libertad,CHACO,166,185,332,362,694
22,22077,220770304,Libertad,CHACO,120,145,175,221,396
22,22077,220770305,Libertad,CHACO,32,52,48,67,115
22,22077,220770306,Libertad,CHACO,11,14,15,18,33
22,22077,220770307,Libertad,CHACO,25,36,37,47,84
22,22077,220770308,Libertad,CHACO,10,16,14,16,30
22,22077,220770401,Libertad,CHACO,6,9,13,14,27
22,22077,220770402,Libertad,CHACO,15,22,16,27,43
22,22077,220770403,Libertad,CHACO,14,21,23,24,47
22,22084,220840101,Libertador General San Martín,CHACO,501,508,872,817,1689
22,22084,220840102,Libertador General San Martín,CHACO,250,244,499,512,1011
22,22084,220840103,Libertador General San Martín,CHACO,284,280,519,499,1018
22,22084,220840104,Libertador General San Martín,CHACO,279,290,455,442,897
22,22084,220840105,Libertador General San Martín,CHACO,406,403,806,869,1675
22,22084,220840201,Libertador General San Martín,CHACO,19,20,23,41,64
22,22084,220840202,Libertador General San Martín,CHACO,111,122,202,257,459
22,22084,220840203,Libertador General San Martín,CHACO,255,273,538,635,1173
22,22084,220840204,Libertador General San Martín,CHACO,160,176,285,363,648
22,22084,220840205,Libertador General San Martín,CHACO,588,599,1318,1495,2813
22,22084,220840206,Libertador General San Martín,CHACO,140,130,310,316,626
22,22084,220840207,Libertador General San Martín,CHACO,85,95,177,200,377
22,22084,220840208,Libertador General San Martín,CHACO,225,242,431,409,840
22,22084,220840209,Libertador General San Martín,CHACO,398,440,751,752,1503
22,22084,220840301,Libertador General San Martín,CHACO,18,23,20,23,43
22,22084,220840302,Libertador General San Martín,CHACO,26,32,47,57,104
22,22084,220840303,Libertador General San Martín,CHACO,92,36,248,246,494
22,22084,220840401,Libertador General San Martín,CHACO,108,137,166,183,349
22,22084,220840402,Libertador General San Martín,CHACO,92,128,154,188,342
22,22084,220840403,Libertador General San Martín,CHACO,47,62,61,87,148
22,22084,220840404,Libertador General San Martín,CHACO,39,52,71,72,143
22,22084,220840501,Libertador General San Martín,CHACO,267,296,462,457,919
22,22084,220840502,Libertador General San Martín,CHACO,281,317,565,543,1108
22,22084,220840503,Libertador General San Martín,CHACO,288,322,526,557,1083
22,22084,220840504,Libertador General San Martín,CHACO,277,295,550,541,1091
22,22084,220840601,Libertador General San Martín,CHACO,308,341,631,576,1207
22,22084,220840602,Libertador General San Martín,CHACO,30,30,51,55,106
22,22084,220840603,Libertador General San Martín,CHACO,51,68,89,123,212
22,22084,220840604,Libertador General San Martín,CHACO,120,140,138,195,333
22,22084,220840605,Libertador General San Martín,CHACO,208,222,378,408,786
22,22084,220840606,Libertador General San Martín,CHACO,18,26,19,38,57
22,22084,220840607,Libertador General San Martín,CHACO,7,15,4,8,12
22,22084,220840701,Libertador General San Martín,CHACO,143,178,212,274,486
22,22084,220840702,Libertador General San Martín,CHACO,13,15,11,17,28
22,22084,220840703,Libertador General San Martín,CHACO,22,47,28,40,68
22,22084,220840704,Libertador General San Martín,CHACO,18,22,26,36,62
22,22084,220840705,Libertador General San Martín,CHACO,27,38,39,38,77
22,22084,220840706,Libertador General San Martín,CHACO,38,42,71,76,147
22,22084,220840707,Libertador General San Martín,CHACO,64,85,97,127,224
22,22084,220840801,Libertador General San Martín,CHACO,148,195,248,286,534
22,22084,220840802,Libertador General San Martín,CHACO,72,118,114,149,263
22,22084,220840803,Libertador General San Martín,CHACO,110,146,175,211,386
22,22084,220840804,Libertador General San Martín,CHACO,214,243,424,485,909
22,22084,220840805,Libertador General San Martín,CHACO,136,160,242,284,526
22,22084,220840901,Libertador General San Martín,CHACO,15,22,21,26,47
22,22084,220840902,Libertador General San Martín,CHACO,13,31,15,18,33
22,22084,220840903,Libertador General San Martín,CHACO,79,110,86,131,217
22,22084,220840904,Libertador General San Martín,CHACO,39,62,66,67,133
22,22084,220841001,Libertador General San Martín,CHACO,88,96,136,175,311
22,22084,220841002,Libertador General San Martín,CHACO,283,305,466,542,1008
22,22084,220841003,Libertador General San Martín,CHACO,13,25,10,22,32
22,22084,220841004,Libertador General San Martín,CHACO,143,168,250,241,491
22,22084,220841005,Libertador General San Martín,CHACO,303,330,547,549,1096
22,22084,220841006,Libertador General San Martín,CHACO,167,195,290,325,615
22,22084,220841101,Libertador General San Martín,CHACO,368,394,681,773,1454
22,22084,220841102,Libertador General San Martín,CHACO,175,260,280,227,507
22,22084,220841103,Libertador General San Martín,CHACO,135,149,227,210,437
22,22084,220841104,Libertador General San Martín,CHACO,278,208,511,472,983
22,22084,220841105,Libertador General San Martín,CHACO,259,291,558,504,1062
22,22084,220841106,Libertador General San Martín,CHACO,269,275,466,423,889
22,22084,220841107,Libertador General San Martín,CHACO,240,286,366,308,674
22,22084,220841108,Libertador General San Martín,CHACO,274,265,464,379,843
22,22084,220841109,Libertador General San Martín,CHACO,157,175,261,279,540
22,22084,220841110,Libertador General San Martín,CHACO,392,431,725,655,1380
22,22084,220841111,Libertador General San Martín,CHACO,259,243,588,528,1116
22,22084,220841112,Libertador General San Martín,CHACO,248,259,495,478,973
22,22084,220841201,Libertador General San Martín,CHACO,421,482,804,762,1566
22,22084,220841202,Libertador General San Martín,CHACO,335,358,604,501,1105
22,22084,220841203,Libertador General San Martín,CHACO,217,226,430,412,842
22,22084,220841204,Libertador General San Martín,CHACO,264,261,490,500,990
22,22084,220841205,Libertador General San Martín,CHACO,244,279,331,295,626
22,22084,220841206,Libertador General San Martín,CHACO,207,258,321,285,606
22,22084,220841207,Libertador General San Martín,CHACO,308,343,510,440,950
22,22084,220841208,Libertador General San Martín,CHACO,195,206,340,313,653
22,22084,220841209,Libertador General San Martín,CHACO,210,220,400,377,777
22,22084,220841210,Libertador General San Martín,CHACO,260,266,604,603,1207
22,22084,220841211,Libertador General San Martín,CHACO,361,405,737,728,1465
22,22084,220841212,Libertador General San Martín,CHACO,239,225,523,538,1061
22,22084,220841213,Libertador General San Martín,CHACO,258,269,471,456,927
22,22084,220841214,Libertador General San Martín,CHACO,256,283,518,529,1047
22,22084,220841215,Libertador General San Martín,CHACO,265,305,508,475,983
22,22084,220841216,Libertador General San Martín,CHACO,391,418,859,801,1660
22,22084,220841217,Libertador General San Martín,CHACO,186,208,392,409,801
22,22091,220910101,Maipú,CHACO,339,393,593,585,1178
22,22091,220910102,Maipú,CHACO,252,275,415,346,761
22,22091,220910103,Maipú,CHACO,389,403,715,643,1358
22,22091,220910104,Maipú,CHACO,269,306,448,369,817
22,22091,220910105,Maipú,CHACO,234,234,408,383,791
22,22091,220910201,Maipú,CHACO,47,56,77,106,183
22,22091,220910202,Maipú,CHACO,79,78,162,207,369
22,22091,220910203,Maipú,CHACO,73,78,158,202,360
22,22091,220910204,Maipú,CHACO,89,99,157,165,322
22,22091,220910301,Maipú,CHACO,115,132,214,251,465
22,22091,220910302,Maipú,CHACO,133,140,307,359,666
22,22091,220910303,Maipú,CHACO,183,195,419,465,884
22,22091,220910304,Maipú,CHACO,61,72,87,120,207
22,22091,220910401,Maipú,CHACO,96,111,169,207,376
22,22091,220910402,Maipú,CHACO,135,139,247,295,542
22,22091,220910403,Maipú,CHACO,130,138,281,299,580
22,22091,220910404,Maipú,CHACO,61,65,98,121,219
22,22091,220910501,Maipú,CHACO,445,461,998,1049,2047
22,22091,220910502,Maipú,CHACO,254,281,522,537,1059
22,22091,220910503,Maipú,CHACO,104,123,166,188,354
22,22091,220910504,Maipú,CHACO,110,111,183,202,385
22,22091,220910505,Maipú,CHACO,62,67,104,119,223
22,22091,220910506,Maipú,CHACO,100,124,196,202,398
22,22091,220910507,Maipú,CHACO,277,295,539,554,1093
22,22091,220910508,Maipú,CHACO,444,471,854,891,1745
22,22091,220910509,Maipú,CHACO,348,377,800,809,1609
22,22091,220910510,Maipú,CHACO,283,278,717,691,1408
22,22091,220910511,Maipú,CHACO,223,246,499,449,948
22,22091,220910512,Maipú,CHACO,270,296,578,502,1080
22,22091,220910513,Maipú,CHACO,277,326,558,524,1082
22,22091,220910601,Maipú,CHACO,44,48,52,92,144
22,22091,220910602,Maipú,CHACO,119,123,181,242,423
22,22091,220910701,Maipú,CHACO,44,61,72,87,159
22,22091,220910702,Maipú,CHACO,44,47,88,101,189
22,22091,220910703,Maipú,CHACO,111,109,227,262,489
22,22091,220910704,Maipú,CHACO,102,114,174,201,375
22,22098,220980101,Mayor Luis J. Fontana,CHACO,287,291,525,445,970
22,22098,220980102,Mayor Luis J. Fontana,CHACO,163,188,328,366,694
22,22098,220980103,Mayor Luis J. Fontana,CHACO,516,577,959,862,1821
22,22098,220980104,Mayor Luis J. Fontana,CHACO,272,282,624,560,1184
22,22098,220980105,Mayor Luis J. Fontana,CHACO,300,318,531,505,1036
22,22098,220980106,Mayor Luis J. Fontana,CHACO,276,305,487,436,923
22,22098,220980107,Mayor Luis J. Fontana,CHACO,284,297,460,396,856
22,22098,220980108,Mayor Luis J. Fontana,CHACO,241,287,362,323,685
22,22098,220980109,Mayor Luis J. Fontana,CHACO,246,271,380,333,713
22,22098,220980110,Mayor Luis J. Fontana,CHACO,311,308,617,532,1149
22,22098,220980111,Mayor Luis J. Fontana,CHACO,375,423,607,557,1164
22,22098,220980112,Mayor Luis J. Fontana,CHACO,163,181,256,247,503
22,22098,220980113,Mayor Luis J. Fontana,CHACO,118,146,185,156,341
22,22098,220980114,Mayor Luis J. Fontana,CHACO,133,160,180,148,328
22,22098,220980115,Mayor Luis J. Fontana,CHACO,167,187,238,218,456
22,22098,220980116,Mayor Luis J. Fontana,CHACO,161,193,223,184,407
22,22098,220980117,Mayor Luis J. Fontana,CHACO,205,240,305,256,561
22,22098,220980118,Mayor Luis J. Fontana,CHACO,184,214,347,327,674
22,22098,220980119,Mayor Luis J. Fontana,CHACO,334,311,663,542,1205
22,22098,220980120,Mayor Luis J. Fontana,CHACO,269,290,462,412,874
22,22098,220980121,Mayor Luis J. Fontana,CHACO,331,346,643,661,1304
22,22098,220980122,Mayor Luis J. Fontana,CHACO,254,258,483,422,905
22,22098,220980123,Mayor Luis J. Fontana,CHACO,264,290,482,448,930
22,22098,220980201,Mayor Luis J. Fontana,CHACO,57,55,88,93,181
22,22098,220980202,Mayor Luis J. Fontana,CHACO,135,95,260,292,552
22,22098,220980203,Mayor Luis J. Fontana,CHACO,12,15,26,28,54
22,22098,220980204,Mayor Luis J. Fontana,CHACO,25,34,45,51,96
22,22098,220980205,Mayor Luis J. Fontana,CHACO,45,55,82,89,171
22,22098,220980206,Mayor Luis J. Fontana,CHACO,44,64,58,73,131
22,22098,220980207,Mayor Luis J. Fontana,CHACO,77,94,135,156,291
22,22098,220980208,Mayor Luis J. Fontana,CHACO,46,46,77,76,153
22,22098,220980209,Mayor Luis J. Fontana,CHACO,69,80,108,128,236
22,22098,220980210,Mayor Luis J. Fontana,CHACO,25,37,45,44,89
22,22098,220980211,Mayor Luis J. Fontana,CHACO,81,115,122,135,257
22,22098,220980212,Mayor Luis J. Fontana,CHACO,43,57,75,96,171
22,22098,220980213,Mayor Luis J. Fontana,CHACO,60,52,98,110,208
22,22098,220980214,Mayor Luis J. Fontana,CHACO,209,226,432,478,910
22,22098,220980301,Mayor Luis J. Fontana,CHACO,163,173,309,267,576
22,22098,220980302,Mayor Luis J. Fontana,CHACO,291,281,513,465,978
22,22098,220980303,Mayor Luis J. Fontana,CHACO,278,303,477,470,947
22,22098,220980304,Mayor Luis J. Fontana,CHACO,206,224,342,306,648
22,22098,220980305,Mayor Luis J. Fontana,CHACO,266,289,442,394,836
22,22098,220980306,Mayor Luis J. Fontana,CHACO,217,239,427,386,813
22,22098,220980307,Mayor Luis J. Fontana,CHACO,213,234,447,425,872
22,22098,220980401,Mayor Luis J. Fontana,CHACO,217,189,416,435,851
22,22098,220980402,Mayor Luis J. Fontana,CHACO,36,48,55,68,123
22,22098,220980403,Mayor Luis J. Fontana,CHACO,37,50,61,72,133
22,22098,220980404,Mayor Luis J. Fontana,CHACO,25,35,37,43,80
22,22098,220980405,Mayor Luis J. Fontana,CHACO,28,38,34,54,88
22,22098,220980406,Mayor Luis J. Fontana,CHACO,289,259,616,643,1259
22,22098,220980407,Mayor Luis J. Fontana,CHACO,114,127,170,187,357
22,22098,220980408,Mayor Luis J. Fontana,CHACO,303,332,600,565,1165
22,22098,220980501,Mayor Luis J. Fontana,CHACO,75,102,120,136,256
22,22098,220980502,Mayor Luis J. Fontana,CHACO,53,49,57,101,158
22,22098,220980503,Mayor Luis J. Fontana,CHACO,39,46,51,84,135
22,22098,220980601,Mayor Luis J. Fontana,CHACO,130,126,263,252,515
22,22098,220980602,Mayor Luis J. Fontana,CHACO,59,39,111,123,234
22,22098,220980603,Mayor Luis J. Fontana,CHACO,66,89,90,119,209
22,22098,220980604,Mayor Luis J. Fontana,CHACO,11,13,26,30,56
22,22098,220980605,Mayor Luis J. Fontana,CHACO,40,50,83,74,157
22,22098,220980701,Mayor Luis J. Fontana,CHACO,436,484,833,763,1596
22,22098,220980702,Mayor Luis J. Fontana,CHACO,409,409,761,781,1542
22,22098,220980703,Mayor Luis J. Fontana,CHACO,197,191,346,299,645
22,22098,220980704,Mayor Luis J. Fontana,CHACO,202,233,335,271,606
22,22098,220980705,Mayor Luis J. Fontana,CHACO,195,255,262,232,494
22,22098,220980706,Mayor Luis J. Fontana,CHACO,298,321,560,458,1018
22,22098,220980707,Mayor Luis J. Fontana,CHACO,467,502,874,917,1791
22,22098,220980708,Mayor Luis J. Fontana,CHACO,427,429,887,844,1731
22,22098,220980709,Mayor Luis J. Fontana,CHACO,356,390,609,574,1183
22,22098,220980710,Mayor Luis J. Fontana,CHACO,261,296,429,401,830
22,22098,220980711,Mayor Luis J. Fontana,CHACO,83,97,147,138,285
22,22098,220980712,Mayor Luis J. Fontana,CHACO,170,171,324,295,619
22,22098,220980713,Mayor Luis J. Fontana,CHACO,151,156,274,274,548
22,22098,220980714,Mayor Luis J. Fontana,CHACO,223,237,451,419,870
22,22098,220980715,Mayor Luis J. Fontana,CHACO,398,396,781,773,1554
22,22098,220980716,Mayor Luis J. Fontana,CHACO,27,38,58,60,118
22,22098,220980717,Mayor Luis J. Fontana,CHACO,321,326,648,607,1255
22,22098,220980718,Mayor Luis J. Fontana,CHACO,563,494,1116,994,2110
22,22098,220980719,Mayor Luis J. Fontana,CHACO,99,112,187,221,408
22,22098,220980720,Mayor Luis J. Fontana,CHACO,274,298,634,614,1248
22,22105,221050101,9 de Julio,CHACO,184,191,329,336,665
22,22105,221050102,9 de Julio,CHACO,200,214,377,352,729
22,22105,221050103,9 de Julio,CHACO,191,223,310,271,581
22,22105,221050104,9 de Julio,CHACO,173,202,281,237,518
22,22105,221050105,9 de Julio,CHACO,165,198,268,210,478
22,22105,221050106,9 de Julio,CHACO,265,281,397,381,778
22,22105,221050107,9 de Julio,CHACO,326,362,546,522,1068
22,22105,221050108,9 de Julio,CHACO,357,398,621,620,1241
22,22105,221050109,9 de Julio,CHACO,317,334,525,480,1005
22,22105,221050110,9 de Julio,CHACO,217,224,310,268,578
22,22105,221050111,9 de Julio,CHACO,228,246,378,284,662
22,22105,221050112,9 de Julio,CHACO,246,264,397,345,742
22,22105,221050113,9 de Julio,CHACO,171,197,284,261,545
22,22105,221050114,9 de Julio,CHACO,232,244,480,453,933
22,22105,221050115,9 de Julio,CHACO,160,178,304,313,617
22,22105,221050201,9 de Julio,CHACO,113,125,182,254,436
22,22105,221050202,9 de Julio,CHACO,84,77,178,198,376
22,22105,221050203,9 de Julio,CHACO,153,152,270,351,621
22,22105,221050204,9 de Julio,CHACO,45,53,106,117,223
22,22105,221050205,9 de Julio,CHACO,115,122,190,214,404
22,22105,221050301,9 de Julio,CHACO,555,602,1139,1072,2211
22,22105,221050302,9 de Julio,CHACO,35,27,65,72,137
22,22105,221050303,9 de Julio,CHACO,347,374,779,774,1553
22,22105,221050304,9 de Julio,CHACO,104,129,188,217,405
22,22105,221050305,9 de Julio,CHACO,70,91,137,148,285
22,22105,221050306,9 de Julio,CHACO,150,146,275,342,617
22,22105,221050307,9 de Julio,CHACO,67,71,129,141,270
22,22105,221050308,9 de Julio,CHACO,37,46,68,82,150
22,22105,221050309,9 de Julio,CHACO,66,71,117,130,247
22,22105,221050310,9 de Julio,CHACO,95,113,171,195,366
22,22105,221050311,9 de Julio,CHACO,416,478,778,721,1499
22,22105,221050312,9 de Julio,CHACO,415,469,807,749,1556
22,22105,221050313,9 de Julio,CHACO,16,20,20,32,52
22,22105,221050314,9 de Julio,CHACO,327,357,740,712,1452
22,22105,221050315,9 de Julio,CHACO,286,285,616,651,1267
22,22105,221050316,9 de Julio,CHACO,328,374,585,508,1093
22,22105,221050317,9 de Julio,CHACO,278,323,597,585,1182
22,22105,221050401,9 de Julio,CHACO,21,25,42,41,83
22,22105,221050402,9 de Julio,CHACO,26,42,33,45,78
22,22105,221050403,9 de Julio,CHACO,71,73,115,146,261
22,22105,221050404,9 de Julio,CHACO,97,104,189,227,416
22,22105,221050405,9 de Julio,CHACO,49,60,82,93,175
22,22112,221120101,O'Higgins,CHACO,359,383,661,623,1284
22,22112,221120102,O'Higgins,CHACO,286,314,454,406,860
22,22112,221120103,O'Higgins,CHACO,425,467,854,830,1684
22,22112,221120104,O'Higgins,CHACO,383,409,790,692,1482
22,22112,221120105,O'Higgins,CHACO,413,457,890,810,1700
22,22112,221120106,O'Higgins,CHACO,486,558,1020,985,2005
22,22112,221120201,O'Higgins,CHACO,0,1,0,0,0
22,22112,221120202,O'Higgins,CHACO,50,59,83,106,189
22,22112,221120203,O'Higgins,CHACO,19,24,26,43,69
22,22112,221120301,O'Higgins,CHACO,230,273,437,413,850
22,22112,221120302,O'Higgins,CHACO,437,497,979,948,1927
22,22112,221120303,O'Higgins,CHACO,34,50,38,72,110
22,22112,221120304,O'Higgins,CHACO,24,33,40,49,89
22,22112,221120305,O'Higgins,CHACO,33,43,67,62,129
22,22112,221120306,O'Higgins,CHACO,191,220,321,284,605
22,22112,221120401,O'Higgins,CHACO,199,222,375,345,720
22,22112,221120402,O'Higgins,CHACO,175,191,411,400,811
22,22112,221120403,O'Higgins,CHACO,107,109,209,230,439
22,22112,221120404,O'Higgins,CHACO,142,160,295,359,654
22,22112,221120405,O'Higgins,CHACO,31,35,58,77,135
22,22112,221120406,O'Higgins,CHACO,40,52,74,74,148
22,22112,221120407,O'Higgins,CHACO,311,329,713,709,1422
22,22112,221120408,O'Higgins,CHACO,49,99,78,71,149
22,22112,221120501,O'Higgins,CHACO,19,37,24,35,59
22,22112,221120502,O'Higgins,CHACO,26,62,27,36,63
22,22112,221120503,O'Higgins,CHACO,18,28,21,32,53
22,22112,221120504,O'Higgins,CHACO,32,46,61,51,112
22,22112,221120505,O'Higgins,CHACO,41,32,77,72,149
22,22112,221120601,O'Higgins,CHACO,15,33,11,22,33
22,22112,221120602,O'Higgins,CHACO,32,72,42,67,109
22,22112,221120603,O'Higgins,CHACO,39,52,60,79,139
22,22112,221120701,O'Higgins,CHACO,42,64,67,82,149
22,22112,221120702,O'Higgins,CHACO,33,46,41,53,94
22,22112,221120801,O'Higgins,CHACO,56,59,128,123,251
22,22112,221120802,O'Higgins,CHACO,67,96,110,109,219
22,22112,221120803,O'Higgins,CHACO,78,98,153,175,328
22,22112,221120901,O'Higgins,CHACO,35,38,59,63,122
22,22112,221120902,O'Higgins,CHACO,26,36,40,47,87
22,22112,221120903,O'Higgins,CHACO,40,60,65,64,129
22,22112,221121001,O'Higgins,CHACO,90,121,180,185,365
22,22112,221121002,O'Higgins,CHACO,55,83,74,83,157
22,22112,221121003,O'Higgins,CHACO,16,27,24,28,52
22,22119,221190101,Presidencia de la Plaza,CHACO,229,255,386,356,742
22,22119,221190102,Presidencia de la Plaza,CHACO,318,355,567,551,1118
22,22119,221190103,Presidencia de la Plaza,CHACO,384,350,719,636,1355
22,22119,221190104,Presidencia de la Plaza,CHACO,402,425,779,704,1483
22,22119,221190105,Presidencia de la Plaza,CHACO,228,240,456,410,866
22,22119,221190106,Presidencia de la Plaza,CHACO,348,369,690,627,1317
22,22119,221190107,Presidencia de la Plaza,CHACO,293,316,623,592,1215
22,22119,221190108,Presidencia de la Plaza,CHACO,289,295,571,528,1099
22,22119,221190201,Presidencia de la Plaza,CHACO,161,142,300,329,629
22,22119,221190202,Presidencia de la Plaza,CHACO,200,191,398,398,796
22,22119,221190203,Presidencia de la Plaza,CHACO,104,122,149,178,327
22,22119,221190204,Presidencia de la Plaza,CHACO,89,100,164,167,331
22,22119,221190205,Presidencia de la Plaza,CHACO,164,175,296,311,607
22,22119,221190206,Presidencia de la Plaza,CHACO,57,60,95,110,205
22,22119,221190207,Presidencia de la Plaza,CHACO,23,29,38,44,82
22,22119,221190208,Presidencia de la Plaza,CHACO,41,41,51,64,115
22,22119,221190301,Presidencia de la Plaza,CHACO,47,55,48,75,123
22,22119,221190302,Presidencia de la Plaza,CHACO,13,18,11,19,30
22,22119,221190303,Presidencia de la Plaza,CHACO,26,36,18,41,59
22,22126,221260101,1º de Mayo,CHACO,283,302,606,550,1156
22,22126,221260102,1º de Mayo,CHACO,203,221,318,311,629
22,22126,221260103,1º de Mayo,CHACO,160,181,245,254,499
22,22126,221260104,1º de Mayo,CHACO,238,242,400,436,836
22,22126,221260105,1º de Mayo,CHACO,193,199,364,330,694
22,22126,221260201,1º de Mayo,CHACO,25,39,21,51,72
22,22126,221260202,1º de Mayo,CHACO,111,150,144,190,334
22,22126,221260203,1º de Mayo,CHACO,49,67,74,78,152
22,22126,221260204,1º de Mayo,CHACO,46,56,84,80,164
22,22126,221260301,1º de Mayo,CHACO,250,273,437,480,917
22,22126,221260302,1º de Mayo,CHACO,48,62,73,92,165
22,22126,221260303,1º de Mayo,CHACO,100,158,144,162,306
22,22126,221260304,1º de Mayo,CHACO,172,252,312,269,581
22,22126,221260305,1º de Mayo,CHACO,231,294,463,474,937
22,22126,221260306,1º de Mayo,CHACO,25,47,38,37,75
22,22126,221260307,1º de Mayo,CHACO,16,28,20,40,60
22,22126,221260308,1º de Mayo,CHACO,19,30,28,36,64
22,22126,221260309,1º de Mayo,CHACO,11,15,19,17,36
22,22126,221260310,1º de Mayo,CHACO,18,23,29,29,58
22,22126,221260311,1º de Mayo,CHACO,56,82,73,92,165
22,22126,221260312,1º de Mayo,CHACO,206,211,406,389,795
22,22126,221260313,1º de Mayo,CHACO,179,221,338,288,626
22,22126,221260314,1º de Mayo,CHACO,303,352,520,450,970
22,22126,221260315,1º de Mayo,CHACO,12,19,15,16,31
22,22133,221330101,Quitilipi,CHACO,218,217,427,414,841
22,22133,221330102,Quitilipi,CHACO,305,321,540,461,1001
22,22133,221330103,Quitilipi,CHACO,318,336,610,570,1180
22,22133,221330104,Quitilipi,CHACO,327,342,600,547,1147
22,22133,221330105,Quitilipi,CHACO,170,169,258,226,484
22,22133,221330106,Quitilipi,CHACO,337,365,572,520,1092
22,22133,221330107,Quitilipi,CHACO,170,196,249,251,500
22,22133,221330108,Quitilipi,CHACO,456,476,1027,962,1989
22,22133,221330109,Quitilipi,CHACO,371,384,772,757,1529
22,22133,221330110,Quitilipi,CHACO,186,188,362,325,687
22,22133,221330111,Quitilipi,CHACO,272,273,550,559,1109
22,22133,221330112,Quitilipi,CHACO,217,216,380,395,775
22,22133,221330113,Quitilipi,CHACO,178,209,335,335,670
22,22133,221330114,Quitilipi,CHACO,376,387,802,860,1662
22,22133,221330115,Quitilipi,CHACO,347,384,691,674,1365
22,22133,221330116,Quitilipi,CHACO,174,182,299,243,542
22,22133,221330117,Quitilipi,CHACO,145,160,265,261,526
22,22133,221330118,Quitilipi,CHACO,238,248,444,427,871
22,22133,221330119,Quitilipi,CHACO,282,291,554,567,1121
22,22133,221330120,Quitilipi,CHACO,249,269,443,380,823
22,22133,221330201,Quitilipi,CHACO,52,50,102,97,199
22,22133,221330202,Quitilipi,CHACO,105,120,201,243,444
22,22133,221330203,Quitilipi,CHACO,113,114,215,275,490
22,22133,221330204,Quitilipi,CHACO,23,25,51,46,97
22,22133,221330205,Quitilipi,CHACO,83,84,171,175,346
22,22133,221330206,Quitilipi,CHACO,81,86,160,196,356
22,22133,221330207,Quitilipi,CHACO,217,253,453,426,879
22,22133,221330208,Quitilipi,CHACO,53,83,117,110,227
22,22133,221330301,Quitilipi,CHACO,85,88,158,160,318
22,22133,221330302,Quitilipi,CHACO,110,125,237,220,457
22,22133,221330303,Quitilipi,CHACO,65,68,118,140,258
22,22133,221330304,Quitilipi,CHACO,59,71,137,155,292
22,22133,221330305,Quitilipi,CHACO,69,94,94,126,220
22,22133,221330306,Quitilipi,CHACO,44,56,67,83,150
22,22133,221330307,Quitilipi,CHACO,43,45,74,69,143
22,22133,221330308,Quitilipi,CHACO,65,66,117,153,270
22,22133,221330309,Quitilipi,CHACO,97,115,200,221,421
22,22133,221330401,Quitilipi,CHACO,101,121,170,193,363
22,22133,221330402,Quitilipi,CHACO,66,73,114,143,257
22,22133,221330403,Quitilipi,CHACO,43,47,60,86,146
22,22133,221330404,Quitilipi,CHACO,60,82,91,122,213
22,22133,221330405,Quitilipi,CHACO,77,81,133,169,302
22,22133,221330406,Quitilipi,CHACO,38,46,54,85,139
22,22133,221330407,Quitilipi,CHACO,5,7,8,10,18
22,22133,221330408,Quitilipi,CHACO,57,65,103,133,236
22,22133,221330409,Quitilipi,CHACO,5,9,7,6,13
22,22133,221330410,Quitilipi,CHACO,7,6,16,13,29
22,22133,221330411,Quitilipi,CHACO,121,128,199,233,432
22,22133,221330412,Quitilipi,CHACO,353,344,838,779,1617
22,22133,221330413,Quitilipi,CHACO,312,337,642,617,1259
22,22133,221330414,Quitilipi,CHACO,211,225,435,343,778
22,22133,221330415,Quitilipi,CHACO,134,137,288,296,584
22,22133,221330501,Quitilipi,CHACO,48,61,69,90,159
22,22133,221330502,Quitilipi,CHACO,272,55,641,662,1303
22,22133,221330503,Quitilipi,CHACO,57,57,108,126,234
22,22133,221330504,Quitilipi,CHACO,32,36,47,56,103
22,22133,221330505,Quitilipi,CHACO,53,64,110,122,232
22,22133,221330506,Quitilipi,CHACO,17,19,18,19,37
22,22133,221330507,Quitilipi,CHACO,18,21,34,35,69
22,22133,221330508,Quitilipi,CHACO,22,30,34,43,77
22,22147,221470101,San Lorenzo,CHACO,62,59,116,139,255
22,22147,221470102,San Lorenzo,CHACO,17,23,31,39,70
22,22147,221470103,San Lorenzo,CHACO,41,46,59,81,140
22,22147,221470104,San Lorenzo,CHACO,65,75,90,128,218
22,22147,221470105,San Lorenzo,CHACO,112,98,195,224,419
22,22147,221470106,San Lorenzo,CHACO,133,132,210,258,468
22,22147,221470107,San Lorenzo,CHACO,44,53,72,81,153
22,22147,221470108,San Lorenzo,CHACO,45,46,55,84,139
22,22147,221470201,San Lorenzo,CHACO,365,397,685,644,1329
22,22147,221470202,San Lorenzo,CHACO,191,235,330,266,596
22,22147,221470203,San Lorenzo,CHACO,306,363,524,513,1037
22,22147,221470204,San Lorenzo,CHACO,175,202,350,325,675
22,22147,221470205,San Lorenzo,CHACO,167,167,256,260,516
22,22147,221470206,San Lorenzo,CHACO,296,325,592,542,1134
22,22147,221470301,San Lorenzo,CHACO,391,465,767,777,1544
22,22147,221470302,San Lorenzo,CHACO,50,61,73,89,162
22,22147,221470303,San Lorenzo,CHACO,101,106,176,218,394
22,22147,221470304,San Lorenzo,CHACO,39,43,59,66,125
22,22147,221470305,San Lorenzo,CHACO,471,541,1012,931,1943
22,22147,221470306,San Lorenzo,CHACO,365,405,746,704,1450
22,22147,221470307,San Lorenzo,CHACO,85,91,166,177,343
22,22147,221470401,San Lorenzo,CHACO,281,314,504,498,1002
22,22147,221470402,San Lorenzo,CHACO,99,110,168,159,327
22,22147,221470403,San Lorenzo,CHACO,54,45,58,98,156
22,22147,221470404,San Lorenzo,CHACO,37,47,47,60,107
22,22154,221540101,Sargento Cabral,CHACO,365,435,623,640,1263
22,22154,221540102,Sargento Cabral,CHACO,256,277,433,523,956
22,22154,221540103,Sargento Cabral,CHACO,104,124,160,229,389
22,22154,221540104,Sargento Cabral,CHACO,153,193,261,261,522
22,22154,221540105,Sargento Cabral,CHACO,320,380,576,523,1099
22,22154,221540106,Sargento Cabral,CHACO,119,140,242,245,487
22,22154,221540201,Sargento Cabral,CHACO,273,323,539,513,1052
22,22154,221540202,Sargento Cabral,CHACO,353,412,612,584,1196
22,22154,221540203,Sargento Cabral,CHACO,30,33,48,65,113
22,22154,221540204,Sargento Cabral,CHACO,165,185,226,320,546
22,22154,221540205,Sargento Cabral,CHACO,37,47,57,69,126
22,22154,221540206,Sargento Cabral,CHACO,265,225,510,524,1034
22,22154,221540301,Sargento Cabral,CHACO,242,269,439,427,866
22,22154,221540302,Sargento Cabral,CHACO,345,393,692,688,1380
22,22154,221540303,Sargento Cabral,CHACO,100,103,174,191,365
22,22154,221540304,Sargento Cabral,CHACO,61,54,116,132,248
22,22154,221540305,Sargento Cabral,CHACO,124,110,241,250,491
22,22154,221540306,Sargento Cabral,CHACO,30,46,36,57,93
22,22154,221540307,Sargento Cabral,CHACO,367,432,666,638,1304
22,22154,221540308,Sargento Cabral,CHACO,95,98,166,186,352
22,22154,221540309,Sargento Cabral,CHACO,201,245,318,331,649
22,22154,221540310,Sargento Cabral,CHACO,106,139,136,200,336
22,22154,221540311,Sargento Cabral,CHACO,256,284,503,519,1022
22,22161,221610101,Tapenagá,CHACO,51,53,55,83,138
22,22161,221610102,Tapenagá,CHACO,50,38,72,83,155
22,22161,221610103,Tapenagá,CHACO,18,26,22,30,52
22,22161,221610201,Tapenagá,CHACO,342,372,664,659,1323
22,22161,221610202,Tapenagá,CHACO,66,90,82,124,206
22,22161,221610203,Tapenagá,CHACO,29,64,43,51,94
22,22161,221610301,Tapenagá,CHACO,399,505,774,745,1519
22,22161,221610302,Tapenagá,CHACO,64,75,112,130,242
22,22161,221610303,Tapenagá,CHACO,15,34,20,29,49
22,22161,221610304,Tapenagá,CHACO,21,48,9,37,46
22,22161,221610305,Tapenagá,CHACO,30,49,28,54,82
22,22161,221610401,Tapenagá,CHACO,61,91,80,89,169
22,22161,221610402,Tapenagá,CHACO,10,29,10,12,22
22,22168,221680101,25 de Mayo,CHACO,341,380,551,459,1010
22,22168,221680102,25 de Mayo,CHACO,258,283,432,376,808
22,22168,221680103,25 de Mayo,CHACO,265,287,581,585,1166
22,22168,221680104,25 de Mayo,CHACO,291,300,540,552,1092
22,22168,221680105,25 de Mayo,CHACO,266,291,411,381,792
22,22168,221680106,25 de Mayo,CHACO,277,300,445,395,840
22,22168,221680107,25 de Mayo,CHACO,547,512,1087,1047,2134
22,22168,221680108,25 de Mayo,CHACO,304,350,656,693,1349
22,22168,221680109,25 de Mayo,CHACO,289,307,624,607,1231
22,22168,221680110,25 de Mayo,CHACO,334,344,659,620,1279
22,22168,221680111,25 de Mayo,CHACO,158,193,350,323,673
22,22168,221680112,25 de Mayo,CHACO,325,343,595,600,1195
22,22168,221680113,25 de Mayo,CHACO,334,366,681,611,1292
22,22168,221680114,25 de Mayo,CHACO,275,281,576,579,1155
22,22168,221680115,25 de Mayo,CHACO,224,255,465,492,957
22,22168,221680116,25 de Mayo,CHACO,188,205,394,417,811
22,22168,221680117,25 de Mayo,CHACO,201,214,402,352,754
22,22168,221680201,25 de Mayo,CHACO,52,47,104,111,215
22,22168,221680202,25 de Mayo,CHACO,80,82,131,173,304
22,22168,221680203,25 de Mayo,CHACO,42,55,65,76,141
22,22168,221680204,25 de Mayo,CHACO,41,43,73,82,155
22,22168,221680205,25 de Mayo,CHACO,66,70,120,136,256
22,22168,221680206,25 de Mayo,CHACO,23,30,37,45,82
22,22168,221680207,25 de Mayo,CHACO,64,35,118,137,255
22,22168,221680301,25 de Mayo,CHACO,60,63,90,125,215
22,22168,221680302,25 de Mayo,CHACO,93,64,150,194,344
22,22168,221680303,25 de Mayo,CHACO,18,18,55,52,107
22,22168,221680304,25 de Mayo,CHACO,40,55,60,85,145
22,22168,221680305,25 de Mayo,CHACO,34,45,50,61,111
22,22168,221680306,25 de Mayo,CHACO,63,81,92,124,216
22,22168,221680307,25 de Mayo,CHACO,51,75,73,78,151
22,22168,221680308,25 de Mayo,CHACO,51,60,68,78,146
22,22168,221680309,25 de Mayo,CHACO,392,225,742,746,1488
22,22168,221680310,25 de Mayo,CHACO,493,420,977,1005,1982
22,22168,221680401,25 de Mayo,CHACO,82,67,184,196,380
22,22168,221680402,25 de Mayo,CHACO,158,173,344,414,758
22,22168,221680403,25 de Mayo,CHACO,140,143,320,358,678
22,22168,221680404,25 de Mayo,CHACO,60,81,126,146,272
22,22168,221680405,25 de Mayo,CHACO,69,74,165,162,327
22,22168,221680406,25 de Mayo,CHACO,89,93,136,167,303
22,22168,221680407,25 de Mayo,CHACO,48,26,75,95,170
22,22168,221680408,25 de Mayo,CHACO,59,69,82,122,204
22,22168,221680409,25 de Mayo,CHACO,287,258,638,634,1272
02,02010,020100607,Comuna 10,CIUDAD DE BUENOS AIRES,284,282,437,394,831
02,02010,020100604,Comuna 10,CIUDAD DE BUENOS AIRES,319,312,468,400,868
02,02010,020100101,Comuna 10,CIUDAD DE BUENOS AIRES,250,246,340,301,641
02,02010,020100606,Comuna 10,CIUDAD DE BUENOS AIRES,298,283,432,419,851
02,02010,020100608,Comuna 10,CIUDAD DE BUENOS AIRES,339,334,478,388,866
02,02010,020100605,Comuna 10,CIUDAD DE BUENOS AIRES,353,339,465,411,876
02,02010,020100102,Comuna 10,CIUDAD DE BUENOS AIRES,353,323,499,384,883
02,02010,020100201,Comuna 10,CIUDAD DE BUENOS AIRES,353,320,496,434,930
02,02010,020100603,Comuna 10,CIUDAD DE BUENOS AIRES,388,372,591,480,1071
02,02010,020100609,Comuna 10,CIUDAD DE BUENOS AIRES,357,354,523,442,965
02,02010,020100103,Comuna 10,CIUDAD DE BUENOS AIRES,341,334,473,454,927
02,02010,020100705,Comuna 10,CIUDAD DE BUENOS AIRES,366,357,463,380,843
02,02010,020100602,Comuna 10,CIUDAD DE BUENOS AIRES,247,236,354,328,682
02,02010,020100610,Comuna 10,CIUDAD DE BUENOS AIRES,422,369,608,492,1100
02,02010,020100706,Comuna 10,CIUDAD DE BUENOS AIRES,342,338,508,452,960
02,02010,020100611,Comuna 10,CIUDAD DE BUENOS AIRES,280,254,430,356,786
02,02010,020100202,Comuna 10,CIUDAD DE BUENOS AIRES,257,244,327,273,600
02,02010,020100601,Comuna 10,CIUDAD DE BUENOS AIRES,231,223,350,312,662
02,02010,020100104,Comuna 10,CIUDAD DE BUENOS AIRES,294,272,457,380,837
02,02010,020100203,Comuna 10,CIUDAD DE BUENOS AIRES,245,230,365,337,702
02,02010,020100612,Comuna 10,CIUDAD DE BUENOS AIRES,266,259,393,324,717
02,02010,020100504,Comuna 10,CIUDAD DE BUENOS AIRES,323,304,512,409,921
02,02010,020100707,Comuna 10,CIUDAD DE BUENOS AIRES,515,506,817,697,1514
02,02010,020100704,Comuna 10,CIUDAD DE BUENOS AIRES,434,424,622,511,1133
02,02010,020101002,Comuna 10,CIUDAD DE BUENOS AIRES,350,345,675,452,1127
02,02010,020100613,Comuna 10,CIUDAD DE BUENOS AIRES,395,385,567,476,1043
02,02010,020100106,Comuna 10,CIUDAD DE BUENOS AIRES,309,257,434,377,811
02,02010,020100204,Comuna 10,CIUDAD DE BUENOS AIRES,303,293,442,433,875
02,02010,020100105,Comuna 10,CIUDAD DE BUENOS AIRES,258,236,346,349,695
02,02010,020100107,Comuna 10,CIUDAD DE BUENOS AIRES,258,248,392,362,754
02,02010,020100505,Comuna 10,CIUDAD DE BUENOS AIRES,299,291,452,374,826
02,02010,020100708,Comuna 10,CIUDAD DE BUENOS AIRES,384,347,557,490,1047
02,02010,020100503,Comuna 10,CIUDAD DE BUENOS AIRES,355,343,504,432,936
02,02010,020101005,Comuna 10,CIUDAD DE BUENOS AIRES,313,299,477,412,889
02,02010,020100206,Comuna 10,CIUDAD DE BUENOS AIRES,393,379,582,526,1108
02,02010,020100108,Comuna 10,CIUDAD DE BUENOS AIRES,353,341,510,466,976
02,02010,020101001,Comuna 10,CIUDAD DE BUENOS AIRES,281,275,387,358,745
02,02010,020100703,Comuna 10,CIUDAD DE BUENOS AIRES,471,451,704,519,1223
02,02010,020101003,Comuna 10,CIUDAD DE BUENOS AIRES,318,297,505,462,967
02,02010,020100508,Comuna 10,CIUDAD DE BUENOS AIRES,357,350,496,466,962
02,02010,020100709,Comuna 10,CIUDAD DE BUENOS AIRES,339,312,506,453,959
02,02010,020100502,Comuna 10,CIUDAD DE BUENOS AIRES,292,285,392,331,723
02,02010,020100205,Comuna 10,CIUDAD DE BUENOS AIRES,297,287,449,390,839
02,02010,020101011,Comuna 10,CIUDAD DE BUENOS AIRES,304,287,430,380,810
02,02010,020100509,Comuna 10,CIUDAD DE BUENOS AIRES,263,250,371,322,693
02,02010,020100506,Comuna 10,CIUDAD DE BUENOS AIRES,339,319,475,378,853
02,02010,020100710,Comuna 10,CIUDAD DE BUENOS AIRES,402,385,584,531,1115
02,02010,020100501,Comuna 10,CIUDAD DE BUENOS AIRES,243,226,393,307,700
02,02010,020101004,Comuna 10,CIUDAD DE BUENOS AIRES,284,269,403,377,780
02,02010,020100904,Comuna 10,CIUDAD DE BUENOS AIRES,310,306,450,390,840
02,02010,020100512,Comuna 10,CIUDAD DE BUENOS AIRES,265,254,419,348,767
02,02010,020100208,Comuna 10,CIUDAD DE BUENOS AIRES,316,304,457,411,868
02,02010,020101006,Comuna 10,CIUDAD DE BUENOS AIRES,314,307,483,425,908
02,02010,020100702,Comuna 10,CIUDAD DE BUENOS AIRES,407,397,578,490,1068
02,02010,020100905,Comuna 10,CIUDAD DE BUENOS AIRES,302,286,541,460,1001
02,02010,020100511,Comuna 10,CIUDAD DE BUENOS AIRES,248,242,358,345,703
02,02010,020100507,Comuna 10,CIUDAD DE BUENOS AIRES,306,301,451,404,855
02,02010,020100207,Comuna 10,CIUDAD DE BUENOS AIRES,340,331,509,464,973
02,02010,020101007,Comuna 10,CIUDAD DE BUENOS AIRES,308,298,437,387,824
02,02010,020101105,Comuna 10,CIUDAD DE BUENOS AIRES,301,256,506,438,944
02,02010,020101010,Comuna 10,CIUDAD DE BUENOS AIRES,262,255,408,318,726
02,02010,020101012,Comuna 10,CIUDAD DE BUENOS AIRES,346,336,490,410,900
02,02010,020100903,Comuna 10,CIUDAD DE BUENOS AIRES,303,285,435,396,831
02,02010,020101008,Comuna 10,CIUDAD DE BUENOS AIRES,254,253,405,328,733
02,02010,020100401,Comuna 10,CIUDAD DE BUENOS AIRES,370,357,564,472,1036
02,02010,020100510,Comuna 10,CIUDAD DE BUENOS AIRES,296,257,428,377,805
02,02010,020100513,Comuna 10,CIUDAD DE BUENOS AIRES,288,278,432,388,820
02,02010,020100701,Comuna 10,CIUDAD DE BUENOS AIRES,381,347,633,509,1142
02,02010,020100301,Comuna 10,CIUDAD DE BUENOS AIRES,222,215,330,282,612
02,02010,020100902,Comuna 10,CIUDAD DE BUENOS AIRES,321,306,486,413,899
02,02010,020101104,Comuna 10,CIUDAD DE BUENOS AIRES,394,346,524,497,1021
02,02010,020100909,Comuna 10,CIUDAD DE BUENOS AIRES,250,247,348,337,685
02,02010,020100801,Comuna 10,CIUDAD DE BUENOS AIRES,406,382,582,503,1085
02,02010,020101103,Comuna 10,CIUDAD DE BUENOS AIRES,354,338,470,386,856
02,02010,020101009,Comuna 10,CIUDAD DE BUENOS AIRES,350,338,532,425,957
02,02010,020101106,Comuna 10,CIUDAD DE BUENOS AIRES,183,181,269,241,510
02,02010,020100906,Comuna 10,CIUDAD DE BUENOS AIRES,343,331,523,469,992
02,02010,020101301,Comuna 10,CIUDAD DE BUENOS AIRES,226,212,385,333,718
02,02010,020100302,Comuna 10,CIUDAD DE BUENOS AIRES,290,281,428,408,836
02,02010,020100803,Comuna 10,CIUDAD DE BUENOS AIRES,319,285,437,363,800
02,02010,020100514,Comuna 10,CIUDAD DE BUENOS AIRES,269,260,379,358,737
02,02010,020100901,Comuna 10,CIUDAD DE BUENOS AIRES,329,321,449,389,838
02,02010,020100307,Comuna 10,CIUDAD DE BUENOS AIRES,342,337,478,432,910
02,02010,020100806,Comuna 10,CIUDAD DE BUENOS AIRES,290,284,461,421,882
02,02010,020100408,Comuna 10,CIUDAD DE BUENOS AIRES,264,262,369,348,717
02,02010,020100407,Comuna 10,CIUDAD DE BUENOS AIRES,301,287,426,349,775
02,02010,020101903,Comuna 10,CIUDAD DE BUENOS AIRES,355,298,609,491,1100
02,02010,020101309,Comuna 10,CIUDAD DE BUENOS AIRES,281,276,403,323,726
02,02010,020101307,Comuna 10,CIUDAD DE BUENOS AIRES,254,244,415,307,722
02,02010,020101405,Comuna 10,CIUDAD DE BUENOS AIRES,262,256,389,330,719
02,02010,020100908,Comuna 10,CIUDAD DE BUENOS AIRES,259,246,382,355,737
02,02010,020100402,Comuna 10,CIUDAD DE BUENOS AIRES,402,381,586,519,1105
02,02010,020101303,Comuna 10,CIUDAD DE BUENOS AIRES,261,258,371,354,725
02,02010,020101102,Comuna 10,CIUDAD DE BUENOS AIRES,433,406,582,531,1113
02,02010,020100910,Comuna 10,CIUDAD DE BUENOS AIRES,279,234,407,394,801
02,02010,020101108,Comuna 10,CIUDAD DE BUENOS AIRES,344,338,445,394,839
02,02010,020100804,Comuna 10,CIUDAD DE BUENOS AIRES,367,355,512,509,1021
02,02010,020101101,Comuna 10,CIUDAD DE BUENOS AIRES,309,299,434,416,850
02,02010,020101107,Comuna 10,CIUDAD DE BUENOS AIRES,377,330,574,505,1079
02,02010,020100403,Comuna 10,CIUDAD DE BUENOS AIRES,300,291,486,393,879
02,02010,020101302,Comuna 10,CIUDAD DE BUENOS AIRES,255,246,407,346,753
02,02010,020100303,Comuna 10,CIUDAD DE BUENOS AIRES,293,288,432,371,803
02,02010,020101111,Comuna 10,CIUDAD DE BUENOS AIRES,251,244,348,297,645
02,02010,020101304,Comuna 10,CIUDAD DE BUENOS AIRES,248,239,318,287,605
02,02010,020100802,Comuna 10,CIUDAD DE BUENOS AIRES,428,408,630,578,1208
02,02010,020101402,Comuna 10,CIUDAD DE BUENOS AIRES,315,304,476,449,925
02,02010,020101109,Comuna 10,CIUDAD DE BUENOS AIRES,381,345,556,529,1085
02,02010,020100805,Comuna 10,CIUDAD DE BUENOS AIRES,302,260,445,403,848
02,02010,020101206,Comuna 10,CIUDAD DE BUENOS AIRES,214,191,322,279,601
02,02010,020100907,Comuna 10,CIUDAD DE BUENOS AIRES,312,301,478,407,885
02,02010,020100405,Comuna 10,CIUDAD DE BUENOS AIRES,286,269,402,387,789
02,02010,020101305,Comuna 10,CIUDAD DE BUENOS AIRES,315,301,419,391,810
02,02010,020101110,Comuna 10,CIUDAD DE BUENOS AIRES,296,263,383,295,678
02,02010,020101205,Comuna 10,CIUDAD DE BUENOS AIRES,189,151,314,291,605
02,02010,020100807,Comuna 10,CIUDAD DE BUENOS AIRES,425,402,615,539,1154
02,02010,020100304,Comuna 10,CIUDAD DE BUENOS AIRES,218,206,316,272,588
02,02010,020101204,Comuna 10,CIUDAD DE BUENOS AIRES,243,235,347,282,629
02,02010,020100305,Comuna 10,CIUDAD DE BUENOS AIRES,283,261,424,382,806
02,02010,020101306,Comuna 10,CIUDAD DE BUENOS AIRES,278,265,458,382,840
02,02010,020100404,Comuna 10,CIUDAD DE BUENOS AIRES,288,285,442,372,814
02,02010,020100406,Comuna 10,CIUDAD DE BUENOS AIRES,235,218,326,329,655
02,02010,020101203,Comuna 10,CIUDAD DE BUENOS AIRES,309,260,436,371,807
02,02010,020101401,Comuna 10,CIUDAD DE BUENOS AIRES,334,314,482,420,902
02,02010,020101202,Comuna 10,CIUDAD DE BUENOS AIRES,370,364,473,402,875
02,02010,020101308,Comuna 10,CIUDAD DE BUENOS AIRES,290,284,428,357,785
02,02010,020101403,Comuna 10,CIUDAD DE BUENOS AIRES,322,317,442,371,813
02,02010,020100308,Comuna 10,CIUDAD DE BUENOS AIRES,344,334,540,466,1006
02,02010,020101201,Comuna 10,CIUDAD DE BUENOS AIRES,347,331,544,462,1006
02,02010,020100808,Comuna 10,CIUDAD DE BUENOS AIRES,408,395,617,504,1121
02,02010,020101207,Comuna 10,CIUDAD DE BUENOS AIRES,238,225,365,294,659
02,02010,020101404,Comuna 10,CIUDAD DE BUENOS AIRES,296,280,432,400,832
02,02010,020101210,Comuna 10,CIUDAD DE BUENOS AIRES,246,239,335,277,612
02,02010,020101208,Comuna 10,CIUDAD DE BUENOS AIRES,311,291,401,352,753
02,02010,020101311,Comuna 10,CIUDAD DE BUENOS AIRES,287,276,355,264,619
02,02010,020101209,Comuna 10,CIUDAD DE BUENOS AIRES,308,307,414,323,737
02,02010,020100409,Comuna 10,CIUDAD DE BUENOS AIRES,305,265,411,363,774
02,02010,020101902,Comuna 10,CIUDAD DE BUENOS AIRES,436,408,576,518,1094
02,02010,020101502,Comuna 10,CIUDAD DE BUENOS AIRES,347,343,515,403,918
02,02010,020101310,Comuna 10,CIUDAD DE BUENOS AIRES,230,229,303,290,593
02,02010,020101904,Comuna 10,CIUDAD DE BUENOS AIRES,340,325,427,361,788
02,02010,020100809,Comuna 10,CIUDAD DE BUENOS AIRES,264,257,440,360,800
02,02010,020101312,Comuna 10,CIUDAD DE BUENOS AIRES,267,262,347,254,601
02,02010,020101503,Comuna 10,CIUDAD DE BUENOS AIRES,202,198,292,265,557
02,02010,020100306,Comuna 10,CIUDAD DE BUENOS AIRES,278,265,407,310,717
02,02010,020101901,Comuna 10,CIUDAD DE BUENOS AIRES,265,241,316,247,563
02,02010,020101501,Comuna 10,CIUDAD DE BUENOS AIRES,263,246,344,289,633
02,02010,020101406,Comuna 10,CIUDAD DE BUENOS AIRES,205,199,310,283,593
02,02010,020101905,Comuna 10,CIUDAD DE BUENOS AIRES,348,341,441,381,822
02,02010,020101407,Comuna 10,CIUDAD DE BUENOS AIRES,291,266,450,385,835
02,02010,020101906,Comuna 10,CIUDAD DE BUENOS AIRES,347,264,442,416,858
02,02010,020101806,Comuna 10,CIUDAD DE BUENOS AIRES,280,276,347,259,606
02,02010,020101910,Comuna 10,CIUDAD DE BUENOS AIRES,400,378,568,440,1008
02,02010,020101907,Comuna 10,CIUDAD DE BUENOS AIRES,328,322,451,324,775
02,02010,020101504,Comuna 10,CIUDAD DE BUENOS AIRES,247,241,363,313,676
02,02010,020101805,Comuna 10,CIUDAD DE BUENOS AIRES,277,275,442,337,779
02,02010,020101505,Comuna 10,CIUDAD DE BUENOS AIRES,298,293,395,425,820
02,02010,020101809,Comuna 10,CIUDAD DE BUENOS AIRES,458,360,709,575,1284
02,02010,020101909,Comuna 10,CIUDAD DE BUENOS AIRES,276,272,375,354,729
02,02010,020101409,Comuna 10,CIUDAD DE BUENOS AIRES,337,320,480,407,887
02,02010,020101807,Comuna 10,CIUDAD DE BUENOS AIRES,365,359,438,347,785
02,02010,020101804,Comuna 10,CIUDAD DE BUENOS AIRES,396,373,623,491,1114
02,02010,020101911,Comuna 10,CIUDAD DE BUENOS AIRES,344,329,469,450,919
02,02010,020101908,Comuna 10,CIUDAD DE BUENOS AIRES,215,201,282,230,512
02,02010,020101408,Comuna 10,CIUDAD DE BUENOS AIRES,253,247,317,282,599
02,02010,020101411,Comuna 10,CIUDAD DE BUENOS AIRES,267,259,370,339,709
02,02010,020101803,Comuna 10,CIUDAD DE BUENOS AIRES,337,319,451,329,780
02,02010,020101508,Comuna 10,CIUDAD DE BUENOS AIRES,375,333,556,517,1073
02,02010,020101808,Comuna 10,CIUDAD DE BUENOS AIRES,184,178,318,278,596
02,02010,020101410,Comuna 10,CIUDAD DE BUENOS AIRES,341,331,460,379,839
02,02010,020101507,Comuna 10,CIUDAD DE BUENOS AIRES,225,218,272,254,526
02,02010,020101912,Comuna 10,CIUDAD DE BUENOS AIRES,429,402,620,517,1137
02,02010,020101506,Comuna 10,CIUDAD DE BUENOS AIRES,248,238,340,273,613
02,02010,020101810,Comuna 10,CIUDAD DE BUENOS AIRES,191,175,277,239,516
02,02010,020101601,Comuna 10,CIUDAD DE BUENOS AIRES,270,264,363,308,671
02,02010,020101802,Comuna 10,CIUDAD DE BUENOS AIRES,270,265,403,352,755
02,02010,020101602,Comuna 10,CIUDAD DE BUENOS AIRES,408,386,585,492,1077
02,02010,020101509,Comuna 10,CIUDAD DE BUENOS AIRES,459,454,657,566,1223
02,02010,020101801,Comuna 10,CIUDAD DE BUENOS AIRES,280,253,387,349,736
02,02010,020101703,Comuna 10,CIUDAD DE BUENOS AIRES,360,353,507,437,944
02,02010,020101702,Comuna 10,CIUDAD DE BUENOS AIRES,372,351,439,405,844
02,02010,020101701,Comuna 10,CIUDAD DE BUENOS AIRES,313,310,412,336,748
02,02010,020101706,Comuna 10,CIUDAD DE BUENOS AIRES,308,292,467,405,872
02,02010,020101705,Comuna 10,CIUDAD DE BUENOS AIRES,367,296,564,497,1061
02,02010,020101603,Comuna 10,CIUDAD DE BUENOS AIRES,282,247,417,361,778
02,02010,020101811,Comuna 10,CIUDAD DE BUENOS AIRES,224,210,360,303,663
02,02010,020101704,Comuna 10,CIUDAD DE BUENOS AIRES,378,378,564,519,1083
02,02010,020101812,Comuna 10,CIUDAD DE BUENOS AIRES,297,290,446,362,808
02,02010,020101604,Comuna 10,CIUDAD DE BUENOS AIRES,344,332,470,403,873
02,02010,020101605,Comuna 10,CIUDAD DE BUENOS AIRES,389,380,591,460,1051
02,02010,020101607,Comuna 10,CIUDAD DE BUENOS AIRES,289,288,408,374,782
02,02010,020101606,Comuna 10,CIUDAD DE BUENOS AIRES,356,338,518,488,1006
02,02010,020101707,Comuna 10,CIUDAD DE BUENOS AIRES,289,269,465,410,875
02,02010,020101708,Comuna 10,CIUDAD DE BUENOS AIRES,246,218,375,319,694
02,02010,020101709,Comuna 10,CIUDAD DE BUENOS AIRES,239,215,332,306,638
02,02010,020101609,Comuna 10,CIUDAD DE BUENOS AIRES,338,327,511,442,953
02,02010,020101608,Comuna 10,CIUDAD DE BUENOS AIRES,312,298,452,401,853
02,02010,020101710,Comuna 10,CIUDAD DE BUENOS AIRES,269,264,395,346,741
02,02007,020070403,Comuna 7,CIUDAD DE BUENOS AIRES,450,401,562,450,1012
02,02007,020070404,Comuna 7,CIUDAD DE BUENOS AIRES,560,525,731,571,1302
02,02007,020070402,Comuna 7,CIUDAD DE BUENOS AIRES,334,304,414,356,770
02,02007,020070401,Comuna 7,CIUDAD DE BUENOS AIRES,534,513,573,496,1069
02,02007,020070303,Comuna 7,CIUDAD DE BUENOS AIRES,477,458,615,519,1134
02,02007,020070405,Comuna 7,CIUDAD DE BUENOS AIRES,397,278,469,364,833
02,02007,020070302,Comuna 7,CIUDAD DE BUENOS AIRES,381,342,527,426,953
02,02007,020070406,Comuna 7,CIUDAD DE BUENOS AIRES,436,286,624,550,1174
02,02007,020070301,Comuna 7,CIUDAD DE BUENOS AIRES,301,296,370,319,689
02,02007,020070202,Comuna 7,CIUDAD DE BUENOS AIRES,370,355,522,467,989
02,02007,020070408,Comuna 7,CIUDAD DE BUENOS AIRES,396,267,522,429,951
02,02007,020070304,Comuna 7,CIUDAD DE BUENOS AIRES,395,345,621,553,1174
02,02007,020070306,Comuna 7,CIUDAD DE BUENOS AIRES,338,311,516,408,924
02,02007,020070407,Comuna 7,CIUDAD DE BUENOS AIRES,472,345,630,561,1191
02,02007,020070409,Comuna 7,CIUDAD DE BUENOS AIRES,223,210,320,292,612
02,02007,020070201,Comuna 7,CIUDAD DE BUENOS AIRES,289,274,441,387,828
02,02007,020070203,Comuna 7,CIUDAD DE BUENOS AIRES,303,288,423,401,824
02,02007,020070307,Comuna 7,CIUDAD DE BUENOS AIRES,448,438,612,558,1170
02,02007,020070305,Comuna 7,CIUDAD DE BUENOS AIRES,309,303,418,369,787
02,02007,020070410,Comuna 7,CIUDAD DE BUENOS AIRES,365,359,500,428,928
02,02007,020070209,Comuna 7,CIUDAD DE BUENOS AIRES,394,382,536,462,998
02,02007,020070102,Comuna 7,CIUDAD DE BUENOS AIRES,306,284,485,406,891
02,02007,020070204,Comuna 7,CIUDAD DE BUENOS AIRES,660,592,918,859,1777
02,02007,020070101,Comuna 7,CIUDAD DE BUENOS AIRES,223,197,314,287,601
02,02007,020070505,Comuna 7,CIUDAD DE BUENOS AIRES,462,451,602,527,1129
02,02007,020070308,Comuna 7,CIUDAD DE BUENOS AIRES,307,295,434,302,736
02,02007,020070205,Comuna 7,CIUDAD DE BUENOS AIRES,358,351,513,472,985
02,02007,020070309,Comuna 7,CIUDAD DE BUENOS AIRES,273,268,373,338,711
02,02007,020070507,Comuna 7,CIUDAD DE BUENOS AIRES,269,264,370,290,660
02,02007,020070208,Comuna 7,CIUDAD DE BUENOS AIRES,296,292,356,356,712
02,02007,020070310,Comuna 7,CIUDAD DE BUENOS AIRES,425,419,588,474,1062
02,02007,020070508,Comuna 7,CIUDAD DE BUENOS AIRES,345,337,440,300,740
02,02007,020070207,Comuna 7,CIUDAD DE BUENOS AIRES,245,239,400,324,724
02,02007,020070601,Comuna 7,CIUDAD DE BUENOS AIRES,372,370,517,410,927
02,02007,020070103,Comuna 7,CIUDAD DE BUENOS AIRES,316,302,485,393,878
02,02007,020070506,Comuna 7,CIUDAD DE BUENOS AIRES,269,267,359,281,640
02,02007,020070104,Comuna 7,CIUDAD DE BUENOS AIRES,255,236,386,352,738
02,02007,020070602,Comuna 7,CIUDAD DE BUENOS AIRES,299,240,446,355,801
02,02007,020070509,Comuna 7,CIUDAD DE BUENOS AIRES,460,430,597,501,1098
02,02007,020070603,Comuna 7,CIUDAD DE BUENOS AIRES,243,232,330,301,631
02,02007,020070503,Comuna 7,CIUDAD DE BUENOS AIRES,328,299,489,377,866
02,02007,020070704,Comuna 7,CIUDAD DE BUENOS AIRES,266,234,338,301,639
02,02007,020070206,Comuna 7,CIUDAD DE BUENOS AIRES,396,374,597,503,1100
02,02007,020072201,Comuna 7,CIUDAD DE BUENOS AIRES,297,285,350,284,634
02,02007,020072102,Comuna 7,CIUDAD DE BUENOS AIRES,466,442,622,499,1121
02,02007,020070910,Comuna 7,CIUDAD DE BUENOS AIRES,307,301,389,303,692
02,02007,020071008,Comuna 7,CIUDAD DE BUENOS AIRES,428,423,605,467,1072
02,02007,020071107,Comuna 7,CIUDAD DE BUENOS AIRES,496,489,634,489,1123
02,02007,020070802,Comuna 7,CIUDAD DE BUENOS AIRES,356,339,491,388,879
02,02007,020070605,Comuna 7,CIUDAD DE BUENOS AIRES,414,410,503,396,899
02,02007,020070502,Comuna 7,CIUDAD DE BUENOS AIRES,243,218,388,260,648
02,02007,020070703,Comuna 7,CIUDAD DE BUENOS AIRES,409,408,533,425,958
02,02007,020070504,Comuna 7,CIUDAD DE BUENOS AIRES,457,452,580,444,1024
02,02007,020070604,Comuna 7,CIUDAD DE BUENOS AIRES,305,274,443,391,834
02,02007,020070702,Comuna 7,CIUDAD DE BUENOS AIRES,204,196,318,268,586
02,02007,020070606,Comuna 7,CIUDAD DE BUENOS AIRES,394,346,494,414,908
02,02007,020070705,Comuna 7,CIUDAD DE BUENOS AIRES,287,260,335,302,637
02,02007,020071101,Comuna 7,CIUDAD DE BUENOS AIRES,315,304,485,370,855
02,02007,020070701,Comuna 7,CIUDAD DE BUENOS AIRES,245,244,356,285,641
02,02007,020070501,Comuna 7,CIUDAD DE BUENOS AIRES,341,332,422,324,746
02,02007,020070706,Comuna 7,CIUDAD DE BUENOS AIRES,365,353,504,455,959
02,02007,020071102,Comuna 7,CIUDAD DE BUENOS AIRES,402,399,496,367,863
02,02007,020070106,Comuna 7,CIUDAD DE BUENOS AIRES,269,217,410,339,749
02,02007,020070607,Comuna 7,CIUDAD DE BUENOS AIRES,379,377,479,390,869
02,02007,020071103,Comuna 7,CIUDAD DE BUENOS AIRES,367,361,484,366,850
02,02007,020070707,Comuna 7,CIUDAD DE BUENOS AIRES,248,216,364,301,665
02,02007,020070609,Comuna 7,CIUDAD DE BUENOS AIRES,289,270,405,282,687
02,02007,020071105,Comuna 7,CIUDAD DE BUENOS AIRES,229,225,294,254,548
02,02007,020070105,Comuna 7,CIUDAD DE BUENOS AIRES,172,162,231,219,450
02,02007,020071003,Comuna 7,CIUDAD DE BUENOS AIRES,254,252,340,248,588
02,02007,020070608,Comuna 7,CIUDAD DE BUENOS AIRES,185,183,237,202,439
02,02007,020070107,Comuna 7,CIUDAD DE BUENOS AIRES,185,169,257,230,487
02,02007,020071104,Comuna 7,CIUDAD DE BUENOS AIRES,380,375,519,420,939
02,02007,020072304,Comuna 7,CIUDAD DE BUENOS AIRES,272,265,358,275,633
02,02007,020070708,Comuna 7,CIUDAD DE BUENOS AIRES,220,217,275,231,506
02,02007,020071002,Comuna 7,CIUDAD DE BUENOS AIRES,185,178,220,160,380
02,02007,020072303,Comuna 7,CIUDAD DE BUENOS AIRES,318,314,404,324,728
02,02007,020072302,Comuna 7,CIUDAD DE BUENOS AIRES,388,371,535,449,984
02,02007,020071001,Comuna 7,CIUDAD DE BUENOS AIRES,303,301,417,316,733
02,02007,020070711,Comuna 7,CIUDAD DE BUENOS AIRES,282,280,369,244,613
02,02007,020072301,Comuna 7,CIUDAD DE BUENOS AIRES,303,285,436,386,822
02,02007,020070709,Comuna 7,CIUDAD DE BUENOS AIRES,410,377,518,418,936
02,02007,020070710,Comuna 7,CIUDAD DE BUENOS AIRES,355,349,435,354,789
02,02007,020072208,Comuna 7,CIUDAD DE BUENOS AIRES,235,232,311,258,569
02,02007,020072207,Comuna 7,CIUDAD DE BUENOS AIRES,221,213,295,266,561
02,02007,020071004,Comuna 7,CIUDAD DE BUENOS AIRES,295,289,388,302,690
02,02007,020072206,Comuna 7,CIUDAD DE BUENOS AIRES,365,329,483,420,903
02,02007,020071106,Comuna 7,CIUDAD DE BUENOS AIRES,267,266,426,375,801
02,02007,020072305,Comuna 7,CIUDAD DE BUENOS AIRES,290,268,415,320,735
02,02007,020072205,Comuna 7,CIUDAD DE BUENOS AIRES,386,374,534,466,1000
02,02007,020070908,Comuna 7,CIUDAD DE BUENOS AIRES,397,377,531,441,972
02,02007,020071006,Comuna 7,CIUDAD DE BUENOS AIRES,351,347,411,349,760
02,02007,020072306,Comuna 7,CIUDAD DE BUENOS AIRES,276,273,412,348,760
02,02007,020071108,Comuna 7,CIUDAD DE BUENOS AIRES,452,444,542,463,1005
02,02007,020072202,Comuna 7,CIUDAD DE BUENOS AIRES,365,342,474,449,923
02,02007,020071007,Comuna 7,CIUDAD DE BUENOS AIRES,339,335,418,292,710
02,02007,020070909,Comuna 7,CIUDAD DE BUENOS AIRES,298,278,367,318,685
02,02007,020070109,Comuna 7,CIUDAD DE BUENOS AIRES,291,267,352,328,680
02,02007,020070108,Comuna 7,CIUDAD DE BUENOS AIRES,319,298,408,313,721
02,02007,020071005,Comuna 7,CIUDAD DE BUENOS AIRES,240,239,356,284,640
02,02007,020070801,Comuna 7,CIUDAD DE BUENOS AIRES,326,302,387,295,682
02,02007,020072101,Comuna 7,CIUDAD DE BUENOS AIRES,424,396,652,486,1138
02,02007,020072103,Comuna 7,CIUDAD DE BUENOS AIRES,433,419,521,438,959
02,02007,020072203,Comuna 7,CIUDAD DE BUENOS AIRES,361,355,488,386,874
02,02007,020071010,Comuna 7,CIUDAD DE BUENOS AIRES,332,317,550,382,932
02,02007,020071109,Comuna 7,CIUDAD DE BUENOS AIRES,366,363,579,408,987
02,02007,020070110,Comuna 7,CIUDAD DE BUENOS AIRES,419,365,645,480,1125
02,02007,020072104,Comuna 7,CIUDAD DE BUENOS AIRES,240,237,302,263,565
02,02007,020071201,Comuna 7,CIUDAD DE BUENOS AIRES,422,417,553,467,1020
02,02007,020071009,Comuna 7,CIUDAD DE BUENOS AIRES,307,299,390,292,682
02,02007,020072209,Comuna 7,CIUDAD DE BUENOS AIRES,224,219,318,288,606
02,02007,020070911,Comuna 7,CIUDAD DE BUENOS AIRES,263,224,320,257,577
02,02007,020072307,Comuna 7,CIUDAD DE BUENOS AIRES,313,296,463,358,821
02,02007,020071110,Comuna 7,CIUDAD DE BUENOS AIRES,249,241,368,277,645
02,02007,020072105,Comuna 7,CIUDAD DE BUENOS AIRES,250,238,343,343,686
02,02007,020072108,Comuna 7,CIUDAD DE BUENOS AIRES,175,172,246,186,432
02,02007,020072308,Comuna 7,CIUDAD DE BUENOS AIRES,322,257,442,372,814
02,02007,020070907,Comuna 7,CIUDAD DE BUENOS AIRES,329,321,420,333,753
02,02007,020072204,Comuna 7,CIUDAD DE BUENOS AIRES,378,370,506,426,932
02,02007,020072309,Comuna 7,CIUDAD DE BUENOS AIRES,289,268,393,342,735
02,02007,020071304,Comuna 7,CIUDAD DE BUENOS AIRES,216,213,310,252,562
02,02007,020070906,Comuna 7,CIUDAD DE BUENOS AIRES,356,348,489,404,893
02,02007,020070803,Comuna 7,CIUDAD DE BUENOS AIRES,247,246,344,239,583
02,02007,020071203,Comuna 7,CIUDAD DE BUENOS AIRES,278,274,385,387,772
02,02007,020070901,Comuna 7,CIUDAD DE BUENOS AIRES,259,247,358,309,667
02,02007,020070804,Comuna 7,CIUDAD DE BUENOS AIRES,358,347,463,358,821
02,02007,020072210,Comuna 7,CIUDAD DE BUENOS AIRES,268,260,394,384,778
02,02007,020072106,Comuna 7,CIUDAD DE BUENOS AIRES,423,411,497,430,927
02,02007,020070902,Comuna 7,CIUDAD DE BUENOS AIRES,276,273,335,290,625
02,02007,020072211,Comuna 7,CIUDAD DE BUENOS AIRES,286,280,405,348,753
02,02007,020070905,Comuna 7,CIUDAD DE BUENOS AIRES,197,196,273,221,494
02,02007,020071303,Comuna 7,CIUDAD DE BUENOS AIRES,415,390,549,451,1000
02,02007,020071305,Comuna 7,CIUDAD DE BUENOS AIRES,329,326,458,361,819
02,02007,020070805,Comuna 7,CIUDAD DE BUENOS AIRES,392,363,555,485,1040
02,02007,020070903,Comuna 7,CIUDAD DE BUENOS AIRES,226,223,318,225,543
02,02007,020072404,Comuna 7,CIUDAD DE BUENOS AIRES,379,371,548,488,1036
02,02007,020070807,Comuna 7,CIUDAD DE BUENOS AIRES,319,314,381,297,678
02,02007,020072403,Comuna 7,CIUDAD DE BUENOS AIRES,384,346,647,567,1214
02,02007,020072107,Comuna 7,CIUDAD DE BUENOS AIRES,303,296,388,334,722
02,02007,020070904,Comuna 7,CIUDAD DE BUENOS AIRES,415,328,452,374,826
02,02007,020070806,Comuna 7,CIUDAD DE BUENOS AIRES,373,364,482,414,896
02,02007,020071202,Comuna 7,CIUDAD DE BUENOS AIRES,216,213,313,265,578
02,02007,020071204,Comuna 7,CIUDAD DE BUENOS AIRES,319,312,448,349,797
02,02007,020071302,Comuna 7,CIUDAD DE BUENOS AIRES,294,290,391,322,713
02,02007,020072212,Comuna 7,CIUDAD DE BUENOS AIRES,256,253,323,259,582
02,02007,020071315,Comuna 7,CIUDAD DE BUENOS AIRES,185,182,283,220,503
02,02007,020072402,Comuna 7,CIUDAD DE BUENOS AIRES,318,277,470,443,913
02,02007,020072213,Comuna 7,CIUDAD DE BUENOS AIRES,289,283,404,349,753
02,02007,020071306,Comuna 7,CIUDAD DE BUENOS AIRES,265,260,393,351,744
02,02007,020071301,Comuna 7,CIUDAD DE BUENOS AIRES,320,313,377,344,721
02,02007,020071314,Comuna 7,CIUDAD DE BUENOS AIRES,220,204,389,320,709
02,02007,020070808,Comuna 7,CIUDAD DE BUENOS AIRES,368,354,445,373,818
02,02007,020071205,Comuna 7,CIUDAD DE BUENOS AIRES,297,292,429,311,740
02,02007,020071310,Comuna 7,CIUDAD DE BUENOS AIRES,193,192,267,230,497
02,02007,020071402,Comuna 7,CIUDAD DE BUENOS AIRES,298,296,458,359,817
02,02007,020072401,Comuna 7,CIUDAD DE BUENOS AIRES,345,341,462,432,894
02,02007,020072405,Comuna 7,CIUDAD DE BUENOS AIRES,344,333,490,441,931
02,02007,020071206,Comuna 7,CIUDAD DE BUENOS AIRES,302,295,409,346,755
02,02007,020072001,Comuna 7,CIUDAD DE BUENOS AIRES,380,367,530,491,1021
02,02007,020071307,Comuna 7,CIUDAD DE BUENOS AIRES,202,196,309,240,549
02,02007,020071309,Comuna 7,CIUDAD DE BUENOS AIRES,166,161,248,245,493
02,02007,020071311,Comuna 7,CIUDAD DE BUENOS AIRES,253,248,397,353,750
02,02007,020071403,Comuna 7,CIUDAD DE BUENOS AIRES,257,236,398,327,725
02,02007,020071401,Comuna 7,CIUDAD DE BUENOS AIRES,313,288,423,410,833
02,02007,020072111,Comuna 7,CIUDAD DE BUENOS AIRES,339,294,450,361,811
02,02007,020072110,Comuna 7,CIUDAD DE BUENOS AIRES,376,351,505,406,911
02,02007,020072406,Comuna 7,CIUDAD DE BUENOS AIRES,371,354,557,502,1059
02,02007,020072109,Comuna 7,CIUDAD DE BUENOS AIRES,307,286,383,326,709
02,02007,020072006,Comuna 7,CIUDAD DE BUENOS AIRES,283,269,441,374,815
02,02007,020071207,Comuna 7,CIUDAD DE BUENOS AIRES,218,211,310,302,612
02,02007,020072407,Comuna 7,CIUDAD DE BUENOS AIRES,289,261,436,416,852
02,02007,020071404,Comuna 7,CIUDAD DE BUENOS AIRES,258,244,373,323,696
02,02007,020071405,Comuna 7,CIUDAD DE BUENOS AIRES,295,263,504,425,929
02,02007,020072112,Comuna 7,CIUDAD DE BUENOS AIRES,313,256,505,412,917
02,02007,020071313,Comuna 7,CIUDAD DE BUENOS AIRES,196,191,278,287,565
02,02007,020071407,Comuna 7,CIUDAD DE BUENOS AIRES,272,257,496,443,939
02,02007,020072408,Comuna 7,CIUDAD DE BUENOS AIRES,331,314,471,406,877
02,02007,020071308,Comuna 7,CIUDAD DE BUENOS AIRES,194,187,292,268,560
02,02007,020072002,Comuna 7,CIUDAD DE BUENOS AIRES,192,184,293,259,552
02,02007,020071209,Comuna 7,CIUDAD DE BUENOS AIRES,290,282,427,396,823
02,02007,020071312,Comuna 7,CIUDAD DE BUENOS AIRES,222,210,361,331,692
02,02007,020071411,Comuna 7,CIUDAD DE BUENOS AIRES,323,300,474,448,922
02,02007,020071604,Comuna 7,CIUDAD DE BUENOS AIRES,241,182,391,335,726
02,02007,020071406,Comuna 7,CIUDAD DE BUENOS AIRES,379,342,600,525,1125
02,02007,020072003,Comuna 7,CIUDAD DE BUENOS AIRES,259,240,373,349,722
02,02007,020072410,Comuna 7,CIUDAD DE BUENOS AIRES,323,303,520,442,962
02,02007,020072005,Comuna 7,CIUDAD DE BUENOS AIRES,278,263,422,384,806
02,02007,020071412,Comuna 7,CIUDAD DE BUENOS AIRES,339,307,486,438,924
02,02007,020072007,Comuna 7,CIUDAD DE BUENOS AIRES,279,204,437,379,816
02,02007,020072411,Comuna 7,CIUDAD DE BUENOS AIRES,371,354,545,495,1040
02,02007,020071602,Comuna 7,CIUDAD DE BUENOS AIRES,253,231,425,371,796
02,02007,020071605,Comuna 7,CIUDAD DE BUENOS AIRES,274,258,384,411,795
02,02007,020071208,Comuna 7,CIUDAD DE BUENOS AIRES,213,200,292,303,595
02,02007,020072004,Comuna 7,CIUDAD DE BUENOS AIRES,190,180,275,266,541
02,02007,020071408,Comuna 7,CIUDAD DE BUENOS AIRES,300,272,470,466,936
02,02007,020071413,Comuna 7,CIUDAD DE BUENOS AIRES,251,223,382,365,747
02,02007,020072409,Comuna 7,CIUDAD DE BUENOS AIRES,341,325,507,443,950
02,02007,020071410,Comuna 7,CIUDAD DE BUENOS AIRES,233,225,417,349,766
02,02007,020071603,Comuna 7,CIUDAD DE BUENOS AIRES,264,229,434,381,815
02,02007,020072008,Comuna 7,CIUDAD DE BUENOS AIRES,441,417,613,576,1189
02,02007,020072009,Comuna 7,CIUDAD DE BUENOS AIRES,302,263,492,417,909
02,02007,020071601,Comuna 7,CIUDAD DE BUENOS AIRES,248,242,380,342,722
02,02007,020071606,Comuna 7,CIUDAD DE BUENOS AIRES,352,303,526,481,1007
02,02007,020071609,Comuna 7,CIUDAD DE BUENOS AIRES,335,297,559,498,1057
02,02007,020071504,Comuna 7,CIUDAD DE BUENOS AIRES,232,222,344,311,655
02,02007,020071607,Comuna 7,CIUDAD DE BUENOS AIRES,320,292,474,473,947
02,02007,020071409,Comuna 7,CIUDAD DE BUENOS AIRES,289,270,456,400,856
02,02007,020071901,Comuna 7,CIUDAD DE BUENOS AIRES,274,171,457,421,878
02,02007,020072012,Comuna 7,CIUDAD DE BUENOS AIRES,223,205,341,318,659
02,02007,020071503,Comuna 7,CIUDAD DE BUENOS AIRES,316,296,510,450,960
02,02007,020072011,Comuna 7,CIUDAD DE BUENOS AIRES,363,309,579,510,1089
02,02007,020071505,Comuna 7,CIUDAD DE BUENOS AIRES,233,223,370,335,705
02,02007,020071502,Comuna 7,CIUDAD DE BUENOS AIRES,360,253,558,509,1067
02,02007,020071608,Comuna 7,CIUDAD DE BUENOS AIRES,352,338,571,535,1106
02,02007,020072010,Comuna 7,CIUDAD DE BUENOS AIRES,368,328,705,622,1327
02,02007,020071506,Comuna 7,CIUDAD DE BUENOS AIRES,334,330,601,509,1110
02,02007,020071902,Comuna 7,CIUDAD DE BUENOS AIRES,507,258,830,829,1659
02,02007,020071904,Comuna 7,CIUDAD DE BUENOS AIRES,455,277,784,769,1553
02,02007,020072013,Comuna 7,CIUDAD DE BUENOS AIRES,575,562,849,768,1617
02,02007,020071701,Comuna 7,CIUDAD DE BUENOS AIRES,439,328,783,822,1605
02,02007,020071507,Comuna 7,CIUDAD DE BUENOS AIRES,285,280,377,337,714
02,02007,020071903,Comuna 7,CIUDAD DE BUENOS AIRES,363,232,680,659,1339
02,02007,020071508,Comuna 7,CIUDAD DE BUENOS AIRES,293,233,426,371,797
02,02007,020071509,Comuna 7,CIUDAD DE BUENOS AIRES,397,353,652,566,1218
02,02007,020071510,Comuna 7,CIUDAD DE BUENOS AIRES,327,287,519,504,1023
02,02007,020071501,Comuna 7,CIUDAD DE BUENOS AIRES,225,165,348,340,688
02,02007,020071905,Comuna 7,CIUDAD DE BUENOS AIRES,392,295,733,674,1407
02,02007,020071706,Comuna 7,CIUDAD DE BUENOS AIRES,375,352,678,635,1313
02,02007,020071807,Comuna 7,CIUDAD DE BUENOS AIRES,286,255,637,579,1216
02,02007,020071702,Comuna 7,CIUDAD DE BUENOS AIRES,500,297,837,750,1587
02,02007,020071808,Comuna 7,CIUDAD DE BUENOS AIRES,246,219,502,508,1010
02,02007,020071906,Comuna 7,CIUDAD DE BUENOS AIRES,440,422,992,935,1927
02,02007,020071705,Comuna 7,CIUDAD DE BUENOS AIRES,268,100,462,429,891
02,02007,020071805,Comuna 7,CIUDAD DE BUENOS AIRES,292,105,500,503,1003
02,02007,020071707,Comuna 7,CIUDAD DE BUENOS AIRES,764,454,1216,1200,2416
02,02007,020071804,Comuna 7,CIUDAD DE BUENOS AIRES,254,119,413,400,813
02,02007,020071511,Comuna 7,CIUDAD DE BUENOS AIRES,367,316,611,537,1148
02,02007,020071809,Comuna 7,CIUDAD DE BUENOS AIRES,377,258,609,594,1203
02,02007,020071703,Comuna 7,CIUDAD DE BUENOS AIRES,416,207,695,679,1374
02,02007,020071708,Comuna 7,CIUDAD DE BUENOS AIRES,338,150,586,517,1103
02,02007,020071704,Comuna 7,CIUDAD DE BUENOS AIRES,509,246,818,827,1645
02,02007,020071806,Comuna 7,CIUDAD DE BUENOS AIRES,485,280,851,823,1674
02,02007,020071802,Comuna 7,CIUDAD DE BUENOS AIRES,124,119,246,241,487
02,02007,020071709,Comuna 7,CIUDAD DE BUENOS AIRES,618,329,981,865,1846
02,02007,020071803,Comuna 7,CIUDAD DE BUENOS AIRES,288,230,468,474,942
02,02007,020071811,Comuna 7,CIUDAD DE BUENOS AIRES,403,199,640,685,1325
02,02007,020071810,Comuna 7,CIUDAD DE BUENOS AIRES,414,332,770,723,1493
02,02007,020071801,Comuna 7,CIUDAD DE BUENOS AIRES,395,342,787,758,1545
02,02007,020071710,Comuna 7,CIUDAD DE BUENOS AIRES,500,214,774,733,1507
02,02007,020071711,Comuna 7,CIUDAD DE BUENOS AIRES,190,87,290,270,560
02,02004,020041801,Comuna 4,CIUDAD DE BUENOS AIRES,45,42,4,70,74
02,02004,020041408,Comuna 4,CIUDAD DE BUENOS AIRES,410,353,532,460,992
02,02004,020040701,Comuna 4,CIUDAD DE BUENOS AIRES,304,294,448,454,902
02,02004,020041604,Comuna 4,CIUDAD DE BUENOS AIRES,267,247,369,277,646
02,02004,020040607,Comuna 4,CIUDAD DE BUENOS AIRES,310,286,415,351,766
02,02004,020041301,Comuna 4,CIUDAD DE BUENOS AIRES,357,348,479,428,907
02,02004,020041708,Comuna 4,CIUDAD DE BUENOS AIRES,358,346,498,496,994
02,02004,020040603,Comuna 4,CIUDAD DE BUENOS AIRES,285,258,400,351,751
02,02004,020040601,Comuna 4,CIUDAD DE BUENOS AIRES,431,404,598,492,1090
02,02004,020041701,Comuna 4,CIUDAD DE BUENOS AIRES,221,217,304,273,577
02,02004,020041601,Comuna 4,CIUDAD DE BUENOS AIRES,259,253,372,309,681
02,02004,020041704,Comuna 4,CIUDAD DE BUENOS AIRES,296,291,389,286,675
02,02004,020041403,Comuna 4,CIUDAD DE BUENOS AIRES,277,273,327,318,645
02,02004,020041702,Comuna 4,CIUDAD DE BUENOS AIRES,240,237,322,268,590
02,02004,020041402,Comuna 4,CIUDAD DE BUENOS AIRES,259,255,319,269,588
02,02004,020041705,Comuna 4,CIUDAD DE BUENOS AIRES,328,328,416,343,759
02,02004,020041602,Comuna 4,CIUDAD DE BUENOS AIRES,929,879,1067,866,1933
02,02004,020040711,Comuna 4,CIUDAD DE BUENOS AIRES,212,188,781,496,1277
02,02004,020040712,Comuna 4,CIUDAD DE BUENOS AIRES,272,234,405,461,866
02,02004,020041710,Comuna 4,CIUDAD DE BUENOS AIRES,280,261,456,425,881
02,02004,020041401,Comuna 4,CIUDAD DE BUENOS AIRES,272,263,315,320,635
02,02004,020041706,Comuna 4,CIUDAD DE BUENOS AIRES,280,276,336,271,607
02,02004,020040703,Comuna 4,CIUDAD DE BUENOS AIRES,302,238,508,430,938
02,02004,020041407,Comuna 4,CIUDAD DE BUENOS AIRES,289,281,406,351,757
02,02004,020041709,Comuna 4,CIUDAD DE BUENOS AIRES,337,331,425,332,757
02,02004,020041707,Comuna 4,CIUDAD DE BUENOS AIRES,255,255,328,281,609
02,02004,020041703,Comuna 4,CIUDAD DE BUENOS AIRES,217,215,311,273,584
02,02004,020041404,Comuna 4,CIUDAD DE BUENOS AIRES,495,493,608,502,1110
02,02004,020040702,Comuna 4,CIUDAD DE BUENOS AIRES,290,263,400,356,756
02,02004,020041608,Comuna 4,CIUDAD DE BUENOS AIRES,219,212,314,297,611
02,02004,020040704,Comuna 4,CIUDAD DE BUENOS AIRES,814,750,1261,898,2159
02,02004,020041405,Comuna 4,CIUDAD DE BUENOS AIRES,302,288,375,294,669
02,02004,020041603,Comuna 4,CIUDAD DE BUENOS AIRES,438,426,688,557,1245
02,02004,020041501,Comuna 4,CIUDAD DE BUENOS AIRES,259,255,344,295,639
02,02004,020040608,Comuna 4,CIUDAD DE BUENOS AIRES,317,301,503,417,920
02,02004,020041409,Comuna 4,CIUDAD DE BUENOS AIRES,262,250,338,326,664
02,02004,020040606,Comuna 4,CIUDAD DE BUENOS AIRES,375,369,521,408,929
02,02004,020041406,Comuna 4,CIUDAD DE BUENOS AIRES,208,207,266,231,497
02,02004,020041610,Comuna 4,CIUDAD DE BUENOS AIRES,280,273,425,361,786
02,02004,020040705,Comuna 4,CIUDAD DE BUENOS AIRES,297,293,414,349,763
02,02004,020040602,Comuna 4,CIUDAD DE BUENOS AIRES,320,292,426,361,787
02,02004,020041904,Comuna 4,CIUDAD DE BUENOS AIRES,375,332,608,526,1134
02,02004,020041605,Comuna 4,CIUDAD DE BUENOS AIRES,412,381,538,432,970
02,02004,020041201,Comuna 4,CIUDAD DE BUENOS AIRES,229,141,300,304,604
02,02004,020041502,Comuna 4,CIUDAD DE BUENOS AIRES,624,616,712,580,1292
02,02004,020040609,Comuna 4,CIUDAD DE BUENOS AIRES,274,269,388,319,707
02,02004,020041306,Comuna 4,CIUDAD DE BUENOS AIRES,204,170,291,285,576
02,02004,020041609,Comuna 4,CIUDAD DE BUENOS AIRES,431,424,573,491,1064
02,02004,020040605,Comuna 4,CIUDAD DE BUENOS AIRES,275,256,393,340,733
02,02004,020041303,Comuna 4,CIUDAD DE BUENOS AIRES,253,245,349,289,638
02,02004,020040706,Comuna 4,CIUDAD DE BUENOS AIRES,287,273,457,404,861
02,02004,020040604,Comuna 4,CIUDAD DE BUENOS AIRES,320,297,525,430,955
02,02004,020041908,Comuna 4,CIUDAD DE BUENOS AIRES,459,241,752,768,1520
02,02004,020041202,Comuna 4,CIUDAD DE BUENOS AIRES,216,188,301,239,540
02,02004,020041607,Comuna 4,CIUDAD DE BUENOS AIRES,156,147,213,188,401
02,02004,020041503,Comuna 4,CIUDAD DE BUENOS AIRES,483,481,588,476,1064
02,02004,020041903,Comuna 4,CIUDAD DE BUENOS AIRES,323,321,479,425,904
02,02004,020041302,Comuna 4,CIUDAD DE BUENOS AIRES,240,240,324,294,618
02,02004,020041901,Comuna 4,CIUDAD DE BUENOS AIRES,255,243,379,295,674
02,02004,020040710,Comuna 4,CIUDAD DE BUENOS AIRES,287,274,343,267,610
02,02004,020041606,Comuna 4,CIUDAD DE BUENOS AIRES,248,242,301,256,557
02,02004,020041504,Comuna 4,CIUDAD DE BUENOS AIRES,297,291,397,335,732
02,02004,020040709,Comuna 4,CIUDAD DE BUENOS AIRES,273,243,422,322,744
02,02004,020041304,Comuna 4,CIUDAD DE BUENOS AIRES,226,219,259,227,486
02,02004,020040504,Comuna 4,CIUDAD DE BUENOS AIRES,279,250,374,341,715
02,02004,020042007,Comuna 4,CIUDAD DE BUENOS AIRES,290,281,450,399,849
02,02004,020040610,Comuna 4,CIUDAD DE BUENOS AIRES,215,211,418,312,730
02,02004,020041902,Comuna 4,CIUDAD DE BUENOS AIRES,259,240,378,357,735
02,02004,020040708,Comuna 4,CIUDAD DE BUENOS AIRES,286,281,375,314,689
02,02004,020041305,Comuna 4,CIUDAD DE BUENOS AIRES,391,358,537,419,956
02,02004,020040502,Comuna 4,CIUDAD DE BUENOS AIRES,260,238,347,292,639
02,02004,020041905,Comuna 4,CIUDAD DE BUENOS AIRES,286,256,436,369,805
02,02004,020042006,Comuna 4,CIUDAD DE BUENOS AIRES,305,301,455,413,868
02,02004,020041308,Comuna 4,CIUDAD DE BUENOS AIRES,174,174,229,180,409
02,02004,020040707,Comuna 4,CIUDAD DE BUENOS AIRES,314,312,430,355,785
02,02004,020041203,Comuna 4,CIUDAD DE BUENOS AIRES,302,301,380,341,721
02,02004,020041907,Comuna 4,CIUDAD DE BUENOS AIRES,287,265,477,456,933
02,02004,020041506,Comuna 4,CIUDAD DE BUENOS AIRES,240,238,321,273,594
02,02004,020041505,Comuna 4,CIUDAD DE BUENOS AIRES,219,216,291,251,542
02,02004,020040806,Comuna 4,CIUDAD DE BUENOS AIRES,274,273,389,321,710
02,02004,020041906,Comuna 4,CIUDAD DE BUENOS AIRES,363,343,574,573,1147
02,02004,020040501,Comuna 4,CIUDAD DE BUENOS AIRES,369,360,482,409,891
02,02004,020040503,Comuna 4,CIUDAD DE BUENOS AIRES,331,319,452,345,797
02,02004,020042001,Comuna 4,CIUDAD DE BUENOS AIRES,324,272,464,467,931
02,02004,020042008,Comuna 4,CIUDAD DE BUENOS AIRES,243,241,421,376,797
02,02004,020041307,Comuna 4,CIUDAD DE BUENOS AIRES,400,396,511,387,898
02,02004,020040805,Comuna 4,CIUDAD DE BUENOS AIRES,268,266,324,270,594
02,02004,020040611,Comuna 4,CIUDAD DE BUENOS AIRES,246,239,357,297,654
02,02004,020041204,Comuna 4,CIUDAD DE BUENOS AIRES,371,233,516,459,975
02,02004,020041507,Comuna 4,CIUDAD DE BUENOS AIRES,274,268,352,292,644
02,02004,020041309,Comuna 4,CIUDAD DE BUENOS AIRES,170,169,232,175,407
02,02004,020040505,Comuna 4,CIUDAD DE BUENOS AIRES,203,198,250,203,453
02,02004,020040807,Comuna 4,CIUDAD DE BUENOS AIRES,837,774,1272,1192,2464
02,02004,020042004,Comuna 4,CIUDAD DE BUENOS AIRES,221,219,307,296,603
02,02004,020042009,Comuna 4,CIUDAD DE BUENOS AIRES,293,283,443,406,849
02,02004,020041909,Comuna 4,CIUDAD DE BUENOS AIRES,339,307,559,570,1129
02,02004,020040804,Comuna 4,CIUDAD DE BUENOS AIRES,293,253,395,405,800
02,02004,020040506,Comuna 4,CIUDAD DE BUENOS AIRES,349,343,494,442,936
02,02004,020042010,Comuna 4,CIUDAD DE BUENOS AIRES,364,341,612,513,1125
02,02004,020040803,Comuna 4,CIUDAD DE BUENOS AIRES,240,237,328,302,630
02,02004,020041508,Comuna 4,CIUDAD DE BUENOS AIRES,270,270,373,298,671
02,02004,020041311,Comuna 4,CIUDAD DE BUENOS AIRES,448,445,632,507,1139
02,02004,020041310,Comuna 4,CIUDAD DE BUENOS AIRES,202,200,267,224,491
02,02004,020040802,Comuna 4,CIUDAD DE BUENOS AIRES,311,306,431,336,767
02,02004,020041910,Comuna 4,CIUDAD DE BUENOS AIRES,263,257,331,313,644
02,02004,020042002,Comuna 4,CIUDAD DE BUENOS AIRES,257,244,368,337,705
02,02004,020042005,Comuna 4,CIUDAD DE BUENOS AIRES,211,210,410,346,756
02,02004,020041510,Comuna 4,CIUDAD DE BUENOS AIRES,188,181,281,246,527
02,02004,020041509,Comuna 4,CIUDAD DE BUENOS AIRES,254,243,347,316,663
02,02004,020040507,Comuna 4,CIUDAD DE BUENOS AIRES,251,232,478,356,834
02,02004,020041205,Comuna 4,CIUDAD DE BUENOS AIRES,231,215,323,292,615
02,02004,020042011,Comuna 4,CIUDAD DE BUENOS AIRES,323,317,495,418,913
02,02004,020040808,Comuna 4,CIUDAD DE BUENOS AIRES,97,96,190,215,405
02,02004,020042003,Comuna 4,CIUDAD DE BUENOS AIRES,281,254,426,423,849
02,02004,020040508,Comuna 4,CIUDAD DE BUENOS AIRES,247,241,601,481,1082
02,02004,020040809,Comuna 4,CIUDAD DE BUENOS AIRES,350,272,550,543,1093
02,02004,020040801,Comuna 4,CIUDAD DE BUENOS AIRES,304,297,392,313,705
02,02004,020040403,Comuna 4,CIUDAD DE BUENOS AIRES,320,301,488,414,902
02,02004,020042012,Comuna 4,CIUDAD DE BUENOS AIRES,471,457,648,521,1169
02,02004,020042201,Comuna 4,CIUDAD DE BUENOS AIRES,257,246,305,284,589
02,02004,020041208,Comuna 4,CIUDAD DE BUENOS AIRES,184,182,220,183,403
02,02004,020040810,Comuna 4,CIUDAD DE BUENOS AIRES,238,206,392,371,763
02,02004,020041207,Comuna 4,CIUDAD DE BUENOS AIRES,157,113,236,248,484
02,02004,020042103,Comuna 4,CIUDAD DE BUENOS AIRES,207,196,310,251,561
02,02004,020042202,Comuna 4,CIUDAD DE BUENOS AIRES,297,289,400,345,745
02,02004,020040402,Comuna 4,CIUDAD DE BUENOS AIRES,295,293,420,318,738
02,02004,020041206,Comuna 4,CIUDAD DE BUENOS AIRES,249,197,417,379,796
02,02004,020040401,Comuna 4,CIUDAD DE BUENOS AIRES,236,233,353,315,668
02,02004,020041209,Comuna 4,CIUDAD DE BUENOS AIRES,312,302,423,316,739
02,02004,020042102,Comuna 4,CIUDAD DE BUENOS AIRES,263,241,418,381,799
02,02004,020040811,Comuna 4,CIUDAD DE BUENOS AIRES,281,254,468,431,899
02,02004,020042101,Comuna 4,CIUDAD DE BUENOS AIRES,245,237,366,337,703
02,02004,020040308,Comuna 4,CIUDAD DE BUENOS AIRES,275,263,428,416,844
02,02004,020041210,Comuna 4,CIUDAD DE BUENOS AIRES,284,265,457,427,884
02,02004,020042203,Comuna 4,CIUDAD DE BUENOS AIRES,352,346,479,407,886
02,02004,020040307,Comuna 4,CIUDAD DE BUENOS AIRES,229,212,338,348,686
02,02004,020042104,Comuna 4,CIUDAD DE BUENOS AIRES,249,235,381,386,767
02,02004,020040404,Comuna 4,CIUDAD DE BUENOS AIRES,330,320,518,523,1041
02,02004,020040405,Comuna 4,CIUDAD DE BUENOS AIRES,366,358,519,497,1016
02,02004,020040306,Comuna 4,CIUDAD DE BUENOS AIRES,296,272,481,421,902
02,02004,020041001,Comuna 4,CIUDAD DE BUENOS AIRES,23,11,44,29,73
02,02004,020040305,Comuna 4,CIUDAD DE BUENOS AIRES,361,319,559,502,1061
02,02004,020041211,Comuna 4,CIUDAD DE BUENOS AIRES,260,256,355,277,632
02,02004,020042105,Comuna 4,CIUDAD DE BUENOS AIRES,238,236,351,304,655
02,02004,020042205,Comuna 4,CIUDAD DE BUENOS AIRES,284,265,410,355,765
02,02004,020040309,Comuna 4,CIUDAD DE BUENOS AIRES,183,172,310,265,575
02,02004,020040301,Comuna 4,CIUDAD DE BUENOS AIRES,342,319,542,432,974
02,02004,020042106,Comuna 4,CIUDAD DE BUENOS AIRES,270,262,381,351,732
02,02004,020040406,Comuna 4,CIUDAD DE BUENOS AIRES,286,273,425,370,795
02,02004,020042204,Comuna 4,CIUDAD DE BUENOS AIRES,495,486,722,583,1305
02,02004,020040310,Comuna 4,CIUDAD DE BUENOS AIRES,293,271,445,377,822
02,02004,020040509,Comuna 4,CIUDAD DE BUENOS AIRES,634,590,1134,1028,2162
02,02004,020042109,Comuna 4,CIUDAD DE BUENOS AIRES,253,234,419,416,835
02,02004,020042108,Comuna 4,CIUDAD DE BUENOS AIRES,294,290,511,470,981
02,02004,020040407,Comuna 4,CIUDAD DE BUENOS AIRES,329,321,464,422,886
02,02004,020042206,Comuna 4,CIUDAD DE BUENOS AIRES,255,254,332,267,599
02,02004,020041212,Comuna 4,CIUDAD DE BUENOS AIRES,223,210,299,274,573
02,02004,020042107,Comuna 4,CIUDAD DE BUENOS AIRES,275,246,442,396,838
02,02004,020040304,Comuna 4,CIUDAD DE BUENOS AIRES,298,290,464,440,904
02,02004,020040408,Comuna 4,CIUDAD DE BUENOS AIRES,288,261,403,377,780
02,02004,020042110,Comuna 4,CIUDAD DE BUENOS AIRES,234,225,362,371,733
02,02004,020040311,Comuna 4,CIUDAD DE BUENOS AIRES,307,291,490,430,920
02,02004,020040409,Comuna 4,CIUDAD DE BUENOS AIRES,285,255,464,386,850
02,02004,020042208,Comuna 4,CIUDAD DE BUENOS AIRES,363,348,524,463,987
02,02004,020040302,Comuna 4,CIUDAD DE BUENOS AIRES,297,281,433,416,849
02,02004,020042207,Comuna 4,CIUDAD DE BUENOS AIRES,402,378,492,411,903
02,02004,020042305,Comuna 4,CIUDAD DE BUENOS AIRES,227,212,296,247,543
02,02004,020042111,Comuna 4,CIUDAD DE BUENOS AIRES,281,254,450,462,912
02,02004,020040312,Comuna 4,CIUDAD DE BUENOS AIRES,341,321,549,516,1065
02,02004,020040510,Comuna 4,CIUDAD DE BUENOS AIRES,397,357,649,609,1258
02,02004,020040303,Comuna 4,CIUDAD DE BUENOS AIRES,221,206,345,298,643
02,02004,020040511,Comuna 4,CIUDAD DE BUENOS AIRES,340,304,513,503,1016
02,02004,020042304,Comuna 4,CIUDAD DE BUENOS AIRES,265,258,442,385,827
02,02004,020040101,Comuna 4,CIUDAD DE BUENOS AIRES,247,184,410,360,770
02,02004,020040411,Comuna 4,CIUDAD DE BUENOS AIRES,344,277,521,439,960
02,02004,020042112,Comuna 4,CIUDAD DE BUENOS AIRES,190,185,296,261,557
02,02004,020042209,Comuna 4,CIUDAD DE BUENOS AIRES,259,239,374,311,685
02,02004,020042303,Comuna 4,CIUDAD DE BUENOS AIRES,258,243,429,390,819
02,02004,020042301,Comuna 4,CIUDAD DE BUENOS AIRES,272,261,433,401,834
02,02004,020041101,Comuna 4,CIUDAD DE BUENOS AIRES,293,209,454,408,862
02,02004,020042210,Comuna 4,CIUDAD DE BUENOS AIRES,229,226,311,252,563
02,02004,020040313,Comuna 4,CIUDAD DE BUENOS AIRES,197,170,311,279,590
02,02004,020040102,Comuna 4,CIUDAD DE BUENOS AIRES,263,196,402,393,795
02,02004,020040103,Comuna 4,CIUDAD DE BUENOS AIRES,215,160,331,304,635
02,02004,020041002,Comuna 4,CIUDAD DE BUENOS AIRES,661,533,1008,927,1935
02,02004,020040410,Comuna 4,CIUDAD DE BUENOS AIRES,273,261,343,318,661
02,02004,020042603,Comuna 4,CIUDAD DE BUENOS AIRES,340,189,627,592,1219
02,02004,020042211,Comuna 4,CIUDAD DE BUENOS AIRES,290,254,380,348,728
02,02004,020041005,Comuna 4,CIUDAD DE BUENOS AIRES,519,436,863,796,1659
02,02004,020040210,Comuna 4,CIUDAD DE BUENOS AIRES,316,273,538,513,1051
02,02004,020042306,Comuna 4,CIUDAD DE BUENOS AIRES,304,299,376,319,695
02,02004,020042302,Comuna 4,CIUDAD DE BUENOS AIRES,288,275,444,429,873
02,02004,020042212,Comuna 4,CIUDAD DE BUENOS AIRES,218,196,305,300,605
02,02004,020042308,Comuna 4,CIUDAD DE BUENOS AIRES,288,286,453,392,845
02,02004,020041102,Comuna 4,CIUDAD DE BUENOS AIRES,327,306,463,384,847
02,02004,020042307,Comuna 4,CIUDAD DE BUENOS AIRES,233,225,356,297,653
02,02004,020041003,Comuna 4,CIUDAD DE BUENOS AIRES,507,466,841,812,1653
02,02004,020040207,Comuna 4,CIUDAD DE BUENOS AIRES,314,293,461,438,899
02,02004,020041105,Comuna 4,CIUDAD DE BUENOS AIRES,185,161,241,215,456
02,02004,020042311,Comuna 4,CIUDAD DE BUENOS AIRES,206,181,282,291,573
02,02004,020040209,Comuna 4,CIUDAD DE BUENOS AIRES,209,204,326,295,621
02,02004,020040108,Comuna 4,CIUDAD DE BUENOS AIRES,225,218,348,337,685
02,02004,020040208,Comuna 4,CIUDAD DE BUENOS AIRES,189,176,262,258,520
02,02004,020040203,Comuna 4,CIUDAD DE BUENOS AIRES,383,357,571,478,1049
02,02004,020040201,Comuna 4,CIUDAD DE BUENOS AIRES,274,269,409,344,753
02,02004,020041104,Comuna 4,CIUDAD DE BUENOS AIRES,250,247,360,283,643
02,02004,020040904,Comuna 4,CIUDAD DE BUENOS AIRES,176,145,281,222,503
02,02004,020042602,Comuna 4,CIUDAD DE BUENOS AIRES,283,245,624,604,1228
02,02004,020041004,Comuna 4,CIUDAD DE BUENOS AIRES,124,105,235,229,464
02,02004,020040104,Comuna 4,CIUDAD DE BUENOS AIRES,236,175,402,399,801
02,02004,020041103,Comuna 4,CIUDAD DE BUENOS AIRES,282,274,415,370,785
02,02004,020042503,Comuna 4,CIUDAD DE BUENOS AIRES,1093,804,1933,2012,3945
02,02004,020042310,Comuna 4,CIUDAD DE BUENOS AIRES,259,226,419,385,804
02,02004,020040206,Comuna 4,CIUDAD DE BUENOS AIRES,257,248,370,313,683
02,02004,020042601,Comuna 4,CIUDAD DE BUENOS AIRES,261,117,505,503,1008
02,02004,020040109,Comuna 4,CIUDAD DE BUENOS AIRES,224,176,334,316,650
02,02004,020040202,Comuna 4,CIUDAD DE BUENOS AIRES,282,272,463,363,826
02,02004,020041008,Comuna 4,CIUDAD DE BUENOS AIRES,492,402,808,794,1602
02,02004,020041007,Comuna 4,CIUDAD DE BUENOS AIRES,273,232,468,433,901
02,02004,020042309,Comuna 4,CIUDAD DE BUENOS AIRES,150,121,245,226,471
02,02004,020041006,Comuna 4,CIUDAD DE BUENOS AIRES,306,259,525,479,1004
02,02004,020041106,Comuna 4,CIUDAD DE BUENOS AIRES,320,267,497,467,964
02,02004,020040105,Comuna 4,CIUDAD DE BUENOS AIRES,234,163,416,408,824
02,02004,020040903,Comuna 4,CIUDAD DE BUENOS AIRES,186,159,274,262,536
02,02004,020040110,Comuna 4,CIUDAD DE BUENOS AIRES,157,148,248,243,491
02,02004,020042504,Comuna 4,CIUDAD DE BUENOS AIRES,573,440,963,1065,2028
02,02004,020040205,Comuna 4,CIUDAD DE BUENOS AIRES,231,212,395,343,738
02,02004,020041108,Comuna 4,CIUDAD DE BUENOS AIRES,313,285,456,466,922
02,02004,020042402,Comuna 4,CIUDAD DE BUENOS AIRES,538,493,903,949,1852
02,02004,020041107,Comuna 4,CIUDAD DE BUENOS AIRES,328,296,543,506,1049
02,02004,020041009,Comuna 4,CIUDAD DE BUENOS AIRES,624,559,1057,1034,2091
02,02004,020040204,Comuna 4,CIUDAD DE BUENOS AIRES,273,239,420,376,796
02,02004,020042312,Comuna 4,CIUDAD DE BUENOS AIRES,232,201,403,377,780
02,02004,020040107,Comuna 4,CIUDAD DE BUENOS AIRES,168,151,285,233,518
02,02004,020040111,Comuna 4,CIUDAD DE BUENOS AIRES,200,167,318,275,593
02,02004,020040106,Comuna 4,CIUDAD DE BUENOS AIRES,206,118,371,354,725
02,02004,020040905,Comuna 4,CIUDAD DE BUENOS AIRES,189,189,288,249,537
02,02004,020042401,Comuna 4,CIUDAD DE BUENOS AIRES,415,371,712,684,1396
02,02004,020040112,Comuna 4,CIUDAD DE BUENOS AIRES,183,171,278,251,529
02,02004,020040902,Comuna 4,CIUDAD DE BUENOS AIRES,254,225,406,359,765
02,02004,020041109,Comuna 4,CIUDAD DE BUENOS AIRES,269,230,450,435,885
02,02004,020042502,Comuna 4,CIUDAD DE BUENOS AIRES,624,474,1116,1099,2215
02,02004,020040901,Comuna 4,CIUDAD DE BUENOS AIRES,463,260,755,740,1495
02,02004,020042403,Comuna 4,CIUDAD DE BUENOS AIRES,373,305,622,598,1220
02,02004,020040114,Comuna 4,CIUDAD DE BUENOS AIRES,236,204,397,352,749
02,02004,020040906,Comuna 4,CIUDAD DE BUENOS AIRES,279,276,466,373,839
02,02004,020040113,Comuna 4,CIUDAD DE BUENOS AIRES,136,127,215,190,405
02,02004,020040907,Comuna 4,CIUDAD DE BUENOS AIRES,263,249,410,372,782
02,02004,020042404,Comuna 4,CIUDAD DE BUENOS AIRES,534,467,955,974,1929
02,02004,020042405,Comuna 4,CIUDAD DE BUENOS AIRES,406,189,696,654,1350
02,02004,020042501,Comuna 4,CIUDAD DE BUENOS AIRES,688,580,1164,1193,2357
02,02004,020042406,Comuna 4,CIUDAD DE BUENOS AIRES,377,340,726,691,1417
06,06515,065151410,Malvinas Argentinas,BUENOS AIRES,384,396,671,680,1351
06,06515,065152102,Malvinas Argentinas,BUENOS AIRES,146,207,288,288,576
06,06515,065150203,Malvinas Argentinas,BUENOS AIRES,176,179,294,282,576
06,06515,065150205,Malvinas Argentinas,BUENOS AIRES,194,195,370,355,725
06,06515,065150206,Malvinas Argentinas,BUENOS AIRES,200,289,300,314,614
06,06515,065150207,Malvinas Argentinas,BUENOS AIRES,406,385,747,763,1510
06,06515,065150210,Malvinas Argentinas,BUENOS AIRES,518,535,938,1008,1946
06,06515,065150212,Malvinas Argentinas,BUENOS AIRES,283,248,592,578,1170
06,06515,065150214,Malvinas Argentinas,BUENOS AIRES,429,386,891,906,1797
06,06515,065150311,Malvinas Argentinas,BUENOS AIRES,280,290,469,459,928
06,06515,065150401,Malvinas Argentinas,BUENOS AIRES,342,342,621,596,1217
06,06515,065150505,Malvinas Argentinas,BUENOS AIRES,302,308,491,452,943
06,06515,065150606,Malvinas Argentinas,BUENOS AIRES,395,364,638,581,1219
06,06515,065150608,Malvinas Argentinas,BUENOS AIRES,275,280,504,465,969
06,06515,065150610,Malvinas Argentinas,BUENOS AIRES,250,263,485,453,938
06,06515,065150705,Malvinas Argentinas,BUENOS AIRES,287,256,545,516,1061
06,06515,065150910,Malvinas Argentinas,BUENOS AIRES,451,438,782,749,1531
06,06515,065151005,Malvinas Argentinas,BUENOS AIRES,302,323,471,410,881
06,06515,065151010,Malvinas Argentinas,BUENOS AIRES,234,238,382,384,766
06,06515,065151011,Malvinas Argentinas,BUENOS AIRES,232,238,434,419,853
06,06515,065151014,Malvinas Argentinas,BUENOS AIRES,337,338,604,570,1174
06,06515,065151015,Malvinas Argentinas,BUENOS AIRES,290,304,470,443,913
06,06515,065152001,Malvinas Argentinas,BUENOS AIRES,506,474,896,855,1751
06,06515,065152015,Malvinas Argentinas,BUENOS AIRES,427,402,769,692,1461
06,06515,065152107,Malvinas Argentinas,BUENOS AIRES,216,211,389,336,725
06,06515,065152109,Malvinas Argentinas,BUENOS AIRES,363,353,668,615,1283
06,06515,065152111,Malvinas Argentinas,BUENOS AIRES,299,322,500,487,987
06,06515,065151911,Malvinas Argentinas,BUENOS AIRES,502,493,958,893,1851
06,06515,065152007,Malvinas Argentinas,BUENOS AIRES,249,249,455,434,889
06,06515,065152011,Malvinas Argentinas,BUENOS AIRES,232,234,408,370,778
06,06515,065150103,Malvinas Argentinas,BUENOS AIRES,468,431,949,950,1899
06,06515,065150111,Malvinas Argentinas,BUENOS AIRES,426,429,887,893,1780
06,06515,065150113,Malvinas Argentinas,BUENOS AIRES,579,527,1144,1143,2287
06,06515,065150211,Malvinas Argentinas,BUENOS AIRES,351,400,645,645,1290
06,06515,065150303,Malvinas Argentinas,BUENOS AIRES,368,328,703,760,1463
06,06515,065150308,Malvinas Argentinas,BUENOS AIRES,277,273,450,433,883
06,06515,065150309,Malvinas Argentinas,BUENOS AIRES,253,251,495,500,995
06,06515,065150313,Malvinas Argentinas,BUENOS AIRES,229,249,384,378,762
06,06515,065150410,Malvinas Argentinas,BUENOS AIRES,289,276,504,534,1038
06,06515,065150508,Malvinas Argentinas,BUENOS AIRES,214,214,413,330,743
06,06515,065150512,Malvinas Argentinas,BUENOS AIRES,479,477,772,739,1511
06,06515,065150612,Malvinas Argentinas,BUENOS AIRES,227,239,383,379,762
06,06515,065150903,Malvinas Argentinas,BUENOS AIRES,267,279,464,492,956
06,06515,065150913,Malvinas Argentinas,BUENOS AIRES,434,420,798,755,1553
06,06515,065151007,Malvinas Argentinas,BUENOS AIRES,80,186,139,160,299
06,06515,065151008,Malvinas Argentinas,BUENOS AIRES,413,415,700,681,1381
06,06515,065151108,Malvinas Argentinas,BUENOS AIRES,261,237,487,465,952
06,06515,065151201,Malvinas Argentinas,BUENOS AIRES,237,225,458,436,894
06,06515,065151302,Malvinas Argentinas,BUENOS AIRES,333,334,585,614,1199
06,06515,065151401,Malvinas Argentinas,BUENOS AIRES,284,286,595,631,1226
06,06515,065151403,Malvinas Argentinas,BUENOS AIRES,345,337,705,715,1420
06,06515,065151408,Malvinas Argentinas,BUENOS AIRES,488,435,886,901,1787
06,06515,065151411,Malvinas Argentinas,BUENOS AIRES,310,264,530,577,1107
06,06515,065151504,Malvinas Argentinas,BUENOS AIRES,356,386,654,683,1337
06,06515,065151701,Malvinas Argentinas,BUENOS AIRES,363,408,615,644,1259
06,06515,065150209,Malvinas Argentinas,BUENOS AIRES,355,360,645,634,1279
06,06515,065152113,Malvinas Argentinas,BUENOS AIRES,298,326,577,456,1033
06,06515,065150108,Malvinas Argentinas,BUENOS AIRES,498,493,1022,990,2012
06,06515,065150109,Malvinas Argentinas,BUENOS AIRES,276,238,535,511,1046
06,06515,065150201,Malvinas Argentinas,BUENOS AIRES,90,97,125,150,275
06,06515,065150406,Malvinas Argentinas,BUENOS AIRES,416,328,823,782,1605
06,06515,065150411,Malvinas Argentinas,BUENOS AIRES,187,167,382,421,803
06,06515,065150504,Malvinas Argentinas,BUENOS AIRES,458,392,829,801,1630
06,06515,065150609,Malvinas Argentinas,BUENOS AIRES,436,410,786,714,1500
06,06515,065150702,Malvinas Argentinas,BUENOS AIRES,323,337,596,605,1201
06,06515,065150708,Malvinas Argentinas,BUENOS AIRES,394,338,767,739,1506
06,06515,065150905,Malvinas Argentinas,BUENOS AIRES,424,426,749,679,1428
06,06515,065151106,Malvinas Argentinas,BUENOS AIRES,241,249,410,396,806
06,06515,065151105,Malvinas Argentinas,BUENOS AIRES,229,231,380,344,724
06,06515,065151107,Malvinas Argentinas,BUENOS AIRES,248,270,413,379,792
06,06515,065151206,Malvinas Argentinas,BUENOS AIRES,287,288,512,468,980
06,06515,065151209,Malvinas Argentinas,BUENOS AIRES,420,428,811,729,1540
06,06515,065151212,Malvinas Argentinas,BUENOS AIRES,344,303,594,567,1161
06,06515,065151314,Malvinas Argentinas,BUENOS AIRES,263,274,491,464,955
06,06515,065151407,Malvinas Argentinas,BUENOS AIRES,235,207,468,431,899
06,06515,065151507,Malvinas Argentinas,BUENOS AIRES,409,375,749,736,1485
06,06515,065151601,Malvinas Argentinas,BUENOS AIRES,294,333,449,426,875
06,06515,065151609,Malvinas Argentinas,BUENOS AIRES,268,299,445,457,902
06,06515,065151702,Malvinas Argentinas,BUENOS AIRES,365,407,644,607,1251
06,06515,065150703,Malvinas Argentinas,BUENOS AIRES,284,264,547,552,1099
06,06515,065150909,Malvinas Argentinas,BUENOS AIRES,419,408,700,679,1379
06,06515,065151902,Malvinas Argentinas,BUENOS AIRES,295,289,593,548,1141
06,06515,065151912,Malvinas Argentinas,BUENOS AIRES,257,244,476,456,932
06,06515,065152003,Malvinas Argentinas,BUENOS AIRES,323,273,622,597,1219
06,06515,065152004,Malvinas Argentinas,BUENOS AIRES,257,224,483,507,990
06,06515,065152006,Malvinas Argentinas,BUENOS AIRES,233,228,399,401,800
06,06515,065152008,Malvinas Argentinas,BUENOS AIRES,315,327,594,618,1212
06,06515,065152014,Malvinas Argentinas,BUENOS AIRES,485,444,921,925,1846
06,06515,065152104,Malvinas Argentinas,BUENOS AIRES,227,234,419,425,844
06,06515,065152106,Malvinas Argentinas,BUENOS AIRES,294,269,488,411,899
06,06515,065152112,Malvinas Argentinas,BUENOS AIRES,252,257,517,521,1038
06,06515,065152114,Malvinas Argentinas,BUENOS AIRES,224,229,389,397,786
06,06515,065150204,Malvinas Argentinas,BUENOS AIRES,33,30,49,65,114
06,06515,065150405,Malvinas Argentinas,BUENOS AIRES,275,296,489,482,971
06,06515,065150501,Malvinas Argentinas,BUENOS AIRES,241,214,460,473,933
06,06515,065150611,Malvinas Argentinas,BUENOS AIRES,206,216,355,361,716
06,06515,065150704,Malvinas Argentinas,BUENOS AIRES,537,470,1050,1066,2116
06,06515,065150709,Malvinas Argentinas,BUENOS AIRES,464,429,803,838,1641
06,06515,065150711,Malvinas Argentinas,BUENOS AIRES,169,146,347,332,679
06,06515,065150802,Malvinas Argentinas,BUENOS AIRES,312,310,513,523,1036
06,06515,065150806,Malvinas Argentinas,BUENOS AIRES,243,229,458,436,894
06,06515,065150807,Malvinas Argentinas,BUENOS AIRES,362,366,587,579,1166
06,06515,065150901,Malvinas Argentinas,BUENOS AIRES,255,274,434,394,828
06,06515,065151003,Malvinas Argentinas,BUENOS AIRES,416,413,726,637,1363
06,06515,065151004,Malvinas Argentinas,BUENOS AIRES,273,295,428,365,793
06,06515,065151113,Malvinas Argentinas,BUENOS AIRES,301,298,552,535,1087
06,06515,065151207,Malvinas Argentinas,BUENOS AIRES,485,409,839,800,1639
06,06515,065151208,Malvinas Argentinas,BUENOS AIRES,251,198,462,438,900
06,06515,065151304,Malvinas Argentinas,BUENOS AIRES,305,309,557,543,1100
06,06515,065151306,Malvinas Argentinas,BUENOS AIRES,462,473,820,765,1585
06,06515,065151309,Malvinas Argentinas,BUENOS AIRES,444,464,795,734,1529
06,06515,065151313,Malvinas Argentinas,BUENOS AIRES,321,339,526,491,1017
06,06515,065151409,Malvinas Argentinas,BUENOS AIRES,241,240,469,417,886
06,06515,065151503,Malvinas Argentinas,BUENOS AIRES,362,333,700,694,1394
06,06515,065151506,Malvinas Argentinas,BUENOS AIRES,350,361,732,726,1458
06,06515,065151510,Malvinas Argentinas,BUENOS AIRES,380,343,751,721,1472
06,06515,065151512,Malvinas Argentinas,BUENOS AIRES,328,288,603,541,1144
06,06515,065151602,Malvinas Argentinas,BUENOS AIRES,294,323,515,517,1032
06,06515,065151606,Malvinas Argentinas,BUENOS AIRES,293,339,577,504,1081
06,06515,065150302,Malvinas Argentinas,BUENOS AIRES,368,357,759,729,1488
06,06515,065150506,Malvinas Argentinas,BUENOS AIRES,357,384,625,570,1195
06,06515,065150706,Malvinas Argentinas,BUENOS AIRES,340,350,614,581,1195
06,06515,065151708,Malvinas Argentinas,BUENOS AIRES,139,176,250,254,504
06,06515,065151803,Malvinas Argentinas,BUENOS AIRES,388,398,762,804,1566
06,06515,065151805,Malvinas Argentinas,BUENOS AIRES,299,283,647,687,1334
06,06515,065151904,Malvinas Argentinas,BUENOS AIRES,416,384,824,860,1684
06,06515,065151914,Malvinas Argentinas,BUENOS AIRES,260,176,474,426,900
06,06515,065152009,Malvinas Argentinas,BUENOS AIRES,330,283,689,618,1307
06,06515,065152013,Malvinas Argentinas,BUENOS AIRES,419,353,758,722,1480
06,06515,065151204,Malvinas Argentinas,BUENOS AIRES,233,185,450,456,906
06,06515,065151210,Malvinas Argentinas,BUENOS AIRES,291,244,538,511,1049
06,06515,065151211,Malvinas Argentinas,BUENOS AIRES,353,266,631,625,1256
06,06515,065151213,Malvinas Argentinas,BUENOS AIRES,280,210,544,538,1082
06,06515,065151216,Malvinas Argentinas,BUENOS AIRES,300,254,516,536,1052
06,06515,065151307,Malvinas Argentinas,BUENOS AIRES,258,297,400,397,797
06,06515,065151308,Malvinas Argentinas,BUENOS AIRES,305,319,492,449,941
06,06515,065151311,Malvinas Argentinas,BUENOS AIRES,447,463,739,666,1405
06,06515,065151502,Malvinas Argentinas,BUENOS AIRES,293,290,523,475,998
06,06515,065151511,Malvinas Argentinas,BUENOS AIRES,384,249,718,760,1478
06,06515,065151513,Malvinas Argentinas,BUENOS AIRES,395,364,697,677,1374
06,06515,065150105,Malvinas Argentinas,BUENOS AIRES,477,454,925,887,1812
06,06515,065152005,Malvinas Argentinas,BUENOS AIRES,304,271,530,529,1059
06,06515,065151804,Malvinas Argentinas,BUENOS AIRES,378,359,800,804,1604
06,06515,065151809,Malvinas Argentinas,BUENOS AIRES,235,166,408,428,836
06,06515,065151901,Malvinas Argentinas,BUENOS AIRES,451,454,857,829,1686
06,06515,065150106,Malvinas Argentinas,BUENOS AIRES,349,330,680,705,1385
06,06515,065150110,Malvinas Argentinas,BUENOS AIRES,423,401,857,909,1766
06,06515,065150112,Malvinas Argentinas,BUENOS AIRES,530,477,973,1049,2022
06,06515,065150213,Malvinas Argentinas,BUENOS AIRES,209,209,438,473,911
06,06515,065150216,Malvinas Argentinas,BUENOS AIRES,281,279,589,618,1207
06,06515,065150310,Malvinas Argentinas,BUENOS AIRES,294,287,558,520,1078
06,06515,065150403,Malvinas Argentinas,BUENOS AIRES,329,339,679,636,1315
06,06515,065150404,Malvinas Argentinas,BUENOS AIRES,196,272,351,368,719
06,06515,065150409,Malvinas Argentinas,BUENOS AIRES,318,297,623,555,1178
06,06515,065150511,Malvinas Argentinas,BUENOS AIRES,411,462,822,842,1664
06,06515,065150601,Malvinas Argentinas,BUENOS AIRES,251,232,484,522,1006
06,06515,065150607,Malvinas Argentinas,BUENOS AIRES,386,378,680,604,1284
06,06515,065150712,Malvinas Argentinas,BUENOS AIRES,466,431,816,818,1634
06,06515,065150714,Malvinas Argentinas,BUENOS AIRES,245,221,483,445,928
06,06515,065150801,Malvinas Argentinas,BUENOS AIRES,343,365,721,685,1406
06,06515,065150805,Malvinas Argentinas,BUENOS AIRES,251,236,436,391,827
06,06515,065150809,Malvinas Argentinas,BUENOS AIRES,393,352,656,635,1291
06,06515,065150904,Malvinas Argentinas,BUENOS AIRES,242,239,408,394,802
06,06515,065150906,Malvinas Argentinas,BUENOS AIRES,332,275,569,508,1077
06,06515,065150911,Malvinas Argentinas,BUENOS AIRES,293,313,482,496,978
06,06515,065150914,Malvinas Argentinas,BUENOS AIRES,356,314,659,659,1318
06,06515,065151002,Malvinas Argentinas,BUENOS AIRES,481,459,909,808,1717
06,06515,065151310,Malvinas Argentinas,BUENOS AIRES,398,397,693,592,1285
06,06515,065151402,Malvinas Argentinas,BUENOS AIRES,315,270,535,505,1040
06,06515,065151605,Malvinas Argentinas,BUENOS AIRES,239,254,394,363,757
06,06515,065151703,Malvinas Argentinas,BUENOS AIRES,194,217,290,295,585
06,06515,065151906,Malvinas Argentinas,BUENOS AIRES,240,233,475,478,953
06,06515,065151807,Malvinas Argentinas,BUENOS AIRES,349,286,713,718,1431
06,06515,065151705,Malvinas Argentinas,BUENOS AIRES,204,310,335,316,651
06,06515,065151706,Malvinas Argentinas,BUENOS AIRES,388,597,817,799,1616
06,06515,065151811,Malvinas Argentinas,BUENOS AIRES,308,218,553,595,1148
06,06515,065151903,Malvinas Argentinas,BUENOS AIRES,413,450,784,847,1631
06,06515,065151907,Malvinas Argentinas,BUENOS AIRES,511,504,967,955,1922
06,06515,065151909,Malvinas Argentinas,BUENOS AIRES,340,336,642,635,1277
06,06515,065150107,Malvinas Argentinas,BUENOS AIRES,258,257,482,461,943
06,06515,065152101,Malvinas Argentinas,BUENOS AIRES,101,199,196,223,419
06,06515,065152110,Malvinas Argentinas,BUENOS AIRES,328,326,640,572,1212
06,06515,065152115,Malvinas Argentinas,BUENOS AIRES,203,224,372,370,742
06,06515,065150215,Malvinas Argentinas,BUENOS AIRES,363,353,742,737,1479
06,06515,065150304,Malvinas Argentinas,BUENOS AIRES,369,368,671,652,1323
06,06515,065150307,Malvinas Argentinas,BUENOS AIRES,297,292,579,582,1161
06,06515,065150503,Malvinas Argentinas,BUENOS AIRES,471,377,878,854,1732
06,06515,065150507,Malvinas Argentinas,BUENOS AIRES,337,341,560,567,1127
06,06515,065150510,Malvinas Argentinas,BUENOS AIRES,96,96,161,175,336
06,06515,065150615,Malvinas Argentinas,BUENOS AIRES,233,239,381,345,726
06,06515,065150701,Malvinas Argentinas,BUENOS AIRES,525,506,967,953,1920
06,06515,065150803,Malvinas Argentinas,BUENOS AIRES,304,299,546,557,1103
06,06515,065150808,Malvinas Argentinas,BUENOS AIRES,379,409,597,581,1178
06,06515,065150912,Malvinas Argentinas,BUENOS AIRES,345,350,565,563,1128
06,06515,065151012,Malvinas Argentinas,BUENOS AIRES,162,166,313,290,603
06,06515,065151104,Malvinas Argentinas,BUENOS AIRES,230,223,398,385,783
06,06515,065151217,Malvinas Argentinas,BUENOS AIRES,231,195,428,399,827
06,06515,065151301,Malvinas Argentinas,BUENOS AIRES,317,312,559,585,1144
06,06515,065151303,Malvinas Argentinas,BUENOS AIRES,255,184,499,480,979
06,06515,065151405,Malvinas Argentinas,BUENOS AIRES,164,152,336,335,671
06,06515,065151406,Malvinas Argentinas,BUENOS AIRES,304,236,548,548,1096
06,06515,065151505,Malvinas Argentinas,BUENOS AIRES,390,304,740,743,1483
06,06515,065151604,Malvinas Argentinas,BUENOS AIRES,210,219,360,372,732
06,06515,065151607,Malvinas Argentinas,BUENOS AIRES,393,418,648,649,1297
06,06515,065151707,Malvinas Argentinas,BUENOS AIRES,320,361,546,553,1099
06,06515,065151813,Malvinas Argentinas,BUENOS AIRES,350,361,627,661,1288
06,06515,065150603,Malvinas Argentinas,BUENOS AIRES,239,216,441,426,867
06,06515,065152002,Malvinas Argentinas,BUENOS AIRES,273,252,474,481,955
06,06515,065152103,Malvinas Argentinas,BUENOS AIRES,197,236,343,329,672
06,06515,065150101,Malvinas Argentinas,BUENOS AIRES,193,188,332,346,678
06,06515,065150208,Malvinas Argentinas,BUENOS AIRES,371,465,683,649,1332
06,06515,065150305,Malvinas Argentinas,BUENOS AIRES,217,225,412,448,860
06,06515,065150407,Malvinas Argentinas,BUENOS AIRES,318,315,581,567,1148
06,06515,065150408,Malvinas Argentinas,BUENOS AIRES,355,321,731,673,1404
06,06515,065150502,Malvinas Argentinas,BUENOS AIRES,247,241,450,435,885
06,06515,065150604,Malvinas Argentinas,BUENOS AIRES,287,281,518,494,1012
06,06515,065150602,Malvinas Argentinas,BUENOS AIRES,341,366,587,527,1114
06,06515,065150616,Malvinas Argentinas,BUENOS AIRES,279,293,473,469,942
06,06515,065150707,Malvinas Argentinas,BUENOS AIRES,376,390,647,611,1258
06,06515,065150710,Malvinas Argentinas,BUENOS AIRES,255,215,491,470,961
06,06515,065150713,Malvinas Argentinas,BUENOS AIRES,263,261,455,429,884
06,06515,065150804,Malvinas Argentinas,BUENOS AIRES,263,242,446,443,889
06,06515,065150811,Malvinas Argentinas,BUENOS AIRES,351,327,655,649,1304
06,06515,065150902,Malvinas Argentinas,BUENOS AIRES,409,413,691,652,1343
06,06515,065150908,Malvinas Argentinas,BUENOS AIRES,256,251,441,429,870
06,06515,065151001,Malvinas Argentinas,BUENOS AIRES,293,260,551,547,1098
06,06515,065151006,Malvinas Argentinas,BUENOS AIRES,359,364,603,595,1198
06,06515,065151501,Malvinas Argentinas,BUENOS AIRES,424,431,696,631,1327
06,06515,065151013,Malvinas Argentinas,BUENOS AIRES,312,317,540,511,1051
06,06515,065151102,Malvinas Argentinas,BUENOS AIRES,427,489,694,635,1329
06,06515,065151110,Malvinas Argentinas,BUENOS AIRES,399,382,697,658,1355
06,06515,065151111,Malvinas Argentinas,BUENOS AIRES,243,240,447,445,892
06,06515,065151202,Malvinas Argentinas,BUENOS AIRES,252,271,422,512,934
06,06515,065151205,Malvinas Argentinas,BUENOS AIRES,296,275,584,574,1158
06,06515,065151214,Malvinas Argentinas,BUENOS AIRES,291,280,513,520,1033
06,06515,065151404,Malvinas Argentinas,BUENOS AIRES,515,443,978,1017,1995
06,06515,065151508,Malvinas Argentinas,BUENOS AIRES,400,362,732,731,1463
06,06515,065151509,Malvinas Argentinas,BUENOS AIRES,333,341,617,622,1239
06,06515,065151608,Malvinas Argentinas,BUENOS AIRES,359,407,726,692,1418
06,06515,065151109,Malvinas Argentinas,BUENOS AIRES,377,356,669,601,1270
06,06515,065151312,Malvinas Argentinas,BUENOS AIRES,363,337,686,683,1369
06,06515,065151709,Malvinas Argentinas,BUENOS AIRES,117,152,152,154,306
06,06515,065151801,Malvinas Argentinas,BUENOS AIRES,488,458,894,908,1802
06,06515,065151802,Malvinas Argentinas,BUENOS AIRES,333,286,581,555,1136
06,06515,065151806,Malvinas Argentinas,BUENOS AIRES,351,345,784,756,1540
06,06515,065151808,Malvinas Argentinas,BUENOS AIRES,309,287,580,577,1157
06,06515,065152012,Malvinas Argentinas,BUENOS AIRES,242,233,435,395,830
06,06515,065151908,Malvinas Argentinas,BUENOS AIRES,396,363,781,736,1517
06,06515,065151910,Malvinas Argentinas,BUENOS AIRES,448,434,847,831,1678
06,06515,065151913,Malvinas Argentinas,BUENOS AIRES,151,163,284,308,592
06,06515,065152010,Malvinas Argentinas,BUENOS AIRES,466,444,832,837,1669
06,06515,065152105,Malvinas Argentinas,BUENOS AIRES,255,259,470,462,932
06,06515,065152108,Malvinas Argentinas,BUENOS AIRES,274,253,512,512,1024
06,06515,065150102,Malvinas Argentinas,BUENOS AIRES,1,1,1,1,2
06,06515,065150202,Malvinas Argentinas,BUENOS AIRES,318,317,574,535,1109
06,06515,065150301,Malvinas Argentinas,BUENOS AIRES,368,312,703,661,1364
06,06515,065150306,Malvinas Argentinas,BUENOS AIRES,291,291,567,570,1137
06,06515,065150312,Malvinas Argentinas,BUENOS AIRES,306,289,587,547,1134
06,06515,065150314,Malvinas Argentinas,BUENOS AIRES,289,297,473,471,944
06,06515,065150402,Malvinas Argentinas,BUENOS AIRES,319,231,551,555,1106
06,06515,065150509,Malvinas Argentinas,BUENOS AIRES,339,325,612,584,1196
06,06515,065150605,Malvinas Argentinas,BUENOS AIRES,194,164,340,306,646
06,06515,065150613,Malvinas Argentinas,BUENOS AIRES,194,182,318,306,624
06,06515,065150614,Malvinas Argentinas,BUENOS AIRES,310,251,544,476,1020
06,06515,065150810,Malvinas Argentinas,BUENOS AIRES,348,303,608,604,1212
06,06515,065150812,Malvinas Argentinas,BUENOS AIRES,318,347,513,501,1014
06,06515,065150907,Malvinas Argentinas,BUENOS AIRES,209,232,413,347,760
06,06515,065151009,Malvinas Argentinas,BUENOS AIRES,322,321,588,611,1199
06,06515,065151101,Malvinas Argentinas,BUENOS AIRES,354,390,586,528,1114
06,06515,065151103,Malvinas Argentinas,BUENOS AIRES,393,381,674,611,1285
06,06515,065151112,Malvinas Argentinas,BUENOS AIRES,249,235,480,444,924
06,06515,065151203,Malvinas Argentinas,BUENOS AIRES,286,229,609,602,1211
06,06515,065151215,Malvinas Argentinas,BUENOS AIRES,278,245,483,492,975
06,06515,065151305,Malvinas Argentinas,BUENOS AIRES,487,518,744,695,1439
06,06515,065151603,Malvinas Argentinas,BUENOS AIRES,235,273,441,414,855
06,06515,065150104,Malvinas Argentinas,BUENOS AIRES,462,385,829,872,1701
06,06515,065151704,Malvinas Argentinas,BUENOS AIRES,173,268,277,325,602
06,06515,065151710,Malvinas Argentinas,BUENOS AIRES,334,360,622,608,1230
06,06515,065151810,Malvinas Argentinas,BUENOS AIRES,319,264,602,576,1178
06,06515,065151812,Malvinas Argentinas,BUENOS AIRES,402,358,757,787,1544
06,06515,065151905,Malvinas Argentinas,BUENOS AIRES,300,271,614,605,1219
06,06140,061400306,Capitán Sarmiento,BUENOS AIRES,236,248,408,437,845
06,06140,061400308,Capitán Sarmiento,BUENOS AIRES,308,356,495,425,920
06,06140,061400304,Capitán Sarmiento,BUENOS AIRES,275,292,418,368,786
06,06140,061400502,Capitán Sarmiento,BUENOS AIRES,14,23,21,24,45
06,06140,061400103,Capitán Sarmiento,BUENOS AIRES,29,41,44,50,94
06,06140,061400201,Capitán Sarmiento,BUENOS AIRES,9,21,11,13,24
06,06140,061400503,Capitán Sarmiento,BUENOS AIRES,14,20,15,20,35
06,06140,061400601,Capitán Sarmiento,BUENOS AIRES,6,6,7,9,16
06,06140,061400309,Capitán Sarmiento,BUENOS AIRES,251,279,404,389,793
06,06140,061400303,Capitán Sarmiento,BUENOS AIRES,284,288,448,439,887
06,06140,061400307,Capitán Sarmiento,BUENOS AIRES,299,320,445,407,852
06,06140,061400315,Capitán Sarmiento,BUENOS AIRES,350,398,573,522,1095
06,06140,061400318,Capitán Sarmiento,BUENOS AIRES,251,264,424,403,827
06,06140,061400203,Capitán Sarmiento,BUENOS AIRES,20,33,21,46,67
06,06140,061400402,Capitán Sarmiento,BUENOS AIRES,23,37,33,36,69
06,06140,061400401,Capitán Sarmiento,BUENOS AIRES,82,108,114,116,230
06,06140,061400101,Capitán Sarmiento,BUENOS AIRES,36,35,53,66,119
06,06140,061400312,Capitán Sarmiento,BUENOS AIRES,18,36,24,31,55
06,06140,061400403,Capitán Sarmiento,BUENOS AIRES,30,29,30,38,68
06,06140,061400302,Capitán Sarmiento,BUENOS AIRES,401,433,649,571,1220
06,06140,061400319,Capitán Sarmiento,BUENOS AIRES,279,300,423,433,856
06,06140,061400313,Capitán Sarmiento,BUENOS AIRES,13,25,13,16,29
06,06140,061400501,Capitán Sarmiento,BUENOS AIRES,19,23,24,44,68
06,06140,061400310,Capitán Sarmiento,BUENOS AIRES,192,212,361,349,710
06,06140,061400102,Capitán Sarmiento,BUENOS AIRES,17,22,23,24,47
06,06140,061400314,Capitán Sarmiento,BUENOS AIRES,11,26,12,25,37
06,06140,061400204,Capitán Sarmiento,BUENOS AIRES,19,23,25,24,49
06,06140,061400301,Capitán Sarmiento,BUENOS AIRES,217,222,351,338,689
06,06140,061400317,Capitán Sarmiento,BUENOS AIRES,273,305,422,347,769
06,06140,061400202,Capitán Sarmiento,BUENOS AIRES,15,36,15,17,32
06,06140,061400305,Capitán Sarmiento,BUENOS AIRES,326,385,494,417,911
06,06140,061400316,Capitán Sarmiento,BUENOS AIRES,338,351,613,584,1197
06,06140,061400311,Capitán Sarmiento,BUENOS AIRES,17,30,23,30,53
06,06147,061470103,Carlos Casares,BUENOS AIRES,240,292,309,260,569
06,06147,061470104,Carlos Casares,BUENOS AIRES,280,288,432,403,835
06,06147,061470201,Carlos Casares,BUENOS AIRES,167,209,224,241,465
06,06147,061470501,Carlos Casares,BUENOS AIRES,497,520,881,846,1727
06,06147,061470901,Carlos Casares,BUENOS AIRES,74,89,103,111,214
06,06147,061471204,Carlos Casares,BUENOS AIRES,245,267,339,336,675
06,06147,061470701,Carlos Casares,BUENOS AIRES,228,303,354,347,701
06,06147,061471201,Carlos Casares,BUENOS AIRES,349,397,448,428,876
06,06147,061471206,Carlos Casares,BUENOS AIRES,252,323,334,279,613
06,06147,061471207,Carlos Casares,BUENOS AIRES,285,331,377,338,715
06,06147,061470401,Carlos Casares,BUENOS AIRES,8,22,9,12,21
06,06147,061470402,Carlos Casares,BUENOS AIRES,15,26,15,24,39
06,06147,061470703,Carlos Casares,BUENOS AIRES,76,70,86,143,229
06,06147,061470802,Carlos Casares,BUENOS AIRES,12,17,12,17,29
06,06147,061470804,Carlos Casares,BUENOS AIRES,15,17,22,22,44
06,06147,061470108,Carlos Casares,BUENOS AIRES,285,314,384,326,710
06,06147,061471203,Carlos Casares,BUENOS AIRES,330,326,529,508,1037
06,06147,061471209,Carlos Casares,BUENOS AIRES,305,337,468,424,892
06,06147,061470307,Carlos Casares,BUENOS AIRES,17,50,16,24,40
06,06147,061470705,Carlos Casares,BUENOS AIRES,4,13,4,5,9
06,06147,061470906,Carlos Casares,BUENOS AIRES,12,52,14,18,32
06,06147,061470203,Carlos Casares,BUENOS AIRES,43,54,65,73,138
06,06147,061470304,Carlos Casares,BUENOS AIRES,16,32,13,17,30
06,06147,061470604,Carlos Casares,BUENOS AIRES,4,4,4,8,12
06,06147,061470706,Carlos Casares,BUENOS AIRES,2,14,0,3,3
06,06147,061471103,Carlos Casares,BUENOS AIRES,13,19,17,17,34
06,06147,061470301,Carlos Casares,BUENOS AIRES,145,190,245,226,471
06,06147,061471101,Carlos Casares,BUENOS AIRES,57,79,87,87,174
06,06147,061471210,Carlos Casares,BUENOS AIRES,231,226,370,366,736
06,06147,061470306,Carlos Casares,BUENOS AIRES,7,20,7,8,15
06,06147,061470403,Carlos Casares,BUENOS AIRES,15,57,13,22,35
06,06147,061470502,Carlos Casares,BUENOS AIRES,14,22,19,22,41
06,06147,061470903,Carlos Casares,BUENOS AIRES,9,26,8,12,20
06,06147,061471205,Carlos Casares,BUENOS AIRES,233,274,331,295,626
06,06147,061470202,Carlos Casares,BUENOS AIRES,13,37,30,23,53
06,06147,061470601,Carlos Casares,BUENOS AIRES,4,21,7,7,14
06,06147,061470707,Carlos Casares,BUENOS AIRES,1,11,1,3,4
06,06147,061470902,Carlos Casares,BUENOS AIRES,48,71,64,82,146
06,06147,061471102,Carlos Casares,BUENOS AIRES,9,31,18,14,32
06,06147,061470102,Carlos Casares,BUENOS AIRES,321,383,460,401,861
06,06147,061470101,Carlos Casares,BUENOS AIRES,338,368,525,478,1003
06,06147,061470303,Carlos Casares,BUENOS AIRES,3,4,2,6,8
06,06147,061470702,Carlos Casares,BUENOS AIRES,4,13,5,7,12
06,06147,061470205,Carlos Casares,BUENOS AIRES,9,28,7,11,18
06,06147,061470305,Carlos Casares,BUENOS AIRES,15,33,14,22,36
06,06147,061470503,Carlos Casares,BUENOS AIRES,14,27,8,19,27
06,06147,061470711,Carlos Casares,BUENOS AIRES,8,18,10,7,17
06,06147,061470712,Carlos Casares,BUENOS AIRES,2,12,4,2,6
06,06147,061470803,Carlos Casares,BUENOS AIRES,7,16,8,9,17
06,06147,061470904,Carlos Casares,BUENOS AIRES,10,26,9,13,22
06,06147,061470905,Carlos Casares,BUENOS AIRES,9,27,12,12,24
06,06147,061470106,Carlos Casares,BUENOS AIRES,289,342,398,322,720
06,06147,061470107,Carlos Casares,BUENOS AIRES,291,297,392,398,790
06,06147,061470109,Carlos Casares,BUENOS AIRES,359,396,700,618,1318
06,06147,061470302,Carlos Casares,BUENOS AIRES,27,56,36,40,76
06,06147,061471202,Carlos Casares,BUENOS AIRES,304,331,428,413,841
06,06147,061470204,Carlos Casares,BUENOS AIRES,9,16,12,22,34
06,06147,061470704,Carlos Casares,BUENOS AIRES,16,34,15,28,43
06,06147,061470710,Carlos Casares,BUENOS AIRES,7,11,4,11,15
06,06147,061470907,Carlos Casares,BUENOS AIRES,22,56,36,31,67
06,06147,061471002,Carlos Casares,BUENOS AIRES,23,49,41,47,88
06,06147,061471003,Carlos Casares,BUENOS AIRES,15,57,20,21,41
06,06147,061470602,Carlos Casares,BUENOS AIRES,125,138,215,206,421
06,06147,061470603,Carlos Casares,BUENOS AIRES,20,33,20,44,64
06,06147,061470708,Carlos Casares,BUENOS AIRES,26,47,31,46,77
06,06147,061470105,Carlos Casares,BUENOS AIRES,291,337,362,297,659
06,06147,061470801,Carlos Casares,BUENOS AIRES,185,252,268,274,542
06,06147,061471001,Carlos Casares,BUENOS AIRES,73,104,105,119,224
06,06147,061471208,Carlos Casares,BUENOS AIRES,365,433,535,488,1023
06,06147,061470709,Carlos Casares,BUENOS AIRES,8,25,13,13,26
06,06147,061470805,Carlos Casares,BUENOS AIRES,20,26,27,34,61
06,06357,063573510,General Pueyrredón,BUENOS AIRES,132,362,150,96,246
06,06357,063577713,General Pueyrredón,BUENOS AIRES,60,147,100,94,194
06,06357,063574904,General Pueyrredón,BUENOS AIRES,232,295,331,273,604
06,06357,063576002,General Pueyrredón,BUENOS AIRES,226,272,326,281,607
06,06357,063577701,General Pueyrredón,BUENOS AIRES,195,217,353,373,726
06,06357,063572207,General Pueyrredón,BUENOS AIRES,193,334,212,132,344
06,06357,063572209,General Pueyrredón,BUENOS AIRES,247,418,282,190,472
06,06357,063572906,General Pueyrredón,BUENOS AIRES,280,770,264,204,468
06,06357,063573101,General Pueyrredón,BUENOS AIRES,272,560,280,172,452
06,06357,063573507,General Pueyrredón,BUENOS AIRES,231,448,281,190,471
06,06357,063570104,General Pueyrredón,BUENOS AIRES,375,452,625,580,1205
06,06357,063570105,General Pueyrredón,BUENOS AIRES,344,392,544,505,1049
06,06357,063570107,General Pueyrredón,BUENOS AIRES,255,297,414,314,728
06,06357,063570304,General Pueyrredón,BUENOS AIRES,209,248,351,352,703
06,06357,063570308,General Pueyrredón,BUENOS AIRES,343,423,509,494,1003
06,06357,063570410,General Pueyrredón,BUENOS AIRES,223,454,301,277,578
06,06357,063570512,General Pueyrredón,BUENOS AIRES,191,320,276,243,519
06,06357,063570514,General Pueyrredón,BUENOS AIRES,116,267,214,194,408
06,06357,063570603,General Pueyrredón,BUENOS AIRES,247,277,378,361,739
06,06357,063570609,General Pueyrredón,BUENOS AIRES,373,422,610,524,1134
06,06357,063573508,General Pueyrredón,BUENOS AIRES,273,656,250,196,446
06,06357,063570711,General Pueyrredón,BUENOS AIRES,241,258,423,411,834
06,06357,063570811,General Pueyrredón,BUENOS AIRES,371,414,572,521,1093
06,06357,063573605,General Pueyrredón,BUENOS AIRES,57,247,61,42,103
06,06357,063571012,General Pueyrredón,BUENOS AIRES,302,316,476,495,971
06,06357,063571015,General Pueyrredón,BUENOS AIRES,235,249,402,438,840
06,06357,063571111,General Pueyrredón,BUENOS AIRES,289,347,460,424,884
06,06357,063571112,General Pueyrredón,BUENOS AIRES,342,338,620,591,1211
06,06357,063571212,General Pueyrredón,BUENOS AIRES,305,313,598,564,1162
06,06357,063571301,General Pueyrredón,BUENOS AIRES,281,316,448,420,868
06,06357,063571406,General Pueyrredón,BUENOS AIRES,302,393,431,319,750
06,06357,063571909,General Pueyrredón,BUENOS AIRES,123,252,153,120,273
06,06357,063572302,General Pueyrredón,BUENOS AIRES,199,483,242,185,427
06,06357,063572305,General Pueyrredón,BUENOS AIRES,93,275,122,95,217
06,06357,063572401,General Pueyrredón,BUENOS AIRES,68,330,89,81,170
06,06357,063572402,General Pueyrredón,BUENOS AIRES,52,339,58,55,113
06,06357,063572404,General Pueyrredón,BUENOS AIRES,144,512,188,160,348
06,06357,063572601,General Pueyrredón,BUENOS AIRES,243,887,249,176,425
06,06357,063572704,General Pueyrredón,BUENOS AIRES,163,515,202,142,344
06,06357,063573202,General Pueyrredón,BUENOS AIRES,260,395,367,283,650
06,06357,063573203,General Pueyrredón,BUENOS AIRES,245,345,413,279,692
06,06357,063573308,General Pueyrredón,BUENOS AIRES,240,427,317,236,553
06,06357,063573310,General Pueyrredón,BUENOS AIRES,137,244,178,140,318
06,06357,063573402,General Pueyrredón,BUENOS AIRES,197,283,246,171,417
06,06357,063574103,General Pueyrredón,BUENOS AIRES,261,1172,285,232,517
06,06357,063574202,General Pueyrredón,BUENOS AIRES,128,359,163,117,280
06,06357,063574309,General Pueyrredón,BUENOS AIRES,103,345,113,119,232
06,06357,063574503,General Pueyrredón,BUENOS AIRES,222,333,324,230,554
06,06357,063574505,General Pueyrredón,BUENOS AIRES,151,242,230,175,405
06,06357,063574514,General Pueyrredón,BUENOS AIRES,97,186,106,91,197
06,06357,063574605,General Pueyrredón,BUENOS AIRES,282,407,354,289,643
06,06357,063574702,General Pueyrredón,BUENOS AIRES,279,345,370,341,711
06,06357,063574707,General Pueyrredón,BUENOS AIRES,173,230,223,172,395
06,06357,063574906,General Pueyrredón,BUENOS AIRES,245,343,382,285,667
06,06357,063575005,General Pueyrredón,BUENOS AIRES,349,398,551,512,1063
06,06357,063575006,General Pueyrredón,BUENOS AIRES,348,403,502,437,939
06,06357,063575202,General Pueyrredón,BUENOS AIRES,398,390,706,702,1408
06,06357,063575210,General Pueyrredón,BUENOS AIRES,478,477,857,880,1737
06,06357,063575310,General Pueyrredón,BUENOS AIRES,368,413,622,609,1231
06,06357,063575503,General Pueyrredón,BUENOS AIRES,365,465,526,455,981
06,06357,063575601,General Pueyrredón,BUENOS AIRES,340,359,472,434,906
06,06357,063575801,General Pueyrredón,BUENOS AIRES,272,321,362,340,702
06,06357,063575906,General Pueyrredón,BUENOS AIRES,414,494,653,549,1202
06,06357,063576103,General Pueyrredón,BUENOS AIRES,162,215,227,209,436
06,06357,063576108,General Pueyrredón,BUENOS AIRES,11,13,22,18,40
06,06357,063576210,General Pueyrredón,BUENOS AIRES,102,184,142,117,259
06,06357,063576211,General Pueyrredón,BUENOS AIRES,216,323,309,299,608
06,06357,063576308,General Pueyrredón,BUENOS AIRES,83,424,124,127,251
06,06357,063576402,General Pueyrredón,BUENOS AIRES,358,419,614,635,1249
06,06357,063576502,General Pueyrredón,BUENOS AIRES,226,297,335,369,704
06,06357,063576512,General Pueyrredón,BUENOS AIRES,202,407,298,295,593
06,06357,063576705,General Pueyrredón,BUENOS AIRES,324,338,544,502,1046
06,06357,063576802,General Pueyrredón,BUENOS AIRES,382,414,646,612,1258
06,06357,063576906,General Pueyrredón,BUENOS AIRES,284,299,473,459,932
06,06357,063577101,General Pueyrredón,BUENOS AIRES,234,244,393,393,786
06,06357,063577102,General Pueyrredón,BUENOS AIRES,306,299,496,405,901
06,06357,063577205,General Pueyrredón,BUENOS AIRES,369,354,653,602,1255
06,06357,063577208,General Pueyrredón,BUENOS AIRES,211,219,346,330,676
06,06357,063577301,General Pueyrredón,BUENOS AIRES,67,96,143,150,293
06,06357,063577304,General Pueyrredón,BUENOS AIRES,63,67,106,120,226
06,06357,063577309,General Pueyrredón,BUENOS AIRES,160,185,289,299,588
06,06357,063577402,General Pueyrredón,BUENOS AIRES,318,336,597,644,1241
06,06357,063577404,General Pueyrredón,BUENOS AIRES,279,296,523,593,1116
06,06357,063577408,General Pueyrredón,BUENOS AIRES,257,321,480,483,963
06,06357,063577409,General Pueyrredón,BUENOS AIRES,178,244,292,287,579
06,06357,063577410,General Pueyrredón,BUENOS AIRES,182,230,297,294,591
06,06357,063577417,General Pueyrredón,BUENOS AIRES,193,308,300,306,606
06,06357,063577502,General Pueyrredón,BUENOS AIRES,71,296,103,93,196
06,06357,063577504,General Pueyrredón,BUENOS AIRES,115,239,177,175,352
06,06357,063577605,General Pueyrredón,BUENOS AIRES,93,260,123,121,244
06,06357,063577714,General Pueyrredón,BUENOS AIRES,63,198,414,269,683
06,06357,063577717,General Pueyrredón,BUENOS AIRES,34,238,44,45,89
06,06357,063577811,General Pueyrredón,BUENOS AIRES,355,350,752,756,1508
06,06357,063577815,General Pueyrredón,BUENOS AIRES,194,200,349,368,717
06,06357,063578001,General Pueyrredón,BUENOS AIRES,353,397,636,646,1282
06,06357,063578106,General Pueyrredón,BUENOS AIRES,139,175,197,220,417
06,06357,063578113,General Pueyrredón,BUENOS AIRES,154,158,256,279,535
06,06357,063577916,General Pueyrredón,BUENOS AIRES,64,58,105,105,210
06,06357,063578102,General Pueyrredón,BUENOS AIRES,18,33,17,25,42
06,06357,063578301,General Pueyrredón,BUENOS AIRES,87,125,131,160,291
06,06357,063573008,General Pueyrredón,BUENOS AIRES,111,188,115,82,197
06,06357,063577909,General Pueyrredón,BUENOS AIRES,377,445,607,654,1261
06,06357,063573706,General Pueyrredón,BUENOS AIRES,170,601,195,145,340
06,06357,063573708,General Pueyrredón,BUENOS AIRES,127,265,138,122,260
06,06357,063573804,General Pueyrredón,BUENOS AIRES,111,387,125,94,219
06,06357,063571604,General Pueyrredón,BUENOS AIRES,321,426,455,312,767
06,06357,063571305,General Pueyrredón,BUENOS AIRES,255,292,406,395,801
06,06357,063574102,General Pueyrredón,BUENOS AIRES,267,952,355,245,600
06,06357,063572107,General Pueyrredón,BUENOS AIRES,196,373,326,202,528
06,06357,063572205,General Pueyrredón,BUENOS AIRES,180,380,182,150,332
06,06357,063572213,General Pueyrredón,BUENOS AIRES,136,296,178,116,294
06,06357,063572901,General Pueyrredón,BUENOS AIRES,149,435,160,117,277
06,06357,063573001,General Pueyrredón,BUENOS AIRES,172,456,161,119,280
06,06357,063571602,General Pueyrredón,BUENOS AIRES,264,326,362,321,683
06,06357,063570206,General Pueyrredón,BUENOS AIRES,276,329,432,427,859
06,06357,063573107,General Pueyrredón,BUENOS AIRES,302,622,307,189,496
06,06357,063570806,General Pueyrredón,BUENOS AIRES,266,287,427,405,832
06,06357,063570201,General Pueyrredón,BUENOS AIRES,287,317,473,458,931
06,06357,063570302,General Pueyrredón,BUENOS AIRES,171,283,255,275,530
06,06357,063570311,General Pueyrredón,BUENOS AIRES,355,444,597,535,1132
06,06357,063570504,General Pueyrredón,BUENOS AIRES,244,315,318,357,675
06,06357,063570601,General Pueyrredón,BUENOS AIRES,307,336,484,483,967
06,06357,063570804,General Pueyrredón,BUENOS AIRES,249,299,411,375,786
06,06357,063570812,General Pueyrredón,BUENOS AIRES,356,405,576,521,1097
06,06357,063571003,General Pueyrredón,BUENOS AIRES,382,431,622,586,1208
06,06357,063571009,General Pueyrredón,BUENOS AIRES,243,263,426,428,854
06,06357,063573701,General Pueyrredón,BUENOS AIRES,213,494,212,162,374
06,06357,063571014,General Pueyrredón,BUENOS AIRES,266,278,511,518,1029
06,06357,063571101,General Pueyrredón,BUENOS AIRES,213,245,386,354,740
06,06357,063571107,General Pueyrredón,BUENOS AIRES,314,284,605,593,1198
06,06357,063571109,General Pueyrredón,BUENOS AIRES,417,415,714,641,1355
06,06357,063571201,General Pueyrredón,BUENOS AIRES,322,358,544,534,1078
06,06357,063571208,General Pueyrredón,BUENOS AIRES,375,377,683,754,1437
06,06357,063571308,General Pueyrredón,BUENOS AIRES,282,320,473,461,934
06,06357,063571404,General Pueyrredón,BUENOS AIRES,326,360,515,435,950
06,06357,063571503,General Pueyrredón,BUENOS AIRES,272,312,388,345,733
06,06357,063571509,General Pueyrredón,BUENOS AIRES,294,323,399,364,763
06,06357,063571701,General Pueyrredón,BUENOS AIRES,266,343,393,401,794
06,06357,063571703,General Pueyrredón,BUENOS AIRES,183,278,240,216,456
06,06357,063571706,General Pueyrredón,BUENOS AIRES,195,267,276,282,558
06,06357,063571805,General Pueyrredón,BUENOS AIRES,321,429,461,392,853
06,06357,063571806,General Pueyrredón,BUENOS AIRES,255,312,370,326,696
06,06357,063572004,General Pueyrredón,BUENOS AIRES,151,366,162,126,288
06,06357,063572405,General Pueyrredón,BUENOS AIRES,238,796,244,188,432
06,06357,063572602,General Pueyrredón,BUENOS AIRES,323,1053,337,222,559
06,06357,063572702,General Pueyrredón,BUENOS AIRES,182,466,192,146,338
06,06357,063573404,General Pueyrredón,BUENOS AIRES,365,784,382,229,611
06,06357,063573408,General Pueyrredón,BUENOS AIRES,98,223,124,84,208
06,06357,063573504,General Pueyrredón,BUENOS AIRES,196,427,218,164,382
06,06357,063574001,General Pueyrredón,BUENOS AIRES,24,75,34,20,54
06,06357,063574005,General Pueyrredón,BUENOS AIRES,143,595,135,125,260
06,06357,063574007,General Pueyrredón,BUENOS AIRES,268,888,272,216,488
06,06357,063574206,General Pueyrredón,BUENOS AIRES,170,445,169,128,297
06,06357,063574409,General Pueyrredón,BUENOS AIRES,84,278,89,99,188
06,06357,063574507,General Pueyrredón,BUENOS AIRES,283,413,460,357,817
06,06357,063574510,General Pueyrredón,BUENOS AIRES,278,356,452,431,883
06,06357,063574511,General Pueyrredón,BUENOS AIRES,126,376,176,140,316
06,06357,063574604,General Pueyrredón,BUENOS AIRES,149,215,220,168,388
06,06357,063574607,General Pueyrredón,BUENOS AIRES,197,262,235,182,417
06,06357,063574703,General Pueyrredón,BUENOS AIRES,317,393,440,352,792
06,06357,063574907,General Pueyrredón,BUENOS AIRES,291,393,395,315,710
06,06357,063575004,General Pueyrredón,BUENOS AIRES,343,403,514,442,956
06,06357,063575106,General Pueyrredón,BUENOS AIRES,296,322,511,516,1027
06,06357,063575707,General Pueyrredón,BUENOS AIRES,223,256,340,274,614
06,06357,063575307,General Pueyrredón,BUENOS AIRES,385,427,647,594,1241
06,06357,063575406,General Pueyrredón,BUENOS AIRES,247,289,389,340,729
06,06357,063575407,General Pueyrredón,BUENOS AIRES,241,273,402,377,779
06,06357,063575604,General Pueyrredón,BUENOS AIRES,373,450,563,435,998
06,06357,063575607,General Pueyrredón,BUENOS AIRES,346,386,516,442,958
06,06357,063575701,General Pueyrredón,BUENOS AIRES,473,488,721,686,1407
06,06357,063575905,General Pueyrredón,BUENOS AIRES,286,345,419,358,777
06,06357,063575909,General Pueyrredón,BUENOS AIRES,181,217,286,220,506
06,06357,063575910,General Pueyrredón,BUENOS AIRES,192,234,280,215,495
06,06357,063575911,General Pueyrredón,BUENOS AIRES,318,385,457,414,871
06,06357,063576003,General Pueyrredón,BUENOS AIRES,292,363,431,338,769
06,06357,063576004,General Pueyrredón,BUENOS AIRES,205,241,295,244,539
06,06357,063576008,General Pueyrredón,BUENOS AIRES,240,267,348,319,667
06,06357,063576201,General Pueyrredón,BUENOS AIRES,334,400,528,478,1006
06,06357,063576401,General Pueyrredón,BUENOS AIRES,352,420,597,588,1185
06,06357,063576405,General Pueyrredón,BUENOS AIRES,204,305,338,309,647
06,06357,063576411,General Pueyrredón,BUENOS AIRES,118,463,172,138,310
06,06357,063576501,General Pueyrredón,BUENOS AIRES,178,217,281,273,554
06,06357,063576507,General Pueyrredón,BUENOS AIRES,252,318,408,410,818
06,06357,063576510,General Pueyrredón,BUENOS AIRES,187,278,284,271,555
06,06357,063576513,General Pueyrredón,BUENOS AIRES,70,232,101,99,200
06,06357,063576602,General Pueyrredón,BUENOS AIRES,289,312,451,419,870
06,06357,063576702,General Pueyrredón,BUENOS AIRES,242,250,401,364,765
06,06357,063576713,General Pueyrredón,BUENOS AIRES,213,187,381,404,785
06,06357,063577003,General Pueyrredón,BUENOS AIRES,447,505,669,648,1317
06,06357,063577009,General Pueyrredón,BUENOS AIRES,232,239,389,356,745
06,06357,063577014,General Pueyrredón,BUENOS AIRES,286,292,539,522,1061
06,06357,063577207,General Pueyrredón,BUENOS AIRES,341,343,576,604,1180
06,06357,063577712,General Pueyrredón,BUENOS AIRES,58,146,89,81,170
06,06357,063577715,General Pueyrredón,BUENOS AIRES,48,183,67,72,139
06,06357,063577804,General Pueyrredón,BUENOS AIRES,289,325,533,521,1054
06,06357,063577904,General Pueyrredón,BUENOS AIRES,231,262,392,418,810
06,06357,063577906,General Pueyrredón,BUENOS AIRES,219,227,446,440,886
06,06357,063577907,General Pueyrredón,BUENOS AIRES,199,198,404,414,818
06,06357,063578002,General Pueyrredón,BUENOS AIRES,249,322,436,425,861
06,06357,063578003,General Pueyrredón,BUENOS AIRES,291,319,526,504,1030
06,06357,063578004,General Pueyrredón,BUENOS AIRES,296,316,519,567,1086
06,06357,063578016,General Pueyrredón,BUENOS AIRES,230,313,372,398,770
06,06357,063578110,General Pueyrredón,BUENOS AIRES,176,207,270,283,553
06,06357,063578212,General Pueyrredón,BUENOS AIRES,153,335,223,209,432
06,06357,063578213,General Pueyrredón,BUENOS AIRES,123,138,186,241,427
06,06357,063577706,General Pueyrredón,BUENOS AIRES,21,28,27,42,69
06,06357,063577807,General Pueyrredón,BUENOS AIRES,112,126,146,209,355
06,06357,063578103,General Pueyrredón,BUENOS AIRES,10,11,11,15,26
06,06357,063573902,General Pueyrredón,BUENOS AIRES,162,483,170,130,300
06,06357,063573905,General Pueyrredón,BUENOS AIRES,138,393,160,136,296
06,06357,063573908,General Pueyrredón,BUENOS AIRES,173,366,196,142,338
06,06357,063578017,General Pueyrredón,BUENOS AIRES,140,225,248,210,458
06,06357,063578108,General Pueyrredón,BUENOS AIRES,153,224,236,228,464
06,06357,063572208,General Pueyrredón,BUENOS AIRES,224,394,290,184,474
06,06357,063572212,General Pueyrredón,BUENOS AIRES,186,415,222,153,375
06,06357,063572803,General Pueyrredón,BUENOS AIRES,159,550,178,127,305
06,06357,063572804,General Pueyrredón,BUENOS AIRES,133,417,146,102,248
06,06357,063572904,General Pueyrredón,BUENOS AIRES,206,592,212,144,356
06,06357,063570507,General Pueyrredón,BUENOS AIRES,183,226,284,253,537
06,06357,063570509,General Pueyrredón,BUENOS AIRES,338,428,525,464,989
06,06357,063570513,General Pueyrredón,BUENOS AIRES,147,227,211,181,392
06,06357,063570602,General Pueyrredón,BUENOS AIRES,261,268,429,378,807
06,06357,063570704,General Pueyrredón,BUENOS AIRES,307,356,543,522,1065
06,06357,063570706,General Pueyrredón,BUENOS AIRES,343,378,569,520,1089
06,06357,063570708,General Pueyrredón,BUENOS AIRES,268,283,418,415,833
06,06357,063570803,General Pueyrredón,BUENOS AIRES,204,221,341,327,668
06,06357,063570905,General Pueyrredón,BUENOS AIRES,348,332,613,552,1165
06,06357,063570907,General Pueyrredón,BUENOS AIRES,327,331,603,594,1197
06,06357,063570911,General Pueyrredón,BUENOS AIRES,367,346,612,573,1185
06,06357,063570912,General Pueyrredón,BUENOS AIRES,422,460,709,674,1383
06,06357,063571011,General Pueyrredón,BUENOS AIRES,330,328,527,466,993
06,06357,063571206,General Pueyrredón,BUENOS AIRES,208,194,334,302,636
06,06357,063571209,General Pueyrredón,BUENOS AIRES,338,324,610,597,1207
06,06357,063571303,General Pueyrredón,BUENOS AIRES,415,436,621,548,1169
06,06357,063571306,General Pueyrredón,BUENOS AIRES,415,447,679,685,1364
06,06357,063571408,General Pueyrredón,BUENOS AIRES,359,419,482,415,897
06,06357,063571607,General Pueyrredón,BUENOS AIRES,188,266,257,195,452
06,06357,063571702,General Pueyrredón,BUENOS AIRES,109,176,132,104,236
06,06357,063571710,General Pueyrredón,BUENOS AIRES,185,271,265,240,505
06,06357,063571807,General Pueyrredón,BUENOS AIRES,247,308,351,318,669
06,06357,063571809,General Pueyrredón,BUENOS AIRES,234,390,354,286,640
06,06357,063571906,General Pueyrredón,BUENOS AIRES,127,288,152,126,278
06,06357,063572301,General Pueyrredón,BUENOS AIRES,165,467,215,174,389
06,06357,063572308,General Pueyrredón,BUENOS AIRES,58,355,108,113,221
06,06357,063572701,General Pueyrredón,BUENOS AIRES,178,509,210,141,351
06,06357,063572703,General Pueyrredón,BUENOS AIRES,240,695,288,192,480
06,06357,063573305,General Pueyrredón,BUENOS AIRES,271,394,345,248,593
06,06357,063573311,General Pueyrredón,BUENOS AIRES,170,250,226,141,367
06,06357,063573406,General Pueyrredón,BUENOS AIRES,162,340,200,123,323
06,06357,063573407,General Pueyrredón,BUENOS AIRES,189,334,269,202,471
06,06357,063574004,General Pueyrredón,BUENOS AIRES,207,844,642,346,988
06,06357,063574201,General Pueyrredón,BUENOS AIRES,163,672,171,116,287
06,06357,063574307,General Pueyrredón,BUENOS AIRES,135,339,227,220,447
06,06357,063574401,General Pueyrredón,BUENOS AIRES,27,51,37,37,74
06,06357,063574403,General Pueyrredón,BUENOS AIRES,235,329,362,313,675
06,06357,063574406,General Pueyrredón,BUENOS AIRES,112,452,138,112,250
06,06357,063574501,General Pueyrredón,BUENOS AIRES,171,227,210,143,353
06,06357,063574504,General Pueyrredón,BUENOS AIRES,227,288,354,272,626
06,06357,063574513,General Pueyrredón,BUENOS AIRES,74,231,215,230,445
06,06357,063574602,General Pueyrredón,BUENOS AIRES,197,230,275,194,469
06,06357,063574611,General Pueyrredón,BUENOS AIRES,244,310,380,336,716
06,06357,063574706,General Pueyrredón,BUENOS AIRES,185,273,257,177,434
06,06357,063574812,General Pueyrredón,BUENOS AIRES,188,231,228,207,435
06,06357,063574903,General Pueyrredón,BUENOS AIRES,222,281,320,262,582
06,06357,063575010,General Pueyrredón,BUENOS AIRES,208,252,302,253,555
06,06357,063575108,General Pueyrredón,BUENOS AIRES,288,286,607,614,1221
06,06357,063575204,General Pueyrredón,BUENOS AIRES,383,416,646,621,1267
06,06357,063575208,General Pueyrredón,BUENOS AIRES,270,251,441,437,878
06,06357,063575302,General Pueyrredón,BUENOS AIRES,343,348,554,509,1063
06,06357,063575501,General Pueyrredón,BUENOS AIRES,199,227,291,257,548
06,06357,063575603,General Pueyrredón,BUENOS AIRES,312,369,427,359,786
06,06357,063575702,General Pueyrredón,BUENOS AIRES,346,404,496,437,933
06,06357,063575705,General Pueyrredón,BUENOS AIRES,217,229,324,289,613
06,06357,063575706,General Pueyrredón,BUENOS AIRES,343,357,484,445,929
06,06357,063575807,General Pueyrredón,BUENOS AIRES,293,322,434,392,826
06,06357,063575902,General Pueyrredón,BUENOS AIRES,301,391,416,362,778
06,06357,063575903,General Pueyrredón,BUENOS AIRES,252,315,512,371,883
06,06357,063576101,General Pueyrredón,BUENOS AIRES,310,376,502,477,979
06,06357,063576105,General Pueyrredón,BUENOS AIRES,284,324,474,458,932
06,06357,063576110,General Pueyrredón,BUENOS AIRES,322,451,460,434,894
06,06357,063576303,General Pueyrredón,BUENOS AIRES,71,312,89,99,188
06,06357,063576305,General Pueyrredón,BUENOS AIRES,133,446,183,179,362
06,06357,063576306,General Pueyrredón,BUENOS AIRES,59,274,86,74,160
06,06357,063576307,General Pueyrredón,BUENOS AIRES,57,269,81,87,168
06,06357,063576404,General Pueyrredón,BUENOS AIRES,225,286,383,398,781
06,06357,063576506,General Pueyrredón,BUENOS AIRES,193,272,316,277,593
06,06357,063576607,General Pueyrredón,BUENOS AIRES,274,299,469,424,893
06,06357,063576710,General Pueyrredón,BUENOS AIRES,326,357,628,583,1211
06,06357,063576805,General Pueyrredón,BUENOS AIRES,183,195,297,267,564
06,06357,063576806,General Pueyrredón,BUENOS AIRES,253,278,472,410,882
06,06357,063576902,General Pueyrredón,BUENOS AIRES,225,263,408,372,780
06,06357,063576904,General Pueyrredón,BUENOS AIRES,250,276,419,415,834
06,06357,063576905,General Pueyrredón,BUENOS AIRES,248,244,415,397,812
06,06357,063577012,General Pueyrredón,BUENOS AIRES,207,205,379,339,718
06,06357,063577210,General Pueyrredón,BUENOS AIRES,426,443,722,748,1470
06,06357,063577305,General Pueyrredón,BUENOS AIRES,349,404,666,579,1245
06,06357,063577508,General Pueyrredón,BUENOS AIRES,138,300,223,202,425
06,06357,063577601,General Pueyrredón,BUENOS AIRES,98,131,166,163,329
06,06357,063577611,General Pueyrredón,BUENOS AIRES,110,192,188,201,389
06,06357,063577613,General Pueyrredón,BUENOS AIRES,80,246,104,118,222
06,06357,063577615,General Pueyrredón,BUENOS AIRES,79,200,109,116,225
06,06357,063577616,General Pueyrredón,BUENOS AIRES,79,192,135,151,286
06,06357,063577707,General Pueyrredón,BUENOS AIRES,59,135,67,75,142
06,06357,063577718,General Pueyrredón,BUENOS AIRES,40,228,49,58,107
06,06357,063577802,General Pueyrredón,BUENOS AIRES,162,181,310,312,622
06,06357,063577805,General Pueyrredón,BUENOS AIRES,274,298,517,510,1027
06,06357,063577813,General Pueyrredón,BUENOS AIRES,261,290,476,473,949
06,06357,063577912,General Pueyrredón,BUENOS AIRES,223,251,386,352,738
06,06357,063578104,General Pueyrredón,BUENOS AIRES,78,111,130,137,267
06,06357,063578211,General Pueyrredón,BUENOS AIRES,151,309,220,211,431
06,06357,063577801,General Pueyrredón,BUENOS AIRES,12,23,17,23,40
06,06357,063578206,General Pueyrredón,BUENOS AIRES,217,272,335,389,724
06,06357,063578203,General Pueyrredón,BUENOS AIRES,227,331,341,393,734
06,06357,063573707,General Pueyrredón,BUENOS AIRES,159,441,178,111,289
06,06357,063573802,General Pueyrredón,BUENOS AIRES,179,783,184,135,319
06,06357,063572101,General Pueyrredón,BUENOS AIRES,157,247,194,151,345
06,06357,063573909,General Pueyrredón,BUENOS AIRES,101,220,109,66,175
06,06357,063572204,General Pueyrredón,BUENOS AIRES,165,287,202,140,342
06,06357,063572206,General Pueyrredón,BUENOS AIRES,242,464,280,208,488
06,06357,063572210,General Pueyrredón,BUENOS AIRES,173,308,209,136,345
06,06357,063572905,General Pueyrredón,BUENOS AIRES,51,116,64,67,131
06,06357,063573010,General Pueyrredón,BUENOS AIRES,160,388,182,116,298
06,06357,063573011,General Pueyrredón,BUENOS AIRES,205,591,232,176,408
06,06357,063571203,General Pueyrredón,BUENOS AIRES,298,318,468,449,917
06,06357,063573104,General Pueyrredón,BUENOS AIRES,111,214,109,77,186
06,06357,063573106,General Pueyrredón,BUENOS AIRES,189,371,228,167,395
06,06357,063570401,General Pueyrredón,BUENOS AIRES,231,317,348,296,644
06,06357,063570103,General Pueyrredón,BUENOS AIRES,359,381,616,602,1218
06,06357,063570106,General Pueyrredón,BUENOS AIRES,247,288,386,342,728
06,06357,063570306,General Pueyrredón,BUENOS AIRES,327,413,567,462,1029
06,06357,063570307,General Pueyrredón,BUENOS AIRES,282,457,421,346,767
06,06357,063570403,General Pueyrredón,BUENOS AIRES,161,323,219,191,410
06,06357,063570606,General Pueyrredón,BUENOS AIRES,236,287,359,334,693
06,06357,063570607,General Pueyrredón,BUENOS AIRES,333,394,475,401,876
06,06357,063570608,General Pueyrredón,BUENOS AIRES,340,400,516,507,1023
06,06357,063570805,General Pueyrredón,BUENOS AIRES,320,368,508,459,967
06,06357,063570810,General Pueyrredón,BUENOS AIRES,370,410,542,514,1056
06,06357,063570903,General Pueyrredón,BUENOS AIRES,284,278,520,501,1021
06,06357,063570904,General Pueyrredón,BUENOS AIRES,349,348,619,596,1215
06,06357,063570906,General Pueyrredón,BUENOS AIRES,376,391,685,675,1360
06,06357,063570908,General Pueyrredón,BUENOS AIRES,319,281,572,565,1137
06,06357,063571013,General Pueyrredón,BUENOS AIRES,217,232,381,421,802
06,06357,063571214,General Pueyrredón,BUENOS AIRES,295,378,435,364,799
06,06357,063571309,General Pueyrredón,BUENOS AIRES,185,223,281,266,547
06,06357,063571407,General Pueyrredón,BUENOS AIRES,383,431,572,493,1065
06,06357,063571705,General Pueyrredón,BUENOS AIRES,379,466,588,592,1180
06,06357,063571709,General Pueyrredón,BUENOS AIRES,226,309,326,281,607
06,06357,063571905,General Pueyrredón,BUENOS AIRES,162,556,165,143,308
06,06357,063571910,General Pueyrredón,BUENOS AIRES,110,293,141,96,237
06,06357,063572303,General Pueyrredón,BUENOS AIRES,110,266,156,114,270
06,06357,063572307,General Pueyrredón,BUENOS AIRES,110,544,103,95,198
06,06357,063572501,General Pueyrredón,BUENOS AIRES,249,1071,278,183,461
06,06357,063572502,General Pueyrredón,BUENOS AIRES,241,1075,279,211,490
06,06357,063572503,General Pueyrredón,BUENOS AIRES,138,771,145,118,263
06,06357,063573301,General Pueyrredón,BUENOS AIRES,270,334,354,289,643
06,06357,063573306,General Pueyrredón,BUENOS AIRES,226,355,260,195,455
06,06357,063574003,General Pueyrredón,BUENOS AIRES,160,648,178,128,306
06,06357,063574106,General Pueyrredón,BUENOS AIRES,62,302,74,59,133
06,06357,063574205,General Pueyrredón,BUENOS AIRES,137,379,136,107,243
06,06357,063574301,General Pueyrredón,BUENOS AIRES,80,360,94,75,169
06,06357,063574303,General Pueyrredón,BUENOS AIRES,107,394,129,110,239
06,06357,063574304,General Pueyrredón,BUENOS AIRES,166,376,254,185,439
06,06357,063574305,General Pueyrredón,BUENOS AIRES,55,296,54,50,104
06,06357,063574310,General Pueyrredón,BUENOS AIRES,96,558,122,86,208
06,06357,063574312,General Pueyrredón,BUENOS AIRES,92,363,108,92,200
06,06357,063574508,General Pueyrredón,BUENOS AIRES,269,359,394,268,662
06,06357,063574512,General Pueyrredón,BUENOS AIRES,134,286,164,151,315
06,06357,063574516,General Pueyrredón,BUENOS AIRES,268,612,349,318,667
06,06357,063574612,General Pueyrredón,BUENOS AIRES,249,341,398,330,728
06,06357,063574701,General Pueyrredón,BUENOS AIRES,317,385,414,309,723
06,06357,063574710,General Pueyrredón,BUENOS AIRES,327,434,420,344,764
06,06357,063574802,General Pueyrredón,BUENOS AIRES,325,369,489,411,900
06,06357,063574803,General Pueyrredón,BUENOS AIRES,297,374,432,360,792
06,06357,063574806,General Pueyrredón,BUENOS AIRES,166,206,241,209,450
06,06357,063574809,General Pueyrredón,BUENOS AIRES,172,211,245,214,459
06,06357,063575007,General Pueyrredón,BUENOS AIRES,367,415,605,588,1193
06,06357,063575105,General Pueyrredón,BUENOS AIRES,335,331,550,555,1105
06,06357,063575203,General Pueyrredón,BUENOS AIRES,379,425,644,571,1215
06,06357,063575206,General Pueyrredón,BUENOS AIRES,243,259,432,383,815
06,06357,063575214,General Pueyrredón,BUENOS AIRES,381,394,750,704,1454
06,06357,063575215,General Pueyrredón,BUENOS AIRES,443,446,811,854,1665
06,06357,063575216,General Pueyrredón,BUENOS AIRES,447,463,851,860,1711
06,06357,063575304,General Pueyrredón,BUENOS AIRES,298,334,438,398,836
06,06357,063575306,General Pueyrredón,BUENOS AIRES,259,305,409,441,850
06,06357,063575315,General Pueyrredón,BUENOS AIRES,298,279,564,544,1108
06,06357,063575610,General Pueyrredón,BUENOS AIRES,160,185,217,177,394
06,06357,063575808,General Pueyrredón,BUENOS AIRES,437,454,669,608,1277
06,06357,063575907,General Pueyrredón,BUENOS AIRES,311,340,519,534,1053
06,06357,063576005,General Pueyrredón,BUENOS AIRES,280,314,419,410,829
06,06357,063576104,General Pueyrredón,BUENOS AIRES,223,276,357,290,647
06,06357,063576406,General Pueyrredón,BUENOS AIRES,143,268,234,236,470
06,06357,063576508,General Pueyrredón,BUENOS AIRES,323,405,536,489,1025
06,06357,063576606,General Pueyrredón,BUENOS AIRES,253,285,425,434,859
06,06357,063576608,General Pueyrredón,BUENOS AIRES,213,237,348,321,669
06,06357,063576706,General Pueyrredón,BUENOS AIRES,241,259,410,343,753
06,06357,063576715,General Pueyrredón,BUENOS AIRES,365,350,671,700,1371
06,06357,063576801,General Pueyrredón,BUENOS AIRES,437,444,690,637,1327
06,06357,063576907,General Pueyrredón,BUENOS AIRES,372,379,693,622,1315
06,06357,063577001,General Pueyrredón,BUENOS AIRES,261,273,455,425,880
06,06357,063577005,General Pueyrredón,BUENOS AIRES,204,231,325,282,607
06,06357,063577111,General Pueyrredón,BUENOS AIRES,391,401,731,751,1482
06,06357,063577206,General Pueyrredón,BUENOS AIRES,293,316,504,541,1045
06,06357,063577308,General Pueyrredón,BUENOS AIRES,145,163,272,312,584
06,06357,063577310,General Pueyrredón,BUENOS AIRES,3,5,3,5,8
06,06357,063577312,General Pueyrredón,BUENOS AIRES,74,160,102,113,215
06,06357,063577415,General Pueyrredón,BUENOS AIRES,175,280,263,302,565
06,06357,063577501,General Pueyrredón,BUENOS AIRES,149,365,221,195,416
06,06357,063577603,General Pueyrredón,BUENOS AIRES,56,157,70,83,153
06,06357,063577606,General Pueyrredón,BUENOS AIRES,45,142,61,59,120
06,06357,063577607,General Pueyrredón,BUENOS AIRES,94,339,151,118,269
06,06357,063577608,General Pueyrredón,BUENOS AIRES,131,398,177,155,332
06,06357,063577614,General Pueyrredón,BUENOS AIRES,49,248,55,70,125
06,06357,063577702,General Pueyrredón,BUENOS AIRES,187,200,370,330,700
06,06357,063577703,General Pueyrredón,BUENOS AIRES,62,71,106,101,207
06,06357,063577710,General Pueyrredón,BUENOS AIRES,76,279,213,195,408
06,06357,063577908,General Pueyrredón,BUENOS AIRES,311,357,540,576,1116
06,06357,063577913,General Pueyrredón,BUENOS AIRES,369,394,652,632,1284
06,06357,063578111,General Pueyrredón,BUENOS AIRES,171,230,262,256,518
06,06357,063577917,General Pueyrredón,BUENOS AIRES,43,49,78,96,174
06,06357,063578201,General Pueyrredón,BUENOS AIRES,35,54,38,59,97
06,06357,063573801,General Pueyrredón,BUENOS AIRES,238,1002,238,151,389
06,06357,063572102,General Pueyrredón,BUENOS AIRES,272,459,337,278,615
06,06357,063573602,General Pueyrredón,BUENOS AIRES,261,716,270,227,497
06,06357,063573603,General Pueyrredón,BUENOS AIRES,173,569,200,155,355
06,06357,063574311,General Pueyrredón,BUENOS AIRES,81,246,88,78,166
06,06357,063572106,General Pueyrredón,BUENOS AIRES,196,386,312,224,536
06,06357,063576111,General Pueyrredón,BUENOS AIRES,202,241,328,263,591
06,06357,063577303,General Pueyrredón,BUENOS AIRES,19,17,11,23,34
06,06357,063577311,General Pueyrredón,BUENOS AIRES,114,200,158,185,343
06,06357,063578010,General Pueyrredón,BUENOS AIRES,111,173,194,193,387
06,06357,063572211,General Pueyrredón,BUENOS AIRES,168,351,195,128,323
06,06357,063572705,General Pueyrredón,BUENOS AIRES,239,838,240,171,411
06,06357,063572806,General Pueyrredón,BUENOS AIRES,177,610,193,160,353
06,06357,063572902,General Pueyrredón,BUENOS AIRES,110,305,140,112,252
06,06357,063573002,General Pueyrredón,BUENOS AIRES,161,384,190,161,351
06,06357,063570205,General Pueyrredón,BUENOS AIRES,270,342,426,420,846
06,06357,063570701,General Pueyrredón,BUENOS AIRES,287,342,413,371,784
06,06357,063570102,General Pueyrredón,BUENOS AIRES,326,347,512,501,1013
06,06357,063570203,General Pueyrredón,BUENOS AIRES,267,334,469,398,867
06,06357,063570209,General Pueyrredón,BUENOS AIRES,281,339,451,444,895
06,06357,063570301,General Pueyrredón,BUENOS AIRES,147,213,211,210,421
06,06357,063570409,General Pueyrredón,BUENOS AIRES,228,328,356,350,706
06,06357,063571002,General Pueyrredón,BUENOS AIRES,214,274,336,316,652
06,06357,063571005,General Pueyrredón,BUENOS AIRES,337,357,642,603,1245
06,06357,063571104,General Pueyrredón,BUENOS AIRES,404,397,785,783,1568
06,06357,063571110,General Pueyrredón,BUENOS AIRES,269,276,444,424,868
06,06357,063571205,General Pueyrredón,BUENOS AIRES,381,442,580,504,1084
06,06357,063571213,General Pueyrredón,BUENOS AIRES,279,306,500,477,977
06,06357,063571307,General Pueyrredón,BUENOS AIRES,364,358,578,587,1165
06,06357,063571502,General Pueyrredón,BUENOS AIRES,208,243,343,264,607
06,06357,063571505,General Pueyrredón,BUENOS AIRES,356,431,567,445,1012
06,06357,063571506,General Pueyrredón,BUENOS AIRES,245,283,381,330,711
06,06357,063571507,General Pueyrredón,BUENOS AIRES,701,822,966,761,1727
06,06357,063571601,General Pueyrredón,BUENOS AIRES,269,334,375,366,741
06,06357,063571605,General Pueyrredón,BUENOS AIRES,201,281,344,287,631
06,06357,063571609,General Pueyrredón,BUENOS AIRES,155,251,201,166,367
06,06357,063571611,General Pueyrredón,BUENOS AIRES,170,235,217,171,388
06,06357,063571613,General Pueyrredón,BUENOS AIRES,205,237,288,229,517
06,06357,063571704,General Pueyrredón,BUENOS AIRES,199,253,326,310,636
06,06357,063571708,General Pueyrredón,BUENOS AIRES,249,316,392,383,775
06,06357,063571903,General Pueyrredón,BUENOS AIRES,155,403,206,159,365
06,06357,063572214,General Pueyrredón,BUENOS AIRES,204,459,209,140,349
06,06357,063573209,General Pueyrredón,BUENOS AIRES,252,350,332,225,557
06,06357,063573401,General Pueyrredón,BUENOS AIRES,176,248,231,174,405
06,06357,063573501,General Pueyrredón,BUENOS AIRES,256,819,280,197,477
06,06357,063574006,General Pueyrredón,BUENOS AIRES,161,744,170,108,278
06,06357,063574302,General Pueyrredón,BUENOS AIRES,89,225,123,108,231
06,06357,063574408,General Pueyrredón,BUENOS AIRES,126,229,198,198,396
06,06357,063574502,General Pueyrredón,BUENOS AIRES,184,269,259,224,483
06,06357,063574509,General Pueyrredón,BUENOS AIRES,336,391,518,491,1009
06,06357,063574603,General Pueyrredón,BUENOS AIRES,238,381,353,280,633
06,06357,063574704,General Pueyrredón,BUENOS AIRES,261,329,355,312,667
06,06357,063574801,General Pueyrredón,BUENOS AIRES,363,447,528,411,939
06,06357,063574805,General Pueyrredón,BUENOS AIRES,204,234,291,228,519
06,06357,063574808,General Pueyrredón,BUENOS AIRES,197,236,269,229,498
06,06357,063574815,General Pueyrredón,BUENOS AIRES,214,268,285,234,519
06,06357,063575001,General Pueyrredón,BUENOS AIRES,257,307,382,327,709
06,06357,063575013,General Pueyrredón,BUENOS AIRES,192,220,307,258,565
06,06357,063575101,General Pueyrredón,BUENOS AIRES,237,281,366,345,711
06,06357,063575212,General Pueyrredón,BUENOS AIRES,324,333,578,563,1141
06,06357,063575305,General Pueyrredón,BUENOS AIRES,264,302,408,410,818
06,06357,063575311,General Pueyrredón,BUENOS AIRES,329,348,564,554,1118
06,06357,063575314,General Pueyrredón,BUENOS AIRES,234,239,411,402,813
06,06357,063575401,General Pueyrredón,BUENOS AIRES,301,324,456,435,891
06,06357,063575506,General Pueyrredón,BUENOS AIRES,257,270,446,374,820
06,06357,063575606,General Pueyrredón,BUENOS AIRES,284,330,425,342,767
06,06357,063575708,General Pueyrredón,BUENOS AIRES,208,237,297,245,542
06,06357,063575805,General Pueyrredón,BUENOS AIRES,350,392,505,459,964
06,06357,063575904,General Pueyrredón,BUENOS AIRES,291,372,408,358,766
06,06357,063576009,General Pueyrredón,BUENOS AIRES,212,236,362,294,656
06,06357,063576106,General Pueyrredón,BUENOS AIRES,373,454,611,573,1184
06,06357,063576204,General Pueyrredón,BUENOS AIRES,292,344,450,381,831
06,06357,063576208,General Pueyrredón,BUENOS AIRES,183,234,269,243,512
06,06357,063576301,General Pueyrredón,BUENOS AIRES,4,5,13,46,59
06,06357,063576504,General Pueyrredón,BUENOS AIRES,334,455,539,471,1010
06,06357,063576704,General Pueyrredón,BUENOS AIRES,302,320,529,505,1034
06,06357,063576707,General Pueyrredón,BUENOS AIRES,402,417,673,687,1360
06,06357,063576708,General Pueyrredón,BUENOS AIRES,252,259,436,401,837
06,06357,063576711,General Pueyrredón,BUENOS AIRES,379,385,750,659,1409
06,06357,063576901,General Pueyrredón,BUENOS AIRES,240,249,438,386,824
06,06357,063576911,General Pueyrredón,BUENOS AIRES,194,214,343,328,671
06,06357,063577004,General Pueyrredón,BUENOS AIRES,419,462,675,584,1259
06,06357,063577006,General Pueyrredón,BUENOS AIRES,253,273,395,383,778
06,06357,063577007,General Pueyrredón,BUENOS AIRES,380,407,602,554,1156
06,06357,063577103,General Pueyrredón,BUENOS AIRES,397,437,610,544,1154
06,06357,063577105,General Pueyrredón,BUENOS AIRES,269,292,449,412,861
06,06357,063577107,General Pueyrredón,BUENOS AIRES,321,321,492,460,952
06,06357,063577108,General Pueyrredón,BUENOS AIRES,424,455,655,552,1207
06,06357,063577201,General Pueyrredón,BUENOS AIRES,289,299,594,573,1167
06,06357,063577306,General Pueyrredón,BUENOS AIRES,347,378,687,680,1367
06,06357,063577307,General Pueyrredón,BUENOS AIRES,71,95,123,136,259
06,06357,063577401,General Pueyrredón,BUENOS AIRES,336,465,509,474,983
06,06357,063577403,General Pueyrredón,BUENOS AIRES,228,256,368,382,750
06,06357,063577416,General Pueyrredón,BUENOS AIRES,158,251,249,278,527
06,06357,063577505,General Pueyrredón,BUENOS AIRES,64,276,123,124,247
06,06357,063577507,General Pueyrredón,BUENOS AIRES,196,356,312,285,597
06,06357,063577509,General Pueyrredón,BUENOS AIRES,82,243,121,106,227
06,06357,063577516,General Pueyrredón,BUENOS AIRES,58,159,78,92,170
06,06357,063577610,General Pueyrredón,BUENOS AIRES,242,443,375,356,731
06,06357,063577708,General Pueyrredón,BUENOS AIRES,42,139,61,75,136
06,06357,063577716,General Pueyrredón,BUENOS AIRES,66,314,671,1065,1736
06,06357,063577803,General Pueyrredón,BUENOS AIRES,111,126,199,220,419
06,06357,063577810,General Pueyrredón,BUENOS AIRES,296,307,594,602,1196
06,06357,063577816,General Pueyrredón,BUENOS AIRES,207,208,406,416,822
06,06357,063578014,General Pueyrredón,BUENOS AIRES,137,176,199,234,433
06,06357,063578012,General Pueyrredón,BUENOS AIRES,100,147,144,160,304
06,06357,063578208,General Pueyrredón,BUENOS AIRES,90,210,114,108,222
06,06357,063578209,General Pueyrredón,BUENOS AIRES,67,166,98,93,191
06,06357,063577705,General Pueyrredón,BUENOS AIRES,52,83,62,83,145
06,06357,063578105,General Pueyrredón,BUENOS AIRES,70,93,97,113,210
06,06357,063574002,General Pueyrredón,BUENOS AIRES,246,603,274,261,535
06,06357,063573703,General Pueyrredón,BUENOS AIRES,206,448,245,163,408
06,06357,063573705,General Pueyrredón,BUENOS AIRES,213,651,243,164,407
06,06357,063573903,General Pueyrredón,BUENOS AIRES,168,459,189,138,327
06,06357,063572104,General Pueyrredón,BUENOS AIRES,131,238,171,153,324
06,06357,063573509,General Pueyrredón,BUENOS AIRES,239,576,261,186,447
06,06357,063576113,General Pueyrredón,BUENOS AIRES,238,372,351,280,631
06,06357,063577910,General Pueyrredón,BUENOS AIRES,228,254,463,472,935
06,06357,063572802,General Pueyrredón,BUENOS AIRES,133,648,191,130,321
06,06357,063572805,General Pueyrredón,BUENOS AIRES,201,581,190,154,344
06,06357,063573004,General Pueyrredón,BUENOS AIRES,182,395,203,154,357
06,06357,063573005,General Pueyrredón,BUENOS AIRES,159,290,188,117,305
06,06357,063573007,General Pueyrredón,BUENOS AIRES,130,282,147,102,249
06,06357,063573009,General Pueyrredón,BUENOS AIRES,213,438,248,147,395
06,06357,063573105,General Pueyrredón,BUENOS AIRES,208,410,221,165,386
06,06357,063573109,General Pueyrredón,BUENOS AIRES,258,647,248,186,434
06,06357,063570108,General Pueyrredón,BUENOS AIRES,341,396,569,548,1117
06,06357,063570109,General Pueyrredón,BUENOS AIRES,255,318,459,430,889
06,06357,063570305,General Pueyrredón,BUENOS AIRES,227,313,376,347,723
06,06357,063570310,General Pueyrredón,BUENOS AIRES,290,368,473,434,907
06,06357,063570402,General Pueyrredón,BUENOS AIRES,171,360,223,225,448
06,06357,063570405,General Pueyrredón,BUENOS AIRES,154,224,221,216,437
06,06357,063570505,General Pueyrredón,BUENOS AIRES,191,241,283,263,546
06,06357,063570506,General Pueyrredón,BUENOS AIRES,237,294,360,326,686
06,06357,063570508,General Pueyrredón,BUENOS AIRES,196,247,344,275,619
06,06357,063570801,General Pueyrredón,BUENOS AIRES,370,330,608,625,1233
06,06357,063570807,General Pueyrredón,BUENOS AIRES,320,355,542,447,989
06,06357,063570813,General Pueyrredón,BUENOS AIRES,213,239,356,328,684
06,06357,063570814,General Pueyrredón,BUENOS AIRES,150,178,243,205,448
06,06357,063570901,General Pueyrredón,BUENOS AIRES,426,464,723,707,1430
06,06357,063571006,General Pueyrredón,BUENOS AIRES,394,408,653,639,1292
06,06357,063571103,General Pueyrredón,BUENOS AIRES,252,267,460,454,914
06,06357,063571108,General Pueyrredón,BUENOS AIRES,210,227,386,349,735
06,06357,063571215,General Pueyrredón,BUENOS AIRES,380,364,777,684,1461
06,06357,063571302,General Pueyrredón,BUENOS AIRES,309,358,437,370,807
06,06357,063571401,General Pueyrredón,BUENOS AIRES,375,455,521,489,1010
06,06357,063571405,General Pueyrredón,BUENOS AIRES,219,287,300,309,609
06,06357,063571501,General Pueyrredón,BUENOS AIRES,351,391,478,461,939
06,06357,063571504,General Pueyrredón,BUENOS AIRES,352,405,560,459,1019
06,06357,063572002,General Pueyrredón,BUENOS AIRES,329,666,380,272,652
06,06357,063572003,General Pueyrredón,BUENOS AIRES,174,344,213,136,349
06,06357,063573205,General Pueyrredón,BUENOS AIRES,139,217,134,95,229
06,06357,063573302,General Pueyrredón,BUENOS AIRES,338,442,428,367,795
06,06357,063573303,General Pueyrredón,BUENOS AIRES,305,396,428,341,769
06,06357,063573309,General Pueyrredón,BUENOS AIRES,180,263,241,183,424
06,06357,063573403,General Pueyrredón,BUENOS AIRES,151,242,164,111,275
06,06357,063574101,General Pueyrredón,BUENOS AIRES,299,676,438,380,818
06,06357,063574107,General Pueyrredón,BUENOS AIRES,115,461,128,122,250
06,06357,063574204,General Pueyrredón,BUENOS AIRES,68,220,70,51,121
06,06357,063574308,General Pueyrredón,BUENOS AIRES,47,265,54,43,97
06,06357,063574601,General Pueyrredón,BUENOS AIRES,178,245,243,168,411
06,06357,063574608,General Pueyrredón,BUENOS AIRES,202,281,246,179,425
06,06357,063574609,General Pueyrredón,BUENOS AIRES,274,365,431,321,752
06,06357,063574613,General Pueyrredón,BUENOS AIRES,195,312,279,207,486
06,06357,063574705,General Pueyrredón,BUENOS AIRES,348,464,462,342,804
06,06357,063574709,General Pueyrredón,BUENOS AIRES,300,371,399,315,714
06,06357,063574804,General Pueyrredón,BUENOS AIRES,147,172,240,183,423
06,06357,063574902,General Pueyrredón,BUENOS AIRES,311,370,470,393,863
06,06357,063575011,General Pueyrredón,BUENOS AIRES,155,184,218,203,421
06,06357,063575102,General Pueyrredón,BUENOS AIRES,284,357,391,394,785
06,06357,063575312,General Pueyrredón,BUENOS AIRES,366,437,582,604,1186
06,06357,063575402,General Pueyrredón,BUENOS AIRES,325,319,544,443,987
06,06357,063575508,General Pueyrredón,BUENOS AIRES,438,502,666,629,1295
06,06357,063575602,General Pueyrredón,BUENOS AIRES,352,370,501,448,949
06,06357,063575609,General Pueyrredón,BUENOS AIRES,286,318,421,339,760
06,06357,063575709,General Pueyrredón,BUENOS AIRES,376,434,524,531,1055
06,06357,063575710,General Pueyrredón,BUENOS AIRES,237,263,363,302,665
06,06357,063575804,General Pueyrredón,BUENOS AIRES,298,346,412,361,773
06,06357,063575806,General Pueyrredón,BUENOS AIRES,355,396,508,447,955
06,06357,063576001,General Pueyrredón,BUENOS AIRES,321,375,497,438,935
06,06357,063576107,General Pueyrredón,BUENOS AIRES,160,197,288,267,555
06,06357,063576203,General Pueyrredón,BUENOS AIRES,169,231,262,244,506
06,06357,063576207,General Pueyrredón,BUENOS AIRES,229,282,356,344,700
06,06357,063576209,General Pueyrredón,BUENOS AIRES,261,351,381,338,719
06,06357,063576309,General Pueyrredón,BUENOS AIRES,55,320,66,59,125
06,06357,063576407,General Pueyrredón,BUENOS AIRES,170,356,281,262,543
06,06357,063576410,General Pueyrredón,BUENOS AIRES,66,207,106,91,197
06,06357,063576509,General Pueyrredón,BUENOS AIRES,262,473,418,397,815
06,06357,063576604,General Pueyrredón,BUENOS AIRES,352,393,542,518,1060
06,06357,063576709,General Pueyrredón,BUENOS AIRES,291,295,502,493,995
06,06357,063576714,General Pueyrredón,BUENOS AIRES,206,205,386,330,716
06,06357,063576803,General Pueyrredón,BUENOS AIRES,251,251,434,381,815
06,06357,063576804,General Pueyrredón,BUENOS AIRES,200,194,289,265,554
06,06357,063576807,General Pueyrredón,BUENOS AIRES,275,291,446,418,864
06,06357,063576903,General Pueyrredón,BUENOS AIRES,194,199,333,331,664
06,06357,063576908,General Pueyrredón,BUENOS AIRES,289,296,502,474,976
06,06357,063576910,General Pueyrredón,BUENOS AIRES,326,313,644,585,1229
06,06357,063577010,General Pueyrredón,BUENOS AIRES,241,217,393,366,759
06,06357,063577104,General Pueyrredón,BUENOS AIRES,408,424,646,539,1185
06,06357,063577106,General Pueyrredón,BUENOS AIRES,394,392,739,668,1407
06,06357,063577302,General Pueyrredón,BUENOS AIRES,369,448,677,685,1362
06,06357,063577506,General Pueyrredón,BUENOS AIRES,128,310,195,208,403
06,06357,063577512,General Pueyrredón,BUENOS AIRES,162,272,262,268,530
06,06357,063577515,General Pueyrredón,BUENOS AIRES,74,167,118,93,211
06,06357,063577602,General Pueyrredón,BUENOS AIRES,153,247,275,248,523
06,06357,063577609,General Pueyrredón,BUENOS AIRES,138,324,208,226,434
06,06357,063577709,General Pueyrredón,BUENOS AIRES,130,333,179,166,345
06,06357,063577711,General Pueyrredón,BUENOS AIRES,61,157,69,90,159
06,06357,063577901,General Pueyrredón,BUENOS AIRES,2,4,2,3,5
06,06357,063577902,General Pueyrredón,BUENOS AIRES,284,349,466,437,903
06,06357,063578008,General Pueyrredón,BUENOS AIRES,180,202,299,303,602
06,06357,063578018,General Pueyrredón,BUENOS AIRES,102,177,180,173,353
06,06357,063578107,General Pueyrredón,BUENOS AIRES,124,174,206,218,424
06,06357,063578109,General Pueyrredón,BUENOS AIRES,162,190,271,272,543
06,06357,063578114,General Pueyrredón,BUENOS AIRES,340,373,618,607,1225
06,06357,063578207,General Pueyrredón,BUENOS AIRES,78,160,114,95,209
06,06357,063577903,General Pueyrredón,BUENOS AIRES,84,110,109,147,256
06,06357,063573704,General Pueyrredón,BUENOS AIRES,143,398,144,113,257
06,06357,063573904,General Pueyrredón,BUENOS AIRES,290,709,345,217,562
06,06357,063570404,General Pueyrredón,BUENOS AIRES,160,250,238,216,454
06,06357,063570611,General Pueyrredón,BUENOS AIRES,290,320,411,411,822
06,06357,063572007,General Pueyrredón,BUENOS AIRES,151,422,178,141,319
06,06357,063571106,General Pueyrredón,BUENOS AIRES,333,349,603,653,1256
06,06357,063572105,General Pueyrredón,BUENOS AIRES,304,481,411,356,767
06,06357,063575901,General Pueyrredón,BUENOS AIRES,353,456,437,356,793
06,06357,063572202,General Pueyrredón,BUENOS AIRES,110,325,145,103,248
06,06357,063577617,General Pueyrredón,BUENOS AIRES,67,159,88,93,181
06,06357,063572903,General Pueyrredón,BUENOS AIRES,137,415,157,121,278
06,06357,063573006,General Pueyrredón,BUENOS AIRES,247,387,298,179,477
06,06357,063571204,General Pueyrredón,BUENOS AIRES,274,299,394,400,794
06,06357,063570207,General Pueyrredón,BUENOS AIRES,213,251,340,332,672
06,06357,063570208,General Pueyrredón,BUENOS AIRES,191,211,303,272,575
06,06357,063573108,General Pueyrredón,BUENOS AIRES,253,560,290,186,476
06,06357,063570204,General Pueyrredón,BUENOS AIRES,343,423,663,569,1232
06,06357,063571202,General Pueyrredón,BUENOS AIRES,196,214,315,275,590
06,06357,063570202,General Pueyrredón,BUENOS AIRES,258,297,452,424,876
06,06357,063570210,General Pueyrredón,BUENOS AIRES,244,283,394,386,780
06,06357,063570309,General Pueyrredón,BUENOS AIRES,363,456,608,540,1148
06,06357,063570407,General Pueyrredón,BUENOS AIRES,266,459,393,366,759
06,06357,063570408,General Pueyrredón,BUENOS AIRES,304,419,458,445,903
06,06357,063570501,General Pueyrredón,BUENOS AIRES,370,406,561,565,1126
06,06357,063570502,General Pueyrredón,BUENOS AIRES,340,387,616,531,1147
06,06357,063570604,General Pueyrredón,BUENOS AIRES,381,429,634,549,1183
06,06357,063570707,General Pueyrredón,BUENOS AIRES,282,294,430,442,872
06,06357,063570709,General Pueyrredón,BUENOS AIRES,424,463,678,676,1354
06,06357,063570710,General Pueyrredón,BUENOS AIRES,308,317,532,501,1033
06,06357,063571004,General Pueyrredón,BUENOS AIRES,298,358,544,546,1090
06,06357,063571010,General Pueyrredón,BUENOS AIRES,225,247,388,371,759
06,06357,063571102,General Pueyrredón,BUENOS AIRES,336,355,599,590,1189
06,06357,063571105,General Pueyrredón,BUENOS AIRES,327,320,585,578,1163
06,06357,063573702,General Pueyrredón,BUENOS AIRES,221,649,218,143,361
06,06357,063571210,General Pueyrredón,BUENOS AIRES,338,376,719,705,1424
06,06357,063571211,General Pueyrredón,BUENOS AIRES,372,398,841,756,1597
06,06357,063571511,General Pueyrredón,BUENOS AIRES,163,191,220,175,395
06,06357,063571606,General Pueyrredón,BUENOS AIRES,217,253,300,249,549
06,06357,063571612,General Pueyrredón,BUENOS AIRES,158,208,207,161,368
06,06357,063571707,General Pueyrredón,BUENOS AIRES,172,230,233,232,465
06,06357,063571802,General Pueyrredón,BUENOS AIRES,191,404,318,227,545
06,06357,063572008,General Pueyrredón,BUENOS AIRES,44,180,48,45,93
06,06357,063571803,General Pueyrredón,BUENOS AIRES,140,314,174,169,343
06,06357,063571804,General Pueyrredón,BUENOS AIRES,224,338,329,266,595
06,06357,063571810,General Pueyrredón,BUENOS AIRES,209,468,275,226,501
06,06357,063571902,General Pueyrredón,BUENOS AIRES,166,347,241,202,443
06,06357,063571904,General Pueyrredón,BUENOS AIRES,82,332,88,83,171
06,06357,063571908,General Pueyrredón,BUENOS AIRES,209,376,247,207,454
06,06357,063572005,General Pueyrredón,BUENOS AIRES,104,257,104,74,178
06,06357,063572604,General Pueyrredón,BUENOS AIRES,276,754,292,163,455
06,06357,063573207,General Pueyrredón,BUENOS AIRES,226,371,263,187,450
06,06357,063573307,General Pueyrredón,BUENOS AIRES,277,436,320,235,555
06,06357,063573502,General Pueyrredón,BUENOS AIRES,314,928,339,238,577
06,06357,063573503,General Pueyrredón,BUENOS AIRES,156,364,174,118,292
06,06357,063574008,General Pueyrredón,BUENOS AIRES,194,685,201,153,354
06,06357,063574203,General Pueyrredón,BUENOS AIRES,92,265,113,94,207
06,06357,063574306,General Pueyrredón,BUENOS AIRES,104,284,156,121,277
06,06357,063574404,General Pueyrredón,BUENOS AIRES,235,334,376,350,726
06,06357,063574405,General Pueyrredón,BUENOS AIRES,210,436,337,284,621
06,06357,063574407,General Pueyrredón,BUENOS AIRES,151,371,211,191,402
06,06357,063574606,General Pueyrredón,BUENOS AIRES,309,420,446,307,753
06,06357,063574610,General Pueyrredón,BUENOS AIRES,260,316,324,271,595
06,06357,063574708,General Pueyrredón,BUENOS AIRES,287,421,387,297,684
06,06357,063574811,General Pueyrredón,BUENOS AIRES,299,368,393,346,739
06,06357,063574813,General Pueyrredón,BUENOS AIRES,210,234,296,243,539
06,06357,063574814,General Pueyrredón,BUENOS AIRES,237,278,333,271,604
06,06357,063574901,General Pueyrredón,BUENOS AIRES,234,279,347,294,641
06,06357,063575003,General Pueyrredón,BUENOS AIRES,301,368,447,391,838
06,06357,063575008,General Pueyrredón,BUENOS AIRES,534,563,918,846,1764
06,06357,063575012,General Pueyrredón,BUENOS AIRES,352,389,572,465,1037
06,06357,063575104,General Pueyrredón,BUENOS AIRES,285,339,451,369,820
06,06357,063575109,General Pueyrredón,BUENOS AIRES,418,461,655,617,1272
06,06357,063575205,General Pueyrredón,BUENOS AIRES,283,288,450,431,881
06,06357,063575211,General Pueyrredón,BUENOS AIRES,361,373,675,705,1380
06,06357,063575213,General Pueyrredón,BUENOS AIRES,340,314,634,605,1239
06,06357,063575301,General Pueyrredón,BUENOS AIRES,332,357,500,495,995
06,06357,063575313,General Pueyrredón,BUENOS AIRES,251,271,428,430,858
06,06357,063575316,General Pueyrredón,BUENOS AIRES,256,269,491,510,1001
06,06357,063575502,General Pueyrredón,BUENOS AIRES,272,307,379,301,680
06,06357,063575504,General Pueyrredón,BUENOS AIRES,438,511,607,533,1140
06,06357,063575507,General Pueyrredón,BUENOS AIRES,227,247,359,324,683
06,06357,063575611,General Pueyrredón,BUENOS AIRES,397,453,570,473,1043
06,06357,063575703,General Pueyrredón,BUENOS AIRES,280,301,391,351,742
06,06357,063575704,General Pueyrredón,BUENOS AIRES,417,467,603,538,1141
06,06357,063575802,General Pueyrredón,BUENOS AIRES,277,343,402,328,730
06,06357,063575908,General Pueyrredón,BUENOS AIRES,309,373,440,367,807
06,06357,063576007,General Pueyrredón,BUENOS AIRES,315,385,460,409,869
06,06357,063576010,General Pueyrredón,BUENOS AIRES,246,272,393,378,771
06,06357,063576109,General Pueyrredón,BUENOS AIRES,210,243,334,278,612
06,06357,063576408,General Pueyrredón,BUENOS AIRES,140,332,207,194,401
06,06357,063576601,General Pueyrredón,BUENOS AIRES,285,323,458,448,906
06,06357,063576703,General Pueyrredón,BUENOS AIRES,322,361,529,534,1063
06,06357,063576712,General Pueyrredón,BUENOS AIRES,332,344,608,581,1189
06,06357,063576808,General Pueyrredón,BUENOS AIRES,234,265,397,335,732
06,06357,063576810,General Pueyrredón,BUENOS AIRES,325,336,582,524,1106
06,06357,063576909,General Pueyrredón,BUENOS AIRES,289,291,506,500,1006
06,06357,063577008,General Pueyrredón,BUENOS AIRES,375,398,551,517,1068
06,06357,063577011,General Pueyrredón,BUENOS AIRES,261,241,443,423,866
06,06357,063577109,General Pueyrredón,BUENOS AIRES,421,464,696,672,1368
06,06357,063577110,General Pueyrredón,BUENOS AIRES,301,282,506,580,1086
06,06357,063577202,General Pueyrredón,BUENOS AIRES,327,314,632,627,1259
06,06357,063577203,General Pueyrredón,BUENOS AIRES,256,236,512,521,1033
06,06357,063577204,General Pueyrredón,BUENOS AIRES,370,331,670,638,1308
06,06357,063577211,General Pueyrredón,BUENOS AIRES,348,378,609,607,1216
06,06357,063577407,General Pueyrredón,BUENOS AIRES,224,269,374,389,763
06,06357,063577412,General Pueyrredón,BUENOS AIRES,163,250,280,241,521
06,06357,063577414,General Pueyrredón,BUENOS AIRES,330,436,518,520,1038
06,06357,063577418,General Pueyrredón,BUENOS AIRES,177,278,267,276,543
06,06357,063577503,General Pueyrredón,BUENOS AIRES,27,217,38,32,70
06,06357,063577513,General Pueyrredón,BUENOS AIRES,151,264,236,218,454
06,06357,063577514,General Pueyrredón,BUENOS AIRES,92,201,140,130,270
06,06357,063577612,General Pueyrredón,BUENOS AIRES,89,218,134,127,261
06,06357,063578202,General Pueyrredón,BUENOS AIRES,47,102,66,74,140
06,06357,063577911,General Pueyrredón,BUENOS AIRES,165,175,270,276,546
06,06357,063577808,General Pueyrredón,BUENOS AIRES,200,308,310,340,650
06,06357,063577809,General Pueyrredón,BUENOS AIRES,233,244,564,2020,2584
06,06357,063578005,General Pueyrredón,BUENOS AIRES,406,472,681,693,1374
06,06357,063578007,General Pueyrredón,BUENOS AIRES,175,196,321,307,628
06,06357,063578011,General Pueyrredón,BUENOS AIRES,143,215,209,231,440
06,06357,063578013,General Pueyrredón,BUENOS AIRES,156,192,272,303,575
06,06357,063578205,General Pueyrredón,BUENOS AIRES,266,351,455,493,948
06,06357,063578210,General Pueyrredón,BUENOS AIRES,72,134,95,92,187
06,06357,063578101,General Pueyrredón,BUENOS AIRES,95,118,134,178,312
06,06357,063578015,General Pueyrredón,BUENOS AIRES,3,4,13,39,52
06,06357,063572009,General Pueyrredón,BUENOS AIRES,92,334,109,88,197
06,06357,063573803,General Pueyrredón,BUENOS AIRES,212,765,208,165,373
06,06357,063573901,General Pueyrredón,BUENOS AIRES,206,705,214,132,346
06,06357,063573906,General Pueyrredón,BUENOS AIRES,93,265,179,119,298
06,06357,063572103,General Pueyrredón,BUENOS AIRES,214,317,266,207,473
06,06357,063573907,General Pueyrredón,BUENOS AIRES,209,441,323,277,600
06,06357,063571603,General Pueyrredón,BUENOS AIRES,288,374,388,295,683
06,06357,063572603,General Pueyrredón,BUENOS AIRES,264,740,290,193,483
06,06357,063573601,General Pueyrredón,BUENOS AIRES,247,578,279,199,478
06,06357,063573604,General Pueyrredón,BUENOS AIRES,253,936,257,188,445
06,06357,063572108,General Pueyrredón,BUENOS AIRES,216,386,273,177,450
06,06357,063576112,General Pueyrredón,BUENOS AIRES,84,93,178,165,343
06,06357,063572201,General Pueyrredón,BUENOS AIRES,194,388,221,201,422
06,06357,063572203,General Pueyrredón,BUENOS AIRES,193,529,232,195,427
06,06357,063572801,General Pueyrredón,BUENOS AIRES,246,894,255,190,445
06,06357,063573003,General Pueyrredón,BUENOS AIRES,77,150,90,70,160
06,06357,063573102,General Pueyrredón,BUENOS AIRES,213,392,256,172,428
06,06357,063573103,General Pueyrredón,BUENOS AIRES,179,320,185,138,323
06,06357,063573201,General Pueyrredón,BUENOS AIRES,243,374,325,233,558
06,06357,063570101,General Pueyrredón,BUENOS AIRES,260,272,421,451,872
06,06357,063570303,General Pueyrredón,BUENOS AIRES,129,246,169,172,341
06,06357,063570406,General Pueyrredón,BUENOS AIRES,187,251,316,235,551
06,06357,063570503,General Pueyrredón,BUENOS AIRES,251,288,377,322,699
06,06357,063570510,General Pueyrredón,BUENOS AIRES,306,429,461,467,928
06,06357,063570511,General Pueyrredón,BUENOS AIRES,171,262,235,219,454
06,06357,063570605,General Pueyrredón,BUENOS AIRES,260,273,420,373,793
06,06357,063570610,General Pueyrredón,BUENOS AIRES,313,358,492,457,949
06,06357,063570702,General Pueyrredón,BUENOS AIRES,346,398,525,539,1064
06,06357,063570703,General Pueyrredón,BUENOS AIRES,261,298,455,411,866
06,06357,063570705,General Pueyrredón,BUENOS AIRES,379,415,681,604,1285
06,06357,063570802,General Pueyrredón,BUENOS AIRES,281,267,481,446,927
06,06357,063570808,General Pueyrredón,BUENOS AIRES,262,291,398,348,746
06,06357,063570809,General Pueyrredón,BUENOS AIRES,350,408,521,485,1006
06,06357,063570902,General Pueyrredón,BUENOS AIRES,318,296,611,607,1218
06,06357,063570909,General Pueyrredón,BUENOS AIRES,304,320,574,512,1086
06,06357,063570910,General Pueyrredón,BUENOS AIRES,379,386,704,676,1380
06,06357,063570913,General Pueyrredón,BUENOS AIRES,308,311,518,519,1037
06,06357,063571001,General Pueyrredón,BUENOS AIRES,228,257,340,373,713
06,06357,063571007,General Pueyrredón,BUENOS AIRES,286,258,549,607,1156
06,06357,063571008,General Pueyrredón,BUENOS AIRES,406,407,776,826,1602
06,06357,063571207,General Pueyrredón,BUENOS AIRES,327,327,551,561,1112
06,06357,063571304,General Pueyrredón,BUENOS AIRES,472,519,744,676,1420
06,06357,063571402,General Pueyrredón,BUENOS AIRES,328,373,489,411,900
06,06357,063571403,General Pueyrredón,BUENOS AIRES,422,463,671,603,1274
06,06357,063571409,General Pueyrredón,BUENOS AIRES,319,387,477,374,851
06,06357,063571508,General Pueyrredón,BUENOS AIRES,361,431,486,423,909
06,06357,063571510,General Pueyrredón,BUENOS AIRES,303,372,446,393,839
06,06357,063571608,General Pueyrredón,BUENOS AIRES,218,283,335,271,606
06,06357,063571610,General Pueyrredón,BUENOS AIRES,166,228,214,173,387
06,06357,063571801,General Pueyrredón,BUENOS AIRES,282,394,372,327,699
06,06357,063571808,General Pueyrredón,BUENOS AIRES,310,398,479,355,834
06,06357,063571901,General Pueyrredón,BUENOS AIRES,288,456,397,323,720
06,06357,063571907,General Pueyrredón,BUENOS AIRES,234,368,370,305,675
06,06357,063571911,General Pueyrredón,BUENOS AIRES,146,512,186,152,338
06,06357,063572001,General Pueyrredón,BUENOS AIRES,178,371,243,177,420
06,06357,063572006,General Pueyrredón,BUENOS AIRES,112,344,114,97,211
06,06357,063572304,General Pueyrredón,BUENOS AIRES,166,421,163,127,290
06,06357,063572306,General Pueyrredón,BUENOS AIRES,176,741,169,145,314
06,06357,063572403,General Pueyrredón,BUENOS AIRES,156,714,145,115,260
06,06357,063573204,General Pueyrredón,BUENOS AIRES,311,459,366,236,602
06,06357,063573206,General Pueyrredón,BUENOS AIRES,219,343,242,151,393
06,06357,063573208,General Pueyrredón,BUENOS AIRES,117,214,139,89,228
06,06357,063573210,General Pueyrredón,BUENOS AIRES,200,329,253,171,424
06,06357,063573304,General Pueyrredón,BUENOS AIRES,306,445,362,287,649
06,06357,063573405,General Pueyrredón,BUENOS AIRES,176,275,225,161,386
06,06357,063573505,General Pueyrredón,BUENOS AIRES,269,456,314,235,549
06,06357,063573506,General Pueyrredón,BUENOS AIRES,217,404,249,161,410
06,06357,063574104,General Pueyrredón,BUENOS AIRES,207,1000,213,176,389
06,06357,063574105,General Pueyrredón,BUENOS AIRES,208,1051,183,142,325
06,06357,063574207,General Pueyrredón,BUENOS AIRES,93,233,196,131,327
06,06357,063574402,General Pueyrredón,BUENOS AIRES,74,131,130,103,233
06,06357,063574506,General Pueyrredón,BUENOS AIRES,315,470,401,316,717
06,06357,063574515,General Pueyrredón,BUENOS AIRES,162,402,210,160,370
06,06357,063574807,General Pueyrredón,BUENOS AIRES,199,243,311,225,536
06,06357,063574810,General Pueyrredón,BUENOS AIRES,321,429,445,360,805
06,06357,063574905,General Pueyrredón,BUENOS AIRES,287,386,427,363,790
06,06357,063574908,General Pueyrredón,BUENOS AIRES,246,324,326,283,609
06,06357,063575002,General Pueyrredón,BUENOS AIRES,310,369,428,430,858
06,06357,063575009,General Pueyrredón,BUENOS AIRES,624,640,1114,959,2073
06,06357,063575014,General Pueyrredón,BUENOS AIRES,201,241,303,254,557
06,06357,063575103,General Pueyrredón,BUENOS AIRES,358,402,563,453,1016
06,06357,063575107,General Pueyrredón,BUENOS AIRES,360,383,617,623,1240
06,06357,063575201,General Pueyrredón,BUENOS AIRES,432,452,866,879,1745
06,06357,063575207,General Pueyrredón,BUENOS AIRES,382,401,617,609,1226
06,06357,063575209,General Pueyrredón,BUENOS AIRES,243,264,484,482,966
06,06357,063575303,General Pueyrredón,BUENOS AIRES,378,436,624,567,1191
06,06357,063575308,General Pueyrredón,BUENOS AIRES,346,363,577,593,1170
06,06357,063575309,General Pueyrredón,BUENOS AIRES,413,460,718,681,1399
06,06357,063575403,General Pueyrredón,BUENOS AIRES,369,396,643,520,1163
06,06357,063575404,General Pueyrredón,BUENOS AIRES,401,463,628,564,1192
06,06357,063575405,General Pueyrredón,BUENOS AIRES,280,320,434,388,822
06,06357,063575408,General Pueyrredón,BUENOS AIRES,232,257,355,315,670
06,06357,063575505,General Pueyrredón,BUENOS AIRES,185,207,277,259,536
06,06357,063575605,General Pueyrredón,BUENOS AIRES,288,356,393,344,737
06,06357,063575608,General Pueyrredón,BUENOS AIRES,322,379,497,414,911
06,06357,063575612,General Pueyrredón,BUENOS AIRES,287,344,421,339,760
06,06357,063575803,General Pueyrredón,BUENOS AIRES,280,331,377,313,690
06,06357,063576006,General Pueyrredón,BUENOS AIRES,337,393,491,446,937
06,06357,063576011,General Pueyrredón,BUENOS AIRES,230,258,382,355,737
06,06357,063576102,General Pueyrredón,BUENOS AIRES,388,447,567,485,1052
06,06357,063576202,General Pueyrredón,BUENOS AIRES,188,201,296,285,581
06,06357,063576205,General Pueyrredón,BUENOS AIRES,276,335,418,357,775
06,06357,063576206,General Pueyrredón,BUENOS AIRES,267,335,470,349,819
06,06357,063576302,General Pueyrredón,BUENOS AIRES,56,277,113,106,219
06,06357,063576304,General Pueyrredón,BUENOS AIRES,124,341,201,171,372
06,06357,063576403,General Pueyrredón,BUENOS AIRES,201,273,346,336,682
06,06357,063576409,General Pueyrredón,BUENOS AIRES,81,257,116,107,223
06,06357,063576605,General Pueyrredón,BUENOS AIRES,263,291,420,373,793
06,06357,063576503,General Pueyrredón,BUENOS AIRES,3,3,1,7,8
06,06357,063576505,General Pueyrredón,BUENOS AIRES,216,247,342,320,662
06,06357,063576511,General Pueyrredón,BUENOS AIRES,199,297,291,284,575
06,06357,063576514,General Pueyrredón,BUENOS AIRES,98,337,136,139,275
06,06357,063576603,General Pueyrredón,BUENOS AIRES,408,430,696,575,1271
06,06357,063576701,General Pueyrredón,BUENOS AIRES,186,219,295,287,582
06,06357,063576809,General Pueyrredón,BUENOS AIRES,280,274,448,426,874
06,06357,063577002,General Pueyrredón,BUENOS AIRES,341,349,503,500,1003
06,06357,063577013,General Pueyrredón,BUENOS AIRES,267,270,499,435,934
06,06357,063577209,General Pueyrredón,BUENOS AIRES,371,401,672,660,1332
06,06357,063577405,General Pueyrredón,BUENOS AIRES,224,247,422,443,865
06,06357,063577406,General Pueyrredón,BUENOS AIRES,389,420,746,776,1522
06,06357,063577411,General Pueyrredón,BUENOS AIRES,131,200,228,203,431
06,06357,063577413,General Pueyrredón,BUENOS AIRES,211,358,306,333,639
06,06357,063577510,General Pueyrredón,BUENOS AIRES,73,185,157,138,295
06,06357,063577511,General Pueyrredón,BUENOS AIRES,112,264,165,157,322
06,06357,063577604,General Pueyrredón,BUENOS AIRES,103,301,140,137,277
06,06357,063577812,General Pueyrredón,BUENOS AIRES,428,439,809,824,1633
06,06357,063577814,General Pueyrredón,BUENOS AIRES,342,338,677,673,1350
06,06357,063577905,General Pueyrredón,BUENOS AIRES,225,264,419,456,875
06,06357,063577914,General Pueyrredón,BUENOS AIRES,427,450,751,727,1478
06,06357,063577915,General Pueyrredón,BUENOS AIRES,560,556,1030,1019,2049
06,06357,063578006,General Pueyrredón,BUENOS AIRES,326,375,558,564,1122
06,06357,063578009,General Pueyrredón,BUENOS AIRES,129,155,235,247,482
06,06357,063578112,General Pueyrredón,BUENOS AIRES,168,217,295,267,562
06,06357,063578204,General Pueyrredón,BUENOS AIRES,175,218,277,322,599
06,06357,063578302,General Pueyrredón,BUENOS AIRES,141,165,261,248,509
06,06357,063577704,General Pueyrredón,BUENOS AIRES,43,68,62,66,128
06,06357,063577806,General Pueyrredón,BUENOS AIRES,52,67,71,108,179
06,06154,061540401,Carlos Tejedor,BUENOS AIRES,46,91,59,65,124
06,06154,061540402,Carlos Tejedor,BUENOS AIRES,141,207,204,198,402
06,06154,061540501,Carlos Tejedor,BUENOS AIRES,14,42,17,22,39
06,06154,061540701,Carlos Tejedor,BUENOS AIRES,22,51,24,33,57
06,06154,061540901,Carlos Tejedor,BUENOS AIRES,27,35,30,45,75
06,06154,061540102,Carlos Tejedor,BUENOS AIRES,108,139,174,172,346
06,06154,061540103,Carlos Tejedor,BUENOS AIRES,14,29,27,24,51
06,06154,061540207,Carlos Tejedor,BUENOS AIRES,15,20,22,24,46
06,06154,061540403,Carlos Tejedor,BUENOS AIRES,10,40,13,21,34
06,06154,061540702,Carlos Tejedor,BUENOS AIRES,22,56,25,34,59
06,06154,061540806,Carlos Tejedor,BUENOS AIRES,35,56,37,61,98
06,06154,061540104,Carlos Tejedor,BUENOS AIRES,13,33,14,21,35
06,06154,061540204,Carlos Tejedor,BUENOS AIRES,23,34,39,41,80
06,06154,061540804,Carlos Tejedor,BUENOS AIRES,16,20,17,25,42
06,06154,061540611,Carlos Tejedor,BUENOS AIRES,195,221,303,295,598
06,06154,061540601,Carlos Tejedor,BUENOS AIRES,165,181,249,286,535
06,06154,061540605,Carlos Tejedor,BUENOS AIRES,140,165,184,169,353
06,06154,061540802,Carlos Tejedor,BUENOS AIRES,46,64,73,85,158
06,06154,061540208,Carlos Tejedor,BUENOS AIRES,30,35,43,38,81
06,06154,061540404,Carlos Tejedor,BUENOS AIRES,12,47,14,20,34
06,06154,061540703,Carlos Tejedor,BUENOS AIRES,15,29,23,25,48
06,06154,061540205,Carlos Tejedor,BUENOS AIRES,133,153,243,224,467
06,06154,061540202,Carlos Tejedor,BUENOS AIRES,141,164,206,217,423
06,06154,061540602,Carlos Tejedor,BUENOS AIRES,146,163,221,221,442
06,06154,061540206,Carlos Tejedor,BUENOS AIRES,9,11,13,15,28
06,06154,061540302,Carlos Tejedor,BUENOS AIRES,32,47,42,53,95
06,06154,061540803,Carlos Tejedor,BUENOS AIRES,19,33,27,34,61
06,06154,061540603,Carlos Tejedor,BUENOS AIRES,177,204,240,224,464
06,06154,061540606,Carlos Tejedor,BUENOS AIRES,60,69,69,61,130
06,06154,061540608,Carlos Tejedor,BUENOS AIRES,200,220,279,258,537
06,06154,061540301,Carlos Tejedor,BUENOS AIRES,24,33,36,47,83
06,06154,061540609,Carlos Tejedor,BUENOS AIRES,20,36,19,31,50
06,06154,061540101,Carlos Tejedor,BUENOS AIRES,133,154,185,181,366
06,06154,061540201,Carlos Tejedor,BUENOS AIRES,342,388,506,482,988
06,06154,061540209,Carlos Tejedor,BUENOS AIRES,352,412,482,470,952
06,06154,061540210,Carlos Tejedor,BUENOS AIRES,140,167,203,220,423
06,06154,061540801,Carlos Tejedor,BUENOS AIRES,92,116,129,135,264
06,06154,061540203,Carlos Tejedor,BUENOS AIRES,23,25,24,32,56
06,06154,061540805,Carlos Tejedor,BUENOS AIRES,22,28,27,37,64
06,06154,061540105,Carlos Tejedor,BUENOS AIRES,21,33,29,36,65
06,06154,061540610,Carlos Tejedor,BUENOS AIRES,120,196,225,221,446
06,06154,061540612,Carlos Tejedor,BUENOS AIRES,249,280,376,347,723
06,06154,061540604,Carlos Tejedor,BUENOS AIRES,137,168,167,155,322
06,06154,061540607,Carlos Tejedor,BUENOS AIRES,235,260,372,332,704
06,06154,061540405,Carlos Tejedor,BUENOS AIRES,17,15,23,23,46
06,06154,061540502,Carlos Tejedor,BUENOS AIRES,12,21,13,20,33
06,06154,061540902,Carlos Tejedor,BUENOS AIRES,11,20,17,26,43
06,06161,061610105,Carmen de Areco,BUENOS AIRES,174,209,288,281,569
06,06161,061610113,Carmen de Areco,BUENOS AIRES,299,342,458,417,875
06,06161,061610101,Carmen de Areco,BUENOS AIRES,184,198,313,309,622
06,06161,061610106,Carmen de Areco,BUENOS AIRES,266,293,416,403,819
06,06161,061610302,Carmen de Areco,BUENOS AIRES,8,20,6,12,18
06,06161,061610602,Carmen de Areco,BUENOS AIRES,10,21,9,17,26
06,06161,061610702,Carmen de Areco,BUENOS AIRES,20,25,26,37,63
06,06161,061610604,Carmen de Areco,BUENOS AIRES,13,25,13,28,41
06,06161,061610107,Carmen de Areco,BUENOS AIRES,164,195,231,224,455
06,06161,061610402,Carmen de Areco,BUENOS AIRES,25,51,40,42,82
06,06161,061610701,Carmen de Areco,BUENOS AIRES,26,57,40,47,87
06,06161,061610204,Carmen de Areco,BUENOS AIRES,17,20,21,37,58
06,06161,061610401,Carmen de Areco,BUENOS AIRES,26,34,33,37,70
06,06161,061610502,Carmen de Areco,BUENOS AIRES,7,11,15,12,27
06,06161,061610803,Carmen de Areco,BUENOS AIRES,2,7,2,4,6
06,06161,061610804,Carmen de Areco,BUENOS AIRES,14,20,24,21,45
06,06161,061610102,Carmen de Areco,BUENOS AIRES,208,238,322,328,650
06,06161,061610301,Carmen de Areco,BUENOS AIRES,30,41,37,54,91
06,06161,061610405,Carmen de Areco,BUENOS AIRES,47,71,65,79,144
06,06161,061610504,Carmen de Areco,BUENOS AIRES,33,41,49,62,111
06,06161,061610802,Carmen de Areco,BUENOS AIRES,16,21,22,27,49
06,06161,061610108,Carmen de Areco,BUENOS AIRES,173,201,249,215,464
06,06161,061610115,Carmen de Areco,BUENOS AIRES,148,152,281,284,565
06,06161,061610117,Carmen de Areco,BUENOS AIRES,349,391,553,500,1053
06,06161,061610503,Carmen de Areco,BUENOS AIRES,7,14,14,12,26
06,06161,061610703,Carmen de Areco,BUENOS AIRES,11,32,19,20,39
06,06161,061610104,Carmen de Areco,BUENOS AIRES,129,134,223,208,431
06,06161,061610112,Carmen de Areco,BUENOS AIRES,164,209,287,310,597
06,06161,061610116,Carmen de Areco,BUENOS AIRES,200,240,328,337,665
06,06161,061610501,Carmen de Areco,BUENOS AIRES,14,33,19,24,43
06,06161,061610201,Carmen de Areco,BUENOS AIRES,11,13,21,18,39
06,06161,061610403,Carmen de Areco,BUENOS AIRES,176,229,289,296,585
06,06161,061610406,Carmen de Areco,BUENOS AIRES,131,176,182,230,412
06,06161,061610103,Carmen de Areco,BUENOS AIRES,203,235,322,289,611
06,06161,061610111,Carmen de Areco,BUENOS AIRES,230,245,422,429,851
06,06161,061610118,Carmen de Areco,BUENOS AIRES,109,143,180,166,346
06,06161,061610603,Carmen de Areco,BUENOS AIRES,6,12,6,5,11
06,06161,061610202,Carmen de Areco,BUENOS AIRES,11,15,11,14,25
06,06161,061610203,Carmen de Areco,BUENOS AIRES,7,16,10,7,17
06,06161,061610605,Carmen de Areco,BUENOS AIRES,24,33,34,44,78
06,06161,061610601,Carmen de Areco,BUENOS AIRES,111,124,170,169,339
06,06161,061610606,Carmen de Areco,BUENOS AIRES,28,37,38,41,79
06,06161,061610109,Carmen de Areco,BUENOS AIRES,275,338,440,367,807
06,06161,061610110,Carmen de Areco,BUENOS AIRES,182,196,303,314,617
06,06161,061610114,Carmen de Areco,BUENOS AIRES,217,252,341,324,665
06,06161,061610404,Carmen de Areco,BUENOS AIRES,85,99,141,156,297
06,06161,061610801,Carmen de Areco,BUENOS AIRES,41,62,51,71,122
06,06539,065391709,Merlo,BUENOS AIRES,181,196,269,243,512
06,06539,065390113,Merlo,BUENOS AIRES,267,249,470,452,922
06,06539,065393107,Merlo,BUENOS AIRES,462,474,913,941,1854
06,06539,065390902,Merlo,BUENOS AIRES,154,153,292,304,596
06,06539,065391209,Merlo,BUENOS AIRES,340,323,747,738,1485
06,06539,065391309,Merlo,BUENOS AIRES,212,211,468,449,917
06,06539,065391402,Merlo,BUENOS AIRES,203,214,331,305,636
06,06539,065391405,Merlo,BUENOS AIRES,234,252,358,364,722
06,06539,065391409,Merlo,BUENOS AIRES,470,470,858,792,1650
06,06539,065391508,Merlo,BUENOS AIRES,246,298,364,319,683
06,06539,065391602,Merlo,BUENOS AIRES,429,434,711,654,1365
06,06539,065391604,Merlo,BUENOS AIRES,191,243,284,237,521
06,06539,065391611,Merlo,BUENOS AIRES,351,420,501,420,921
06,06539,065391704,Merlo,BUENOS AIRES,307,254,556,546,1102
06,06539,065391705,Merlo,BUENOS AIRES,355,369,623,601,1224
06,06539,065391707,Merlo,BUENOS AIRES,234,226,438,453,891
06,06539,065391708,Merlo,BUENOS AIRES,247,263,420,404,824
06,06539,065391803,Merlo,BUENOS AIRES,416,369,792,715,1507
06,06539,065391908,Merlo,BUENOS AIRES,282,281,503,484,987
06,06539,065391909,Merlo,BUENOS AIRES,290,300,516,512,1028
06,06539,065392003,Merlo,BUENOS AIRES,282,291,502,460,962
06,06539,065392005,Merlo,BUENOS AIRES,291,287,561,522,1083
06,06539,065392107,Merlo,BUENOS AIRES,281,312,458,424,882
06,06539,065392201,Merlo,BUENOS AIRES,478,489,793,808,1601
06,06539,065392208,Merlo,BUENOS AIRES,481,458,858,805,1663
06,06539,065392413,Merlo,BUENOS AIRES,260,247,551,542,1093
06,06539,065392503,Merlo,BUENOS AIRES,481,453,928,854,1782
06,06539,065392504,Merlo,BUENOS AIRES,250,266,422,431,853
06,06539,065392602,Merlo,BUENOS AIRES,450,489,827,925,1752
06,06539,065392603,Merlo,BUENOS AIRES,279,271,547,599,1146
06,06539,065392608,Merlo,BUENOS AIRES,395,406,757,742,1499
06,06539,065392701,Merlo,BUENOS AIRES,471,391,897,854,1751
06,06539,065392704,Merlo,BUENOS AIRES,348,321,632,606,1238
06,06539,065392810,Merlo,BUENOS AIRES,434,401,786,799,1585
06,06539,065392912,Merlo,BUENOS AIRES,73,90,153,168,321
06,06539,065392915,Merlo,BUENOS AIRES,150,138,287,301,588
06,06539,065392916,Merlo,BUENOS AIRES,385,420,748,760,1508
06,06539,065393003,Merlo,BUENOS AIRES,300,312,570,541,1111
06,06539,065393109,Merlo,BUENOS AIRES,335,342,690,692,1382
06,06539,065393205,Merlo,BUENOS AIRES,386,348,864,828,1692
06,06539,065393301,Merlo,BUENOS AIRES,332,348,582,552,1134
06,06539,065393306,Merlo,BUENOS AIRES,295,285,574,588,1162
06,06539,065393311,Merlo,BUENOS AIRES,150,162,289,341,630
06,06539,065393410,Merlo,BUENOS AIRES,322,325,598,605,1203
06,06539,065393412,Merlo,BUENOS AIRES,304,302,570,597,1167
06,06539,065393413,Merlo,BUENOS AIRES,379,398,644,621,1265
06,06539,065390105,Merlo,BUENOS AIRES,401,416,692,652,1344
06,06539,065390108,Merlo,BUENOS AIRES,335,317,646,626,1272
06,06539,065390305,Merlo,BUENOS AIRES,366,395,532,451,983
06,06539,065390307,Merlo,BUENOS AIRES,342,404,509,420,929
06,06539,065390609,Merlo,BUENOS AIRES,284,294,467,461,928
06,06539,065390707,Merlo,BUENOS AIRES,207,202,366,347,713
06,06539,065390809,Merlo,BUENOS AIRES,384,340,685,692,1377
06,06539,065390904,Merlo,BUENOS AIRES,382,342,716,702,1418
06,06539,065391001,Merlo,BUENOS AIRES,370,339,727,684,1411
06,06539,065391005,Merlo,BUENOS AIRES,231,232,352,372,724
06,06539,065391012,Merlo,BUENOS AIRES,508,494,939,943,1882
06,06539,065391203,Merlo,BUENOS AIRES,356,318,669,624,1293
06,06539,065391015,Merlo,BUENOS AIRES,283,267,589,592,1181
06,06539,065393405,Merlo,BUENOS AIRES,361,358,710,722,1432
06,06539,065391210,Merlo,BUENOS AIRES,337,332,629,666,1295
06,06539,065391301,Merlo,BUENOS AIRES,472,493,860,808,1668
06,06539,065391302,Merlo,BUENOS AIRES,276,282,511,505,1016
06,06539,065391304,Merlo,BUENOS AIRES,378,382,740,734,1474
06,06539,065391307,Merlo,BUENOS AIRES,319,320,561,523,1084
06,06539,065391414,Merlo,BUENOS AIRES,271,274,487,478,965
06,06539,065391502,Merlo,BUENOS AIRES,274,335,359,321,680
06,06539,065391503,Merlo,BUENOS AIRES,195,224,297,222,519
06,06539,065391506,Merlo,BUENOS AIRES,245,294,323,287,610
06,06539,065391703,Merlo,BUENOS AIRES,310,298,564,532,1096
06,06539,065391711,Merlo,BUENOS AIRES,243,244,390,373,763
06,06539,065391714,Merlo,BUENOS AIRES,238,218,406,346,752
06,06539,065391805,Merlo,BUENOS AIRES,393,369,665,667,1332
06,06539,065392009,Merlo,BUENOS AIRES,441,431,825,818,1643
06,06539,065392010,Merlo,BUENOS AIRES,446,397,904,875,1779
06,06539,065392013,Merlo,BUENOS AIRES,260,250,492,488,980
06,06539,065392014,Merlo,BUENOS AIRES,254,253,499,521,1020
06,06539,065392312,Merlo,BUENOS AIRES,426,375,870,876,1746
06,06539,065392401,Merlo,BUENOS AIRES,476,488,875,789,1664
06,06539,065392406,Merlo,BUENOS AIRES,285,297,498,476,974
06,06539,065392407,Merlo,BUENOS AIRES,276,243,518,474,992
06,06539,065392408,Merlo,BUENOS AIRES,243,206,464,415,879
06,06539,065392510,Merlo,BUENOS AIRES,349,352,707,671,1378
06,06539,065392607,Merlo,BUENOS AIRES,479,477,906,949,1855
06,06539,065392609,Merlo,BUENOS AIRES,358,346,699,690,1389
06,06539,065392702,Merlo,BUENOS AIRES,352,339,748,787,1535
06,06539,065392707,Merlo,BUENOS AIRES,361,364,682,675,1357
06,06539,065392801,Merlo,BUENOS AIRES,268,256,561,515,1076
06,06539,065393007,Merlo,BUENOS AIRES,197,212,362,397,759
06,06539,065393011,Merlo,BUENOS AIRES,335,340,574,597,1171
06,06539,065393104,Merlo,BUENOS AIRES,479,482,903,948,1851
06,06539,065393206,Merlo,BUENOS AIRES,395,381,792,842,1634
06,06539,065393212,Merlo,BUENOS AIRES,44,52,70,84,154
06,06539,065393307,Merlo,BUENOS AIRES,425,431,766,789,1555
06,06539,065393312,Merlo,BUENOS AIRES,338,370,576,557,1133
06,06539,065393313,Merlo,BUENOS AIRES,396,409,679,658,1337
06,06539,065393406,Merlo,BUENOS AIRES,337,294,640,704,1344
06,06539,065393408,Merlo,BUENOS AIRES,382,375,746,756,1502
06,06539,065390107,Merlo,BUENOS AIRES,308,267,644,692,1336
06,06539,065390204,Merlo,BUENOS AIRES,437,483,741,703,1444
06,06539,065390208,Merlo,BUENOS AIRES,433,442,671,579,1250
06,06539,065390304,Merlo,BUENOS AIRES,335,316,674,668,1342
06,06539,065390308,Merlo,BUENOS AIRES,191,216,293,246,539
06,06539,065390410,Merlo,BUENOS AIRES,267,284,428,341,769
06,06539,065390506,Merlo,BUENOS AIRES,270,271,439,404,843
06,06539,065390602,Merlo,BUENOS AIRES,250,261,420,409,829
06,06539,065390701,Merlo,BUENOS AIRES,410,423,674,552,1226
06,06539,065390802,Merlo,BUENOS AIRES,294,310,467,452,919
06,06539,065390808,Merlo,BUENOS AIRES,544,488,1063,991,2054
06,06539,065390813,Merlo,BUENOS AIRES,331,325,624,652,1276
06,06539,065390905,Merlo,BUENOS AIRES,389,359,713,746,1459
06,06539,065390908,Merlo,BUENOS AIRES,447,424,837,887,1724
06,06539,065390911,Merlo,BUENOS AIRES,191,133,504,412,916
06,06539,065390912,Merlo,BUENOS AIRES,371,336,749,700,1449
06,06539,065391013,Merlo,BUENOS AIRES,425,397,838,815,1653
06,06539,065391108,Merlo,BUENOS AIRES,528,420,954,948,1902
06,06539,065391110,Merlo,BUENOS AIRES,374,354,730,707,1437
06,06539,065391111,Merlo,BUENOS AIRES,378,362,680,665,1345
06,06539,065391113,Merlo,BUENOS AIRES,336,308,603,589,1192
06,06539,065391115,Merlo,BUENOS AIRES,404,409,736,739,1475
06,06539,065392903,Merlo,BUENOS AIRES,77,74,168,146,314
06,06539,065391007,Merlo,BUENOS AIRES,717,710,1415,1498,2913
06,06539,065390412,Merlo,BUENOS AIRES,273,285,475,402,877
06,06539,065391205,Merlo,BUENOS AIRES,314,318,603,562,1165
06,06539,065391207,Merlo,BUENOS AIRES,318,332,570,552,1122
06,06539,065391208,Merlo,BUENOS AIRES,378,406,752,710,1462
06,06539,065391407,Merlo,BUENOS AIRES,499,463,950,819,1769
06,06539,065391510,Merlo,BUENOS AIRES,212,232,310,275,585
06,06539,065391607,Merlo,BUENOS AIRES,409,445,611,527,1138
06,06539,065391706,Merlo,BUENOS AIRES,282,268,512,488,1000
06,06539,065391807,Merlo,BUENOS AIRES,414,415,790,781,1571
06,06539,065391901,Merlo,BUENOS AIRES,329,317,549,526,1075
06,06539,065391904,Merlo,BUENOS AIRES,292,305,518,482,1000
06,06539,065391906,Merlo,BUENOS AIRES,259,257,507,503,1010
06,06539,065391907,Merlo,BUENOS AIRES,315,282,555,521,1076
06,06539,065392102,Merlo,BUENOS AIRES,235,253,406,355,761
06,06539,065392314,Merlo,BUENOS AIRES,332,291,623,666,1289
06,06539,065392402,Merlo,BUENOS AIRES,283,292,513,486,999
06,06539,065392613,Merlo,BUENOS AIRES,204,206,402,403,805
06,06539,065392703,Merlo,BUENOS AIRES,396,411,795,777,1572
06,06539,065392805,Merlo,BUENOS AIRES,362,342,695,727,1422
06,06539,065392812,Merlo,BUENOS AIRES,294,301,532,513,1045
06,06539,065392909,Merlo,BUENOS AIRES,132,147,244,269,513
06,06539,065392910,Merlo,BUENOS AIRES,39,46,85,82,167
06,06539,065392911,Merlo,BUENOS AIRES,191,201,388,397,785
06,06539,065392924,Merlo,BUENOS AIRES,478,409,836,828,1664
06,06539,065393004,Merlo,BUENOS AIRES,404,421,750,749,1499
06,06539,065393014,Merlo,BUENOS AIRES,502,419,1002,923,1925
06,06539,065393204,Merlo,BUENOS AIRES,309,278,616,646,1262
06,06539,065393403,Merlo,BUENOS AIRES,334,332,672,688,1360
06,06539,065393404,Merlo,BUENOS AIRES,329,311,633,657,1290
06,06539,065390106,Merlo,BUENOS AIRES,428,362,833,793,1626
06,06539,065390205,Merlo,BUENOS AIRES,268,263,436,430,866
06,06539,065390209,Merlo,BUENOS AIRES,211,230,313,298,611
06,06539,065390210,Merlo,BUENOS AIRES,240,251,394,354,748
06,06539,065390213,Merlo,BUENOS AIRES,264,269,392,385,777
06,06539,065390501,Merlo,BUENOS AIRES,279,292,431,400,831
06,06539,065390408,Merlo,BUENOS AIRES,385,406,563,500,1063
06,06539,065390502,Merlo,BUENOS AIRES,413,443,653,599,1252
06,06539,065390803,Merlo,BUENOS AIRES,377,377,670,605,1275
06,06539,065390901,Merlo,BUENOS AIRES,23,16,51,79,130
06,06539,065390907,Merlo,BUENOS AIRES,571,518,1142,1025,2167
06,06539,065391009,Merlo,BUENOS AIRES,439,415,879,887,1766
06,06539,065391106,Merlo,BUENOS AIRES,242,247,455,456,911
06,06539,065391107,Merlo,BUENOS AIRES,512,524,937,896,1833
06,06539,065391201,Merlo,BUENOS AIRES,346,334,689,651,1340
06,06539,065392907,Merlo,BUENOS AIRES,142,172,246,263,509
06,06539,065392914,Merlo,BUENOS AIRES,241,241,481,488,969
06,06539,065392917,Merlo,BUENOS AIRES,21,18,30,39,69
06,06539,065392923,Merlo,BUENOS AIRES,315,320,539,476,1015
06,06539,065391308,Merlo,BUENOS AIRES,360,368,557,518,1075
06,06539,065391408,Merlo,BUENOS AIRES,347,310,634,610,1244
06,06539,065391415,Merlo,BUENOS AIRES,271,273,488,467,955
06,06539,065391509,Merlo,BUENOS AIRES,257,263,394,320,714
06,06539,065391601,Merlo,BUENOS AIRES,237,260,397,370,767
06,06539,065391712,Merlo,BUENOS AIRES,255,268,377,349,726
06,06539,065391804,Merlo,BUENOS AIRES,308,342,510,458,968
06,06539,065391806,Merlo,BUENOS AIRES,402,396,714,745,1459
06,06539,065392006,Merlo,BUENOS AIRES,366,337,689,652,1341
06,06539,065392008,Merlo,BUENOS AIRES,464,448,823,793,1616
06,06539,065392101,Merlo,BUENOS AIRES,277,293,458,421,879
06,06539,065392207,Merlo,BUENOS AIRES,477,436,807,787,1594
06,06539,065392303,Merlo,BUENOS AIRES,310,311,565,597,1162
06,06539,065392313,Merlo,BUENOS AIRES,357,317,744,752,1496
06,06539,065392404,Merlo,BUENOS AIRES,424,391,788,777,1565
06,06539,065392405,Merlo,BUENOS AIRES,300,292,573,540,1113
06,06539,065392507,Merlo,BUENOS AIRES,329,353,602,601,1203
06,06539,065392512,Merlo,BUENOS AIRES,220,223,470,438,908
06,06539,065392606,Merlo,BUENOS AIRES,344,343,666,657,1323
06,06539,065392905,Merlo,BUENOS AIRES,92,102,185,196,381
06,06539,065392908,Merlo,BUENOS AIRES,111,116,200,204,404
06,06539,065393316,Merlo,BUENOS AIRES,14,18,23,21,44
06,06539,065392925,Merlo,BUENOS AIRES,309,276,562,593,1155
06,06539,065393105,Merlo,BUENOS AIRES,321,350,573,564,1137
06,06539,065393108,Merlo,BUENOS AIRES,282,289,576,560,1136
06,06539,065393209,Merlo,BUENOS AIRES,235,226,428,457,885
06,06539,065393416,Merlo,BUENOS AIRES,45,56,79,77,156
06,06539,065390201,Merlo,BUENOS AIRES,238,247,382,369,751
06,06539,065390207,Merlo,BUENOS AIRES,391,370,650,579,1229
06,06539,065390310,Merlo,BUENOS AIRES,439,468,695,642,1337
06,06539,065390407,Merlo,BUENOS AIRES,185,249,265,189,454
06,06539,065390504,Merlo,BUENOS AIRES,343,341,603,514,1117
06,06539,065390507,Merlo,BUENOS AIRES,404,414,632,611,1243
06,06539,065390509,Merlo,BUENOS AIRES,418,439,646,590,1236
06,06539,065390601,Merlo,BUENOS AIRES,442,424,707,629,1336
06,06539,065390607,Merlo,BUENOS AIRES,484,458,828,800,1628
06,06539,065390704,Merlo,BUENOS AIRES,543,502,925,900,1825
06,06539,065390804,Merlo,BUENOS AIRES,262,266,474,443,917
06,06539,065390815,Merlo,BUENOS AIRES,310,292,561,584,1145
06,06539,065391003,Merlo,BUENOS AIRES,354,331,752,746,1498
06,06539,065391116,Merlo,BUENOS AIRES,409,382,731,739,1470
06,06539,065391204,Merlo,BUENOS AIRES,497,489,951,944,1895
06,06539,065391011,Merlo,BUENOS AIRES,445,434,857,841,1698
06,06539,065391016,Merlo,BUENOS AIRES,458,547,897,904,1801
06,06539,065391202,Merlo,BUENOS AIRES,300,298,507,518,1025
06,06539,065391609,Merlo,BUENOS AIRES,215,223,365,324,689
06,06539,065392712,Merlo,BUENOS AIRES,430,382,845,801,1646
06,06539,065392922,Merlo,BUENOS AIRES,362,355,638,642,1280
06,06539,065391406,Merlo,BUENOS AIRES,431,424,737,655,1392
06,06539,065391504,Merlo,BUENOS AIRES,385,502,769,687,1456
06,06539,065391507,Merlo,BUENOS AIRES,314,415,449,362,811
06,06539,065391710,Merlo,BUENOS AIRES,290,294,505,437,942
06,06539,065391606,Merlo,BUENOS AIRES,297,480,364,312,676
06,06539,065391701,Merlo,BUENOS AIRES,314,307,627,600,1227
06,06539,065391713,Merlo,BUENOS AIRES,268,293,429,372,801
06,06539,065391801,Merlo,BUENOS AIRES,360,348,777,690,1467
06,06539,065391802,Merlo,BUENOS AIRES,347,308,623,594,1217
06,06539,065391903,Merlo,BUENOS AIRES,308,312,546,536,1082
06,06539,065392001,Merlo,BUENOS AIRES,244,235,426,390,816
06,06539,065392011,Merlo,BUENOS AIRES,379,386,749,700,1449
06,06539,065392203,Merlo,BUENOS AIRES,448,470,820,693,1513
06,06539,065392206,Merlo,BUENOS AIRES,436,455,752,670,1422
06,06539,065392308,Merlo,BUENOS AIRES,335,319,656,652,1308
06,06539,065392309,Merlo,BUENOS AIRES,359,341,692,702,1394
06,06539,065392502,Merlo,BUENOS AIRES,331,303,674,626,1300
06,06539,065392612,Merlo,BUENOS AIRES,394,396,756,748,1504
06,06539,065392706,Merlo,BUENOS AIRES,407,374,800,783,1583
06,06539,065392901,Merlo,BUENOS AIRES,37,53,74,77,151
06,06539,065392920,Merlo,BUENOS AIRES,444,438,897,856,1753
06,06539,065393013,Merlo,BUENOS AIRES,364,378,679,719,1398
06,06539,065393015,Merlo,BUENOS AIRES,323,326,515,501,1016
06,06539,065393016,Merlo,BUENOS AIRES,342,362,605,575,1180
06,06539,065393103,Merlo,BUENOS AIRES,365,373,743,752,1495
06,06539,065393110,Merlo,BUENOS AIRES,380,390,747,731,1478
06,06539,065393202,Merlo,BUENOS AIRES,394,318,802,765,1567
06,06539,065393207,Merlo,BUENOS AIRES,385,316,796,793,1589
06,06539,065393315,Merlo,BUENOS AIRES,160,151,304,333,637
06,06539,065393411,Merlo,BUENOS AIRES,302,291,632,572,1204
06,06539,065393415,Merlo,BUENOS AIRES,265,301,558,460,1018
06,06539,065393417,Merlo,BUENOS AIRES,299,296,538,556,1094
06,06539,065393418,Merlo,BUENOS AIRES,214,209,396,392,788
06,06539,065390114,Merlo,BUENOS AIRES,381,399,641,520,1161
06,06539,065390202,Merlo,BUENOS AIRES,233,223,385,403,788
06,06539,065390303,Merlo,BUENOS AIRES,283,296,471,451,922
06,06539,065390306,Merlo,BUENOS AIRES,280,327,408,321,729
06,06539,065390401,Merlo,BUENOS AIRES,452,472,774,692,1466
06,06539,065390403,Merlo,BUENOS AIRES,404,414,631,550,1181
06,06539,065390404,Merlo,BUENOS AIRES,449,447,807,732,1539
06,06539,065390411,Merlo,BUENOS AIRES,348,369,508,435,943
06,06539,065390604,Merlo,BUENOS AIRES,281,249,474,487,961
06,06539,065390608,Merlo,BUENOS AIRES,352,337,623,629,1252
06,06539,065390708,Merlo,BUENOS AIRES,323,309,518,499,1017
06,06539,065390709,Merlo,BUENOS AIRES,451,491,713,623,1336
06,06539,065390801,Merlo,BUENOS AIRES,224,227,389,369,758
06,06539,065390806,Merlo,BUENOS AIRES,274,265,549,508,1057
06,06539,065391004,Merlo,BUENOS AIRES,314,291,576,557,1133
06,06539,065391104,Merlo,BUENOS AIRES,331,324,633,608,1241
06,06539,065390413,Merlo,BUENOS AIRES,249,252,366,298,664
06,06539,065390909,Merlo,BUENOS AIRES,92,89,169,178,347
06,06539,065391212,Merlo,BUENOS AIRES,402,395,747,684,1431
06,06539,065391213,Merlo,BUENOS AIRES,320,288,628,609,1237
06,06539,065391404,Merlo,BUENOS AIRES,227,256,364,357,721
06,06539,065391410,Merlo,BUENOS AIRES,266,281,424,397,821
06,06539,065391411,Merlo,BUENOS AIRES,269,289,441,402,843
06,06539,065391505,Merlo,BUENOS AIRES,152,238,257,191,448
06,06539,065391608,Merlo,BUENOS AIRES,220,254,375,303,678
06,06539,065391610,Merlo,BUENOS AIRES,319,347,466,409,875
06,06539,065391702,Merlo,BUENOS AIRES,332,297,593,582,1175
06,06539,065391809,Merlo,BUENOS AIRES,395,365,719,678,1397
06,06539,065392007,Merlo,BUENOS AIRES,216,226,341,324,665
06,06539,065392108,Merlo,BUENOS AIRES,241,252,392,381,773
06,06539,065392304,Merlo,BUENOS AIRES,282,263,553,529,1082
06,06539,065392409,Merlo,BUENOS AIRES,234,204,460,466,926
06,06539,065392410,Merlo,BUENOS AIRES,251,215,463,437,900
06,06539,065392411,Merlo,BUENOS AIRES,295,294,547,540,1087
06,06539,065392415,Merlo,BUENOS AIRES,466,445,942,912,1854
06,06539,065392508,Merlo,BUENOS AIRES,382,399,714,713,1427
06,06539,065392511,Merlo,BUENOS AIRES,263,267,476,468,944
06,06539,065392601,Merlo,BUENOS AIRES,452,451,790,751,1541
06,06539,065392604,Merlo,BUENOS AIRES,268,263,581,563,1144
06,06539,065392711,Merlo,BUENOS AIRES,392,313,771,728,1499
06,06539,065392802,Merlo,BUENOS AIRES,328,327,636,567,1203
06,06539,065392803,Merlo,BUENOS AIRES,303,308,596,575,1171
06,06539,065392902,Merlo,BUENOS AIRES,55,64,104,152,256
06,06539,065392913,Merlo,BUENOS AIRES,56,32,112,106,218
06,06539,065392919,Merlo,BUENOS AIRES,213,219,423,408,831
06,06539,065392921,Merlo,BUENOS AIRES,344,322,715,700,1415
06,06539,065393010,Merlo,BUENOS AIRES,324,336,565,535,1100
06,06539,065393111,Merlo,BUENOS AIRES,385,404,736,680,1416
06,06539,065393112,Merlo,BUENOS AIRES,366,411,629,583,1212
06,06539,065393115,Merlo,BUENOS AIRES,296,314,573,617,1190
06,06539,065393116,Merlo,BUENOS AIRES,387,392,751,743,1494
06,06539,065393203,Merlo,BUENOS AIRES,415,359,920,910,1830
06,06539,065393214,Merlo,BUENOS AIRES,275,295,505,496,1001
06,06539,065393302,Merlo,BUENOS AIRES,278,264,566,493,1059
06,06539,065393305,Merlo,BUENOS AIRES,203,192,379,388,767
06,06539,065393308,Merlo,BUENOS AIRES,407,411,831,787,1618
06,06539,065393309,Merlo,BUENOS AIRES,438,455,891,918,1809
06,06539,065393401,Merlo,BUENOS AIRES,322,316,601,595,1196
06,06539,065393409,Merlo,BUENOS AIRES,383,364,786,829,1615
06,06539,065390104,Merlo,BUENOS AIRES,287,306,561,507,1068
06,06539,065390110,Merlo,BUENOS AIRES,248,233,477,447,924
06,06539,065390206,Merlo,BUENOS AIRES,434,456,662,613,1275
06,06539,065390301,Merlo,BUENOS AIRES,313,327,512,484,996
06,06539,065390414,Merlo,BUENOS AIRES,176,189,271,231,502
06,06539,065390405,Merlo,BUENOS AIRES,308,298,516,488,1004
06,06539,065390508,Merlo,BUENOS AIRES,350,359,537,474,1011
06,06539,065390805,Merlo,BUENOS AIRES,417,393,781,793,1574
06,06539,065390807,Merlo,BUENOS AIRES,273,263,577,506,1083
06,06539,065390810,Merlo,BUENOS AIRES,310,304,569,524,1093
06,06539,065390814,Merlo,BUENOS AIRES,311,316,544,502,1046
06,06539,065391008,Merlo,BUENOS AIRES,539,501,1076,1128,2204
06,06539,065391101,Merlo,BUENOS AIRES,315,314,515,490,1005
06,06539,065391109,Merlo,BUENOS AIRES,359,367,669,659,1328
06,06539,065391112,Merlo,BUENOS AIRES,250,241,443,421,864
06,06539,065391114,Merlo,BUENOS AIRES,440,395,823,832,1655
06,06539,065392509,Merlo,BUENOS AIRES,407,401,876,884,1760
06,06539,065390903,Merlo,BUENOS AIRES,316,269,621,591,1212
06,06539,065392804,Merlo,BUENOS AIRES,396,392,828,789,1617
06,06539,065391206,Merlo,BUENOS AIRES,334,349,558,555,1113
06,06539,065391211,Merlo,BUENOS AIRES,300,312,534,537,1071
06,06539,065391214,Merlo,BUENOS AIRES,345,312,638,609,1247
06,06539,065391303,Merlo,BUENOS AIRES,281,290,534,509,1043
06,06539,065391305,Merlo,BUENOS AIRES,298,273,522,536,1058
06,06539,065391306,Merlo,BUENOS AIRES,317,322,632,624,1256
06,06539,065391401,Merlo,BUENOS AIRES,351,396,525,442,967
06,06539,065391403,Merlo,BUENOS AIRES,305,347,453,371,824
06,06539,065391511,Merlo,BUENOS AIRES,289,303,511,425,936
06,06539,065391603,Merlo,BUENOS AIRES,204,212,304,254,558
06,06539,065391717,Merlo,BUENOS AIRES,237,262,353,312,665
06,06539,065391902,Merlo,BUENOS AIRES,350,340,649,563,1212
06,06539,065392002,Merlo,BUENOS AIRES,12,16,135,110,245
06,06539,065392012,Merlo,BUENOS AIRES,439,424,841,763,1604
06,06539,065392106,Merlo,BUENOS AIRES,267,283,426,393,819
06,06539,065392202,Merlo,BUENOS AIRES,525,503,917,850,1767
06,06539,065392305,Merlo,BUENOS AIRES,428,415,787,768,1555
06,06539,065392306,Merlo,BUENOS AIRES,382,397,730,678,1408
06,06539,065392310,Merlo,BUENOS AIRES,338,314,650,604,1254
06,06539,065392311,Merlo,BUENOS AIRES,353,350,670,689,1359
06,06539,065392414,Merlo,BUENOS AIRES,422,396,838,855,1693
06,06539,065392505,Merlo,BUENOS AIRES,287,283,536,492,1028
06,06539,065392506,Merlo,BUENOS AIRES,280,273,494,517,1011
06,06539,065392605,Merlo,BUENOS AIRES,371,358,689,665,1354
06,06539,065392611,Merlo,BUENOS AIRES,307,316,517,536,1053
06,06539,065392705,Merlo,BUENOS AIRES,317,310,606,578,1184
06,06539,065392708,Merlo,BUENOS AIRES,391,371,773,705,1478
06,06539,065392904,Merlo,BUENOS AIRES,72,86,132,152,284
06,06539,065392806,Merlo,BUENOS AIRES,456,423,921,876,1797
06,06539,065392809,Merlo,BUENOS AIRES,318,307,552,566,1118
06,06539,065392811,Merlo,BUENOS AIRES,399,415,757,743,1500
06,06539,065392906,Merlo,BUENOS AIRES,143,145,270,260,530
06,06539,065393001,Merlo,BUENOS AIRES,451,479,855,817,1672
06,06539,065393006,Merlo,BUENOS AIRES,261,226,486,555,1041
06,06539,065393008,Merlo,BUENOS AIRES,232,247,464,465,929
06,06539,065393009,Merlo,BUENOS AIRES,370,395,655,651,1306
06,06539,065393012,Merlo,BUENOS AIRES,299,290,550,571,1121
06,06539,065393101,Merlo,BUENOS AIRES,375,377,696,689,1385
06,06539,065393102,Merlo,BUENOS AIRES,395,417,763,821,1584
06,06539,065393106,Merlo,BUENOS AIRES,429,431,800,823,1623
06,06539,065393114,Merlo,BUENOS AIRES,241,223,476,464,940
06,06539,065393117,Merlo,BUENOS AIRES,379,401,660,657,1317
06,06539,065393208,Merlo,BUENOS AIRES,363,341,747,767,1514
06,06539,065393303,Merlo,BUENOS AIRES,295,298,566,574,1140
06,06539,065393310,Merlo,BUENOS AIRES,301,309,578,642,1220
06,06539,065390102,Merlo,BUENOS AIRES,361,360,633,568,1201
06,06539,065390203,Merlo,BUENOS AIRES,277,280,530,476,1006
06,06539,065390214,Merlo,BUENOS AIRES,227,246,355,329,684
06,06539,065390302,Merlo,BUENOS AIRES,311,354,530,445,975
06,06539,065390402,Merlo,BUENOS AIRES,478,490,732,613,1345
06,06539,065390409,Merlo,BUENOS AIRES,437,462,691,599,1290
06,06539,065390503,Merlo,BUENOS AIRES,443,454,663,648,1311
06,06539,065390812,Merlo,BUENOS AIRES,819,749,1541,1507,3048
06,06539,065390906,Merlo,BUENOS AIRES,462,400,865,896,1761
06,06539,065390910,Merlo,BUENOS AIRES,388,393,752,800,1552
06,06539,065391002,Merlo,BUENOS AIRES,381,351,763,757,1520
06,06539,065391006,Merlo,BUENOS AIRES,267,254,470,454,924
06,06539,065391010,Merlo,BUENOS AIRES,494,462,941,909,1850
06,06539,065391017,Merlo,BUENOS AIRES,112,161,228,223,451
06,06539,065391103,Merlo,BUENOS AIRES,301,292,528,521,1049
06,06539,065390212,Merlo,BUENOS AIRES,256,270,400,368,768
06,06539,065392204,Merlo,BUENOS AIRES,373,364,602,547,1149
06,06539,065391215,Merlo,BUENOS AIRES,291,264,518,516,1034
06,06539,065391412,Merlo,BUENOS AIRES,271,259,516,518,1034
06,06539,065391413,Merlo,BUENOS AIRES,272,249,509,532,1041
06,06539,065391416,Merlo,BUENOS AIRES,265,281,472,449,921
06,06539,065391501,Merlo,BUENOS AIRES,233,271,334,273,607
06,06539,065391605,Merlo,BUENOS AIRES,213,359,271,234,505
06,06539,065391715,Merlo,BUENOS AIRES,224,243,342,315,657
06,06539,065391716,Merlo,BUENOS AIRES,191,228,252,225,477
06,06539,065391808,Merlo,BUENOS AIRES,402,383,743,729,1472
06,06539,065391905,Merlo,BUENOS AIRES,343,349,628,581,1209
06,06539,065392004,Merlo,BUENOS AIRES,287,270,542,484,1026
06,06539,065392103,Merlo,BUENOS AIRES,426,442,685,610,1295
06,06539,065392104,Merlo,BUENOS AIRES,459,487,761,684,1445
06,06539,065392105,Merlo,BUENOS AIRES,248,256,443,417,860
06,06539,065392205,Merlo,BUENOS AIRES,418,449,739,653,1392
06,06539,065392301,Merlo,BUENOS AIRES,279,291,480,522,1002
06,06539,065392302,Merlo,BUENOS AIRES,360,356,653,693,1346
06,06539,065392307,Merlo,BUENOS AIRES,289,267,587,536,1123
06,06539,065392403,Merlo,BUENOS AIRES,251,237,453,426,879
06,06539,065392412,Merlo,BUENOS AIRES,258,231,501,506,1007
06,06539,065392501,Merlo,BUENOS AIRES,457,475,840,796,1636
06,06539,065392610,Merlo,BUENOS AIRES,345,343,648,642,1290
06,06539,065392614,Merlo,BUENOS AIRES,259,248,506,523,1029
06,06539,065392709,Merlo,BUENOS AIRES,369,314,720,695,1415
06,06539,065392710,Merlo,BUENOS AIRES,316,292,613,579,1192
06,06539,065392807,Merlo,BUENOS AIRES,360,359,703,700,1403
06,06539,065392808,Merlo,BUENOS AIRES,437,441,792,811,1603
06,06539,065392918,Merlo,BUENOS AIRES,265,256,511,557,1068
06,06539,065393002,Merlo,BUENOS AIRES,427,443,839,814,1653
06,06539,065393005,Merlo,BUENOS AIRES,307,325,633,605,1238
06,06539,065393113,Merlo,BUENOS AIRES,339,354,628,651,1279
06,06539,065393201,Merlo,BUENOS AIRES,391,366,778,829,1607
06,06539,065393210,Merlo,BUENOS AIRES,274,266,481,499,980
06,06539,065393211,Merlo,BUENOS AIRES,411,393,833,809,1642
06,06539,065393213,Merlo,BUENOS AIRES,225,218,488,469,957
06,06539,065393215,Merlo,BUENOS AIRES,466,432,874,855,1729
06,06539,065393304,Merlo,BUENOS AIRES,227,236,446,460,906
06,06539,065393314,Merlo,BUENOS AIRES,192,203,340,359,699
06,06539,065393402,Merlo,BUENOS AIRES,334,318,737,727,1464
06,06539,065393407,Merlo,BUENOS AIRES,394,340,724,768,1492
06,06539,065393414,Merlo,BUENOS AIRES,438,434,772,801,1573
06,06539,065390101,Merlo,BUENOS AIRES,386,407,761,752,1513
06,06539,065390103,Merlo,BUENOS AIRES,287,259,523,482,1005
06,06539,065390109,Merlo,BUENOS AIRES,261,241,471,467,938
06,06539,065390111,Merlo,BUENOS AIRES,369,371,631,625,1256
06,06539,065390112,Merlo,BUENOS AIRES,287,277,484,460,944
06,06539,065390211,Merlo,BUENOS AIRES,272,310,479,458,937
06,06539,065390309,Merlo,BUENOS AIRES,278,298,426,387,813
06,06539,065390311,Merlo,BUENOS AIRES,411,466,614,562,1176
06,06539,065390406,Merlo,BUENOS AIRES,483,476,776,665,1441
06,06539,065390505,Merlo,BUENOS AIRES,268,269,424,398,822
06,06539,065390603,Merlo,BUENOS AIRES,268,259,429,400,829
06,06539,065390605,Merlo,BUENOS AIRES,256,231,416,348,764
06,06539,065390606,Merlo,BUENOS AIRES,428,406,771,687,1458
06,06539,065390702,Merlo,BUENOS AIRES,344,344,619,527,1146
06,06539,065390703,Merlo,BUENOS AIRES,438,464,697,664,1361
06,06539,065390705,Merlo,BUENOS AIRES,357,342,648,601,1249
06,06539,065390706,Merlo,BUENOS AIRES,353,335,665,587,1252
06,06539,065390811,Merlo,BUENOS AIRES,266,261,521,469,990
06,06539,065391014,Merlo,BUENOS AIRES,370,381,724,749,1473
06,06539,065391102,Merlo,BUENOS AIRES,419,422,724,707,1431
06,06539,065391105,Merlo,BUENOS AIRES,282,262,537,546,1083
06,06175,061750403,Colón,BUENOS AIRES,273,283,570,545,1115
06,06175,061750409,Colón,BUENOS AIRES,327,384,498,507,1005
06,06175,061750412,Colón,BUENOS AIRES,258,267,366,353,719
06,06175,061750601,Colón,BUENOS AIRES,283,301,501,471,972
06,06175,061750604,Colón,BUENOS AIRES,278,295,499,475,974
06,06175,061750101,Colón,BUENOS AIRES,79,94,116,122,238
06,06175,061750606,Colón,BUENOS AIRES,185,202,297,254,551
06,06175,061750404,Colón,BUENOS AIRES,187,205,261,263,524
06,06175,061750607,Colón,BUENOS AIRES,203,211,341,341,682
06,06175,061750303,Colón,BUENOS AIRES,5,9,4,12,16
06,06175,061750503,Colón,BUENOS AIRES,5,12,3,8,11
06,06175,061750102,Colón,BUENOS AIRES,30,47,34,45,79
06,06175,061750204,Colón,BUENOS AIRES,2,10,2,4,6
06,06175,061750417,Colón,BUENOS AIRES,97,125,158,145,303
06,06175,061750613,Colón,BUENOS AIRES,592,639,1132,1024,2156
06,06175,061750302,Colón,BUENOS AIRES,5,9,6,12,18
06,06175,061750501,Colón,BUENOS AIRES,21,45,31,39,70
06,06175,061750602,Colón,BUENOS AIRES,232,237,319,297,616
06,06175,061750603,Colón,BUENOS AIRES,246,247,389,409,798
06,06175,061750504,Colón,BUENOS AIRES,5,28,3,6,9
06,06175,061750201,Colón,BUENOS AIRES,69,104,99,94,193
06,06175,061750405,Colón,BUENOS AIRES,275,327,366,285,651
06,06175,061750407,Colón,BUENOS AIRES,260,315,345,265,610
06,06175,061750413,Colón,BUENOS AIRES,197,230,262,244,506
06,06175,061750608,Colón,BUENOS AIRES,295,320,466,486,952
06,06175,061750609,Colón,BUENOS AIRES,275,292,483,528,1011
06,06175,061750301,Colón,BUENOS AIRES,6,11,7,10,17
06,06175,061750304,Colón,BUENOS AIRES,1,4,0,1,1
06,06175,061750615,Colón,BUENOS AIRES,16,17,24,21,45
06,06175,061750203,Colón,BUENOS AIRES,5,15,6,14,20
06,06175,061750505,Colón,BUENOS AIRES,35,88,52,60,112
06,06175,061750614,Colón,BUENOS AIRES,85,103,128,138,266
06,06175,061750406,Colón,BUENOS AIRES,254,318,389,299,688
06,06175,061750611,Colón,BUENOS AIRES,275,300,411,366,777
06,06175,061750612,Colón,BUENOS AIRES,284,319,413,410,823
06,06175,061750202,Colón,BUENOS AIRES,5,14,10,9,19
06,06175,061750401,Colón,BUENOS AIRES,30,48,39,53,92
06,06175,061750414,Colón,BUENOS AIRES,272,294,396,384,780
06,06175,061750416,Colón,BUENOS AIRES,146,155,228,208,436
06,06175,061750605,Colón,BUENOS AIRES,351,383,511,415,926
06,06175,061750104,Colón,BUENOS AIRES,7,13,10,15,25
06,06175,061750502,Colón,BUENOS AIRES,31,55,48,51,99
06,06175,061750402,Colón,BUENOS AIRES,335,352,538,547,1085
06,06175,061750408,Colón,BUENOS AIRES,370,397,489,443,932
06,06175,061750410,Colón,BUENOS AIRES,324,364,478,404,882
06,06175,061750411,Colón,BUENOS AIRES,198,214,241,217,458
06,06175,061750415,Colón,BUENOS AIRES,164,219,260,252,512
06,06175,061750610,Colón,BUENOS AIRES,301,315,535,540,1075
06,06175,061750103,Colón,BUENOS AIRES,12,18,17,18,35
06,06182,061820111,Coronel de Marina Leonardo Rosales,BUENOS AIRES,324,332,621,572,1193
06,06182,061820307,Coronel de Marina Leonardo Rosales,BUENOS AIRES,0,1,0,0,0
06,06182,061820308,Coronel de Marina Leonardo Rosales,BUENOS AIRES,14,26,23,101,124
06,06182,061820312,Coronel de Marina Leonardo Rosales,BUENOS AIRES,24,51,33,39,72
06,06182,061820602,Coronel de Marina Leonardo Rosales,BUENOS AIRES,61,82,74,90,164
06,06182,061820609,Coronel de Marina Leonardo Rosales,BUENOS AIRES,271,290,406,422,828
06,06182,061820705,Coronel de Marina Leonardo Rosales,BUENOS AIRES,292,290,495,492,987
06,06182,061820902,Coronel de Marina Leonardo Rosales,BUENOS AIRES,41,297,40,65,105
06,06182,061821001,Coronel de Marina Leonardo Rosales,BUENOS AIRES,195,226,311,255,566
06,06182,061821002,Coronel de Marina Leonardo Rosales,BUENOS AIRES,158,184,241,207,448
06,06182,061820101,Coronel de Marina Leonardo Rosales,BUENOS AIRES,251,273,422,404,826
06,06182,061820110,Coronel de Marina Leonardo Rosales,BUENOS AIRES,313,321,556,560,1116
06,06182,061820113,Coronel de Marina Leonardo Rosales,BUENOS AIRES,250,270,434,411,845
06,06182,061820203,Coronel de Marina Leonardo Rosales,BUENOS AIRES,278,319,387,358,745
06,06182,061820206,Coronel de Marina Leonardo Rosales,BUENOS AIRES,260,311,378,340,718
06,06182,061820211,Coronel de Marina Leonardo Rosales,BUENOS AIRES,218,223,331,301,632
06,06182,061820503,Coronel de Marina Leonardo Rosales,BUENOS AIRES,149,158,264,243,507
06,06182,061820607,Coronel de Marina Leonardo Rosales,BUENOS AIRES,408,450,679,659,1338
06,06182,061820904,Coronel de Marina Leonardo Rosales,BUENOS AIRES,71,337,100,96,196
06,06182,061820905,Coronel de Marina Leonardo Rosales,BUENOS AIRES,39,317,46,62,108
06,06182,061821009,Coronel de Marina Leonardo Rosales,BUENOS AIRES,378,415,501,460,961
06,06182,061821010,Coronel de Marina Leonardo Rosales,BUENOS AIRES,320,376,509,440,949
06,06182,061821106,Coronel de Marina Leonardo Rosales,BUENOS AIRES,253,280,382,341,723
06,06182,061821109,Coronel de Marina Leonardo Rosales,BUENOS AIRES,308,333,568,554,1122
06,06182,061821110,Coronel de Marina Leonardo Rosales,BUENOS AIRES,76,78,144,143,287
06,06182,061820102,Coronel de Marina Leonardo Rosales,BUENOS AIRES,375,476,681,649,1330
06,06182,061820105,Coronel de Marina Leonardo Rosales,BUENOS AIRES,359,385,557,518,1075
06,06182,061820107,Coronel de Marina Leonardo Rosales,BUENOS AIRES,305,354,444,410,854
06,06182,061820112,Coronel de Marina Leonardo Rosales,BUENOS AIRES,324,348,582,561,1143
06,06182,061820114,Coronel de Marina Leonardo Rosales,BUENOS AIRES,326,348,624,580,1204
06,06182,061820201,Coronel de Marina Leonardo Rosales,BUENOS AIRES,218,232,345,281,626
06,06182,061820309,Coronel de Marina Leonardo Rosales,BUENOS AIRES,193,208,344,306,650
06,06182,061820604,Coronel de Marina Leonardo Rosales,BUENOS AIRES,342,326,622,591,1213
06,06182,061820605,Coronel de Marina Leonardo Rosales,BUENOS AIRES,442,476,817,841,1658
06,06182,061820704,Coronel de Marina Leonardo Rosales,BUENOS AIRES,238,263,394,369,763
06,06182,061821011,Coronel de Marina Leonardo Rosales,BUENOS AIRES,288,341,415,354,769
06,06182,061821101,Coronel de Marina Leonardo Rosales,BUENOS AIRES,216,248,323,320,643
06,06182,061821102,Coronel de Marina Leonardo Rosales,BUENOS AIRES,322,381,473,442,915
06,06182,061821105,Coronel de Marina Leonardo Rosales,BUENOS AIRES,199,235,286,288,574
06,06182,061820212,Coronel de Marina Leonardo Rosales,BUENOS AIRES,225,264,320,294,614
06,06182,061820306,Coronel de Marina Leonardo Rosales,BUENOS AIRES,1,2,0,1,1
06,06182,061820707,Coronel de Marina Leonardo Rosales,BUENOS AIRES,0,1,0,0,0
06,06182,061820701,Coronel de Marina Leonardo Rosales,BUENOS AIRES,14,37,20,23,43
06,06182,061820801,Coronel de Marina Leonardo Rosales,BUENOS AIRES,26,51,26,37,63
06,06182,061820903,Coronel de Marina Leonardo Rosales,BUENOS AIRES,15,17,22,37,59
06,06182,061820706,Coronel de Marina Leonardo Rosales,BUENOS AIRES,119,131,218,202,420
06,06182,061820104,Coronel de Marina Leonardo Rosales,BUENOS AIRES,328,249,651,576,1227
06,06182,061820502,Coronel de Marina Leonardo Rosales,BUENOS AIRES,127,142,212,226,438
06,06182,061821008,Coronel de Marina Leonardo Rosales,BUENOS AIRES,332,410,464,404,868
06,06182,061820401,Coronel de Marina Leonardo Rosales,BUENOS AIRES,22,43,24,35,59
06,06182,061820603,Coronel de Marina Leonardo Rosales,BUENOS AIRES,18,37,21,30,51
06,06182,061820702,Coronel de Marina Leonardo Rosales,BUENOS AIRES,199,232,408,401,809
06,06182,061821006,Coronel de Marina Leonardo Rosales,BUENOS AIRES,256,300,393,359,752
06,06182,061821007,Coronel de Marina Leonardo Rosales,BUENOS AIRES,247,303,377,351,728
06,06182,061820103,Coronel de Marina Leonardo Rosales,BUENOS AIRES,376,399,684,648,1332
06,06182,061820106,Coronel de Marina Leonardo Rosales,BUENOS AIRES,271,289,435,383,818
06,06182,061820204,Coronel de Marina Leonardo Rosales,BUENOS AIRES,265,329,394,362,756
06,06182,061820205,Coronel de Marina Leonardo Rosales,BUENOS AIRES,245,284,377,331,708
06,06182,061820301,Coronel de Marina Leonardo Rosales,BUENOS AIRES,32,47,63,170,233
06,06182,061820303,Coronel de Marina Leonardo Rosales,BUENOS AIRES,46,60,69,89,158
06,06182,061820311,Coronel de Marina Leonardo Rosales,BUENOS AIRES,152,245,259,259,518
06,06182,061821004,Coronel de Marina Leonardo Rosales,BUENOS AIRES,329,368,482,411,893
06,06182,061820703,Coronel de Marina Leonardo Rosales,BUENOS AIRES,359,406,601,538,1139
06,06182,061821103,Coronel de Marina Leonardo Rosales,BUENOS AIRES,336,382,536,471,1007
06,06182,061820302,Coronel de Marina Leonardo Rosales,BUENOS AIRES,6,19,31,235,266
06,06182,061820601,Coronel de Marina Leonardo Rosales,BUENOS AIRES,20,52,30,30,60
06,06182,061820209,Coronel de Marina Leonardo Rosales,BUENOS AIRES,252,363,319,315,634
06,06182,061820202,Coronel de Marina Leonardo Rosales,BUENOS AIRES,326,387,468,391,859
06,06182,061820305,Coronel de Marina Leonardo Rosales,BUENOS AIRES,68,181,131,116,247
06,06182,061820504,Coronel de Marina Leonardo Rosales,BUENOS AIRES,263,301,456,444,900
06,06182,061820505,Coronel de Marina Leonardo Rosales,BUENOS AIRES,104,173,183,174,357
06,06182,061821003,Coronel de Marina Leonardo Rosales,BUENOS AIRES,338,417,472,407,879
06,06182,061821104,Coronel de Marina Leonardo Rosales,BUENOS AIRES,238,274,393,355,748
06,06182,061821108,Coronel de Marina Leonardo Rosales,BUENOS AIRES,271,302,471,458,929
06,06182,061820501,Coronel de Marina Leonardo Rosales,BUENOS AIRES,142,220,213,201,414
06,06182,061821005,Coronel de Marina Leonardo Rosales,BUENOS AIRES,284,318,416,359,775
06,06182,061820109,Coronel de Marina Leonardo Rosales,BUENOS AIRES,387,406,768,697,1465
06,06182,061820208,Coronel de Marina Leonardo Rosales,BUENOS AIRES,279,347,428,387,815
06,06182,061820213,Coronel de Marina Leonardo Rosales,BUENOS AIRES,242,292,346,331,677
06,06182,061820304,Coronel de Marina Leonardo Rosales,BUENOS AIRES,52,78,397,642,1039
06,06182,061820210,Coronel de Marina Leonardo Rosales,BUENOS AIRES,277,327,389,344,733
06,06182,061820108,Coronel de Marina Leonardo Rosales,BUENOS AIRES,203,218,331,277,608
06,06182,061820207,Coronel de Marina Leonardo Rosales,BUENOS AIRES,272,349,372,316,688
06,06182,061820310,Coronel de Marina Leonardo Rosales,BUENOS AIRES,18,26,24,22,46
06,06182,061820606,Coronel de Marina Leonardo Rosales,BUENOS AIRES,403,407,691,676,1367
06,06182,061820608,Coronel de Marina Leonardo Rosales,BUENOS AIRES,317,347,570,567,1137
06,06182,061820708,Coronel de Marina Leonardo Rosales,BUENOS AIRES,276,306,464,413,877
06,06182,061820709,Coronel de Marina Leonardo Rosales,BUENOS AIRES,281,315,444,474,918
06,06182,061820710,Coronel de Marina Leonardo Rosales,BUENOS AIRES,371,416,586,574,1160
06,06182,061820901,Coronel de Marina Leonardo Rosales,BUENOS AIRES,96,432,119,153,272
06,06182,061821107,Coronel de Marina Leonardo Rosales,BUENOS AIRES,199,223,319,292,611
06,06196,061960203,Coronel Pringles,BUENOS AIRES,104,116,187,164,351
06,06196,061961201,Coronel Pringles,BUENOS AIRES,4,12,4,8,12
06,06196,061960107,Coronel Pringles,BUENOS AIRES,117,121,205,192,397
06,06196,061960113,Coronel Pringles,BUENOS AIRES,233,255,322,307,629
06,06196,061960201,Coronel Pringles,BUENOS AIRES,77,96,133,121,254
06,06196,061960207,Coronel Pringles,BUENOS AIRES,237,308,332,266,598
06,06196,061961508,Coronel Pringles,BUENOS AIRES,98,123,134,126,260
06,06196,061960403,Coronel Pringles,BUENOS AIRES,6,10,10,9,19
06,06196,061960603,Coronel Pringles,BUENOS AIRES,7,16,6,7,13
06,06196,061960705,Coronel Pringles,BUENOS AIRES,12,19,11,17,28
06,06196,061960707,Coronel Pringles,BUENOS AIRES,21,35,19,31,50
06,06196,061960803,Coronel Pringles,BUENOS AIRES,11,23,12,15,27
06,06196,061960805,Coronel Pringles,BUENOS AIRES,1,3,1,1,2
06,06196,061960904,Coronel Pringles,BUENOS AIRES,15,17,23,16,39
06,06196,061961104,Coronel Pringles,BUENOS AIRES,7,17,6,8,14
06,06196,061961107,Coronel Pringles,BUENOS AIRES,6,23,3,6,9
06,06196,061961303,Coronel Pringles,BUENOS AIRES,10,30,17,20,37
06,06196,061961502,Coronel Pringles,BUENOS AIRES,9,18,16,13,29
06,06196,061960103,Coronel Pringles,BUENOS AIRES,266,298,429,348,777
06,06196,061960114,Coronel Pringles,BUENOS AIRES,202,238,270,244,514
06,06196,061960116,Coronel Pringles,BUENOS AIRES,339,381,467,361,828
06,06196,061960204,Coronel Pringles,BUENOS AIRES,243,269,346,361,707
06,06196,061961102,Coronel Pringles,BUENOS AIRES,19,27,23,23,46
06,06196,061960302,Coronel Pringles,BUENOS AIRES,10,17,11,13,24
06,06196,061960304,Coronel Pringles,BUENOS AIRES,4,15,5,7,12
06,06196,061960501,Coronel Pringles,BUENOS AIRES,6,15,9,9,18
06,06196,061960901,Coronel Pringles,BUENOS AIRES,1,3,2,0,2
06,06196,061960905,Coronel Pringles,BUENOS AIRES,11,24,18,29,47
06,06196,061961003,Coronel Pringles,BUENOS AIRES,3,9,9,9,18
06,06196,061961105,Coronel Pringles,BUENOS AIRES,16,22,23,22,45
06,06196,061961106,Coronel Pringles,BUENOS AIRES,8,16,10,13,23
06,06196,061961202,Coronel Pringles,BUENOS AIRES,16,30,17,23,40
06,06196,061961402,Coronel Pringles,BUENOS AIRES,13,28,12,19,31
06,06196,061961503,Coronel Pringles,BUENOS AIRES,6,13,11,7,18
06,06196,061960111,Coronel Pringles,BUENOS AIRES,118,229,194,195,389
06,06196,061960118,Coronel Pringles,BUENOS AIRES,157,184,240,230,470
06,06196,061960208,Coronel Pringles,BUENOS AIRES,261,322,370,297,667
06,06196,061960213,Coronel Pringles,BUENOS AIRES,202,229,268,239,507
06,06196,061960214,Coronel Pringles,BUENOS AIRES,203,246,291,265,556
06,06196,061961507,Coronel Pringles,BUENOS AIRES,150,183,185,181,366
06,06196,061961205,Coronel Pringles,BUENOS AIRES,14,17,18,17,35
06,06196,061960305,Coronel Pringles,BUENOS AIRES,7,12,2,8,10
06,06196,061960504,Coronel Pringles,BUENOS AIRES,4,15,2,8,10
06,06196,061960703,Coronel Pringles,BUENOS AIRES,3,14,1,4,5
06,06196,061960706,Coronel Pringles,BUENOS AIRES,3,4,4,5,9
06,06196,061960802,Coronel Pringles,BUENOS AIRES,13,25,4,16,20
06,06196,061960804,Coronel Pringles,BUENOS AIRES,13,24,19,16,35
06,06196,061961108,Coronel Pringles,BUENOS AIRES,7,15,12,8,20
06,06196,061961301,Coronel Pringles,BUENOS AIRES,3,9,3,9,12
06,06196,061960104,Coronel Pringles,BUENOS AIRES,258,285,389,353,742
06,06196,061960112,Coronel Pringles,BUENOS AIRES,338,373,548,515,1063
06,06196,061960206,Coronel Pringles,BUENOS AIRES,318,388,402,329,731
06,06196,061960211,Coronel Pringles,BUENOS AIRES,154,168,232,226,458
06,06196,061960701,Coronel Pringles,BUENOS AIRES,136,156,216,205,421
06,06196,061961506,Coronel Pringles,BUENOS AIRES,91,120,118,132,250
06,06196,061960402,Coronel Pringles,BUENOS AIRES,10,21,15,22,37
06,06196,061960601,Coronel Pringles,BUENOS AIRES,7,15,6,12,18
06,06196,061960801,Coronel Pringles,BUENOS AIRES,9,13,8,13,21
06,06196,061960902,Coronel Pringles,BUENOS AIRES,5,26,8,11,19
06,06196,061961005,Coronel Pringles,BUENOS AIRES,13,26,18,18,36
06,06196,061961203,Coronel Pringles,BUENOS AIRES,6,19,6,11,17
06,06196,061961206,Coronel Pringles,BUENOS AIRES,9,21,5,11,16
06,06196,061961305,Coronel Pringles,BUENOS AIRES,11,21,11,20,31
06,06196,061961403,Coronel Pringles,BUENOS AIRES,10,16,14,13,27
06,06196,061960101,Coronel Pringles,BUENOS AIRES,284,328,485,484,969
06,06196,061960202,Coronel Pringles,BUENOS AIRES,99,107,164,193,357
06,06196,061960106,Coronel Pringles,BUENOS AIRES,106,109,165,183,348
06,06196,061960110,Coronel Pringles,BUENOS AIRES,122,161,197,203,400
06,06196,061960115,Coronel Pringles,BUENOS AIRES,197,245,261,207,468
06,06196,061960117,Coronel Pringles,BUENOS AIRES,181,217,244,232,476
06,06196,061960210,Coronel Pringles,BUENOS AIRES,315,377,447,400,847
06,06196,061960404,Coronel Pringles,BUENOS AIRES,7,13,7,9,16
06,06196,061960604,Coronel Pringles,BUENOS AIRES,4,11,3,4,7
06,06196,061961302,Coronel Pringles,BUENOS AIRES,5,18,6,9,15
06,06196,061961505,Coronel Pringles,BUENOS AIRES,2,6,3,2,5
06,06196,061960108,Coronel Pringles,BUENOS AIRES,307,325,474,452,926
06,06196,061960109,Coronel Pringles,BUENOS AIRES,121,155,201,202,403
06,06196,061960119,Coronel Pringles,BUENOS AIRES,164,175,245,239,484
06,06196,061960209,Coronel Pringles,BUENOS AIRES,321,397,479,362,841
06,06196,061960212,Coronel Pringles,BUENOS AIRES,137,157,218,220,438
06,06196,061960303,Coronel Pringles,BUENOS AIRES,8,16,11,15,26
06,06196,061960502,Coronel Pringles,BUENOS AIRES,2,16,1,3,4
06,06196,061960503,Coronel Pringles,BUENOS AIRES,12,29,8,18,26
06,06196,061960702,Coronel Pringles,BUENOS AIRES,5,10,4,8,12
06,06196,061960806,Coronel Pringles,BUENOS AIRES,10,24,17,14,31
06,06196,061960903,Coronel Pringles,BUENOS AIRES,12,18,10,21,31
06,06196,061961304,Coronel Pringles,BUENOS AIRES,12,30,12,18,30
06,06196,061961101,Coronel Pringles,BUENOS AIRES,8,14,8,14,22
06,06196,061961501,Coronel Pringles,BUENOS AIRES,71,91,77,101,178
06,06196,061960401,Coronel Pringles,BUENOS AIRES,19,30,15,28,43
06,06196,061960602,Coronel Pringles,BUENOS AIRES,3,12,1,21,22
06,06196,061961001,Coronel Pringles,BUENOS AIRES,9,14,11,15,26
06,06196,061960105,Coronel Pringles,BUENOS AIRES,98,113,173,188,361
06,06196,061960102,Coronel Pringles,BUENOS AIRES,311,328,524,477,1001
06,06196,061960205,Coronel Pringles,BUENOS AIRES,357,408,498,387,885
06,06196,061960709,Coronel Pringles,BUENOS AIRES,19,31,27,32,59
06,06196,061960301,Coronel Pringles,BUENOS AIRES,9,24,14,12,26
06,06196,061960306,Coronel Pringles,BUENOS AIRES,10,12,10,15,25
06,06196,061960704,Coronel Pringles,BUENOS AIRES,6,12,7,7,14
06,06196,061960708,Coronel Pringles,BUENOS AIRES,34,64,50,59,109
06,06196,061961002,Coronel Pringles,BUENOS AIRES,9,15,7,9,16
06,06196,061961004,Coronel Pringles,BUENOS AIRES,5,5,6,6,12
06,06196,061961103,Coronel Pringles,BUENOS AIRES,12,26,3,18,21
06,06196,061961204,Coronel Pringles,BUENOS AIRES,2,9,4,4,8
06,06196,061961401,Coronel Pringles,BUENOS AIRES,5,7,4,12,16
06,06196,061961504,Coronel Pringles,BUENOS AIRES,6,24,5,8,13
06,06189,061891002,Coronel Dorrego,BUENOS AIRES,240,265,381,346,727
06,06189,061891007,Coronel Dorrego,BUENOS AIRES,341,401,478,437,915
06,06189,061891008,Coronel Dorrego,BUENOS AIRES,216,239,348,333,681
06,06189,061891009,Coronel Dorrego,BUENOS AIRES,189,199,291,304,595
06,06189,061890301,Coronel Dorrego,BUENOS AIRES,24,31,35,30,65
06,06189,061891401,Coronel Dorrego,BUENOS AIRES,5,18,5,8,13
06,06189,061891702,Coronel Dorrego,BUENOS AIRES,173,201,274,280,554
06,06189,061891707,Coronel Dorrego,BUENOS AIRES,328,398,481,369,850
06,06189,061891203,Coronel Dorrego,BUENOS AIRES,7,14,9,11,20
06,06189,061890102,Coronel Dorrego,BUENOS AIRES,10,17,10,13,23
06,06189,061890402,Coronel Dorrego,BUENOS AIRES,5,13,3,9,12
06,06189,061890603,Coronel Dorrego,BUENOS AIRES,5,8,6,15,21
06,06189,061890608,Coronel Dorrego,BUENOS AIRES,7,7,9,12,21
06,06189,061891010,Coronel Dorrego,BUENOS AIRES,17,30,17,25,42
06,06189,061891103,Coronel Dorrego,BUENOS AIRES,5,11,3,6,9
06,06189,061891107,Coronel Dorrego,BUENOS AIRES,3,8,4,3,7
06,06189,061891205,Coronel Dorrego,BUENOS AIRES,6,15,11,8,19
06,06189,061891210,Coronel Dorrego,BUENOS AIRES,9,13,11,16,27
06,06189,061891302,Coronel Dorrego,BUENOS AIRES,7,15,5,10,15
06,06189,061891303,Coronel Dorrego,BUENOS AIRES,12,27,16,18,34
06,06189,061891304,Coronel Dorrego,BUENOS AIRES,6,15,5,7,12
06,06189,061891006,Coronel Dorrego,BUENOS AIRES,308,385,426,337,763
06,06189,061891001,Coronel Dorrego,BUENOS AIRES,209,253,332,283,615
06,06189,061891202,Coronel Dorrego,BUENOS AIRES,7,12,5,15,20
06,06189,061891501,Coronel Dorrego,BUENOS AIRES,156,187,210,208,418
06,06189,061891503,Coronel Dorrego,BUENOS AIRES,63,302,70,88,158
06,06189,061891509,Coronel Dorrego,BUENOS AIRES,179,227,221,183,404
06,06189,061891703,Coronel Dorrego,BUENOS AIRES,314,360,435,361,796
06,06189,061891706,Coronel Dorrego,BUENOS AIRES,225,300,298,235,533
06,06189,061890605,Coronel Dorrego,BUENOS AIRES,1,8,0,1,1
06,06189,061890801,Coronel Dorrego,BUENOS AIRES,2,15,3,3,6
06,06189,061890201,Coronel Dorrego,BUENOS AIRES,1,9,2,0,2
06,06189,061890202,Coronel Dorrego,BUENOS AIRES,2,15,1,2,3
06,06189,061890204,Coronel Dorrego,BUENOS AIRES,1,13,1,1,2
06,06189,061890401,Coronel Dorrego,BUENOS AIRES,2,13,2,5,7
06,06189,061890602,Coronel Dorrego,BUENOS AIRES,10,16,13,22,35
06,06189,061890705,Coronel Dorrego,BUENOS AIRES,6,14,5,7,12
06,06189,061890901,Coronel Dorrego,BUENOS AIRES,7,13,6,9,15
06,06189,061891104,Coronel Dorrego,BUENOS AIRES,4,8,3,6,9
06,06189,061891209,Coronel Dorrego,BUENOS AIRES,3,7,2,4,6
06,06189,061891403,Coronel Dorrego,BUENOS AIRES,7,14,9,11,20
06,06189,061891505,Coronel Dorrego,BUENOS AIRES,18,35,16,25,41
06,06189,061891211,Coronel Dorrego,BUENOS AIRES,136,190,209,189,398
06,06189,061890206,Coronel Dorrego,BUENOS AIRES,6,15,4,8,12
06,06189,061890303,Coronel Dorrego,BUENOS AIRES,7,18,7,16,23
06,06189,061890403,Coronel Dorrego,BUENOS AIRES,8,15,6,13,19
06,06189,061890505,Coronel Dorrego,BUENOS AIRES,4,17,3,9,12
06,06189,061890606,Coronel Dorrego,BUENOS AIRES,1,6,1,2,3
06,06189,061890607,Coronel Dorrego,BUENOS AIRES,4,9,5,6,11
06,06189,061890706,Coronel Dorrego,BUENOS AIRES,2,13,2,3,5
06,06189,061891101,Coronel Dorrego,BUENOS AIRES,4,14,7,5,12
06,06189,061891206,Coronel Dorrego,BUENOS AIRES,7,25,7,11,18
06,06189,061891504,Coronel Dorrego,BUENOS AIRES,24,53,24,32,56
06,06189,061891507,Coronel Dorrego,BUENOS AIRES,5,35,3,6,9
06,06189,061891307,Coronel Dorrego,BUENOS AIRES,11,16,2,11,13
06,06189,061890601,Coronel Dorrego,BUENOS AIRES,17,27,19,19,38
06,06189,061891003,Coronel Dorrego,BUENOS AIRES,252,271,406,404,810
06,06189,061891004,Coronel Dorrego,BUENOS AIRES,278,309,441,401,842
06,06189,061891502,Coronel Dorrego,BUENOS AIRES,363,463,507,449,956
06,06189,061890304,Coronel Dorrego,BUENOS AIRES,2,10,1,2,3
06,06189,061891406,Coronel Dorrego,BUENOS AIRES,6,10,3,8,11
06,06189,061890703,Coronel Dorrego,BUENOS AIRES,11,19,14,15,29
06,06189,061890704,Coronel Dorrego,BUENOS AIRES,2,3,3,4,7
06,06189,061890707,Coronel Dorrego,BUENOS AIRES,10,16,5,14,19
06,06189,061890803,Coronel Dorrego,BUENOS AIRES,4,8,2,8,10
06,06189,061890902,Coronel Dorrego,BUENOS AIRES,16,20,12,16,28
06,06189,061891204,Coronel Dorrego,BUENOS AIRES,3,8,3,4,7
06,06189,061891305,Coronel Dorrego,BUENOS AIRES,2,7,3,3,6
06,06189,061891404,Coronel Dorrego,BUENOS AIRES,2,9,2,2,4
06,06189,061891603,Coronel Dorrego,BUENOS AIRES,11,21,10,21,31
06,06189,061891605,Coronel Dorrego,BUENOS AIRES,4,22,0,5,5
06,06189,061891701,Coronel Dorrego,BUENOS AIRES,23,29,32,35,67
06,06189,061891201,Coronel Dorrego,BUENOS AIRES,151,191,232,224,456
06,06189,061891301,Coronel Dorrego,BUENOS AIRES,34,62,35,45,80
06,06189,061891704,Coronel Dorrego,BUENOS AIRES,218,263,325,277,602
06,06189,061890501,Coronel Dorrego,BUENOS AIRES,2,9,3,5,8
06,06189,061890207,Coronel Dorrego,BUENOS AIRES,9,18,6,14,20
06,06189,061890302,Coronel Dorrego,BUENOS AIRES,5,16,5,8,13
06,06189,061890503,Coronel Dorrego,BUENOS AIRES,6,16,5,9,14
06,06189,061890804,Coronel Dorrego,BUENOS AIRES,3,13,0,3,3
06,06189,061891208,Coronel Dorrego,BUENOS AIRES,5,14,5,9,14
06,06189,061891306,Coronel Dorrego,BUENOS AIRES,4,12,2,7,9
06,06189,061891309,Coronel Dorrego,BUENOS AIRES,1,11,2,1,3
06,06189,061891601,Coronel Dorrego,BUENOS AIRES,11,22,8,22,30
06,06189,061891604,Coronel Dorrego,BUENOS AIRES,3,7,3,4,7
06,06189,061891005,Coronel Dorrego,BUENOS AIRES,258,297,409,375,784
06,06189,061890101,Coronel Dorrego,BUENOS AIRES,9,16,6,18,24
06,06189,061890103,Coronel Dorrego,BUENOS AIRES,3,9,2,7,9
06,06189,061890104,Coronel Dorrego,BUENOS AIRES,7,18,7,11,18
06,06189,061890305,Coronel Dorrego,BUENOS AIRES,5,22,8,7,15
06,06189,061890604,Coronel Dorrego,BUENOS AIRES,7,8,6,23,29
06,06189,061890701,Coronel Dorrego,BUENOS AIRES,6,17,6,9,15
06,06189,061890702,Coronel Dorrego,BUENOS AIRES,3,14,4,6,10
06,06189,061891207,Coronel Dorrego,BUENOS AIRES,2,9,3,3,6
06,06189,061891106,Coronel Dorrego,BUENOS AIRES,5,11,5,4,9
06,06189,061891308,Coronel Dorrego,BUENOS AIRES,5,14,7,8,15
06,06189,061891602,Coronel Dorrego,BUENOS AIRES,1,15,1,1,2
06,06189,061891705,Coronel Dorrego,BUENOS AIRES,217,259,305,275,580
06,06189,061891708,Coronel Dorrego,BUENOS AIRES,269,314,439,424,863
06,06189,061890205,Coronel Dorrego,BUENOS AIRES,1,5,1,1,2
06,06189,061890502,Coronel Dorrego,BUENOS AIRES,4,14,1,6,7
06,06189,061890802,Coronel Dorrego,BUENOS AIRES,9,19,12,18,30
06,06189,061891102,Coronel Dorrego,BUENOS AIRES,10,30,15,14,29
06,06189,061891105,Coronel Dorrego,BUENOS AIRES,15,12,14,19,33
06,06189,061891506,Coronel Dorrego,BUENOS AIRES,2,14,4,3,7
06,06189,061890203,Coronel Dorrego,BUENOS AIRES,3,18,5,4,9
06,06189,061890504,Coronel Dorrego,BUENOS AIRES,5,16,7,8,15
06,06189,061891402,Coronel Dorrego,BUENOS AIRES,2,14,3,8,11
06,06189,061891405,Coronel Dorrego,BUENOS AIRES,4,12,6,4,10
06,06189,061891508,Coronel Dorrego,BUENOS AIRES,9,13,2,11,13
06,06189,061891709,Coronel Dorrego,BUENOS AIRES,11,18,10,19,29
06,06784,067840403,Suipacha,BUENOS AIRES,5,12,5,11,16
06,06784,067840703,Suipacha,BUENOS AIRES,8,12,14,15,29
06,06784,067840812,Suipacha,BUENOS AIRES,15,27,21,28,49
06,06784,067841001,Suipacha,BUENOS AIRES,9,9,15,20,35
06,06784,067840802,Suipacha,BUENOS AIRES,85,108,150,145,295
06,06784,067840811,Suipacha,BUENOS AIRES,333,359,549,548,1097
06,06784,067840204,Suipacha,BUENOS AIRES,5,9,6,9,15
06,06784,067840102,Suipacha,BUENOS AIRES,12,29,13,15,28
06,06784,067840503,Suipacha,BUENOS AIRES,9,14,14,15,29
06,06784,067840701,Suipacha,BUENOS AIRES,11,15,19,17,36
06,06784,067840804,Suipacha,BUENOS AIRES,332,359,607,590,1197
06,06784,067840807,Suipacha,BUENOS AIRES,290,352,437,368,805
06,06784,067841101,Suipacha,BUENOS AIRES,5,11,10,15,25
06,06784,067840404,Suipacha,BUENOS AIRES,6,12,8,11,19
06,06784,067840704,Suipacha,BUENOS AIRES,11,14,24,19,43
06,06784,067841203,Suipacha,BUENOS AIRES,26,30,43,49,92
06,06784,067840202,Suipacha,BUENOS AIRES,160,208,264,257,521
06,06784,067840810,Suipacha,BUENOS AIRES,232,260,352,306,658
06,06784,067841202,Suipacha,BUENOS AIRES,10,17,12,16,28
06,06784,067840303,Suipacha,BUENOS AIRES,4,15,13,11,24
06,06784,067840803,Suipacha,BUENOS AIRES,278,316,454,462,916
06,06784,067840805,Suipacha,BUENOS AIRES,250,281,406,397,803
06,06784,067840808,Suipacha,BUENOS AIRES,388,423,560,531,1091
06,06784,067840809,Suipacha,BUENOS AIRES,265,307,422,410,832
06,06784,067840601,Suipacha,BUENOS AIRES,10,18,13,14,27
06,06784,067840301,Suipacha,BUENOS AIRES,7,17,8,8,16
06,06784,067840501,Suipacha,BUENOS AIRES,7,11,13,20,33
06,06784,067840502,Suipacha,BUENOS AIRES,6,12,11,17,28
06,06784,067840201,Suipacha,BUENOS AIRES,5,21,7,10,17
06,06784,067840302,Suipacha,BUENOS AIRES,12,22,19,23,42
06,06784,067840702,Suipacha,BUENOS AIRES,9,12,12,18,30
06,06784,067840101,Suipacha,BUENOS AIRES,5,14,11,8,19
06,06784,067840901,Suipacha,BUENOS AIRES,9,15,6,12,18
06,06784,067840902,Suipacha,BUENOS AIRES,5,10,9,6,15
06,06784,067841104,Suipacha,BUENOS AIRES,3,10,6,5,11
06,06784,067840203,Suipacha,BUENOS AIRES,16,29,21,28,49
06,06784,067840402,Suipacha,BUENOS AIRES,13,25,15,23,38
06,06784,067840801,Suipacha,BUENOS AIRES,24,35,33,31,64
06,06784,067841102,Suipacha,BUENOS AIRES,8,14,8,12,20
06,06784,067841204,Suipacha,BUENOS AIRES,6,10,15,18,33
06,06784,067840806,Suipacha,BUENOS AIRES,235,265,377,332,709
06,06784,067841201,Suipacha,BUENOS AIRES,11,18,16,18,34
06,06784,067840401,Suipacha,BUENOS AIRES,3,5,6,8,14
06,06784,067840813,Suipacha,BUENOS AIRES,27,37,38,47,85
06,06784,067841002,Suipacha,BUENOS AIRES,3,7,3,5,8
06,06784,067841003,Suipacha,BUENOS AIRES,11,14,15,16,31
06,06784,067841004,Suipacha,BUENOS AIRES,8,14,7,11,18
06,06784,067841103,Suipacha,BUENOS AIRES,12,12,19,20,39
06,06791,067910901,Tandil,BUENOS AIRES,35,54,44,63,107
06,06791,067911103,Tandil,BUENOS AIRES,23,36,31,34,65
06,06791,067910102,Tandil,BUENOS AIRES,178,228,251,209,460
06,06791,067910103,Tandil,BUENOS AIRES,232,261,315,261,576
06,06791,067910104,Tandil,BUENOS AIRES,172,232,227,173,400
06,06791,067910202,Tandil,BUENOS AIRES,304,357,417,400,817
06,06791,067910407,Tandil,BUENOS AIRES,209,297,249,200,449
06,06791,067911203,Tandil,BUENOS AIRES,433,471,729,742,1471
06,06791,067911210,Tandil,BUENOS AIRES,334,369,501,400,901
06,06791,067911301,Tandil,BUENOS AIRES,499,555,858,887,1745
06,06791,067911809,Tandil,BUENOS AIRES,265,262,408,358,766
06,06791,067911902,Tandil,BUENOS AIRES,234,260,326,277,603
06,06791,067911911,Tandil,BUENOS AIRES,243,337,345,264,609
06,06791,067912008,Tandil,BUENOS AIRES,171,244,274,279,553
06,06791,067912203,Tandil,BUENOS AIRES,207,257,406,391,797
06,06791,067912115,Tandil,BUENOS AIRES,119,192,196,205,401
06,06791,067912202,Tandil,BUENOS AIRES,148,196,224,282,506
06,06791,067912208,Tandil,BUENOS AIRES,403,413,609,608,1217
06,06791,067912216,Tandil,BUENOS AIRES,311,361,547,561,1108
06,06791,067911314,Tandil,BUENOS AIRES,287,320,463,411,874
06,06791,067910501,Tandil,BUENOS AIRES,35,47,37,63,100
06,06791,067910702,Tandil,BUENOS AIRES,38,62,41,67,108
06,06791,067911001,Tandil,BUENOS AIRES,34,67,49,53,102
06,06791,067911501,Tandil,BUENOS AIRES,63,110,132,143,275
06,06791,067911505,Tandil,BUENOS AIRES,20,27,27,30,57
06,06791,067911602,Tandil,BUENOS AIRES,43,44,39,56,95
06,06791,067910214,Tandil,BUENOS AIRES,279,303,439,389,828
06,06791,067910108,Tandil,BUENOS AIRES,203,284,262,196,458
06,06791,067910111,Tandil,BUENOS AIRES,210,263,272,227,499
06,06791,067910204,Tandil,BUENOS AIRES,268,299,364,366,730
06,06791,067910208,Tandil,BUENOS AIRES,309,371,441,360,801
06,06791,067910211,Tandil,BUENOS AIRES,333,397,490,434,924
06,06791,067910302,Tandil,BUENOS AIRES,206,238,290,275,565
06,06791,067910305,Tandil,BUENOS AIRES,161,196,188,172,360
06,06791,067910404,Tandil,BUENOS AIRES,215,269,294,267,561
06,06791,067910405,Tandil,BUENOS AIRES,159,229,180,159,339
06,06791,067910411,Tandil,BUENOS AIRES,224,299,269,260,529
06,06791,067911002,Tandil,BUENOS AIRES,84,104,113,137,250
06,06791,067911008,Tandil,BUENOS AIRES,147,171,240,224,464
06,06791,067911302,Tandil,BUENOS AIRES,270,274,484,491,975
06,06791,067911309,Tandil,BUENOS AIRES,246,254,375,382,757
06,06791,067911310,Tandil,BUENOS AIRES,264,290,478,462,940
06,06791,067911910,Tandil,BUENOS AIRES,202,315,240,220,460
06,06791,067912001,Tandil,BUENOS AIRES,301,325,481,421,902
06,06791,067912006,Tandil,BUENOS AIRES,388,492,486,470,956
06,06791,067912214,Tandil,BUENOS AIRES,229,255,351,320,671
06,06791,067912217,Tandil,BUENOS AIRES,159,222,309,295,604
06,06791,067911007,Tandil,BUENOS AIRES,137,166,234,213,447
06,06791,067910905,Tandil,BUENOS AIRES,30,38,42,55,97
06,06791,067911105,Tandil,BUENOS AIRES,34,42,46,60,106
06,06791,067911601,Tandil,BUENOS AIRES,29,33,34,45,79
06,06791,067910217,Tandil,BUENOS AIRES,294,348,355,334,689
06,06791,067910109,Tandil,BUENOS AIRES,226,303,253,216,469
06,06791,067910303,Tandil,BUENOS AIRES,241,283,369,344,713
06,06791,067910306,Tandil,BUENOS AIRES,202,241,271,222,493
06,06791,067911213,Tandil,BUENOS AIRES,405,434,604,549,1153
06,06791,067911307,Tandil,BUENOS AIRES,246,265,431,400,831
06,06791,067911814,Tandil,BUENOS AIRES,326,364,518,456,974
06,06791,067911908,Tandil,BUENOS AIRES,223,294,284,185,469
06,06791,067912112,Tandil,BUENOS AIRES,338,383,573,581,1154
06,06791,067912206,Tandil,BUENOS AIRES,354,368,615,603,1218
06,06791,067912209,Tandil,BUENOS AIRES,293,326,434,390,824
06,06791,067912215,Tandil,BUENOS AIRES,265,326,385,352,737
06,06791,067910603,Tandil,BUENOS AIRES,23,31,22,37,59
06,06791,067910215,Tandil,BUENOS AIRES,298,370,402,359,761
06,06791,067910110,Tandil,BUENOS AIRES,344,411,380,309,689
06,06791,067910304,Tandil,BUENOS AIRES,395,451,587,512,1099
06,06791,067910402,Tandil,BUENOS AIRES,254,340,299,252,551
06,06791,067911805,Tandil,BUENOS AIRES,192,208,298,246,544
06,06791,067911202,Tandil,BUENOS AIRES,352,379,592,613,1205
06,06791,067911204,Tandil,BUENOS AIRES,291,317,446,430,876
06,06791,067911205,Tandil,BUENOS AIRES,243,277,369,330,699
06,06791,067911209,Tandil,BUENOS AIRES,376,414,538,459,997
06,06791,067911304,Tandil,BUENOS AIRES,317,316,527,510,1037
06,06791,067911306,Tandil,BUENOS AIRES,531,565,820,806,1626
06,06791,067911806,Tandil,BUENOS AIRES,236,260,286,278,564
06,06791,067911312,Tandil,BUENOS AIRES,259,268,439,415,854
06,06791,067911313,Tandil,BUENOS AIRES,300,294,471,467,938
06,06791,067911803,Tandil,BUENOS AIRES,188,226,224,217,441
06,06791,067911807,Tandil,BUENOS AIRES,287,317,412,369,781
06,06791,067911811,Tandil,BUENOS AIRES,211,238,363,333,696
06,06791,067911906,Tandil,BUENOS AIRES,261,331,340,301,641
06,06791,067912101,Tandil,BUENOS AIRES,203,216,368,379,747
06,06791,067912104,Tandil,BUENOS AIRES,231,238,428,405,833
06,06791,067912107,Tandil,BUENOS AIRES,271,272,382,334,716
06,06791,067912114,Tandil,BUENOS AIRES,113,124,180,206,386
06,06791,067912116,Tandil,BUENOS AIRES,221,261,355,345,700
06,06791,067912205,Tandil,BUENOS AIRES,286,357,454,461,915
06,06791,067912213,Tandil,BUENOS AIRES,240,268,369,352,721
06,06791,067910101,Tandil,BUENOS AIRES,415,475,589,506,1095
06,06791,067910701,Tandil,BUENOS AIRES,55,79,63,102,165
06,06791,067910906,Tandil,BUENOS AIRES,51,82,67,75,142
06,06791,067911504,Tandil,BUENOS AIRES,46,54,57,79,136
06,06791,067910213,Tandil,BUENOS AIRES,345,443,453,358,811
06,06791,067910106,Tandil,BUENOS AIRES,302,390,397,300,697
06,06791,067910206,Tandil,BUENOS AIRES,370,431,439,401,840
06,06791,067910207,Tandil,BUENOS AIRES,291,342,396,350,746
06,06791,067910212,Tandil,BUENOS AIRES,299,395,417,317,734
06,06791,067910307,Tandil,BUENOS AIRES,387,461,568,491,1059
06,06791,067910308,Tandil,BUENOS AIRES,244,258,380,304,684
06,06791,067910310,Tandil,BUENOS AIRES,404,459,604,575,1179
06,06791,067910408,Tandil,BUENOS AIRES,274,389,302,223,525
06,06791,067910409,Tandil,BUENOS AIRES,191,259,287,238,525
06,06791,067910410,Tandil,BUENOS AIRES,200,264,279,202,481
06,06791,067910412,Tandil,BUENOS AIRES,193,242,216,211,427
06,06791,067911208,Tandil,BUENOS AIRES,422,464,604,560,1164
06,06791,067911211,Tandil,BUENOS AIRES,225,246,329,302,631
06,06791,067911804,Tandil,BUENOS AIRES,253,302,345,308,653
06,06791,067912005,Tandil,BUENOS AIRES,306,326,513,424,937
06,06791,067912009,Tandil,BUENOS AIRES,333,398,505,478,983
06,06791,067912102,Tandil,BUENOS AIRES,361,374,570,646,1216
06,06791,067912201,Tandil,BUENOS AIRES,131,197,196,220,416
06,06791,067910602,Tandil,BUENOS AIRES,38,53,36,69,105
06,06791,067910904,Tandil,BUENOS AIRES,31,62,38,59,97
06,06791,067911102,Tandil,BUENOS AIRES,29,47,39,51,90
06,06791,067911104,Tandil,BUENOS AIRES,60,91,86,96,182
06,06791,067911503,Tandil,BUENOS AIRES,32,45,40,66,106
06,06791,067910105,Tandil,BUENOS AIRES,206,247,235,189,424
06,06791,067910107,Tandil,BUENOS AIRES,371,470,469,389,858
06,06791,067910201,Tandil,BUENOS AIRES,184,215,241,214,455
06,06791,067910203,Tandil,BUENOS AIRES,268,299,417,356,773
06,06791,067910210,Tandil,BUENOS AIRES,355,430,566,405,971
06,06791,067910406,Tandil,BUENOS AIRES,224,290,282,221,503
06,06791,067911003,Tandil,BUENOS AIRES,87,104,143,139,282
06,06791,067911303,Tandil,BUENOS AIRES,267,291,438,395,833
06,06791,067911305,Tandil,BUENOS AIRES,498,525,807,811,1618
06,06791,067911907,Tandil,BUENOS AIRES,180,221,256,231,487
06,06791,067912002,Tandil,BUENOS AIRES,313,338,534,454,988
06,06791,067912003,Tandil,BUENOS AIRES,450,502,818,845,1663
06,06791,067912004,Tandil,BUENOS AIRES,353,383,598,569,1167
06,06791,067912007,Tandil,BUENOS AIRES,326,371,469,449,918
06,06791,067912111,Tandil,BUENOS AIRES,288,322,522,537,1059
06,06791,067912212,Tandil,BUENOS AIRES,254,281,391,358,749
06,06791,067910902,Tandil,BUENOS AIRES,66,89,47,79,126
06,06791,067910903,Tandil,BUENOS AIRES,35,52,60,61,121
06,06791,067910502,Tandil,BUENOS AIRES,28,36,27,45,72
06,06791,067911004,Tandil,BUENOS AIRES,35,46,45,57,102
06,06791,067911401,Tandil,BUENOS AIRES,27,37,37,41,78
06,06791,067911502,Tandil,BUENOS AIRES,125,147,121,195,316
06,06791,067911701,Tandil,BUENOS AIRES,42,51,34,90,124
06,06791,067910802,Tandil,BUENOS AIRES,39,53,54,64,118
06,06791,067910216,Tandil,BUENOS AIRES,259,310,335,272,607
06,06791,067910209,Tandil,BUENOS AIRES,255,295,331,279,610
06,06791,067910403,Tandil,BUENOS AIRES,225,296,283,216,499
06,06791,067911207,Tandil,BUENOS AIRES,345,362,557,489,1046
06,06791,067911308,Tandil,BUENOS AIRES,264,282,450,389,839
06,06791,067911311,Tandil,BUENOS AIRES,279,302,499,470,969
06,06791,067911802,Tandil,BUENOS AIRES,221,277,291,252,543
06,06791,067911808,Tandil,BUENOS AIRES,266,291,410,359,769
06,06791,067911812,Tandil,BUENOS AIRES,234,269,352,353,705
06,06791,067911901,Tandil,BUENOS AIRES,218,251,299,246,545
06,06791,067911903,Tandil,BUENOS AIRES,294,347,403,300,703
06,06791,067911905,Tandil,BUENOS AIRES,424,496,534,471,1005
06,06791,067911909,Tandil,BUENOS AIRES,175,237,185,144,329
06,06791,067912103,Tandil,BUENOS AIRES,281,286,472,506,978
06,06791,067912105,Tandil,BUENOS AIRES,436,448,674,693,1367
06,06791,067912106,Tandil,BUENOS AIRES,415,437,633,582,1215
06,06791,067912109,Tandil,BUENOS AIRES,479,512,720,670,1390
06,06791,067912204,Tandil,BUENOS AIRES,181,221,316,309,625
06,06791,067912207,Tandil,BUENOS AIRES,462,493,759,746,1505
06,06791,067912210,Tandil,BUENOS AIRES,365,418,524,470,994
06,06791,067912211,Tandil,BUENOS AIRES,243,330,359,365,724
06,06791,067912218,Tandil,BUENOS AIRES,132,174,303,374,677
06,06791,067911801,Tandil,BUENOS AIRES,214,236,276,246,522
06,06791,067910503,Tandil,BUENOS AIRES,8,16,1,10,11
06,06791,067911009,Tandil,BUENOS AIRES,29,46,36,55,91
06,06791,067911402,Tandil,BUENOS AIRES,47,56,36,70,106
06,06791,067911813,Tandil,BUENOS AIRES,304,333,462,432,894
06,06791,067911403,Tandil,BUENOS AIRES,63,94,81,105,186
06,06791,067910205,Tandil,BUENOS AIRES,270,317,346,317,663
06,06791,067910301,Tandil,BUENOS AIRES,310,349,478,409,887
06,06791,067910309,Tandil,BUENOS AIRES,328,371,524,513,1037
06,06791,067910401,Tandil,BUENOS AIRES,225,296,315,274,589
06,06791,067911006,Tandil,BUENOS AIRES,322,377,460,459,919
06,06791,067911005,Tandil,BUENOS AIRES,44,66,56,62,118
06,06791,067911201,Tandil,BUENOS AIRES,246,329,427,455,882
06,06791,067911206,Tandil,BUENOS AIRES,400,433,650,580,1230
06,06791,067911212,Tandil,BUENOS AIRES,223,252,340,298,638
06,06791,067911904,Tandil,BUENOS AIRES,303,358,390,333,723
06,06791,067912108,Tandil,BUENOS AIRES,232,250,295,320,615
06,06791,067912110,Tandil,BUENOS AIRES,373,459,800,769,1569
06,06791,067912113,Tandil,BUENOS AIRES,188,255,285,275,560
06,06791,067910218,Tandil,BUENOS AIRES,453,465,621,563,1184
06,06791,067910601,Tandil,BUENOS AIRES,71,105,86,114,200
06,06791,067910801,Tandil,BUENOS AIRES,15,18,13,22,35
06,06791,067910803,Tandil,BUENOS AIRES,23,40,22,46,68
06,06791,067911101,Tandil,BUENOS AIRES,27,35,30,35,65
06,06791,067911404,Tandil,BUENOS AIRES,45,64,48,78,126
06,06791,067911405,Tandil,BUENOS AIRES,78,67,64,101,165
06,06791,067911406,Tandil,BUENOS AIRES,41,47,61,57,118
06,06791,067911506,Tandil,BUENOS AIRES,14,23,22,20,42
06,06791,067911702,Tandil,BUENOS AIRES,34,59,37,52,89
06,06798,067980103,Tapalqué,BUENOS AIRES,19,19,18,25,43
06,06798,067980202,Tapalqué,BUENOS AIRES,7,12,3,13,16
06,06798,067980401,Tapalqué,BUENOS AIRES,8,28,11,13,24
06,06798,067980506,Tapalqué,BUENOS AIRES,14,27,16,19,35
06,06798,067980801,Tapalqué,BUENOS AIRES,14,26,10,20,30
06,06798,067980707,Tapalqué,BUENOS AIRES,178,212,318,294,612
06,06798,067980701,Tapalqué,BUENOS AIRES,198,258,319,289,608
06,06798,067980203,Tapalqué,BUENOS AIRES,30,34,37,43,80
06,06798,067980505,Tapalqué,BUENOS AIRES,22,16,18,17,35
06,06798,067980502,Tapalqué,BUENOS AIRES,28,38,42,47,89
06,06798,067980702,Tapalqué,BUENOS AIRES,400,490,581,530,1111
06,06798,067980711,Tapalqué,BUENOS AIRES,261,311,383,333,716
06,06798,067980705,Tapalqué,BUENOS AIRES,174,229,311,256,567
06,06798,067980710,Tapalqué,BUENOS AIRES,202,255,291,262,553
06,06798,067980301,Tapalqué,BUENOS AIRES,14,18,12,28,40
06,06798,067980302,Tapalqué,BUENOS AIRES,21,31,16,33,49
06,06798,067980507,Tapalqué,BUENOS AIRES,13,20,12,24,36
06,06798,067980901,Tapalqué,BUENOS AIRES,19,33,19,38,57
06,06798,067981006,Tapalqué,BUENOS AIRES,6,16,8,12,20
06,06798,067980708,Tapalqué,BUENOS AIRES,413,500,735,693,1428
06,06798,067980501,Tapalqué,BUENOS AIRES,49,73,83,75,158
06,06798,067981001,Tapalqué,BUENOS AIRES,20,36,27,30,57
06,06798,067980201,Tapalqué,BUENOS AIRES,22,26,27,47,74
06,06798,067980101,Tapalqué,BUENOS AIRES,20,23,22,27,49
06,06798,067980102,Tapalqué,BUENOS AIRES,21,21,21,38,59
06,06798,067980402,Tapalqué,BUENOS AIRES,16,24,19,25,44
06,06798,067980902,Tapalqué,BUENOS AIRES,12,23,11,17,28
06,06798,067980703,Tapalqué,BUENOS AIRES,318,435,433,380,813
06,06798,067980709,Tapalqué,BUENOS AIRES,180,229,254,257,511
06,06798,067980504,Tapalqué,BUENOS AIRES,9,22,12,14,26
06,06798,067980706,Tapalqué,BUENOS AIRES,37,83,47,53,100
06,06798,067980905,Tapalqué,BUENOS AIRES,10,29,10,15,25
06,06798,067981004,Tapalqué,BUENOS AIRES,20,39,24,30,54
06,06798,067980704,Tapalqué,BUENOS AIRES,220,277,304,299,603
06,06798,067981002,Tapalqué,BUENOS AIRES,24,38,33,37,70
06,06798,067980503,Tapalqué,BUENOS AIRES,8,12,7,9,16
06,06798,067981005,Tapalqué,BUENOS AIRES,15,31,21,25,46
06,06798,067980601,Tapalqué,BUENOS AIRES,77,84,72,106,178
06,06798,067980903,Tapalqué,BUENOS AIRES,12,20,13,19,32
06,06798,067980904,Tapalqué,BUENOS AIRES,15,28,17,23,40
06,06798,067981003,Tapalqué,BUENOS AIRES,17,26,25,21,46
06,06553,065530313,Monte Hermoso,BUENOS AIRES,40,363,48,55,103
06,06553,065530202,Monte Hermoso,BUENOS AIRES,34,297,32,41,73
06,06553,065530110,Monte Hermoso,BUENOS AIRES,37,411,55,36,91
06,06553,065530305,Monte Hermoso,BUENOS AIRES,100,263,135,153,288
06,06553,065530103,Monte Hermoso,BUENOS AIRES,147,505,183,180,363
06,06553,065530107,Monte Hermoso,BUENOS AIRES,58,439,67,68,135
06,06553,065530108,Monte Hermoso,BUENOS AIRES,86,427,108,93,201
06,06553,065530309,Monte Hermoso,BUENOS AIRES,42,345,50,49,99
06,06553,065530101,Monte Hermoso,BUENOS AIRES,253,384,394,340,734
06,06553,065530105,Monte Hermoso,BUENOS AIRES,78,313,115,124,239
06,06553,065530205,Monte Hermoso,BUENOS AIRES,52,429,53,65,118
06,06553,065530204,Monte Hermoso,BUENOS AIRES,387,752,652,696,1348
06,06553,065530303,Monte Hermoso,BUENOS AIRES,64,241,85,103,188
06,06553,065530111,Monte Hermoso,BUENOS AIRES,17,395,15,25,40
06,06553,065530102,Monte Hermoso,BUENOS AIRES,143,344,189,204,393
06,06553,065530106,Monte Hermoso,BUENOS AIRES,88,267,127,143,270
06,06553,065530307,Monte Hermoso,BUENOS AIRES,73,364,86,91,177
06,06553,065530302,Monte Hermoso,BUENOS AIRES,87,258,102,135,237
06,06553,065530312,Monte Hermoso,BUENOS AIRES,32,336,38,44,82
06,06553,065530104,Monte Hermoso,BUENOS AIRES,48,165,63,54,117
06,06553,065530109,Monte Hermoso,BUENOS AIRES,51,335,55,57,112
06,06553,065530203,Monte Hermoso,BUENOS AIRES,60,314,70,70,140
06,06553,065530301,Monte Hermoso,BUENOS AIRES,68,258,74,94,168
06,06553,065530310,Monte Hermoso,BUENOS AIRES,22,278,27,26,53
06,06553,065530314,Monte Hermoso,BUENOS AIRES,45,312,48,55,103
06,06553,065530311,Monte Hermoso,BUENOS AIRES,18,378,20,28,48
06,06553,065530306,Monte Hermoso,BUENOS AIRES,82,391,105,120,225
06,06553,065530308,Monte Hermoso,BUENOS AIRES,37,292,53,53,106
06,06553,065530201,Monte Hermoso,BUENOS AIRES,5,7,5,8,13
06,06553,065530304,Monte Hermoso,BUENOS AIRES,77,242,119,116,235
06,06581,065810507,Necochea,BUENOS AIRES,94,458,86,86,172
06,06581,065810105,Necochea,BUENOS AIRES,420,460,658,566,1224
06,06581,065810106,Necochea,BUENOS AIRES,243,283,327,275,602
06,06581,065810303,Necochea,BUENOS AIRES,294,355,440,413,853
06,06581,065810407,Necochea,BUENOS AIRES,214,269,336,297,633
06,06581,065811707,Necochea,BUENOS AIRES,216,339,389,285,674
06,06581,065811711,Necochea,BUENOS AIRES,264,350,390,370,760
06,06581,065811304,Necochea,BUENOS AIRES,275,292,525,478,1003
06,06581,065811501,Necochea,BUENOS AIRES,126,121,251,224,475
06,06581,065811511,Necochea,BUENOS AIRES,281,341,382,319,701
06,06581,065811704,Necochea,BUENOS AIRES,189,229,275,204,479
06,06581,065810202,Necochea,BUENOS AIRES,239,338,328,262,590
06,06581,065810501,Necochea,BUENOS AIRES,77,194,91,67,158
06,06581,065810603,Necochea,BUENOS AIRES,31,42,44,39,83
06,06581,065810604,Necochea,BUENOS AIRES,11,33,11,16,27
06,06581,065810705,Necochea,BUENOS AIRES,14,23,13,28,41
06,06581,065810102,Necochea,BUENOS AIRES,374,401,712,634,1346
06,06581,065810103,Necochea,BUENOS AIRES,393,422,665,666,1331
06,06581,065810206,Necochea,BUENOS AIRES,298,389,393,260,653
06,06581,065810208,Necochea,BUENOS AIRES,289,338,418,342,760
06,06581,065810211,Necochea,BUENOS AIRES,261,280,469,441,910
06,06581,065810301,Necochea,BUENOS AIRES,304,349,464,350,814
06,06581,065810302,Necochea,BUENOS AIRES,325,376,459,381,840
06,06581,065810402,Necochea,BUENOS AIRES,209,268,275,250,525
06,06581,065810708,Necochea,BUENOS AIRES,186,220,280,284,564
06,06581,065811708,Necochea,BUENOS AIRES,142,194,212,161,373
06,06581,065811709,Necochea,BUENOS AIRES,82,164,142,84,226
06,06581,065811401,Necochea,BUENOS AIRES,96,122,184,162,346
06,06581,065811403,Necochea,BUENOS AIRES,333,350,609,588,1197
06,06581,065811502,Necochea,BUENOS AIRES,332,335,563,545,1108
06,06581,065811912,Necochea,BUENOS AIRES,256,348,387,371,758
06,06581,065810709,Necochea,BUENOS AIRES,214,258,296,275,571
06,06581,065810710,Necochea,BUENOS AIRES,175,209,247,239,486
06,06581,065810908,Necochea,BUENOS AIRES,2,6,3,3,6
06,06581,065810910,Necochea,BUENOS AIRES,4,10,4,6,10
06,06581,065811101,Necochea,BUENOS AIRES,2,14,3,3,6
06,06581,065810601,Necochea,BUENOS AIRES,11,25,10,24,34
06,06581,065810804,Necochea,BUENOS AIRES,28,40,42,51,93
06,06581,065811106,Necochea,BUENOS AIRES,4,14,4,4,8
06,06581,065811108,Necochea,BUENOS AIRES,11,17,6,13,19
06,06581,065811201,Necochea,BUENOS AIRES,12,27,7,17,24
06,06581,065811202,Necochea,BUENOS AIRES,8,19,3,10,13
06,06581,065811204,Necochea,BUENOS AIRES,21,29,24,26,50
06,06581,065811206,Necochea,BUENOS AIRES,42,62,67,79,146
06,06581,065810107,Necochea,BUENOS AIRES,278,336,397,330,727
06,06581,065811307,Necochea,BUENOS AIRES,88,138,120,152,272
06,06581,065810108,Necochea,BUENOS AIRES,265,277,436,447,883
06,06581,065810109,Necochea,BUENOS AIRES,277,293,481,444,925
06,06581,065810204,Necochea,BUENOS AIRES,253,339,380,321,701
06,06581,065810707,Necochea,BUENOS AIRES,39,50,64,60,124
06,06581,065811705,Necochea,BUENOS AIRES,274,371,403,347,750
06,06581,065811302,Necochea,BUENOS AIRES,223,231,434,419,853
06,06581,065811305,Necochea,BUENOS AIRES,281,299,482,398,880
06,06581,065811508,Necochea,BUENOS AIRES,282,301,429,451,880
06,06581,065811607,Necochea,BUENOS AIRES,263,289,410,353,763
06,06581,065811805,Necochea,BUENOS AIRES,111,403,142,106,248
06,06581,065811809,Necochea,BUENOS AIRES,102,457,112,93,205
06,06581,065811904,Necochea,BUENOS AIRES,138,304,199,191,390
06,06581,065811910,Necochea,BUENOS AIRES,166,186,252,238,490
06,06581,065810906,Necochea,BUENOS AIRES,8,11,14,11,25
06,06581,065810703,Necochea,BUENOS AIRES,25,34,39,41,80
06,06581,065810805,Necochea,BUENOS AIRES,17,45,22,32,54
06,06581,065810806,Necochea,BUENOS AIRES,15,25,21,22,43
06,06581,065810902,Necochea,BUENOS AIRES,10,23,8,13,21
06,06581,065810909,Necochea,BUENOS AIRES,3,5,3,5,8
06,06581,065811005,Necochea,BUENOS AIRES,9,13,8,16,24
06,06581,065811103,Necochea,BUENOS AIRES,16,29,10,23,33
06,06581,065811203,Necochea,BUENOS AIRES,15,31,16,21,37
06,06581,065811105,Necochea,BUENOS AIRES,27,49,41,45,86
06,06581,065810205,Necochea,BUENOS AIRES,165,269,224,192,416
06,06581,065810212,Necochea,BUENOS AIRES,242,277,382,357,739
06,06581,065810304,Necochea,BUENOS AIRES,203,243,294,242,536
06,06581,065810306,Necochea,BUENOS AIRES,210,277,300,228,528
06,06581,065810307,Necochea,BUENOS AIRES,267,352,370,276,646
06,06581,065810405,Necochea,BUENOS AIRES,371,409,556,547,1103
06,06581,065810701,Necochea,BUENOS AIRES,184,232,316,323,639
06,06581,065811706,Necochea,BUENOS AIRES,234,272,343,338,681
06,06581,065811303,Necochea,BUENOS AIRES,286,303,578,499,1077
06,06581,065811310,Necochea,BUENOS AIRES,205,286,310,323,633
06,06581,065811311,Necochea,BUENOS AIRES,280,415,429,410,839
06,06581,065811402,Necochea,BUENOS AIRES,275,291,480,465,945
06,06581,065811404,Necochea,BUENOS AIRES,152,168,235,208,443
06,06581,065811408,Necochea,BUENOS AIRES,271,286,461,489,950
06,06581,065811409,Necochea,BUENOS AIRES,257,295,425,376,801
06,06581,065811411,Necochea,BUENOS AIRES,222,243,410,411,821
06,06581,065811509,Necochea,BUENOS AIRES,329,348,541,464,1005
06,06581,065811603,Necochea,BUENOS AIRES,311,368,450,374,824
06,06581,065811606,Necochea,BUENOS AIRES,415,476,653,585,1238
06,06581,065811701,Necochea,BUENOS AIRES,203,242,271,269,540
06,06581,065811703,Necochea,BUENOS AIRES,252,357,337,277,614
06,06581,065811802,Necochea,BUENOS AIRES,104,178,122,98,220
06,06581,065811804,Necochea,BUENOS AIRES,94,262,187,316,503
06,06581,065811906,Necochea,BUENOS AIRES,129,145,252,236,488
06,06581,065811909,Necochea,BUENOS AIRES,207,229,310,317,627
06,06581,065811911,Necochea,BUENOS AIRES,199,230,323,296,619
06,06581,065810704,Necochea,BUENOS AIRES,19,25,21,35,56
06,06581,065810808,Necochea,BUENOS AIRES,18,30,33,28,61
06,06581,065810903,Necochea,BUENOS AIRES,8,17,2,10,12
06,06581,065810907,Necochea,BUENOS AIRES,4,4,4,6,10
06,06581,065811002,Necochea,BUENOS AIRES,22,50,26,38,64
06,06581,065811004,Necochea,BUENOS AIRES,7,18,4,7,11
06,06581,065811107,Necochea,BUENOS AIRES,23,100,29,33,62
06,06581,065811109,Necochea,BUENOS AIRES,5,14,5,32,37
06,06581,065811207,Necochea,BUENOS AIRES,17,26,15,24,39
06,06581,065810104,Necochea,BUENOS AIRES,381,387,644,545,1189
06,06581,065810203,Necochea,BUENOS AIRES,144,213,178,124,302
06,06581,065810401,Necochea,BUENOS AIRES,360,391,500,483,983
06,06581,065810404,Necochea,BUENOS AIRES,232,277,317,315,632
06,06581,065810801,Necochea,BUENOS AIRES,188,225,310,284,594
06,06581,065811410,Necochea,BUENOS AIRES,268,268,455,397,852
06,06581,065811412,Necochea,BUENOS AIRES,395,425,646,587,1233
06,06581,065811506,Necochea,BUENOS AIRES,279,249,471,450,921
06,06581,065811510,Necochea,BUENOS AIRES,307,325,432,437,869
06,06581,065811702,Necochea,BUENOS AIRES,238,289,344,274,618
06,06581,065811905,Necochea,BUENOS AIRES,269,325,527,505,1032
06,06581,065811908,Necochea,BUENOS AIRES,351,389,551,502,1053
06,06581,065810504,Necochea,BUENOS AIRES,83,403,91,77,168
06,06581,065810706,Necochea,BUENOS AIRES,22,48,37,38,75
06,06581,065810901,Necochea,BUENOS AIRES,7,11,16,13,29
06,06581,065810904,Necochea,BUENOS AIRES,7,13,8,9,17
06,06581,065810911,Necochea,BUENOS AIRES,2,3,1,3,4
06,06581,065810913,Necochea,BUENOS AIRES,11,11,15,14,29
06,06581,065811006,Necochea,BUENOS AIRES,13,28,26,25,51
06,06581,065811104,Necochea,BUENOS AIRES,8,16,11,15,26
06,06581,065810508,Necochea,BUENOS AIRES,102,419,122,84,206
06,06581,065810209,Necochea,BUENOS AIRES,268,328,342,312,654
06,06581,065810802,Necochea,BUENOS AIRES,192,219,252,249,501
06,06581,065811504,Necochea,BUENOS AIRES,359,359,501,460,961
06,06581,065811604,Necochea,BUENOS AIRES,319,310,469,436,905
06,06581,065811608,Necochea,BUENOS AIRES,271,289,466,455,921
06,06581,065811803,Necochea,BUENOS AIRES,107,205,131,99,230
06,06581,065811806,Necochea,BUENOS AIRES,94,306,102,96,198
06,06581,065810502,Necochea,BUENOS AIRES,52,139,56,35,91
06,06581,065810602,Necochea,BUENOS AIRES,36,66,50,61,111
06,06581,065810905,Necochea,BUENOS AIRES,3,10,2,6,8
06,06581,065811003,Necochea,BUENOS AIRES,14,24,19,22,41
06,06581,065811205,Necochea,BUENOS AIRES,35,31,44,53,97
06,06581,065810505,Necochea,BUENOS AIRES,73,526,80,77,157
06,06581,065810506,Necochea,BUENOS AIRES,149,341,220,173,393
06,06581,065810410,Necochea,BUENOS AIRES,185,272,261,216,477
06,06581,065810411,Necochea,BUENOS AIRES,212,316,294,253,547
06,06581,065811602,Necochea,BUENOS AIRES,342,394,479,443,922
06,06581,065810111,Necochea,BUENOS AIRES,239,252,491,466,957
06,06581,065810201,Necochea,BUENOS AIRES,291,343,412,320,732
06,06581,065810207,Necochea,BUENOS AIRES,291,350,418,374,792
06,06581,065810403,Necochea,BUENOS AIRES,197,242,305,226,531
06,06581,065810809,Necochea,BUENOS AIRES,180,196,265,276,541
06,06581,065810810,Necochea,BUENOS AIRES,173,202,256,239,495
06,06581,065811001,Necochea,BUENOS AIRES,141,211,210,220,430
06,06581,065811301,Necochea,BUENOS AIRES,248,315,414,436,850
06,06581,065811308,Necochea,BUENOS AIRES,191,351,280,332,612
06,06581,065811405,Necochea,BUENOS AIRES,163,174,258,253,511
06,06581,065811407,Necochea,BUENOS AIRES,236,254,414,420,834
06,06581,065811507,Necochea,BUENOS AIRES,403,398,764,725,1489
06,06581,065811901,Necochea,BUENOS AIRES,84,366,110,107,217
06,06581,065811903,Necochea,BUENOS AIRES,124,418,171,165,336
06,06581,065811907,Necochea,BUENOS AIRES,137,149,245,249,494
06,06581,065810712,Necochea,BUENOS AIRES,158,203,249,247,496
06,06581,065811102,Necochea,BUENOS AIRES,8,13,7,11,18
06,06581,065810503,Necochea,BUENOS AIRES,123,455,133,99,232
06,06581,065810912,Necochea,BUENOS AIRES,9,15,5,15,20
06,06581,065810409,Necochea,BUENOS AIRES,240,332,350,281,631
06,06581,065810305,Necochea,BUENOS AIRES,215,258,314,219,533
06,06581,065810101,Necochea,BUENOS AIRES,359,386,602,568,1170
06,06581,065810110,Necochea,BUENOS AIRES,263,280,457,463,920
06,06581,065810210,Necochea,BUENOS AIRES,248,259,368,350,718
06,06581,065810308,Necochea,BUENOS AIRES,208,258,315,287,602
06,06581,065810406,Necochea,BUENOS AIRES,151,214,220,214,434
06,06581,065811306,Necochea,BUENOS AIRES,522,557,913,837,1750
06,06581,065811309,Necochea,BUENOS AIRES,181,279,298,288,586
06,06581,065811406,Necochea,BUENOS AIRES,143,162,278,249,527
06,06581,065811503,Necochea,BUENOS AIRES,194,198,302,270,572
06,06581,065811505,Necochea,BUENOS AIRES,301,324,510,506,1016
06,06581,065811601,Necochea,BUENOS AIRES,313,360,452,349,801
06,06581,065811605,Necochea,BUENOS AIRES,225,273,344,318,662
06,06581,065811801,Necochea,BUENOS AIRES,292,329,418,371,789
06,06581,065811807,Necochea,BUENOS AIRES,179,376,220,164,384
06,06581,065811808,Necochea,BUENOS AIRES,145,380,161,110,271
06,06581,065811902,Necochea,BUENOS AIRES,40,142,61,66,127
06,06581,065810408,Necochea,BUENOS AIRES,261,346,383,320,703
06,06581,065810711,Necochea,BUENOS AIRES,173,201,255,225,480
06,06581,065811710,Necochea,BUENOS AIRES,179,303,239,192,431
06,06581,065810702,Necochea,BUENOS AIRES,7,12,8,11,19
06,06581,065810803,Necochea,BUENOS AIRES,33,92,48,45,93
06,06581,065810807,Necochea,BUENOS AIRES,2,11,5,4,9
06,06547,065470905,Monte,BUENOS AIRES,428,471,679,610,1289
06,06547,065470906,Monte,BUENOS AIRES,359,418,541,460,1001
06,06547,065470501,Monte,BUENOS AIRES,27,36,37,39,76
06,06547,065470102,Monte,BUENOS AIRES,22,38,24,36,60
06,06547,065470202,Monte,BUENOS AIRES,30,41,38,61,99
06,06547,065470203,Monte,BUENOS AIRES,44,62,65,67,132
06,06547,065470313,Monte,BUENOS AIRES,63,87,109,102,211
06,06547,065470502,Monte,BUENOS AIRES,32,48,49,63,112
06,06547,065470702,Monte,BUENOS AIRES,20,23,23,31,54
06,06547,065470306,Monte,BUENOS AIRES,410,464,684,665,1349
06,06547,065470910,Monte,BUENOS AIRES,283,358,419,365,784
06,06547,065470303,Monte,BUENOS AIRES,27,41,32,31,63
06,06547,065470601,Monte,BUENOS AIRES,73,135,115,128,243
06,06547,065470308,Monte,BUENOS AIRES,116,135,188,203,391
06,06547,065470309,Monte,BUENOS AIRES,261,340,487,479,966
06,06547,065470904,Monte,BUENOS AIRES,446,504,729,622,1351
06,06547,065470305,Monte,BUENOS AIRES,241,272,420,415,835
06,06547,065470311,Monte,BUENOS AIRES,118,245,169,172,341
06,06547,065470902,Monte,BUENOS AIRES,318,371,537,582,1119
06,06547,065470901,Monte,BUENOS AIRES,218,395,563,574,1137
06,06547,065470503,Monte,BUENOS AIRES,22,48,24,33,57
06,06547,065470908,Monte,BUENOS AIRES,376,423,569,490,1059
06,06547,065470302,Monte,BUENOS AIRES,44,70,61,64,125
06,06547,065470304,Monte,BUENOS AIRES,33,66,39,63,102
06,06547,065470602,Monte,BUENOS AIRES,31,53,42,51,93
06,06547,065470801,Monte,BUENOS AIRES,71,128,106,129,235
06,06547,065470201,Monte,BUENOS AIRES,198,247,306,297,603
06,06547,065470307,Monte,BUENOS AIRES,402,426,761,714,1475
06,06547,065470310,Monte,BUENOS AIRES,124,263,202,249,451
06,06547,065470909,Monte,BUENOS AIRES,303,351,440,391,831
06,06547,065470101,Monte,BUENOS AIRES,35,74,46,51,97
06,06547,065470301,Monte,BUENOS AIRES,32,47,47,50,97
06,06547,065470402,Monte,BUENOS AIRES,58,100,79,83,162
06,06547,065470603,Monte,BUENOS AIRES,80,156,108,134,242
06,06547,065470903,Monte,BUENOS AIRES,315,332,584,591,1175
06,06547,065470701,Monte,BUENOS AIRES,16,22,13,30,43
06,06547,065470401,Monte,BUENOS AIRES,11,27,9,11,20
06,06547,065470703,Monte,BUENOS AIRES,37,161,50,58,108
06,06547,065470802,Monte,BUENOS AIRES,42,89,48,67,115
06,06547,065470312,Monte,BUENOS AIRES,406,482,631,547,1178
06,06547,065470907,Monte,BUENOS AIRES,415,493,603,550,1153
06,06560,065600112,Moreno,BUENOS AIRES,312,314,576,582,1158
06,06560,065600202,Moreno,BUENOS AIRES,429,417,806,813,1619
06,06560,065600211,Moreno,BUENOS AIRES,929,997,1682,1729,3411
06,06560,065601206,Moreno,BUENOS AIRES,286,273,488,401,889
06,06560,065601208,Moreno,BUENOS AIRES,267,255,479,438,917
06,06560,065600301,Moreno,BUENOS AIRES,1080,972,2176,2236,4412
06,06560,065601213,Moreno,BUENOS AIRES,304,275,526,475,1001
06,06560,065600310,Moreno,BUENOS AIRES,382,387,726,723,1449
06,06560,065600412,Moreno,BUENOS AIRES,301,302,559,536,1095
06,06560,065600414,Moreno,BUENOS AIRES,278,297,480,425,905
06,06560,065600418,Moreno,BUENOS AIRES,282,277,457,463,920
06,06560,065600515,Moreno,BUENOS AIRES,282,300,549,487,1036
06,06560,065600605,Moreno,BUENOS AIRES,694,680,1279,1309,2588
06,06560,065601305,Moreno,BUENOS AIRES,375,353,731,743,1474
06,06560,065600705,Moreno,BUENOS AIRES,368,361,690,669,1359
06,06560,065600708,Moreno,BUENOS AIRES,97,91,190,206,396
06,06560,065601402,Moreno,BUENOS AIRES,413,412,788,817,1605
06,06560,065601403,Moreno,BUENOS AIRES,341,352,576,644,1220
06,06560,065601409,Moreno,BUENOS AIRES,236,235,476,498,974
06,06560,065601503,Moreno,BUENOS AIRES,293,275,578,606,1184
06,06560,065601511,Moreno,BUENOS AIRES,395,375,760,758,1518
06,06560,065601515,Moreno,BUENOS AIRES,408,399,837,832,1669
06,06560,065601601,Moreno,BUENOS AIRES,334,384,603,594,1197
06,06560,065601614,Moreno,BUENOS AIRES,417,411,767,776,1543
06,06560,065601814,Moreno,BUENOS AIRES,448,429,801,775,1576
06,06560,065601711,Moreno,BUENOS AIRES,176,338,283,287,570
06,06560,065601715,Moreno,BUENOS AIRES,180,181,316,324,640
06,06560,065601815,Moreno,BUENOS AIRES,364,398,699,668,1367
06,06560,065601919,Moreno,BUENOS AIRES,182,225,318,381,699
06,06560,065602104,Moreno,BUENOS AIRES,199,259,379,372,751
06,06560,065602106,Moreno,BUENOS AIRES,264,354,486,489,975
06,06560,065602102,Moreno,BUENOS AIRES,211,267,325,354,679
06,06560,065602205,Moreno,BUENOS AIRES,404,422,704,691,1395
06,06560,065602208,Moreno,BUENOS AIRES,399,428,631,550,1181
06,06560,065602312,Moreno,BUENOS AIRES,189,242,344,350,694
06,06560,065602314,Moreno,BUENOS AIRES,219,240,315,281,596
06,06560,065602412,Moreno,BUENOS AIRES,191,221,257,218,475
06,06560,065600714,Moreno,BUENOS AIRES,445,366,825,849,1674
06,06560,065601717,Moreno,BUENOS AIRES,237,247,507,456,963
06,06560,065600903,Moreno,BUENOS AIRES,49,57,99,115,214
06,06560,065600806,Moreno,BUENOS AIRES,321,347,524,556,1080
06,06560,065600901,Moreno,BUENOS AIRES,228,221,382,425,807
06,06560,065600902,Moreno,BUENOS AIRES,93,100,174,193,367
06,06560,065600911,Moreno,BUENOS AIRES,57,50,88,104,192
06,06560,065601001,Moreno,BUENOS AIRES,163,221,258,271,529
06,06560,065601006,Moreno,BUENOS AIRES,387,386,704,726,1430
06,06560,065601007,Moreno,BUENOS AIRES,448,490,834,857,1691
06,06560,065601011,Moreno,BUENOS AIRES,377,368,652,654,1306
06,06560,065601105,Moreno,BUENOS AIRES,236,226,478,468,946
06,06560,065601110,Moreno,BUENOS AIRES,453,444,777,825,1602
06,06560,065600104,Moreno,BUENOS AIRES,322,331,675,681,1356
06,06560,065600113,Moreno,BUENOS AIRES,299,296,593,576,1169
06,06560,065600206,Moreno,BUENOS AIRES,433,410,880,904,1784
06,06560,065600207,Moreno,BUENOS AIRES,372,370,757,722,1479
06,06560,065600210,Moreno,BUENOS AIRES,412,409,781,821,1602
06,06560,065600404,Moreno,BUENOS AIRES,455,437,905,900,1805
06,06560,065600215,Moreno,BUENOS AIRES,408,446,809,823,1632
06,06560,065601202,Moreno,BUENOS AIRES,307,296,631,580,1211
06,06560,065600216,Moreno,BUENOS AIRES,691,845,1071,1239,2310
06,06560,065600407,Moreno,BUENOS AIRES,216,238,475,513,988
06,06560,065600416,Moreno,BUENOS AIRES,301,313,530,456,986
06,06560,065600503,Moreno,BUENOS AIRES,187,180,362,347,709
06,06560,065600603,Moreno,BUENOS AIRES,446,433,805,771,1576
06,06560,065601401,Moreno,BUENOS AIRES,476,400,988,1080,2068
06,06560,065601404,Moreno,BUENOS AIRES,326,341,711,682,1393
06,06560,065601509,Moreno,BUENOS AIRES,499,452,970,1008,1978
06,06560,065601610,Moreno,BUENOS AIRES,353,379,668,659,1327
06,06560,065601613,Moreno,BUENOS AIRES,385,411,711,751,1462
06,06560,065601801,Moreno,BUENOS AIRES,215,260,402,411,813
06,06560,065601803,Moreno,BUENOS AIRES,222,256,421,410,831
06,06560,065601808,Moreno,BUENOS AIRES,185,278,289,295,584
06,06560,065601809,Moreno,BUENOS AIRES,405,432,777,802,1579
06,06560,065601910,Moreno,BUENOS AIRES,379,453,726,720,1446
06,06560,065601916,Moreno,BUENOS AIRES,201,227,369,394,763
06,06560,065602012,Moreno,BUENOS AIRES,297,293,543,487,1030
06,06560,065602109,Moreno,BUENOS AIRES,395,433,701,677,1378
06,06560,065602203,Moreno,BUENOS AIRES,357,455,584,590,1174
06,06560,065602207,Moreno,BUENOS AIRES,249,282,414,395,809
06,06560,065602302,Moreno,BUENOS AIRES,295,295,560,536,1096
06,06560,065602305,Moreno,BUENOS AIRES,345,350,566,541,1107
06,06560,065602315,Moreno,BUENOS AIRES,258,280,382,300,682
06,06560,065602505,Moreno,BUENOS AIRES,217,246,357,349,706
06,06560,065602512,Moreno,BUENOS AIRES,261,273,477,435,912
06,06560,065600408,Moreno,BUENOS AIRES,284,314,361,417,778
06,06560,065600808,Moreno,BUENOS AIRES,393,401,717,714,1431
06,06560,065600810,Moreno,BUENOS AIRES,318,311,499,465,964
06,06560,065601108,Moreno,BUENOS AIRES,396,395,736,731,1467
06,06560,065601109,Moreno,BUENOS AIRES,382,394,738,729,1467
06,06560,065601113,Moreno,BUENOS AIRES,421,465,751,723,1474
06,06560,065600101,Moreno,BUENOS AIRES,394,362,770,784,1554
06,06560,065600201,Moreno,BUENOS AIRES,397,392,758,805,1563
06,06560,065600203,Moreno,BUENOS AIRES,414,369,741,787,1528
06,06560,065600212,Moreno,BUENOS AIRES,324,341,620,628,1248
06,06560,065600213,Moreno,BUENOS AIRES,333,362,657,675,1332
06,06560,065600405,Moreno,BUENOS AIRES,322,280,725,642,1367
06,06560,065600309,Moreno,BUENOS AIRES,421,354,862,837,1699
06,06560,065600410,Moreno,BUENOS AIRES,363,341,679,729,1408
06,06560,065600504,Moreno,BUENOS AIRES,357,340,645,693,1338
06,06560,065600601,Moreno,BUENOS AIRES,375,354,651,662,1313
06,06560,065601215,Moreno,BUENOS AIRES,262,267,413,412,825
06,06560,065600602,Moreno,BUENOS AIRES,431,406,890,781,1671
06,06560,065600604,Moreno,BUENOS AIRES,271,255,484,494,978
06,06560,065600607,Moreno,BUENOS AIRES,1225,1179,2349,2282,4631
06,06560,065600611,Moreno,BUENOS AIRES,422,363,755,696,1451
06,06560,065602401,Moreno,BUENOS AIRES,229,270,305,248,553
06,06560,065601303,Moreno,BUENOS AIRES,474,461,980,937,1917
06,06560,065600618,Moreno,BUENOS AIRES,288,290,572,506,1078
06,06560,065600703,Moreno,BUENOS AIRES,364,362,604,568,1172
06,06560,065600706,Moreno,BUENOS AIRES,454,412,869,862,1731
06,06560,065600710,Moreno,BUENOS AIRES,209,215,395,387,782
06,06560,065601410,Moreno,BUENOS AIRES,236,218,523,480,1003
06,06560,065601505,Moreno,BUENOS AIRES,266,250,574,496,1070
06,06560,065601514,Moreno,BUENOS AIRES,384,361,808,766,1574
06,06560,065601704,Moreno,BUENOS AIRES,188,94,369,373,742
06,06560,065601705,Moreno,BUENOS AIRES,238,324,394,406,800
06,06560,065601713,Moreno,BUENOS AIRES,240,256,504,520,1024
06,06560,065601804,Moreno,BUENOS AIRES,225,258,375,402,777
06,06560,065601813,Moreno,BUENOS AIRES,275,320,505,481,986
06,06560,065601902,Moreno,BUENOS AIRES,291,319,531,524,1055
06,06560,065601911,Moreno,BUENOS AIRES,262,309,434,410,844
06,06560,065602001,Moreno,BUENOS AIRES,468,462,1252,1234,2486
06,06560,065602005,Moreno,BUENOS AIRES,274,268,569,596,1165
06,06560,065602014,Moreno,BUENOS AIRES,344,329,600,644,1244
06,06560,065602316,Moreno,BUENOS AIRES,298,325,415,429,844
06,06560,065602402,Moreno,BUENOS AIRES,186,246,267,222,489
06,06560,065602407,Moreno,BUENOS AIRES,308,349,536,506,1042
06,06560,065602502,Moreno,BUENOS AIRES,265,282,438,365,803
06,06560,065602503,Moreno,BUENOS AIRES,374,418,555,507,1062
06,06560,065602510,Moreno,BUENOS AIRES,507,528,806,700,1506
06,06560,065602511,Moreno,BUENOS AIRES,264,281,444,420,864
06,06560,065600803,Moreno,BUENOS AIRES,305,328,535,528,1063
06,06560,065601913,Moreno,BUENOS AIRES,195,227,324,329,653
06,06560,065600718,Moreno,BUENOS AIRES,326,339,535,586,1121
06,06560,065600906,Moreno,BUENOS AIRES,104,105,190,205,395
06,06560,065601005,Moreno,BUENOS AIRES,395,410,738,679,1417
06,06560,065601008,Moreno,BUENOS AIRES,363,391,632,632,1264
06,06560,065601013,Moreno,BUENOS AIRES,345,358,589,535,1124
06,06560,065601103,Moreno,BUENOS AIRES,238,241,409,424,833
06,06560,065601311,Moreno,BUENOS AIRES,483,462,888,866,1754
06,06560,065601603,Moreno,BUENOS AIRES,340,328,562,590,1152
06,06560,065601612,Moreno,BUENOS AIRES,463,465,861,834,1695
06,06560,065601712,Moreno,BUENOS AIRES,132,256,187,220,407
06,06560,065601806,Moreno,BUENOS AIRES,516,705,898,913,1811
06,06560,065601812,Moreno,BUENOS AIRES,270,331,442,374,816
06,06560,065601903,Moreno,BUENOS AIRES,376,409,712,744,1456
06,06560,065601909,Moreno,BUENOS AIRES,289,349,508,481,989
06,06560,065602317,Moreno,BUENOS AIRES,386,473,550,439,989
06,06560,065601917,Moreno,BUENOS AIRES,165,213,309,348,657
06,06560,065602105,Moreno,BUENOS AIRES,257,308,469,441,910
06,06560,065602313,Moreno,BUENOS AIRES,329,388,463,390,853
06,06560,065602405,Moreno,BUENOS AIRES,281,279,444,433,877
06,06560,065602415,Moreno,BUENOS AIRES,198,254,276,215,491
06,06560,065602416,Moreno,BUENOS AIRES,279,318,412,424,836
06,06560,065602501,Moreno,BUENOS AIRES,247,263,357,337,694
06,06560,065602509,Moreno,BUENOS AIRES,469,486,755,710,1465
06,06560,065602513,Moreno,BUENOS AIRES,430,441,825,777,1602
06,06560,065600102,Moreno,BUENOS AIRES,381,374,760,764,1524
06,06560,065600302,Moreno,BUENOS AIRES,501,451,965,926,1891
06,06560,065601714,Moreno,BUENOS AIRES,194,212,385,391,776
06,06560,065602206,Moreno,BUENOS AIRES,257,268,428,409,837
06,06560,065600715,Moreno,BUENOS AIRES,406,381,772,763,1535
06,06560,065600807,Moreno,BUENOS AIRES,378,363,692,750,1442
06,06560,065600811,Moreno,BUENOS AIRES,274,272,491,452,943
06,06560,065600812,Moreno,BUENOS AIRES,232,250,421,384,805
06,06560,065600908,Moreno,BUENOS AIRES,78,89,157,164,321
06,06560,065601003,Moreno,BUENOS AIRES,314,343,546,498,1044
06,06560,065601102,Moreno,BUENOS AIRES,384,386,666,650,1316
06,06560,065601111,Moreno,BUENOS AIRES,427,421,809,797,1606
06,06560,065601114,Moreno,BUENOS AIRES,342,379,578,599,1177
06,06560,065600115,Moreno,BUENOS AIRES,275,307,499,532,1031
06,06560,065601207,Moreno,BUENOS AIRES,287,275,503,487,990
06,06560,065601212,Moreno,BUENOS AIRES,262,263,510,492,1002
06,06560,065600311,Moreno,BUENOS AIRES,383,407,722,664,1386
06,06560,065600314,Moreno,BUENOS AIRES,235,236,458,451,909
06,06560,065600502,Moreno,BUENOS AIRES,386,392,693,673,1366
06,06560,065600506,Moreno,BUENOS AIRES,59,58,105,108,213
06,06560,065600609,Moreno,BUENOS AIRES,445,447,812,750,1562
06,06560,065600614,Moreno,BUENOS AIRES,214,224,403,378,781
06,06560,065600702,Moreno,BUENOS AIRES,337,347,590,580,1170
06,06560,065601502,Moreno,BUENOS AIRES,205,207,402,386,788
06,06560,065601407,Moreno,BUENOS AIRES,269,262,556,544,1100
06,06560,065601408,Moreno,BUENOS AIRES,557,565,1042,1028,2070
06,06560,065601411,Moreno,BUENOS AIRES,279,254,609,590,1199
06,06560,065601412,Moreno,BUENOS AIRES,363,359,737,707,1444
06,06560,065601413,Moreno,BUENOS AIRES,318,331,659,623,1282
06,06560,065601512,Moreno,BUENOS AIRES,402,387,861,792,1653
06,06560,065601513,Moreno,BUENOS AIRES,383,360,771,766,1537
06,06560,065601602,Moreno,BUENOS AIRES,266,274,520,498,1018
06,06560,065601606,Moreno,BUENOS AIRES,434,393,751,755,1506
06,06560,065601611,Moreno,BUENOS AIRES,409,400,759,729,1488
06,06560,065601615,Moreno,BUENOS AIRES,258,290,451,493,944
06,06560,065601706,Moreno,BUENOS AIRES,222,309,346,391,737
06,06560,065601718,Moreno,BUENOS AIRES,184,214,346,342,688
06,06560,065601802,Moreno,BUENOS AIRES,358,443,646,640,1286
06,06560,065601810,Moreno,BUENOS AIRES,474,483,865,883,1748
06,06560,065601811,Moreno,BUENOS AIRES,411,444,722,739,1461
06,06560,065601901,Moreno,BUENOS AIRES,256,293,494,472,966
06,06560,065602007,Moreno,BUENOS AIRES,339,332,732,719,1451
06,06560,065602008,Moreno,BUENOS AIRES,293,288,657,639,1296
06,06560,065602009,Moreno,BUENOS AIRES,335,354,697,641,1338
06,06560,065602010,Moreno,BUENOS AIRES,325,330,704,718,1422
06,06560,065602013,Moreno,BUENOS AIRES,423,445,873,838,1711
06,06560,065602103,Moreno,BUENOS AIRES,245,280,485,482,967
06,06560,065602108,Moreno,BUENOS AIRES,404,393,759,729,1488
06,06560,065602111,Moreno,BUENOS AIRES,441,465,821,773,1594
06,06560,065602201,Moreno,BUENOS AIRES,291,354,524,531,1055
06,06560,065602301,Moreno,BUENOS AIRES,326,362,555,572,1127
06,06560,065602309,Moreno,BUENOS AIRES,189,260,245,221,466
06,06560,065602408,Moreno,BUENOS AIRES,297,307,466,433,899
06,06560,065602411,Moreno,BUENOS AIRES,293,386,433,332,765
06,06560,065602508,Moreno,BUENOS AIRES,363,342,711,677,1388
06,06560,065600717,Moreno,BUENOS AIRES,416,449,746,790,1536
06,06560,065601107,Moreno,BUENOS AIRES,393,437,742,765,1507
06,06560,065601204,Moreno,BUENOS AIRES,232,241,414,392,806
06,06560,065601703,Moreno,BUENOS AIRES,334,222,619,627,1246
06,06560,065602011,Moreno,BUENOS AIRES,276,224,547,493,1040
06,06560,065601106,Moreno,BUENOS AIRES,257,271,504,497,1001
06,06560,065600909,Moreno,BUENOS AIRES,106,112,188,196,384
06,06560,065600910,Moreno,BUENOS AIRES,55,78,93,94,187
06,06560,065601004,Moreno,BUENOS AIRES,378,373,696,685,1381
06,06560,065601009,Moreno,BUENOS AIRES,347,372,646,657,1303
06,06560,065601012,Moreno,BUENOS AIRES,336,352,624,617,1241
06,06560,065601115,Moreno,BUENOS AIRES,319,383,569,546,1115
06,06560,065600107,Moreno,BUENOS AIRES,259,260,528,535,1063
06,06560,065600111,Moreno,BUENOS AIRES,316,325,671,638,1309
06,06560,065600409,Moreno,BUENOS AIRES,328,299,631,710,1341
06,06560,065600209,Moreno,BUENOS AIRES,465,394,822,832,1654
06,06560,065600305,Moreno,BUENOS AIRES,269,267,528,553,1081
06,06560,065600312,Moreno,BUENOS AIRES,345,334,615,591,1206
06,06560,065600316,Moreno,BUENOS AIRES,81,103,139,163,302
06,06560,065600402,Moreno,BUENOS AIRES,284,266,500,497,997
06,06560,065600508,Moreno,BUENOS AIRES,89,88,165,157,322
06,06560,065600510,Moreno,BUENOS AIRES,381,371,706,692,1398
06,06560,065600608,Moreno,BUENOS AIRES,387,371,735,689,1424
06,06560,065600615,Moreno,BUENOS AIRES,266,262,472,451,923
06,06560,065601306,Moreno,BUENOS AIRES,291,295,536,482,1018
06,06560,065600709,Moreno,BUENOS AIRES,246,244,432,433,865
06,06560,065601307,Moreno,BUENOS AIRES,456,435,841,835,1676
06,06560,065601308,Moreno,BUENOS AIRES,339,359,627,596,1223
06,06560,065601506,Moreno,BUENOS AIRES,287,274,556,538,1094
06,06560,065601508,Moreno,BUENOS AIRES,729,1200,1712,1608,3320
06,06560,065601510,Moreno,BUENOS AIRES,328,291,586,540,1126
06,06560,065601609,Moreno,BUENOS AIRES,387,353,722,714,1436
06,06560,065601616,Moreno,BUENOS AIRES,240,328,380,364,744
06,06560,065601701,Moreno,BUENOS AIRES,377,381,757,734,1491
06,06560,065601716,Moreno,BUENOS AIRES,248,261,483,458,941
06,06560,065601723,Moreno,BUENOS AIRES,224,391,363,382,745
06,06560,065601724,Moreno,BUENOS AIRES,245,491,366,394,760
06,06560,065601906,Moreno,BUENOS AIRES,203,239,372,335,707
06,06560,065601907,Moreno,BUENOS AIRES,302,343,517,507,1024
06,06560,065601908,Moreno,BUENOS AIRES,286,290,433,446,879
06,06560,065602006,Moreno,BUENOS AIRES,303,312,710,730,1440
06,06560,065602101,Moreno,BUENOS AIRES,377,443,656,657,1313
06,06560,065602310,Moreno,BUENOS AIRES,233,320,339,258,597
06,06560,065602406,Moreno,BUENOS AIRES,282,283,483,455,938
06,06560,065602507,Moreno,BUENOS AIRES,280,315,439,380,819
06,06560,065601915,Moreno,BUENOS AIRES,312,345,707,658,1365
06,06560,065601002,Moreno,BUENOS AIRES,273,311,461,446,907
06,06560,065601101,Moreno,BUENOS AIRES,293,285,513,525,1038
06,06560,065600106,Moreno,BUENOS AIRES,260,250,542,557,1099
06,06560,065600108,Moreno,BUENOS AIRES,380,349,727,756,1483
06,06560,065601301,Moreno,BUENOS AIRES,346,337,682,634,1316
06,06560,065600114,Moreno,BUENOS AIRES,427,441,1021,1073,2094
06,06560,065600208,Moreno,BUENOS AIRES,420,398,746,772,1518
06,06560,065601117,Moreno,BUENOS AIRES,257,301,440,410,850
06,06560,065601201,Moreno,BUENOS AIRES,360,319,681,632,1313
06,06560,065601203,Moreno,BUENOS AIRES,435,370,856,816,1672
06,06560,065601210,Moreno,BUENOS AIRES,265,277,506,478,984
06,06560,065600303,Moreno,BUENOS AIRES,314,300,570,598,1168
06,06560,065600406,Moreno,BUENOS AIRES,213,234,436,485,921
06,06560,065600401,Moreno,BUENOS AIRES,302,284,549,593,1142
06,06560,065600411,Moreno,BUENOS AIRES,305,259,580,572,1152
06,06560,065600413,Moreno,BUENOS AIRES,292,319,491,456,947
06,06560,065600415,Moreno,BUENOS AIRES,253,281,461,448,909
06,06560,065600417,Moreno,BUENOS AIRES,395,310,715,670,1385
06,06560,065600512,Moreno,BUENOS AIRES,285,277,550,511,1061
06,06560,065600513,Moreno,BUENOS AIRES,397,385,772,792,1564
06,06560,065600610,Moreno,BUENOS AIRES,382,353,639,607,1246
06,06560,065600712,Moreno,BUENOS AIRES,212,226,380,370,750
06,06560,065600805,Moreno,BUENOS AIRES,282,333,510,499,1009
06,06560,065601310,Moreno,BUENOS AIRES,458,445,891,859,1750
06,06560,065601406,Moreno,BUENOS AIRES,391,372,847,836,1683
06,06560,065601507,Moreno,BUENOS AIRES,226,219,425,450,875
06,06560,065601608,Moreno,BUENOS AIRES,396,412,800,775,1575
06,06560,065601707,Moreno,BUENOS AIRES,156,288,292,274,566
06,06560,065601708,Moreno,BUENOS AIRES,77,158,149,143,292
06,06560,065601722,Moreno,BUENOS AIRES,225,434,388,372,760
06,06560,065601805,Moreno,BUENOS AIRES,184,262,305,345,650
06,06560,065601807,Moreno,BUENOS AIRES,219,343,324,350,674
06,06560,065601918,Moreno,BUENOS AIRES,127,209,203,236,439
06,06560,065602003,Moreno,BUENOS AIRES,383,408,744,754,1498
06,06560,065602107,Moreno,BUENOS AIRES,431,412,855,848,1703
06,06560,065602110,Moreno,BUENOS AIRES,231,301,428,412,840
06,06560,065602113,Moreno,BUENOS AIRES,335,330,571,583,1154
06,06560,065602202,Moreno,BUENOS AIRES,335,442,615,534,1149
06,06560,065602204,Moreno,BUENOS AIRES,359,351,666,627,1293
06,06560,065602209,Moreno,BUENOS AIRES,342,354,573,524,1097
06,06560,065602210,Moreno,BUENOS AIRES,344,351,584,581,1165
06,06560,065602303,Moreno,BUENOS AIRES,267,301,434,421,855
06,06560,065602306,Moreno,BUENOS AIRES,335,376,582,490,1072
06,06560,065602311,Moreno,BUENOS AIRES,174,266,208,149,357
06,06560,065602403,Moreno,BUENOS AIRES,254,299,364,341,705
06,06560,065602409,Moreno,BUENOS AIRES,223,247,355,290,645
06,06560,065602410,Moreno,BUENOS AIRES,205,240,297,278,575
06,06560,065602413,Moreno,BUENOS AIRES,212,236,317,245,562
06,06560,065602417,Moreno,BUENOS AIRES,392,378,745,725,1470
06,06560,065602504,Moreno,BUENOS AIRES,452,504,770,664,1434
06,06560,065602506,Moreno,BUENOS AIRES,249,261,434,391,825
06,06560,065601304,Moreno,BUENOS AIRES,321,324,591,560,1151
06,06560,065601914,Moreno,BUENOS AIRES,243,282,456,421,877
06,06560,065602002,Moreno,BUENOS AIRES,363,362,732,741,1473
06,06560,065600912,Moreno,BUENOS AIRES,99,101,162,169,331
06,06560,065601010,Moreno,BUENOS AIRES,403,401,731,726,1457
06,06560,065601104,Moreno,BUENOS AIRES,244,254,460,469,929
06,06560,065601112,Moreno,BUENOS AIRES,374,388,681,692,1373
06,06560,065600103,Moreno,BUENOS AIRES,393,360,756,750,1506
06,06560,065600105,Moreno,BUENOS AIRES,488,472,957,1052,2009
06,06560,065600904,Moreno,BUENOS AIRES,133,135,261,276,537
06,06560,065601116,Moreno,BUENOS AIRES,238,300,370,401,771
06,06560,065600214,Moreno,BUENOS AIRES,372,416,734,724,1458
06,06560,065601205,Moreno,BUENOS AIRES,338,339,604,571,1175
06,06560,065600307,Moreno,BUENOS AIRES,496,470,983,1020,2003
06,06560,065600308,Moreno,BUENOS AIRES,412,500,698,770,1468
06,06560,065600313,Moreno,BUENOS AIRES,225,244,365,330,695
06,06560,065600315,Moreno,BUENOS AIRES,358,369,703,723,1426
06,06560,065600907,Moreno,BUENOS AIRES,108,110,250,264,514
06,06560,065600419,Moreno,BUENOS AIRES,403,384,771,773,1544
06,06560,065600501,Moreno,BUENOS AIRES,216,216,385,362,747
06,06560,065600505,Moreno,BUENOS AIRES,87,89,164,161,325
06,06560,065600507,Moreno,BUENOS AIRES,356,354,644,624,1268
06,06560,065600509,Moreno,BUENOS AIRES,79,78,160,138,298
06,06560,065600514,Moreno,BUENOS AIRES,349,348,671,654,1325
06,06560,065601216,Moreno,BUENOS AIRES,241,283,388,375,763
06,06560,065600612,Moreno,BUENOS AIRES,385,335,724,741,1465
06,06560,065600613,Moreno,BUENOS AIRES,234,199,455,430,885
06,06560,065601302,Moreno,BUENOS AIRES,386,299,756,746,1502
06,06560,065600701,Moreno,BUENOS AIRES,244,257,411,435,846
06,06560,065600704,Moreno,BUENOS AIRES,304,298,511,476,987
06,06560,065600707,Moreno,BUENOS AIRES,245,232,440,445,885
06,06560,065600905,Moreno,BUENOS AIRES,103,103,210,221,431
06,06560,065601309,Moreno,BUENOS AIRES,313,327,592,516,1108
06,06560,065601405,Moreno,BUENOS AIRES,399,361,793,850,1643
06,06560,065601414,Moreno,BUENOS AIRES,343,317,658,686,1344
06,06560,065601501,Moreno,BUENOS AIRES,293,283,544,565,1109
06,06560,065601504,Moreno,BUENOS AIRES,285,274,577,583,1160
06,06560,065601516,Moreno,BUENOS AIRES,409,461,660,633,1293
06,06560,065601604,Moreno,BUENOS AIRES,329,356,655,608,1263
06,06560,065601605,Moreno,BUENOS AIRES,331,296,636,610,1246
06,06560,065601607,Moreno,BUENOS AIRES,330,319,673,621,1294
06,06560,065601702,Moreno,BUENOS AIRES,327,347,610,662,1272
06,06560,065601709,Moreno,BUENOS AIRES,53,147,105,89,194
06,06560,065601710,Moreno,BUENOS AIRES,117,263,191,173,364
06,06560,065601719,Moreno,BUENOS AIRES,380,382,749,758,1507
06,06560,065601720,Moreno,BUENOS AIRES,231,252,427,396,823
06,06560,065601721,Moreno,BUENOS AIRES,217,247,380,395,775
06,06560,065601904,Moreno,BUENOS AIRES,308,346,593,566,1159
06,06560,065601905,Moreno,BUENOS AIRES,200,241,345,353,698
06,06560,065601912,Moreno,BUENOS AIRES,234,280,404,419,823
06,06560,065601920,Moreno,BUENOS AIRES,202,257,348,360,708
06,06560,065602004,Moreno,BUENOS AIRES,393,359,732,718,1450
06,06560,065602112,Moreno,BUENOS AIRES,229,224,479,441,920
06,06560,065602304,Moreno,BUENOS AIRES,418,427,696,668,1364
06,06560,065602307,Moreno,BUENOS AIRES,347,413,519,452,971
06,06560,065602308,Moreno,BUENOS AIRES,207,250,461,369,830
06,06560,065602404,Moreno,BUENOS AIRES,287,322,430,354,784
06,06560,065602414,Moreno,BUENOS AIRES,222,252,338,295,633
06,06560,065602514,Moreno,BUENOS AIRES,346,366,619,570,1189
06,06560,065600716,Moreno,BUENOS AIRES,538,470,951,961,1912
06,06560,065600801,Moreno,BUENOS AIRES,347,357,575,578,1153
06,06560,065600802,Moreno,BUENOS AIRES,321,346,565,544,1109
06,06560,065600804,Moreno,BUENOS AIRES,294,331,506,457,963
06,06560,065600809,Moreno,BUENOS AIRES,297,335,455,448,903
06,06560,065600109,Moreno,BUENOS AIRES,370,377,748,715,1463
06,06560,065600110,Moreno,BUENOS AIRES,356,371,652,592,1244
06,06560,065600204,Moreno,BUENOS AIRES,450,438,922,964,1886
06,06560,065600205,Moreno,BUENOS AIRES,368,349,725,700,1425
06,06560,065600403,Moreno,BUENOS AIRES,516,511,967,936,1903
06,06560,065601209,Moreno,BUENOS AIRES,491,429,836,828,1664
06,06560,065601211,Moreno,BUENOS AIRES,226,239,385,386,771
06,06560,065600304,Moreno,BUENOS AIRES,280,252,555,516,1071
06,06560,065600306,Moreno,BUENOS AIRES,297,274,561,545,1106
06,06560,065601214,Moreno,BUENOS AIRES,431,483,724,678,1402
06,06560,065600420,Moreno,BUENOS AIRES,370,398,699,709,1408
06,06560,065600511,Moreno,BUENOS AIRES,305,293,574,569,1143
06,06560,065600606,Moreno,BUENOS AIRES,445,433,804,821,1625
06,06560,065600616,Moreno,BUENOS AIRES,343,312,649,675,1324
06,06560,065600617,Moreno,BUENOS AIRES,351,341,671,713,1384
06,06560,065600711,Moreno,BUENOS AIRES,198,199,388,345,733
06,06560,065600713,Moreno,BUENOS AIRES,356,295,705,765,1470
06,06763,067631703,San Nicolás,BUENOS AIRES,278,295,452,428,880
06,06763,067630703,San Nicolás,BUENOS AIRES,353,347,754,709,1463
06,06763,067630102,San Nicolás,BUENOS AIRES,328,353,459,408,867
06,06763,067630113,San Nicolás,BUENOS AIRES,286,328,444,409,853
06,06763,067630114,San Nicolás,BUENOS AIRES,269,295,417,368,785
06,06763,067630303,San Nicolás,BUENOS AIRES,228,280,299,227,526
06,06763,067630309,San Nicolás,BUENOS AIRES,405,462,626,539,1165
06,06763,067630502,San Nicolás,BUENOS AIRES,302,273,544,564,1108
06,06763,067630516,San Nicolás,BUENOS AIRES,224,256,366,299,665
06,06763,067630605,San Nicolás,BUENOS AIRES,314,337,523,536,1059
06,06763,067630612,San Nicolás,BUENOS AIRES,257,254,468,483,951
06,06763,067630704,San Nicolás,BUENOS AIRES,309,311,550,508,1058
06,06763,067630710,San Nicolás,BUENOS AIRES,418,388,922,812,1734
06,06763,067630810,San Nicolás,BUENOS AIRES,248,252,483,457,940
06,06763,067631702,San Nicolás,BUENOS AIRES,289,302,415,350,765
06,06763,067631806,San Nicolás,BUENOS AIRES,201,140,332,345,677
06,06763,067631809,San Nicolás,BUENOS AIRES,212,234,303,300,603
06,06763,067631811,San Nicolás,BUENOS AIRES,305,313,435,426,861
06,06763,067630206,San Nicolás,BUENOS AIRES,362,432,514,444,958
06,06763,067630601,San Nicolás,BUENOS AIRES,420,441,823,849,1672
06,06763,067630809,San Nicolás,BUENOS AIRES,358,370,706,715,1421
06,06763,067630105,San Nicolás,BUENOS AIRES,318,332,492,473,965
06,06763,067630209,San Nicolás,BUENOS AIRES,322,370,468,396,864
06,06763,067630504,San Nicolás,BUENOS AIRES,164,179,265,683,948
06,06763,067630602,San Nicolás,BUENOS AIRES,264,288,496,471,967
06,06763,067630706,San Nicolás,BUENOS AIRES,445,472,789,773,1562
06,06763,067630801,San Nicolás,BUENOS AIRES,240,236,374,415,789
06,06763,067630902,San Nicolás,BUENOS AIRES,189,193,336,396,732
06,06763,067631808,San Nicolás,BUENOS AIRES,169,178,328,312,640
06,06763,067632002,San Nicolás,BUENOS AIRES,85,106,140,153,293
06,06763,067631908,San Nicolás,BUENOS AIRES,43,46,82,94,176
06,06763,067631203,San Nicolás,BUENOS AIRES,22,42,24,33,57
06,06763,067631301,San Nicolás,BUENOS AIRES,6,10,5,7,12
06,06763,067631501,San Nicolás,BUENOS AIRES,24,43,18,36,54
06,06763,067631907,San Nicolás,BUENOS AIRES,17,25,27,32,59
06,06763,067631701,San Nicolás,BUENOS AIRES,393,418,608,555,1163
06,06763,067630306,San Nicolás,BUENOS AIRES,308,378,422,333,755
06,06763,067630101,San Nicolás,BUENOS AIRES,354,388,567,494,1061
06,06763,067630112,San Nicolás,BUENOS AIRES,229,265,333,280,613
06,06763,067630115,San Nicolás,BUENOS AIRES,391,446,624,559,1183
06,06763,067630201,San Nicolás,BUENOS AIRES,119,156,166,131,297
06,06763,067630202,San Nicolás,BUENOS AIRES,78,74,117,121,238
06,06763,067630501,San Nicolás,BUENOS AIRES,231,234,367,361,728
06,06763,067630510,San Nicolás,BUENOS AIRES,239,228,443,433,876
06,06763,067630603,San Nicolás,BUENOS AIRES,288,292,694,706,1400
06,06763,067630606,San Nicolás,BUENOS AIRES,353,345,685,688,1373
06,06763,067630607,San Nicolás,BUENOS AIRES,400,383,710,760,1470
06,06763,067630611,San Nicolás,BUENOS AIRES,267,262,503,529,1032
06,06763,067630712,San Nicolás,BUENOS AIRES,165,162,311,291,602
06,06763,067630803,San Nicolás,BUENOS AIRES,235,265,407,356,763
06,06763,067630812,San Nicolás,BUENOS AIRES,135,140,277,290,567
06,06763,067630901,San Nicolás,BUENOS AIRES,246,284,400,348,748
06,06763,067631101,San Nicolás,BUENOS AIRES,376,401,605,598,1203
06,06763,067631201,San Nicolás,BUENOS AIRES,149,176,220,214,434
06,06763,067631709,San Nicolás,BUENOS AIRES,249,251,455,427,882
06,06763,067631807,San Nicolás,BUENOS AIRES,182,190,324,326,650
06,06763,067631810,San Nicolás,BUENOS AIRES,370,391,547,500,1047
06,06763,067631905,San Nicolás,BUENOS AIRES,349,383,608,545,1153
06,06763,067631906,San Nicolás,BUENOS AIRES,180,208,291,242,533
06,06763,067632012,San Nicolás,BUENOS AIRES,240,238,400,396,796
06,06763,067631901,San Nicolás,BUENOS AIRES,12,19,16,26,42
06,06763,067630701,San Nicolás,BUENOS AIRES,25,24,32,44,76
06,06763,067631812,San Nicolás,BUENOS AIRES,162,188,251,278,529
06,06763,067630107,San Nicolás,BUENOS AIRES,210,313,283,221,504
06,06763,067630103,San Nicolás,BUENOS AIRES,384,401,596,579,1175
06,06763,067630104,San Nicolás,BUENOS AIRES,362,401,543,492,1035
06,06763,067630110,San Nicolás,BUENOS AIRES,307,315,483,386,869
06,06763,067630204,San Nicolás,BUENOS AIRES,310,330,515,474,989
06,06763,067630302,San Nicolás,BUENOS AIRES,355,440,500,463,963
06,06763,067630304,San Nicolás,BUENOS AIRES,341,432,424,316,740
06,06763,067630308,San Nicolás,BUENOS AIRES,366,449,472,433,905
06,06763,067630311,San Nicolás,BUENOS AIRES,285,315,413,346,759
06,06763,067630610,San Nicolás,BUENOS AIRES,298,273,541,542,1083
06,06763,067630804,San Nicolás,BUENOS AIRES,410,415,752,717,1469
06,06763,067631602,San Nicolás,BUENOS AIRES,246,274,349,319,668
06,06763,067631707,San Nicolás,BUENOS AIRES,457,447,798,758,1556
06,06763,067631708,San Nicolás,BUENOS AIRES,241,249,399,387,786
06,06763,067631804,San Nicolás,BUENOS AIRES,237,248,389,403,792
06,06763,067631911,San Nicolás,BUENOS AIRES,189,215,286,267,553
06,06763,067631815,San Nicolás,BUENOS AIRES,177,198,309,326,635
06,06763,067631103,San Nicolás,BUENOS AIRES,17,26,26,21,47
06,06763,067631903,San Nicolás,BUENOS AIRES,65,90,110,136,246
06,06763,067632001,San Nicolás,BUENOS AIRES,105,153,197,169,366
06,06763,067630111,San Nicolás,BUENOS AIRES,354,406,513,462,975
06,06763,067630205,San Nicolás,BUENOS AIRES,427,436,701,628,1329
06,06763,067630208,San Nicolás,BUENOS AIRES,162,202,285,243,528
06,06763,067630211,San Nicolás,BUENOS AIRES,351,425,498,412,910
06,06763,067630212,San Nicolás,BUENOS AIRES,169,244,196,142,338
06,06763,067630310,San Nicolás,BUENOS AIRES,261,302,363,321,684
06,06763,067630503,San Nicolás,BUENOS AIRES,252,272,393,377,770
06,06763,067630505,San Nicolás,BUENOS AIRES,249,247,381,383,764
06,06763,067630506,San Nicolás,BUENOS AIRES,362,383,632,607,1239
06,06763,067630515,San Nicolás,BUENOS AIRES,273,279,416,397,813
06,06763,067630517,San Nicolás,BUENOS AIRES,271,256,472,488,960
06,06763,067630615,San Nicolás,BUENOS AIRES,426,426,756,768,1524
06,06763,067630705,San Nicolás,BUENOS AIRES,308,350,523,479,1002
06,06763,067630711,San Nicolás,BUENOS AIRES,519,466,1025,1035,2060
06,06763,067630802,San Nicolás,BUENOS AIRES,320,327,542,570,1112
06,06763,067630805,San Nicolás,BUENOS AIRES,307,314,558,556,1114
06,06763,067630811,San Nicolás,BUENOS AIRES,302,286,462,454,916
06,06763,067631102,San Nicolás,BUENOS AIRES,399,423,639,622,1261
06,06763,067631705,San Nicolás,BUENOS AIRES,275,293,490,416,906
06,06763,067631706,San Nicolás,BUENOS AIRES,317,334,514,479,993
06,06763,067631803,San Nicolás,BUENOS AIRES,352,350,618,618,1236
06,06763,067632006,San Nicolás,BUENOS AIRES,368,371,611,577,1188
06,06763,067632007,San Nicolás,BUENOS AIRES,155,158,257,226,483
06,06763,067632008,San Nicolás,BUENOS AIRES,393,362,664,639,1303
06,06763,067631816,San Nicolás,BUENOS AIRES,218,256,387,395,782
06,06763,067631302,San Nicolás,BUENOS AIRES,17,28,23,27,50
06,06763,067631704,San Nicolás,BUENOS AIRES,379,413,585,550,1135
06,06763,067630108,San Nicolás,BUENOS AIRES,345,449,485,380,865
06,06763,067630109,San Nicolás,BUENOS AIRES,389,513,540,504,1044
06,06763,067630401,San Nicolás,BUENOS AIRES,325,354,497,502,999
06,06763,067630409,San Nicolás,BUENOS AIRES,271,286,492,424,916
06,06763,067630508,San Nicolás,BUENOS AIRES,217,219,404,405,809
06,06763,067630509,San Nicolás,BUENOS AIRES,257,268,480,471,951
06,06763,067630511,San Nicolás,BUENOS AIRES,432,439,694,703,1397
06,06763,067630512,San Nicolás,BUENOS AIRES,140,96,228,221,449
06,06763,067630513,San Nicolás,BUENOS AIRES,320,319,616,600,1216
06,06763,067630604,San Nicolás,BUENOS AIRES,376,372,679,646,1325
06,06763,067630608,San Nicolás,BUENOS AIRES,408,390,771,830,1601
06,06763,067630609,San Nicolás,BUENOS AIRES,298,279,593,591,1184
06,06763,067630806,San Nicolás,BUENOS AIRES,326,317,568,518,1086
06,06763,067630808,San Nicolás,BUENOS AIRES,374,406,645,666,1311
06,06763,067630813,San Nicolás,BUENOS AIRES,284,281,534,527,1061
06,06763,067632013,San Nicolás,BUENOS AIRES,262,265,469,470,939
06,06763,067631802,San Nicolás,BUENOS AIRES,274,259,501,499,1000
06,06763,067631805,San Nicolás,BUENOS AIRES,215,252,358,377,735
06,06763,067631814,San Nicolás,BUENOS AIRES,301,324,510,522,1032
06,06763,067631910,San Nicolás,BUENOS AIRES,295,314,419,341,760
06,06763,067632004,San Nicolás,BUENOS AIRES,41,64,64,75,139
06,06763,067632009,San Nicolás,BUENOS AIRES,310,335,484,438,922
06,06763,067631202,San Nicolás,BUENOS AIRES,18,30,23,27,50
06,06763,067631603,San Nicolás,BUENOS AIRES,19,39,22,32,54
06,06763,067631813,San Nicolás,BUENOS AIRES,11,23,17,17,34
06,06763,067630305,San Nicolás,BUENOS AIRES,236,308,386,283,669
06,06763,067630210,San Nicolás,BUENOS AIRES,325,358,493,394,887
06,06763,067630213,San Nicolás,BUENOS AIRES,100,137,117,96,213
06,06763,067630402,San Nicolás,BUENOS AIRES,384,416,581,509,1090
06,06763,067630403,San Nicolás,BUENOS AIRES,309,311,490,456,946
06,06763,067630404,San Nicolás,BUENOS AIRES,234,239,343,325,668
06,06763,067630514,San Nicolás,BUENOS AIRES,353,341,719,725,1444
06,06763,067630613,San Nicolás,BUENOS AIRES,305,309,572,520,1092
06,06763,067630707,San Nicolás,BUENOS AIRES,330,329,568,535,1103
06,06763,067630708,San Nicolás,BUENOS AIRES,278,291,441,421,862
06,06763,067630709,San Nicolás,BUENOS AIRES,221,239,376,373,749
06,06763,067630903,San Nicolás,BUENOS AIRES,101,99,187,199,386
06,06763,067631601,San Nicolás,BUENOS AIRES,193,228,285,252,537
06,06763,067632005,San Nicolás,BUENOS AIRES,83,93,147,128,275
06,06763,067632010,San Nicolás,BUENOS AIRES,232,246,383,355,738
06,06763,067631001,San Nicolás,BUENOS AIRES,17,27,22,26,48
06,06763,067631002,San Nicolás,BUENOS AIRES,3,11,5,6,11
06,06763,067631402,San Nicolás,BUENOS AIRES,12,32,11,17,28
06,06763,067631902,San Nicolás,BUENOS AIRES,7,11,12,15,27
06,06763,067632101,San Nicolás,BUENOS AIRES,10,28,2,14,16
06,06763,067630904,San Nicolás,BUENOS AIRES,103,250,135,163,298
06,06763,067630106,San Nicolás,BUENOS AIRES,208,314,325,291,616
06,06763,067630203,San Nicolás,BUENOS AIRES,258,286,365,313,678
06,06763,067630207,San Nicolás,BUENOS AIRES,318,415,419,366,785
06,06763,067630301,San Nicolás,BUENOS AIRES,342,444,475,378,853
06,06763,067630307,San Nicolás,BUENOS AIRES,379,393,541,481,1022
06,06763,067630405,San Nicolás,BUENOS AIRES,324,333,507,451,958
06,06763,067630406,San Nicolás,BUENOS AIRES,280,283,463,407,870
06,06763,067630408,San Nicolás,BUENOS AIRES,316,326,553,487,1040
06,06763,067630410,San Nicolás,BUENOS AIRES,214,215,328,302,630
06,06763,067630507,San Nicolás,BUENOS AIRES,335,360,539,531,1070
06,06763,067630518,San Nicolás,BUENOS AIRES,305,305,590,538,1128
06,06763,067630614,San Nicolás,BUENOS AIRES,347,345,644,628,1272
06,06763,067630702,San Nicolás,BUENOS AIRES,256,260,491,522,1013
06,06763,067630807,San Nicolás,BUENOS AIRES,301,300,489,485,974
06,06763,067631401,San Nicolás,BUENOS AIRES,289,317,457,404,861
06,06763,067631801,San Nicolás,BUENOS AIRES,346,366,634,561,1195
06,06763,067631909,San Nicolás,BUENOS AIRES,283,301,435,411,846
06,06763,067632003,San Nicolás,BUENOS AIRES,234,283,403,410,813
06,06763,067632011,San Nicolás,BUENOS AIRES,188,195,323,317,640
06,06763,067631403,San Nicolás,BUENOS AIRES,18,36,21,29,50
06,06763,067631904,San Nicolás,BUENOS AIRES,21,23,39,35,74
06,06763,067630407,San Nicolás,BUENOS AIRES,198,194,326,319,645
06,06505,065050320,Magdalena,BUENOS AIRES,179,202,299,290,589
06,06505,065050307,Magdalena,BUENOS AIRES,173,199,273,279,552
06,06505,065050316,Magdalena,BUENOS AIRES,88,119,146,155,301
06,06505,065050321,Magdalena,BUENOS AIRES,162,188,277,258,535
06,06505,065050311,Magdalena,BUENOS AIRES,256,327,384,344,728
06,06505,065050105,Magdalena,BUENOS AIRES,33,52,33,48,81
06,06505,065050202,Magdalena,BUENOS AIRES,24,50,27,48,75
06,06505,065050407,Magdalena,BUENOS AIRES,46,52,72,87,159
06,06505,065050306,Magdalena,BUENOS AIRES,337,412,601,574,1175
06,06505,065050212,Magdalena,BUENOS AIRES,147,170,217,200,417
06,06505,065050302,Magdalena,BUENOS AIRES,63,162,82,78,160
06,06505,065050309,Magdalena,BUENOS AIRES,235,269,376,344,720
06,06505,065050315,Magdalena,BUENOS AIRES,281,302,458,478,936
06,06505,065050207,Magdalena,BUENOS AIRES,13,27,21,29,50
06,06505,065050211,Magdalena,BUENOS AIRES,179,214,269,253,522
06,06505,065050308,Magdalena,BUENOS AIRES,259,289,396,418,814
06,06505,065050318,Magdalena,BUENOS AIRES,106,92,190,194,384
06,06505,065050401,Magdalena,BUENOS AIRES,95,145,147,140,287
06,06505,065050101,Magdalena,BUENOS AIRES,27,30,35,39,74
06,06505,065050102,Magdalena,BUENOS AIRES,36,47,57,64,121
06,06505,065050209,Magdalena,BUENOS AIRES,34,49,45,61,106
06,06505,065050406,Magdalena,BUENOS AIRES,38,53,62,66,128
06,06505,065050301,Magdalena,BUENOS AIRES,48,116,84,68,152
06,06505,065050304,Magdalena,BUENOS AIRES,66,130,98,104,202
06,06505,065050310,Magdalena,BUENOS AIRES,163,184,278,251,529
06,06505,065050103,Magdalena,BUENOS AIRES,72,89,99,125,224
06,06505,065050208,Magdalena,BUENOS AIRES,24,38,29,33,62
06,06505,065050106,Magdalena,BUENOS AIRES,15,22,18,21,39
06,06505,065050204,Magdalena,BUENOS AIRES,108,187,169,187,356
06,06505,065050104,Magdalena,BUENOS AIRES,8,13,17,11,28
06,06505,065050402,Magdalena,BUENOS AIRES,97,160,135,138,273
06,06505,065050404,Magdalena,BUENOS AIRES,36,32,43,61,104
06,06505,065050313,Magdalena,BUENOS AIRES,161,172,241,213,454
06,06505,065050317,Magdalena,BUENOS AIRES,91,116,156,161,317
06,06505,065050405,Magdalena,BUENOS AIRES,19,26,29,37,66
06,06505,065050205,Magdalena,BUENOS AIRES,93,167,138,150,288
06,06505,065050305,Magdalena,BUENOS AIRES,52,124,83,92,175
06,06505,065050322,Magdalena,BUENOS AIRES,193,231,380,348,728
06,06505,065050201,Magdalena,BUENOS AIRES,153,177,226,222,448
06,06505,065050210,Magdalena,BUENOS AIRES,183,225,310,325,635
06,06505,065050319,Magdalena,BUENOS AIRES,310,363,472,426,898
06,06505,065050312,Magdalena,BUENOS AIRES,243,275,357,310,667
06,06505,065050303,Magdalena,BUENOS AIRES,62,153,97,93,190
06,06505,065050314,Magdalena,BUENOS AIRES,265,282,467,443,910
06,06505,065050203,Magdalena,BUENOS AIRES,11,26,10,22,32
06,06505,065050206,Magdalena,BUENOS AIRES,44,85,57,78,135
06,06505,065050403,Magdalena,BUENOS AIRES,30,49,193,2282,2475
06,06511,065110512,Maipú,BUENOS AIRES,360,389,609,526,1135
06,06511,065110513,Maipú,BUENOS AIRES,197,285,379,336,715
06,06511,065110301,Maipú,BUENOS AIRES,33,50,47,48,95
06,06511,065110501,Maipú,BUENOS AIRES,100,129,148,160,308
06,06511,065110503,Maipú,BUENOS AIRES,379,451,658,573,1231
06,06511,065110509,Maipú,BUENOS AIRES,201,215,334,323,657
06,06511,065110506,Maipú,BUENOS AIRES,238,330,343,291,634
06,06511,065110202,Maipú,BUENOS AIRES,26,41,35,40,75
06,06511,065110701,Maipú,BUENOS AIRES,25,41,35,31,66
06,06511,065110504,Maipú,BUENOS AIRES,277,330,414,335,749
06,06511,065110510,Maipú,BUENOS AIRES,7,9,7,12,19
06,06511,065110402,Maipú,BUENOS AIRES,6,18,6,10,16
06,06511,065110502,Maipú,BUENOS AIRES,302,365,421,373,794
06,06511,065110507,Maipú,BUENOS AIRES,297,363,444,383,827
06,06511,065110508,Maipú,BUENOS AIRES,322,374,505,418,923
06,06511,065110601,Maipú,BUENOS AIRES,133,177,181,184,365
06,06511,065110304,Maipú,BUENOS AIRES,42,62,57,69,126
06,06511,065110401,Maipú,BUENOS AIRES,31,43,48,46,94
06,06511,065110511,Maipú,BUENOS AIRES,16,31,20,27,47
06,06511,065110602,Maipú,BUENOS AIRES,27,51,24,36,60
06,06511,065110603,Maipú,BUENOS AIRES,24,62,19,34,53
06,06511,065110702,Maipú,BUENOS AIRES,17,30,21,26,47
06,06511,065110505,Maipú,BUENOS AIRES,306,356,479,431,910
06,06511,065110101,Maipú,BUENOS AIRES,18,23,19,32,51
06,06511,065110201,Maipú,BUENOS AIRES,17,30,20,29,49
06,06511,065110303,Maipú,BUENOS AIRES,22,39,31,28,59
06,06511,065110102,Maipú,BUENOS AIRES,10,17,13,16,29
06,06511,065110302,Maipú,BUENOS AIRES,14,21,22,32,54
06,06518,065180102,Mar Chiquita,BUENOS AIRES,123,141,191,184,375
06,06518,065180103,Mar Chiquita,BUENOS AIRES,186,210,306,276,582
06,06518,065180203,Mar Chiquita,BUENOS AIRES,247,284,378,315,693
06,06518,065180301,Mar Chiquita,BUENOS AIRES,75,83,109,120,229
06,06518,065180607,Mar Chiquita,BUENOS AIRES,66,125,91,73,164
06,06518,065180101,Mar Chiquita,BUENOS AIRES,186,212,284,263,547
06,06518,065180112,Mar Chiquita,BUENOS AIRES,26,37,38,45,83
06,06518,065180206,Mar Chiquita,BUENOS AIRES,190,216,325,319,644
06,06518,065180710,Mar Chiquita,BUENOS AIRES,103,275,152,144,296
06,06518,065180209,Mar Chiquita,BUENOS AIRES,79,87,149,144,293
06,06518,065180207,Mar Chiquita,BUENOS AIRES,18,29,31,32,63
06,06518,065180304,Mar Chiquita,BUENOS AIRES,42,55,53,64,117
06,06518,065180411,Mar Chiquita,BUENOS AIRES,3,4,4,9,13
06,06518,065180614,Mar Chiquita,BUENOS AIRES,96,199,145,137,282
06,06518,065180810,Mar Chiquita,BUENOS AIRES,54,170,65,68,133
06,06518,065180202,Mar Chiquita,BUENOS AIRES,194,203,342,299,641
06,06518,065180205,Mar Chiquita,BUENOS AIRES,359,385,597,556,1153
06,06518,065180212,Mar Chiquita,BUENOS AIRES,164,220,268,258,526
06,06518,065180504,Mar Chiquita,BUENOS AIRES,237,273,374,377,751
06,06518,065180706,Mar Chiquita,BUENOS AIRES,52,243,53,72,125
06,06518,065180408,Mar Chiquita,BUENOS AIRES,10,16,3,11,14
06,06518,065180110,Mar Chiquita,BUENOS AIRES,3,5,3,5,8
06,06518,065180404,Mar Chiquita,BUENOS AIRES,21,35,13,25,38
06,06518,065180503,Mar Chiquita,BUENOS AIRES,18,28,23,24,47
06,06518,065180507,Mar Chiquita,BUENOS AIRES,8,16,19,15,34
06,06518,065180510,Mar Chiquita,BUENOS AIRES,22,29,37,37,74
06,06518,065180511,Mar Chiquita,BUENOS AIRES,34,120,43,51,94
06,06518,065180801,Mar Chiquita,BUENOS AIRES,3,6,1,3,4
06,06518,065180610,Mar Chiquita,BUENOS AIRES,38,93,60,62,122
06,06518,065180612,Mar Chiquita,BUENOS AIRES,75,184,95,112,207
06,06518,065180713,Mar Chiquita,BUENOS AIRES,130,245,210,185,395
06,06518,065180802,Mar Chiquita,BUENOS AIRES,42,117,66,68,134
06,06518,065180113,Mar Chiquita,BUENOS AIRES,17,32,21,25,46
06,06518,065180115,Mar Chiquita,BUENOS AIRES,197,221,367,344,711
06,06518,065180603,Mar Chiquita,BUENOS AIRES,79,261,104,104,208
06,06518,065180605,Mar Chiquita,BUENOS AIRES,75,160,130,112,242
06,06518,065180211,Mar Chiquita,BUENOS AIRES,214,226,343,333,676
06,06518,065180105,Mar Chiquita,BUENOS AIRES,7,16,5,7,12
06,06518,065180106,Mar Chiquita,BUENOS AIRES,3,8,3,3,6
06,06518,065180108,Mar Chiquita,BUENOS AIRES,6,15,5,9,14
06,06518,065180109,Mar Chiquita,BUENOS AIRES,9,12,8,17,25
06,06518,065180305,Mar Chiquita,BUENOS AIRES,28,49,34,47,81
06,06518,065180402,Mar Chiquita,BUENOS AIRES,20,44,24,30,54
06,06518,065180405,Mar Chiquita,BUENOS AIRES,14,31,16,21,37
06,06518,065180410,Mar Chiquita,BUENOS AIRES,6,8,7,10,17
06,06518,065180805,Mar Chiquita,BUENOS AIRES,4,4,2,4,6
06,06518,065180811,Mar Chiquita,BUENOS AIRES,15,15,18,20,38
06,06518,065180601,Mar Chiquita,BUENOS AIRES,53,246,78,61,139
06,06518,065180502,Mar Chiquita,BUENOS AIRES,11,20,9,12,21
06,06518,065180403,Mar Chiquita,BUENOS AIRES,6,23,9,11,20
06,06518,065180509,Mar Chiquita,BUENOS AIRES,3,8,2,3,5
06,06518,065180615,Mar Chiquita,BUENOS AIRES,9,16,9,14,23
06,06518,065180813,Mar Chiquita,BUENOS AIRES,7,15,8,14,22
06,06518,065180814,Mar Chiquita,BUENOS AIRES,3,3,4,6,10
06,06518,065180716,Mar Chiquita,BUENOS AIRES,101,385,145,129,274
06,06518,065180302,Mar Chiquita,BUENOS AIRES,111,136,183,182,365
06,06518,065180604,Mar Chiquita,BUENOS AIRES,190,472,264,231,495
06,06518,065180808,Mar Chiquita,BUENOS AIRES,83,390,108,123,231
06,06518,065180210,Mar Chiquita,BUENOS AIRES,0,1,0,0,0
06,06518,065180409,Mar Chiquita,BUENOS AIRES,5,8,6,6,12
06,06518,065180412,Mar Chiquita,BUENOS AIRES,12,15,7,20,27
06,06518,065180613,Mar Chiquita,BUENOS AIRES,61,190,96,105,201
06,06518,065180708,Mar Chiquita,BUENOS AIRES,128,427,161,184,345
06,06518,065180715,Mar Chiquita,BUENOS AIRES,123,276,187,164,351
06,06518,065180717,Mar Chiquita,BUENOS AIRES,104,377,108,123,231
06,06518,065180804,Mar Chiquita,BUENOS AIRES,49,220,61,68,129
06,06518,065180111,Mar Chiquita,BUENOS AIRES,52,56,78,97,175
06,06518,065180201,Mar Chiquita,BUENOS AIRES,96,101,214,205,419
06,06518,065180812,Mar Chiquita,BUENOS AIRES,66,175,81,91,172
06,06518,065180501,Mar Chiquita,BUENOS AIRES,11,20,22,23,45
06,06518,065180505,Mar Chiquita,BUENOS AIRES,7,9,6,7,13
06,06518,065180508,Mar Chiquita,BUENOS AIRES,6,15,6,8,14
06,06518,065180701,Mar Chiquita,BUENOS AIRES,27,28,43,44,87
06,06518,065180806,Mar Chiquita,BUENOS AIRES,8,16,9,12,21
06,06518,065180702,Mar Chiquita,BUENOS AIRES,42,116,47,70,117
06,06518,065180803,Mar Chiquita,BUENOS AIRES,78,331,102,122,224
06,06518,065180709,Mar Chiquita,BUENOS AIRES,105,229,165,182,347
06,06518,065180711,Mar Chiquita,BUENOS AIRES,189,330,334,327,661
06,06518,065180704,Mar Chiquita,BUENOS AIRES,76,407,87,95,182
06,06518,065180602,Mar Chiquita,BUENOS AIRES,78,388,98,95,193
06,06518,065180606,Mar Chiquita,BUENOS AIRES,86,174,132,126,258
06,06518,065180705,Mar Chiquita,BUENOS AIRES,101,432,132,127,259
06,06518,065180707,Mar Chiquita,BUENOS AIRES,53,251,65,67,132
06,06518,065180608,Mar Chiquita,BUENOS AIRES,4,11,8,4,12
06,06518,065180506,Mar Chiquita,BUENOS AIRES,67,86,96,109,205
06,06518,065180303,Mar Chiquita,BUENOS AIRES,67,113,70,98,168
06,06518,065180401,Mar Chiquita,BUENOS AIRES,13,20,16,19,35
06,06518,065180407,Mar Chiquita,BUENOS AIRES,6,12,9,14,23
06,06518,065180609,Mar Chiquita,BUENOS AIRES,62,167,78,86,164
06,06518,065180611,Mar Chiquita,BUENOS AIRES,52,178,72,75,147
06,06518,065180714,Mar Chiquita,BUENOS AIRES,115,235,177,171,348
06,06518,065180114,Mar Chiquita,BUENOS AIRES,144,170,238,215,453
06,06518,065180104,Mar Chiquita,BUENOS AIRES,55,77,61,82,143
06,06518,065180107,Mar Chiquita,BUENOS AIRES,11,19,7,17,24
06,06518,065180208,Mar Chiquita,BUENOS AIRES,35,55,35,53,88
06,06518,065180406,Mar Chiquita,BUENOS AIRES,6,16,4,7,11
06,06518,065180703,Mar Chiquita,BUENOS AIRES,70,188,101,110,211
06,06518,065180712,Mar Chiquita,BUENOS AIRES,189,280,306,299,605
06,06518,065180807,Mar Chiquita,BUENOS AIRES,36,194,53,55,108
06,06518,065180809,Mar Chiquita,BUENOS AIRES,113,333,139,149,288
06,06518,065180204,Mar Chiquita,BUENOS AIRES,332,359,523,449,972
06,06028,060283103,Almirante Brown,BUENOS AIRES,288,330,464,372,836
06,06028,060280207,Almirante Brown,BUENOS AIRES,310,295,604,565,1169
06,06028,060280201,Almirante Brown,BUENOS AIRES,456,381,861,824,1685
06,06028,060280302,Almirante Brown,BUENOS AIRES,430,407,815,798,1613
06,06028,060280407,Almirante Brown,BUENOS AIRES,422,337,830,830,1660
06,06028,060280408,Almirante Brown,BUENOS AIRES,401,379,814,806,1620
06,06028,060280411,Almirante Brown,BUENOS AIRES,380,349,737,734,1471
06,06028,060280506,Almirante Brown,BUENOS AIRES,198,196,349,369,718
06,06028,060280604,Almirante Brown,BUENOS AIRES,1165,1059,2151,2139,4290
06,06028,060280709,Almirante Brown,BUENOS AIRES,361,355,690,661,1351
06,06028,060280804,Almirante Brown,BUENOS AIRES,60,57,125,113,238
06,06028,060280808,Almirante Brown,BUENOS AIRES,337,346,572,527,1099
06,06028,060280907,Almirante Brown,BUENOS AIRES,316,264,638,607,1245
06,06028,060281008,Almirante Brown,BUENOS AIRES,442,428,766,743,1509
06,06028,060281110,Almirante Brown,BUENOS AIRES,475,511,771,682,1453
06,06028,060281112,Almirante Brown,BUENOS AIRES,254,259,459,417,876
06,06028,060281310,Almirante Brown,BUENOS AIRES,392,395,632,545,1177
06,06028,060281408,Almirante Brown,BUENOS AIRES,306,250,556,512,1068
06,06028,060281506,Almirante Brown,BUENOS AIRES,259,273,487,403,890
06,06028,060281706,Almirante Brown,BUENOS AIRES,456,468,840,748,1588
06,06028,060281808,Almirante Brown,BUENOS AIRES,438,416,872,885,1757
06,06028,060281809,Almirante Brown,BUENOS AIRES,295,300,600,622,1222
06,06028,060281908,Almirante Brown,BUENOS AIRES,361,425,650,613,1263
06,06028,060281909,Almirante Brown,BUENOS AIRES,407,416,776,693,1469
06,06028,060281910,Almirante Brown,BUENOS AIRES,255,377,357,325,682
06,06028,060282014,Almirante Brown,BUENOS AIRES,352,334,710,650,1360
06,06028,060282101,Almirante Brown,BUENOS AIRES,213,202,355,325,680
06,06028,060282204,Almirante Brown,BUENOS AIRES,263,262,465,468,933
06,06028,060282305,Almirante Brown,BUENOS AIRES,241,259,392,314,706
06,06028,060282601,Almirante Brown,BUENOS AIRES,157,190,242,205,447
06,06028,060282611,Almirante Brown,BUENOS AIRES,149,165,257,241,498
06,06028,060282704,Almirante Brown,BUENOS AIRES,316,332,505,448,953
06,06028,060282806,Almirante Brown,BUENOS AIRES,523,488,976,979,1955
06,06028,060282809,Almirante Brown,BUENOS AIRES,339,313,631,660,1291
06,06028,060282911,Almirante Brown,BUENOS AIRES,308,308,579,549,1128
06,06028,060282913,Almirante Brown,BUENOS AIRES,274,281,499,449,948
06,06028,060283003,Almirante Brown,BUENOS AIRES,236,296,407,412,819
06,06028,060283005,Almirante Brown,BUENOS AIRES,284,255,514,455,969
06,06028,060283101,Almirante Brown,BUENOS AIRES,288,321,455,399,854
06,06028,060283105,Almirante Brown,BUENOS AIRES,258,275,369,371,740
06,06028,060283304,Almirante Brown,BUENOS AIRES,270,275,450,391,841
06,06028,060283307,Almirante Brown,BUENOS AIRES,403,338,756,743,1499
06,06028,060283402,Almirante Brown,BUENOS AIRES,389,402,713,637,1350
06,06028,060283405,Almirante Brown,BUENOS AIRES,275,282,512,504,1016
06,06028,060283407,Almirante Brown,BUENOS AIRES,223,243,364,344,708
06,06028,060283408,Almirante Brown,BUENOS AIRES,335,340,481,467,948
06,06028,060283603,Almirante Brown,BUENOS AIRES,280,359,396,371,767
06,06028,060283610,Almirante Brown,BUENOS AIRES,316,330,588,580,1168
06,06028,060283612,Almirante Brown,BUENOS AIRES,381,443,691,759,1450
06,06028,060283712,Almirante Brown,BUENOS AIRES,394,385,796,756,1552
06,06028,060283809,Almirante Brown,BUENOS AIRES,287,320,491,531,1022
06,06028,060283901,Almirante Brown,BUENOS AIRES,317,280,652,659,1311
06,06028,060283903,Almirante Brown,BUENOS AIRES,299,269,626,603,1229
06,06028,060283914,Almirante Brown,BUENOS AIRES,227,221,423,408,831
06,06028,060283308,Almirante Brown,BUENOS AIRES,405,416,718,691,1409
06,06028,060283908,Almirante Brown,BUENOS AIRES,269,250,503,535,1038
06,06028,060280104,Almirante Brown,BUENOS AIRES,295,340,500,485,985
06,06028,060280106,Almirante Brown,BUENOS AIRES,266,259,439,445,884
06,06028,060280204,Almirante Brown,BUENOS AIRES,429,393,879,875,1754
06,06028,060280312,Almirante Brown,BUENOS AIRES,266,234,534,508,1042
06,06028,060280602,Almirante Brown,BUENOS AIRES,667,654,1154,1156,2310
06,06028,060280612,Almirante Brown,BUENOS AIRES,256,255,499,512,1011
06,06028,060280701,Almirante Brown,BUENOS AIRES,608,538,1263,1181,2444
06,06028,060280708,Almirante Brown,BUENOS AIRES,307,281,560,556,1116
06,06028,060280710,Almirante Brown,BUENOS AIRES,342,358,572,537,1109
06,06028,060280813,Almirante Brown,BUENOS AIRES,377,394,554,474,1028
06,06028,060280904,Almirante Brown,BUENOS AIRES,533,502,1003,947,1950
06,06028,060281014,Almirante Brown,BUENOS AIRES,347,348,666,617,1283
06,06028,060281016,Almirante Brown,BUENOS AIRES,309,316,508,508,1016
06,06028,060281109,Almirante Brown,BUENOS AIRES,472,499,771,689,1460
06,06028,060281205,Almirante Brown,BUENOS AIRES,314,373,523,437,960
06,06028,060281206,Almirante Brown,BUENOS AIRES,190,248,312,245,557
06,06028,060281405,Almirante Brown,BUENOS AIRES,372,380,705,748,1453
06,06028,060281406,Almirante Brown,BUENOS AIRES,465,425,876,824,1700
06,06028,060281501,Almirante Brown,BUENOS AIRES,250,243,480,481,961
06,06028,060281502,Almirante Brown,BUENOS AIRES,256,226,446,436,882
06,06028,060281509,Almirante Brown,BUENOS AIRES,546,486,936,877,1813
06,06028,060281510,Almirante Brown,BUENOS AIRES,353,351,690,646,1336
06,06028,060281607,Almirante Brown,BUENOS AIRES,234,227,445,392,837
06,06028,060281702,Almirante Brown,BUENOS AIRES,341,332,598,563,1161
06,06028,060281709,Almirante Brown,BUENOS AIRES,288,298,464,433,897
06,06028,060281903,Almirante Brown,BUENOS AIRES,377,398,818,716,1534
06,06028,060281904,Almirante Brown,BUENOS AIRES,378,363,748,727,1475
06,06028,060281905,Almirante Brown,BUENOS AIRES,170,182,331,316,647
06,06028,060282005,Almirante Brown,BUENOS AIRES,418,311,785,810,1595
06,06028,060282006,Almirante Brown,BUENOS AIRES,382,378,750,695,1445
06,06028,060282103,Almirante Brown,BUENOS AIRES,408,394,681,640,1321
06,06028,060282110,Almirante Brown,BUENOS AIRES,247,210,485,478,963
06,06028,060282112,Almirante Brown,BUENOS AIRES,292,300,556,527,1083
06,06028,060282217,Almirante Brown,BUENOS AIRES,208,181,366,360,726
06,06028,060282307,Almirante Brown,BUENOS AIRES,333,380,504,412,916
06,06028,060282404,Almirante Brown,BUENOS AIRES,397,403,525,376,901
06,06028,060282503,Almirante Brown,BUENOS AIRES,189,326,204,129,333
06,06028,060282705,Almirante Brown,BUENOS AIRES,248,267,426,411,837
06,06028,060282708,Almirante Brown,BUENOS AIRES,443,453,796,724,1520
06,06028,060282711,Almirante Brown,BUENOS AIRES,238,268,376,328,704
06,06028,060282802,Almirante Brown,BUENOS AIRES,266,243,430,400,830
06,06028,060282902,Almirante Brown,BUENOS AIRES,229,253,383,326,709
06,06028,060283001,Almirante Brown,BUENOS AIRES,263,242,465,426,891
06,06028,060283015,Almirante Brown,BUENOS AIRES,295,283,535,560,1095
06,06028,060283102,Almirante Brown,BUENOS AIRES,254,296,431,359,790
06,06028,060283108,Almirante Brown,BUENOS AIRES,215,203,444,410,854
06,06028,060283110,Almirante Brown,BUENOS AIRES,420,422,777,689,1466
06,06028,060283111,Almirante Brown,BUENOS AIRES,359,391,602,546,1148
06,06028,060283313,Almirante Brown,BUENOS AIRES,396,382,725,767,1492
06,06028,060283403,Almirante Brown,BUENOS AIRES,416,439,683,636,1319
06,06028,060283409,Almirante Brown,BUENOS AIRES,392,430,634,628,1262
06,06028,060283503,Almirante Brown,BUENOS AIRES,348,340,674,648,1322
06,06028,060283614,Almirante Brown,BUENOS AIRES,422,440,833,852,1685
06,06028,060283704,Almirante Brown,BUENOS AIRES,317,317,601,563,1164
06,06028,060283707,Almirante Brown,BUENOS AIRES,245,256,463,434,897
06,06028,060283812,Almirante Brown,BUENOS AIRES,304,324,553,493,1046
06,06028,060283913,Almirante Brown,BUENOS AIRES,495,507,969,917,1886
06,06028,060281804,Almirante Brown,BUENOS AIRES,231,218,459,440,899
06,06028,060282904,Almirante Brown,BUENOS AIRES,290,282,503,528,1031
06,06028,060283602,Almirante Brown,BUENOS AIRES,186,228,266,223,489
06,06028,060283912,Almirante Brown,BUENOS AIRES,422,469,810,759,1569
06,06028,060280101,Almirante Brown,BUENOS AIRES,360,326,645,663,1308
06,06028,060280102,Almirante Brown,BUENOS AIRES,290,247,618,595,1213
06,06028,060280107,Almirante Brown,BUENOS AIRES,326,353,654,638,1292
06,06028,060280111,Almirante Brown,BUENOS AIRES,395,411,644,602,1246
06,06028,060280301,Almirante Brown,BUENOS AIRES,473,454,819,819,1638
06,06028,060280308,Almirante Brown,BUENOS AIRES,525,528,987,968,1955
06,06028,060280311,Almirante Brown,BUENOS AIRES,251,241,465,425,890
06,06028,060281107,Almirante Brown,BUENOS AIRES,208,239,342,284,626
06,06028,060280410,Almirante Brown,BUENOS AIRES,361,310,743,678,1421
06,06028,060280503,Almirante Brown,BUENOS AIRES,11,12,23,20,43
06,06028,060280608,Almirante Brown,BUENOS AIRES,226,223,426,407,833
06,06028,060280613,Almirante Brown,BUENOS AIRES,244,255,421,360,781
06,06028,060280704,Almirante Brown,BUENOS AIRES,417,374,780,695,1475
06,06028,060280805,Almirante Brown,BUENOS AIRES,324,272,637,640,1277
06,06028,060280906,Almirante Brown,BUENOS AIRES,395,392,633,596,1229
06,06028,060281003,Almirante Brown,BUENOS AIRES,369,341,612,522,1134
06,06028,060281004,Almirante Brown,BUENOS AIRES,249,212,419,377,796
06,06028,060281005,Almirante Brown,BUENOS AIRES,283,241,461,432,893
06,06028,060281010,Almirante Brown,BUENOS AIRES,311,294,577,551,1128
06,06028,060281011,Almirante Brown,BUENOS AIRES,302,286,580,556,1136
06,06028,060281013,Almirante Brown,BUENOS AIRES,528,520,1012,987,1999
06,06028,060281113,Almirante Brown,BUENOS AIRES,227,253,405,348,753
06,06028,060282002,Almirante Brown,BUENOS AIRES,330,326,685,625,1310
06,06028,060281307,Almirante Brown,BUENOS AIRES,255,246,493,510,1003
06,06028,060281312,Almirante Brown,BUENOS AIRES,290,296,499,412,911
06,06028,060281504,Almirante Brown,BUENOS AIRES,269,242,553,539,1092
06,06028,060281505,Almirante Brown,BUENOS AIRES,300,290,540,567,1107
06,06028,060281601,Almirante Brown,BUENOS AIRES,274,279,451,440,891
06,06028,060281803,Almirante Brown,BUENOS AIRES,440,441,842,854,1696
06,06028,060282003,Almirante Brown,BUENOS AIRES,194,193,348,402,750
06,06028,060282007,Almirante Brown,BUENOS AIRES,293,258,596,608,1204
06,06028,060282106,Almirante Brown,BUENOS AIRES,212,243,304,279,583
06,06028,060282208,Almirante Brown,BUENOS AIRES,262,234,406,450,856
06,06028,060282209,Almirante Brown,BUENOS AIRES,385,357,704,647,1351
06,06028,060282210,Almirante Brown,BUENOS AIRES,495,470,887,900,1787
06,06028,060282214,Almirante Brown,BUENOS AIRES,246,246,433,434,867
06,06028,060282301,Almirante Brown,BUENOS AIRES,453,440,707,680,1387
06,06028,060282304,Almirante Brown,BUENOS AIRES,379,390,584,514,1098
06,06028,060282604,Almirante Brown,BUENOS AIRES,241,287,362,252,614
06,06028,060282608,Almirante Brown,BUENOS AIRES,171,237,263,215,478
06,06028,060282709,Almirante Brown,BUENOS AIRES,141,155,207,225,432
06,06028,060282801,Almirante Brown,BUENOS AIRES,354,334,581,523,1104
06,06028,060282804,Almirante Brown,BUENOS AIRES,307,315,623,677,1300
06,06028,060282905,Almirante Brown,BUENOS AIRES,256,263,484,469,953
06,06028,060282906,Almirante Brown,BUENOS AIRES,222,209,487,477,964
06,06028,060282910,Almirante Brown,BUENOS AIRES,246,241,461,478,939
06,06028,060283008,Almirante Brown,BUENOS AIRES,490,386,1010,1004,2014
06,06028,060283014,Almirante Brown,BUENOS AIRES,304,293,588,563,1151
06,06028,060283310,Almirante Brown,BUENOS AIRES,297,358,443,387,830
06,06028,060283207,Almirante Brown,BUENOS AIRES,309,317,509,454,963
06,06028,060283410,Almirante Brown,BUENOS AIRES,355,409,547,514,1061
06,06028,060283505,Almirante Brown,BUENOS AIRES,449,418,908,973,1881
06,06028,060283507,Almirante Brown,BUENOS AIRES,438,383,812,834,1646
06,06028,060283705,Almirante Brown,BUENOS AIRES,371,378,637,681,1318
06,06028,060283608,Almirante Brown,BUENOS AIRES,284,314,481,396,877
06,06028,060283709,Almirante Brown,BUENOS AIRES,279,301,450,462,912
06,06028,060283710,Almirante Brown,BUENOS AIRES,356,384,667,631,1298
06,06028,060283802,Almirante Brown,BUENOS AIRES,347,362,651,648,1299
06,06028,060283805,Almirante Brown,BUENOS AIRES,392,434,584,536,1120
06,06028,060283808,Almirante Brown,BUENOS AIRES,386,423,623,601,1224
06,06028,060283811,Almirante Brown,BUENOS AIRES,269,284,461,420,881
06,06028,060282012,Almirante Brown,BUENOS AIRES,195,233,345,381,726
06,06028,060280502,Almirante Brown,BUENOS AIRES,25,24,47,49,96
06,06028,060281603,Almirante Brown,BUENOS AIRES,559,571,1081,978,2059
06,06028,060280105,Almirante Brown,BUENOS AIRES,201,215,344,270,614
06,06028,060280109,Almirante Brown,BUENOS AIRES,485,475,831,785,1616
06,06028,060280208,Almirante Brown,BUENOS AIRES,324,271,619,625,1244
06,06028,060280305,Almirante Brown,BUENOS AIRES,406,275,934,858,1792
06,06028,060280309,Almirante Brown,BUENOS AIRES,277,251,589,484,1073
06,06028,060280501,Almirante Brown,BUENOS AIRES,21,21,34,38,72
06,06028,060280504,Almirante Brown,BUENOS AIRES,306,276,556,553,1109
06,06028,060280702,Almirante Brown,BUENOS AIRES,546,453,1022,1011,2033
06,06028,060280703,Almirante Brown,BUENOS AIRES,573,478,1088,1075,2163
06,06028,060280706,Almirante Brown,BUENOS AIRES,449,454,751,699,1450
06,06028,060280801,Almirante Brown,BUENOS AIRES,82,82,197,185,382
06,06028,060280806,Almirante Brown,BUENOS AIRES,267,260,490,439,929
06,06028,060280807,Almirante Brown,BUENOS AIRES,260,255,493,445,938
06,06028,060280901,Almirante Brown,BUENOS AIRES,463,396,832,810,1642
06,06028,060281017,Almirante Brown,BUENOS AIRES,245,257,417,406,823
06,06028,060281207,Almirante Brown,BUENOS AIRES,273,342,401,339,740
06,06028,060281210,Almirante Brown,BUENOS AIRES,429,421,746,685,1431
06,06028,060281211,Almirante Brown,BUENOS AIRES,372,399,613,548,1161
06,06028,060281302,Almirante Brown,BUENOS AIRES,235,253,393,396,789
06,06028,060281303,Almirante Brown,BUENOS AIRES,236,234,477,479,956
06,06028,060281308,Almirante Brown,BUENOS AIRES,332,325,635,676,1311
06,06028,060281410,Almirante Brown,BUENOS AIRES,304,267,637,621,1258
06,06028,060281512,Almirante Brown,BUENOS AIRES,292,281,536,495,1031
06,06028,060281608,Almirante Brown,BUENOS AIRES,277,300,464,450,914
06,06028,060281907,Almirante Brown,BUENOS AIRES,282,330,449,462,911
06,06028,060282004,Almirante Brown,BUENOS AIRES,490,503,980,1075,2055
06,06028,060282010,Almirante Brown,BUENOS AIRES,319,309,673,719,1392
06,06028,060282015,Almirante Brown,BUENOS AIRES,377,392,735,746,1481
06,06028,060282108,Almirante Brown,BUENOS AIRES,306,342,580,558,1138
06,06028,060282109,Almirante Brown,BUENOS AIRES,327,300,642,680,1322
06,06028,060282113,Almirante Brown,BUENOS AIRES,254,279,460,430,890
06,06028,060282405,Almirante Brown,BUENOS AIRES,453,433,901,750,1651
06,06028,060282602,Almirante Brown,BUENOS AIRES,126,144,209,176,385
06,06028,060282605,Almirante Brown,BUENOS AIRES,224,243,372,280,652
06,06028,060282609,Almirante Brown,BUENOS AIRES,280,316,476,388,864
06,06028,060282701,Almirante Brown,BUENOS AIRES,210,225,342,316,658
06,06028,060282710,Almirante Brown,BUENOS AIRES,158,175,236,240,476
06,06028,060282712,Almirante Brown,BUENOS AIRES,306,351,473,429,902
06,06028,060282713,Almirante Brown,BUENOS AIRES,344,401,502,483,985
06,06028,060282807,Almirante Brown,BUENOS AIRES,374,403,639,607,1246
06,06028,060283006,Almirante Brown,BUENOS AIRES,288,266,487,469,956
06,06028,060283007,Almirante Brown,BUENOS AIRES,360,378,706,717,1423
06,06028,060283010,Almirante Brown,BUENOS AIRES,385,386,753,743,1496
06,06028,060283112,Almirante Brown,BUENOS AIRES,300,326,475,460,935
06,06028,060283301,Almirante Brown,BUENOS AIRES,627,382,1074,1046,2120
06,06028,060283314,Almirante Brown,BUENOS AIRES,482,489,931,988,1919
06,06028,060283404,Almirante Brown,BUENOS AIRES,367,377,681,619,1300
06,06028,060283406,Almirante Brown,BUENOS AIRES,375,392,592,553,1145
06,06028,060283509,Almirante Brown,BUENOS AIRES,415,411,859,842,1701
06,06028,060283605,Almirante Brown,BUENOS AIRES,420,432,795,800,1595
06,06028,060283607,Almirante Brown,BUENOS AIRES,438,489,743,674,1417
06,06028,060283613,Almirante Brown,BUENOS AIRES,364,463,543,585,1128
06,06028,060283615,Almirante Brown,BUENOS AIRES,448,452,889,927,1816
06,06028,060283711,Almirante Brown,BUENOS AIRES,380,395,678,655,1333
06,06028,060283713,Almirante Brown,BUENOS AIRES,275,253,582,558,1140
06,06028,060283807,Almirante Brown,BUENOS AIRES,229,258,378,383,761
06,06028,060283905,Almirante Brown,BUENOS AIRES,317,303,648,630,1278
06,06028,060283915,Almirante Brown,BUENOS AIRES,269,307,484,465,949
06,06028,060280206,Almirante Brown,BUENOS AIRES,337,319,673,672,1345
06,06028,060280113,Almirante Brown,BUENOS AIRES,277,249,475,476,951
06,06028,060280310,Almirante Brown,BUENOS AIRES,318,314,542,492,1034
06,06028,060280404,Almirante Brown,BUENOS AIRES,331,278,656,709,1365
06,06028,060280508,Almirante Brown,BUENOS AIRES,75,72,149,130,279
06,06028,060280601,Almirante Brown,BUENOS AIRES,389,398,661,583,1244
06,06028,060280611,Almirante Brown,BUENOS AIRES,254,254,557,546,1103
06,06028,060280614,Almirante Brown,BUENOS AIRES,762,733,1435,1426,2861
06,06028,060280707,Almirante Brown,BUENOS AIRES,666,690,1241,1202,2443
06,06028,060280711,Almirante Brown,BUENOS AIRES,433,436,826,771,1597
06,06028,060280905,Almirante Brown,BUENOS AIRES,300,306,576,510,1086
06,06028,060281006,Almirante Brown,BUENOS AIRES,281,225,523,500,1023
06,06028,060281015,Almirante Brown,BUENOS AIRES,286,283,517,479,996
06,06028,060281103,Almirante Brown,BUENOS AIRES,276,247,446,397,843
06,06028,060281104,Almirante Brown,BUENOS AIRES,225,238,360,346,706
06,06028,060281311,Almirante Brown,BUENOS AIRES,367,333,613,605,1218
06,06028,060281407,Almirante Brown,BUENOS AIRES,454,395,869,828,1697
06,06028,060281703,Almirante Brown,BUENOS AIRES,186,167,309,310,619
06,06028,060281705,Almirante Brown,BUENOS AIRES,257,282,478,438,916
06,06028,060281805,Almirante Brown,BUENOS AIRES,240,229,432,441,873
06,06028,060281901,Almirante Brown,BUENOS AIRES,364,339,676,593,1269
06,06028,060281913,Almirante Brown,BUENOS AIRES,192,195,381,396,777
06,06028,060282011,Almirante Brown,BUENOS AIRES,262,269,564,585,1149
06,06028,060282013,Almirante Brown,BUENOS AIRES,406,418,811,799,1610
06,06028,060282107,Almirante Brown,BUENOS AIRES,307,346,525,509,1034
06,06028,060282306,Almirante Brown,BUENOS AIRES,318,352,487,412,899
06,06028,060282308,Almirante Brown,BUENOS AIRES,213,223,329,311,640
06,06028,060282309,Almirante Brown,BUENOS AIRES,284,282,443,444,887
06,06028,060282403,Almirante Brown,BUENOS AIRES,291,312,490,412,902
06,06028,060282409,Almirante Brown,BUENOS AIRES,341,386,509,426,935
06,06028,060282501,Almirante Brown,BUENOS AIRES,262,273,393,353,746
06,06028,060282507,Almirante Brown,BUENOS AIRES,218,333,324,262,586
06,06028,060282508,Almirante Brown,BUENOS AIRES,199,257,310,222,532
06,06028,060282513,Almirante Brown,BUENOS AIRES,307,345,451,398,849
06,06028,060282603,Almirante Brown,BUENOS AIRES,284,271,494,425,919
06,06028,060282612,Almirante Brown,BUENOS AIRES,123,130,239,216,455
06,06028,060282703,Almirante Brown,BUENOS AIRES,373,334,768,801,1569
06,06028,060282805,Almirante Brown,BUENOS AIRES,441,439,847,762,1609
06,06028,060282903,Almirante Brown,BUENOS AIRES,302,331,518,477,995
06,06028,060282908,Almirante Brown,BUENOS AIRES,283,267,514,535,1049
06,06028,060282909,Almirante Brown,BUENOS AIRES,301,308,565,559,1124
06,06028,060283107,Almirante Brown,BUENOS AIRES,387,398,707,660,1367
06,06028,060283109,Almirante Brown,BUENOS AIRES,279,243,539,496,1035
06,06028,060283206,Almirante Brown,BUENOS AIRES,238,265,401,382,783
06,06028,060283312,Almirante Brown,BUENOS AIRES,361,357,615,609,1224
06,06028,060283502,Almirante Brown,BUENOS AIRES,351,355,738,809,1547
06,06028,060283611,Almirante Brown,BUENOS AIRES,304,311,635,596,1231
06,06028,060283702,Almirante Brown,BUENOS AIRES,276,287,485,433,918
06,06028,060283703,Almirante Brown,BUENOS AIRES,286,280,482,536,1018
06,06028,060283714,Almirante Brown,BUENOS AIRES,289,334,597,567,1164
06,06028,060283803,Almirante Brown,BUENOS AIRES,347,368,672,709,1381
06,06028,060283804,Almirante Brown,BUENOS AIRES,436,445,745,742,1487
06,06028,060283904,Almirante Brown,BUENOS AIRES,360,348,665,671,1336
06,06028,060283017,Almirante Brown,BUENOS AIRES,11,11,14,22,36
06,06028,060283011,Almirante Brown,BUENOS AIRES,290,273,533,538,1071
06,06028,060281105,Almirante Brown,BUENOS AIRES,238,258,385,352,737
06,06028,060281911,Almirante Brown,BUENOS AIRES,362,351,720,762,1482
06,06028,060282401,Almirante Brown,BUENOS AIRES,390,393,624,560,1184
06,06028,060282610,Almirante Brown,BUENOS AIRES,171,173,328,311,639
06,06028,060283009,Almirante Brown,BUENOS AIRES,325,277,680,638,1318
06,06028,060283305,Almirante Brown,BUENOS AIRES,288,233,397,343,740
06,06028,060283910,Almirante Brown,BUENOS AIRES,452,455,792,826,1618
06,06028,060283911,Almirante Brown,BUENOS AIRES,408,426,765,795,1560
06,06028,060280303,Almirante Brown,BUENOS AIRES,496,427,1048,1040,2088
06,06028,060280306,Almirante Brown,BUENOS AIRES,194,180,427,444,871
06,06028,060280403,Almirante Brown,BUENOS AIRES,390,259,828,797,1625
06,06028,060280405,Almirante Brown,BUENOS AIRES,339,324,709,791,1500
06,06028,060280409,Almirante Brown,BUENOS AIRES,445,362,910,940,1850
06,06028,060280509,Almirante Brown,BUENOS AIRES,62,57,123,116,239
06,06028,060280510,Almirante Brown,BUENOS AIRES,66,60,137,112,249
06,06028,060280511,Almirante Brown,BUENOS AIRES,324,255,627,627,1254
06,06028,060280513,Almirante Brown,BUENOS AIRES,359,319,677,679,1356
06,06028,060280603,Almirante Brown,BUENOS AIRES,443,372,818,715,1533
06,06028,060280607,Almirante Brown,BUENOS AIRES,400,345,745,721,1466
06,06028,060280609,Almirante Brown,BUENOS AIRES,334,347,585,560,1145
06,06028,060280610,Almirante Brown,BUENOS AIRES,1001,851,1900,1881,3781
06,06028,060280810,Almirante Brown,BUENOS AIRES,490,486,836,789,1625
06,06028,060280811,Almirante Brown,BUENOS AIRES,464,454,722,683,1405
06,06028,060280909,Almirante Brown,BUENOS AIRES,490,510,857,797,1654
06,06028,060281012,Almirante Brown,BUENOS AIRES,320,254,543,566,1109
06,06028,060281101,Almirante Brown,BUENOS AIRES,298,300,571,503,1074
06,06028,060281202,Almirante Brown,BUENOS AIRES,335,373,533,410,943
06,06028,060281203,Almirante Brown,BUENOS AIRES,408,486,640,591,1231
06,06028,060281209,Almirante Brown,BUENOS AIRES,334,374,513,483,996
06,06028,060281404,Almirante Brown,BUENOS AIRES,434,421,832,809,1641
06,06028,060281605,Almirante Brown,BUENOS AIRES,323,293,625,548,1173
06,06028,060281701,Almirante Brown,BUENOS AIRES,247,263,431,346,777
06,06028,060281707,Almirante Brown,BUENOS AIRES,332,356,568,498,1066
06,06028,060281708,Almirante Brown,BUENOS AIRES,397,305,763,649,1412
06,06028,060281806,Almirante Brown,BUENOS AIRES,466,471,949,849,1798
06,06028,060281912,Almirante Brown,BUENOS AIRES,298,291,569,616,1185
06,06028,060282001,Almirante Brown,BUENOS AIRES,397,419,671,654,1325
06,06028,060282102,Almirante Brown,BUENOS AIRES,249,248,419,372,791
06,06028,060282203,Almirante Brown,BUENOS AIRES,345,352,618,594,1212
06,06028,060282205,Almirante Brown,BUENOS AIRES,438,417,850,871,1721
06,06028,060282212,Almirante Brown,BUENOS AIRES,246,267,384,382,766
06,06028,060282216,Almirante Brown,BUENOS AIRES,544,500,982,923,1905
06,06028,060282218,Almirante Brown,BUENOS AIRES,237,221,387,378,765
06,06028,060282311,Almirante Brown,BUENOS AIRES,262,276,383,349,732
06,06028,060282408,Almirante Brown,BUENOS AIRES,324,365,499,444,943
06,06028,060282502,Almirante Brown,BUENOS AIRES,329,438,472,433,905
06,06028,060282511,Almirante Brown,BUENOS AIRES,399,450,602,532,1134
06,06028,060282606,Almirante Brown,BUENOS AIRES,227,217,376,381,757
06,06028,060282707,Almirante Brown,BUENOS AIRES,152,158,301,282,583
06,06028,060282808,Almirante Brown,BUENOS AIRES,253,225,437,441,878
06,06028,060283012,Almirante Brown,BUENOS AIRES,244,197,491,519,1010
06,06028,060283106,Almirante Brown,BUENOS AIRES,407,449,631,597,1228
06,06028,060283204,Almirante Brown,BUENOS AIRES,296,347,433,387,820
06,06028,060283309,Almirante Brown,BUENOS AIRES,373,383,597,504,1101
06,06028,060283401,Almirante Brown,BUENOS AIRES,275,297,485,485,970
06,06028,060283501,Almirante Brown,BUENOS AIRES,386,392,699,712,1411
06,06028,060283504,Almirante Brown,BUENOS AIRES,315,340,541,523,1064
06,06028,060283606,Almirante Brown,BUENOS AIRES,404,411,766,766,1532
06,06028,060283701,Almirante Brown,BUENOS AIRES,352,399,523,578,1101
06,06028,060283708,Almirante Brown,BUENOS AIRES,259,279,437,398,835
06,06028,060283806,Almirante Brown,BUENOS AIRES,272,293,470,452,922
06,06028,060283902,Almirante Brown,BUENOS AIRES,380,373,749,746,1495
06,06028,060283906,Almirante Brown,BUENOS AIRES,251,293,449,502,951
06,06028,060283104,Almirante Brown,BUENOS AIRES,193,200,285,276,561
06,06028,060280110,Almirante Brown,BUENOS AIRES,229,241,378,335,713
06,06028,060280112,Almirante Brown,BUENOS AIRES,301,315,550,465,1015
06,06028,060280202,Almirante Brown,BUENOS AIRES,369,293,696,731,1427
06,06028,060280203,Almirante Brown,BUENOS AIRES,437,393,810,825,1635
06,06028,060280205,Almirante Brown,BUENOS AIRES,292,249,596,593,1189
06,06028,060280307,Almirante Brown,BUENOS AIRES,346,294,748,753,1501
06,06028,060280402,Almirante Brown,BUENOS AIRES,367,293,690,743,1433
06,06028,060280406,Almirante Brown,BUENOS AIRES,379,272,847,839,1686
06,06028,060280507,Almirante Brown,BUENOS AIRES,101,92,206,224,430
06,06028,060280605,Almirante Brown,BUENOS AIRES,536,474,1013,1002,2015
06,06028,060280606,Almirante Brown,BUENOS AIRES,531,512,943,949,1892
06,06028,060280615,Almirante Brown,BUENOS AIRES,1032,890,2060,1987,4047
06,06028,060280705,Almirante Brown,BUENOS AIRES,411,353,791,736,1527
06,06028,060280802,Almirante Brown,BUENOS AIRES,73,66,146,141,287
06,06028,060280902,Almirante Brown,BUENOS AIRES,349,337,660,622,1282
06,06028,060281001,Almirante Brown,BUENOS AIRES,248,223,427,378,805
06,06028,060281007,Almirante Brown,BUENOS AIRES,354,239,665,673,1338
06,06028,060281102,Almirante Brown,BUENOS AIRES,284,288,492,485,977
06,06028,060281106,Almirante Brown,BUENOS AIRES,215,222,329,293,622
06,06028,060281111,Almirante Brown,BUENOS AIRES,526,537,878,781,1659
06,06028,060281208,Almirante Brown,BUENOS AIRES,318,377,490,401,891
06,06028,060281301,Almirante Brown,BUENOS AIRES,434,430,690,642,1332
06,06028,060281306,Almirante Brown,BUENOS AIRES,312,319,543,528,1071
06,06028,060281309,Almirante Brown,BUENOS AIRES,340,365,628,605,1233
06,06028,060281401,Almirante Brown,BUENOS AIRES,410,370,803,743,1546
06,06028,060281402,Almirante Brown,BUENOS AIRES,307,291,580,553,1133
06,06028,060281403,Almirante Brown,BUENOS AIRES,472,461,876,811,1687
06,06028,060281409,Almirante Brown,BUENOS AIRES,271,262,462,487,949
06,06028,060281503,Almirante Brown,BUENOS AIRES,279,287,497,468,965
06,06028,060281602,Almirante Brown,BUENOS AIRES,362,360,759,754,1513
06,06028,060281606,Almirante Brown,BUENOS AIRES,441,394,826,744,1570
06,06028,060281704,Almirante Brown,BUENOS AIRES,246,252,451,416,867
06,06028,060281801,Almirante Brown,BUENOS AIRES,424,416,790,706,1496
06,06028,060281811,Almirante Brown,BUENOS AIRES,237,259,438,442,880
06,06028,060281902,Almirante Brown,BUENOS AIRES,334,359,565,513,1078
06,06028,060281906,Almirante Brown,BUENOS AIRES,92,97,154,168,322
06,06028,060282008,Almirante Brown,BUENOS AIRES,312,283,652,598,1250
06,06028,060282009,Almirante Brown,BUENOS AIRES,283,291,597,581,1178
06,06028,060282104,Almirante Brown,BUENOS AIRES,244,260,388,360,748
06,06028,060282105,Almirante Brown,BUENOS AIRES,289,313,506,486,992
06,06028,060282111,Almirante Brown,BUENOS AIRES,330,327,578,576,1154
06,06028,060282201,Almirante Brown,BUENOS AIRES,147,162,236,207,443
06,06028,060282207,Almirante Brown,BUENOS AIRES,185,197,353,353,706
06,06028,060282213,Almirante Brown,BUENOS AIRES,267,260,461,422,883
06,06028,060282302,Almirante Brown,BUENOS AIRES,453,438,740,675,1415
06,06028,060282312,Almirante Brown,BUENOS AIRES,213,231,347,309,656
06,06028,060282402,Almirante Brown,BUENOS AIRES,418,328,753,718,1471
06,06028,060282406,Almirante Brown,BUENOS AIRES,335,363,601,470,1071
06,06028,060282504,Almirante Brown,BUENOS AIRES,183,311,190,136,326
06,06028,060282506,Almirante Brown,BUENOS AIRES,375,420,552,529,1081
06,06028,060282509,Almirante Brown,BUENOS AIRES,197,232,299,272,571
06,06028,060282510,Almirante Brown,BUENOS AIRES,376,451,608,514,1122
06,06028,060282512,Almirante Brown,BUENOS AIRES,286,321,421,425,846
06,06028,060282607,Almirante Brown,BUENOS AIRES,164,147,301,304,605
06,06028,060282810,Almirante Brown,BUENOS AIRES,316,288,615,675,1290
06,06028,060282811,Almirante Brown,BUENOS AIRES,183,147,320,277,597
06,06028,060282901,Almirante Brown,BUENOS AIRES,332,318,658,611,1269
06,06028,060282907,Almirante Brown,BUENOS AIRES,303,262,618,583,1201
06,06028,060283004,Almirante Brown,BUENOS AIRES,334,319,592,569,1161
06,06028,060283013,Almirante Brown,BUENOS AIRES,237,234,443,412,855
06,06028,060283201,Almirante Brown,BUENOS AIRES,247,246,436,428,864
06,06028,060283202,Almirante Brown,BUENOS AIRES,259,243,414,343,757
06,06028,060283203,Almirante Brown,BUENOS AIRES,322,338,534,493,1027
06,06028,060283302,Almirante Brown,BUENOS AIRES,428,463,734,671,1405
06,06028,060283306,Almirante Brown,BUENOS AIRES,1,1,0,2,2
06,06028,060283411,Almirante Brown,BUENOS AIRES,293,309,511,486,997
06,06028,060283801,Almirante Brown,BUENOS AIRES,514,507,1039,1052,2091
06,06028,060283810,Almirante Brown,BUENOS AIRES,281,322,488,492,980
06,06028,060283907,Almirante Brown,BUENOS AIRES,273,261,533,583,1116
06,06028,060283909,Almirante Brown,BUENOS AIRES,454,438,886,910,1796
06,06028,060280103,Almirante Brown,BUENOS AIRES,326,331,622,592,1214
06,06028,060280108,Almirante Brown,BUENOS AIRES,428,369,809,843,1652
06,06028,060280114,Almirante Brown,BUENOS AIRES,294,314,574,519,1093
06,06028,060280115,Almirante Brown,BUENOS AIRES,426,436,699,684,1383
06,06028,060280304,Almirante Brown,BUENOS AIRES,216,219,439,448,887
06,06028,060280401,Almirante Brown,BUENOS AIRES,459,364,916,959,1875
06,06028,060280412,Almirante Brown,BUENOS AIRES,474,436,893,832,1725
06,06028,060280505,Almirante Brown,BUENOS AIRES,24,20,50,48,98
06,06028,060280512,Almirante Brown,BUENOS AIRES,36,30,77,55,132
06,06028,060280803,Almirante Brown,BUENOS AIRES,20,15,44,41,85
06,06028,060280809,Almirante Brown,BUENOS AIRES,32,28,60,54,114
06,06028,060280812,Almirante Brown,BUENOS AIRES,359,365,564,483,1047
06,06028,060280903,Almirante Brown,BUENOS AIRES,281,283,557,505,1062
06,06028,060280908,Almirante Brown,BUENOS AIRES,364,344,678,647,1325
06,06028,060281002,Almirante Brown,BUENOS AIRES,229,230,373,352,725
06,06028,060281009,Almirante Brown,BUENOS AIRES,280,278,548,487,1035
06,06028,060281108,Almirante Brown,BUENOS AIRES,131,131,218,191,409
06,06028,060281201,Almirante Brown,BUENOS AIRES,416,428,636,571,1207
06,06028,060281204,Almirante Brown,BUENOS AIRES,321,391,473,400,873
06,06028,060281304,Almirante Brown,BUENOS AIRES,465,436,819,832,1651
06,06028,060281305,Almirante Brown,BUENOS AIRES,339,340,577,497,1074
06,06028,060281313,Almirante Brown,BUENOS AIRES,218,208,385,375,760
06,06028,060281507,Almirante Brown,BUENOS AIRES,445,466,747,649,1396
06,06028,060281508,Almirante Brown,BUENOS AIRES,232,251,389,384,773
06,06028,060281511,Almirante Brown,BUENOS AIRES,220,211,381,366,747
06,06028,060281604,Almirante Brown,BUENOS AIRES,309,304,588,533,1121
06,06028,060281802,Almirante Brown,BUENOS AIRES,301,296,516,423,939
06,06028,060281807,Almirante Brown,BUENOS AIRES,302,295,638,674,1312
06,06028,060281810,Almirante Brown,BUENOS AIRES,315,292,606,601,1207
06,06028,060282202,Almirante Brown,BUENOS AIRES,292,303,473,451,924
06,06028,060282206,Almirante Brown,BUENOS AIRES,406,402,756,759,1515
06,06028,060282211,Almirante Brown,BUENOS AIRES,286,294,463,416,879
06,06028,060282215,Almirante Brown,BUENOS AIRES,217,221,385,385,770
06,06028,060282303,Almirante Brown,BUENOS AIRES,265,262,415,379,794
06,06028,060282310,Almirante Brown,BUENOS AIRES,268,272,423,399,822
06,06028,060282313,Almirante Brown,BUENOS AIRES,203,232,323,289,612
06,06028,060282407,Almirante Brown,BUENOS AIRES,381,420,601,582,1183
06,06028,060282505,Almirante Brown,BUENOS AIRES,356,471,521,430,951
06,06028,060282702,Almirante Brown,BUENOS AIRES,289,320,476,467,943
06,06028,060282706,Almirante Brown,BUENOS AIRES,347,319,752,745,1497
06,06028,060282803,Almirante Brown,BUENOS AIRES,380,372,666,687,1353
06,06028,060282912,Almirante Brown,BUENOS AIRES,301,268,561,546,1107
06,06028,060283002,Almirante Brown,BUENOS AIRES,232,228,423,417,840
06,06028,060283205,Almirante Brown,BUENOS AIRES,225,255,372,300,672
06,06028,060283208,Almirante Brown,BUENOS AIRES,386,384,660,641,1301
06,06028,060283209,Almirante Brown,BUENOS AIRES,453,476,756,698,1454
06,06028,060283303,Almirante Brown,BUENOS AIRES,250,247,434,394,828
06,06028,060283311,Almirante Brown,BUENOS AIRES,354,379,556,539,1095
06,06028,060283412,Almirante Brown,BUENOS AIRES,368,393,624,539,1163
06,06028,060283506,Almirante Brown,BUENOS AIRES,373,358,732,725,1457
06,06028,060283508,Almirante Brown,BUENOS AIRES,309,342,548,499,1047
06,06028,060283601,Almirante Brown,BUENOS AIRES,199,219,351,357,708
06,06028,060283604,Almirante Brown,BUENOS AIRES,441,475,700,680,1380
06,06028,060283609,Almirante Brown,BUENOS AIRES,268,284,476,473,949
06,06028,060283706,Almirante Brown,BUENOS AIRES,368,357,758,746,1504
06,06028,060283016,Almirante Brown,BUENOS AIRES,284,287,562,506,1068
06,06035,060350105,Avellaneda,BUENOS AIRES,149,158,259,221,480
06,06035,060350512,Avellaneda,BUENOS AIRES,271,296,411,367,778
06,06035,060352606,Avellaneda,BUENOS AIRES,223,237,435,385,820
06,06035,060351206,Avellaneda,BUENOS AIRES,227,324,276,239,515
06,06035,060351301,Avellaneda,BUENOS AIRES,306,355,508,471,979
06,06035,060350402,Avellaneda,BUENOS AIRES,273,219,437,435,872
06,06035,060350411,Avellaneda,BUENOS AIRES,430,442,696,657,1353
06,06035,060350506,Avellaneda,BUENOS AIRES,445,369,829,850,1679
06,06035,060350508,Avellaneda,BUENOS AIRES,343,373,518,467,985
06,06035,060350601,Avellaneda,BUENOS AIRES,336,348,566,520,1086
06,06035,060350702,Avellaneda,BUENOS AIRES,347,362,591,560,1151
06,06035,060350707,Avellaneda,BUENOS AIRES,199,387,306,292,598
06,06035,060350712,Avellaneda,BUENOS AIRES,98,266,151,134,285
06,06035,060350803,Avellaneda,BUENOS AIRES,344,355,574,558,1132
06,06035,060350914,Avellaneda,BUENOS AIRES,254,229,407,369,776
06,06035,060351006,Avellaneda,BUENOS AIRES,310,370,414,337,751
06,06035,060351009,Avellaneda,BUENOS AIRES,140,172,177,135,312
06,06035,060351106,Avellaneda,BUENOS AIRES,350,401,484,388,872
06,06035,060351110,Avellaneda,BUENOS AIRES,350,442,463,373,836
06,06035,060351207,Avellaneda,BUENOS AIRES,160,201,209,153,362
06,06035,060351208,Avellaneda,BUENOS AIRES,342,473,619,500,1119
06,06035,060351209,Avellaneda,BUENOS AIRES,106,131,149,104,253
06,06035,060351306,Avellaneda,BUENOS AIRES,235,256,339,294,633
06,06035,060351401,Avellaneda,BUENOS AIRES,262,314,397,325,722
06,06035,060351404,Avellaneda,BUENOS AIRES,302,364,449,403,852
06,06035,060351406,Avellaneda,BUENOS AIRES,225,288,298,248,546
06,06035,060351410,Avellaneda,BUENOS AIRES,333,383,438,392,830
06,06035,060351507,Avellaneda,BUENOS AIRES,291,325,521,471,992
06,06035,060351510,Avellaneda,BUENOS AIRES,240,280,353,325,678
06,06035,060351607,Avellaneda,BUENOS AIRES,206,235,315,266,581
06,06035,060351802,Avellaneda,BUENOS AIRES,309,340,494,421,915
06,06035,060352010,Avellaneda,BUENOS AIRES,314,311,500,442,942
06,06035,060352011,Avellaneda,BUENOS AIRES,281,288,449,390,839
06,06035,060352105,Avellaneda,BUENOS AIRES,184,149,213,168,381
06,06035,060352208,Avellaneda,BUENOS AIRES,215,291,272,204,476
06,06035,060352301,Avellaneda,BUENOS AIRES,165,385,243,230,473
06,06035,060352307,Avellaneda,BUENOS AIRES,326,295,598,568,1166
06,06035,060352310,Avellaneda,BUENOS AIRES,325,370,475,443,918
06,06035,060352408,Avellaneda,BUENOS AIRES,350,372,571,542,1113
06,06035,060352503,Avellaneda,BUENOS AIRES,447,423,767,675,1442
06,06035,060352506,Avellaneda,BUENOS AIRES,330,364,533,479,1012
06,06035,060352510,Avellaneda,BUENOS AIRES,555,571,935,910,1845
06,06035,060352602,Avellaneda,BUENOS AIRES,414,393,760,770,1530
06,06035,060352711,Avellaneda,BUENOS AIRES,469,441,912,887,1799
06,06035,060352807,Avellaneda,BUENOS AIRES,261,272,411,366,777
06,06035,060352901,Avellaneda,BUENOS AIRES,223,239,350,298,648
06,06035,060352905,Avellaneda,BUENOS AIRES,254,285,384,342,726
06,06035,060353003,Avellaneda,BUENOS AIRES,301,320,479,429,908
06,06035,060353005,Avellaneda,BUENOS AIRES,262,298,425,373,798
06,06035,060353103,Avellaneda,BUENOS AIRES,271,316,380,355,735
06,06035,060353107,Avellaneda,BUENOS AIRES,152,172,243,203,446
06,06035,060353108,Avellaneda,BUENOS AIRES,251,299,384,338,722
06,06035,060353304,Avellaneda,BUENOS AIRES,289,328,411,402,813
06,06035,060353307,Avellaneda,BUENOS AIRES,295,361,428,387,815
06,06035,060351203,Avellaneda,BUENOS AIRES,166,192,229,178,407
06,06035,060353301,Avellaneda,BUENOS AIRES,320,352,496,469,965
06,06035,060351212,Avellaneda,BUENOS AIRES,218,271,297,261,558
06,06035,060350102,Avellaneda,BUENOS AIRES,418,195,837,811,1648
06,06035,060350203,Avellaneda,BUENOS AIRES,299,296,600,581,1181
06,06035,060350307,Avellaneda,BUENOS AIRES,317,326,461,439,900
06,06035,060350315,Avellaneda,BUENOS AIRES,330,352,500,447,947
06,06035,060350410,Avellaneda,BUENOS AIRES,248,264,376,356,732
06,06035,060350415,Avellaneda,BUENOS AIRES,253,245,361,331,692
06,06035,060350501,Avellaneda,BUENOS AIRES,193,211,304,292,596
06,06035,060350612,Avellaneda,BUENOS AIRES,299,342,490,457,947
06,06035,060350703,Avellaneda,BUENOS AIRES,264,276,486,433,919
06,06035,060350706,Avellaneda,BUENOS AIRES,363,379,567,536,1103
06,06035,060351102,Avellaneda,BUENOS AIRES,259,261,487,485,972
06,06035,060351103,Avellaneda,BUENOS AIRES,157,159,250,260,510
06,06035,060351104,Avellaneda,BUENOS AIRES,320,490,458,372,830
06,06035,060351108,Avellaneda,BUENOS AIRES,365,442,481,447,928
06,06035,060351205,Avellaneda,BUENOS AIRES,261,282,413,423,836
06,06035,060351308,Avellaneda,BUENOS AIRES,245,314,351,332,683
06,06035,060351502,Avellaneda,BUENOS AIRES,312,363,466,346,812
06,06035,060351503,Avellaneda,BUENOS AIRES,340,367,463,398,861
06,06035,060351506,Avellaneda,BUENOS AIRES,480,472,758,702,1460
06,06035,060351512,Avellaneda,BUENOS AIRES,239,275,348,292,640
06,06035,060351603,Avellaneda,BUENOS AIRES,288,322,489,382,871
06,06035,060351611,Avellaneda,BUENOS AIRES,245,253,368,353,721
06,06035,060351705,Avellaneda,BUENOS AIRES,352,362,570,478,1048
06,06035,060351804,Avellaneda,BUENOS AIRES,268,278,424,325,749
06,06035,060351805,Avellaneda,BUENOS AIRES,277,313,420,341,761
06,06035,060351806,Avellaneda,BUENOS AIRES,321,340,478,410,888
06,06035,060351810,Avellaneda,BUENOS AIRES,254,295,348,341,689
06,06035,060351903,Avellaneda,BUENOS AIRES,325,400,449,403,852
06,06035,060352004,Avellaneda,BUENOS AIRES,242,274,378,333,711
06,06035,060352612,Avellaneda,BUENOS AIRES,228,214,404,381,785
06,06035,060352108,Avellaneda,BUENOS AIRES,280,331,313,245,558
06,06035,060352203,Avellaneda,BUENOS AIRES,200,259,249,213,462
06,06035,060352211,Avellaneda,BUENOS AIRES,186,249,252,225,477
06,06035,060352306,Avellaneda,BUENOS AIRES,363,382,570,478,1048
06,06035,060352405,Avellaneda,BUENOS AIRES,248,287,391,352,743
06,06035,060352409,Avellaneda,BUENOS AIRES,352,350,567,576,1143
06,06035,060352604,Avellaneda,BUENOS AIRES,90,90,148,145,293
06,06035,060352703,Avellaneda,BUENOS AIRES,285,293,449,436,885
06,06035,060352705,Avellaneda,BUENOS AIRES,246,224,410,369,779
06,06035,060352710,Avellaneda,BUENOS AIRES,282,289,505,472,977
06,06035,060353002,Avellaneda,BUENOS AIRES,311,317,553,534,1087
06,06035,060353004,Avellaneda,BUENOS AIRES,359,393,627,544,1171
06,06035,060353105,Avellaneda,BUENOS AIRES,373,369,606,551,1157
06,06035,060353106,Avellaneda,BUENOS AIRES,207,203,299,255,554
06,06035,060353206,Avellaneda,BUENOS AIRES,310,405,466,452,918
06,06035,060353207,Avellaneda,BUENOS AIRES,343,406,524,476,1000
06,06035,060353303,Avellaneda,BUENOS AIRES,405,449,634,503,1137
06,06035,060353305,Avellaneda,BUENOS AIRES,183,238,268,224,492
06,06035,060353503,Avellaneda,BUENOS AIRES,273,301,420,378,798
06,06035,060350101,Avellaneda,BUENOS AIRES,731,511,1277,1301,2578
06,06035,060350304,Avellaneda,BUENOS AIRES,357,376,537,462,999
06,06035,060351508,Avellaneda,BUENOS AIRES,324,352,451,420,871
06,06035,060351211,Avellaneda,BUENOS AIRES,329,435,433,392,825
06,06035,060350201,Avellaneda,BUENOS AIRES,321,276,544,530,1074
06,06035,060350202,Avellaneda,BUENOS AIRES,278,260,555,581,1136
06,06035,060350303,Avellaneda,BUENOS AIRES,287,272,486,465,951
06,06035,060350314,Avellaneda,BUENOS AIRES,277,299,428,383,811
06,06035,060350406,Avellaneda,BUENOS AIRES,342,336,541,492,1033
06,06035,060350409,Avellaneda,BUENOS AIRES,435,436,748,660,1408
06,06035,060350414,Avellaneda,BUENOS AIRES,258,312,379,349,728
06,06035,060350502,Avellaneda,BUENOS AIRES,465,455,676,565,1241
06,06035,060350602,Avellaneda,BUENOS AIRES,385,412,592,491,1083
06,06035,060350605,Avellaneda,BUENOS AIRES,316,364,483,398,881
06,06035,060350609,Avellaneda,BUENOS AIRES,315,324,603,534,1137
06,06035,060350611,Avellaneda,BUENOS AIRES,218,228,417,380,797
06,06035,060350705,Avellaneda,BUENOS AIRES,286,319,457,378,835
06,06035,060350807,Avellaneda,BUENOS AIRES,227,229,352,352,704
06,06035,060350809,Avellaneda,BUENOS AIRES,267,239,432,401,833
06,06035,060350815,Avellaneda,BUENOS AIRES,501,186,893,893,1786
06,06035,060350902,Avellaneda,BUENOS AIRES,179,194,339,337,676
06,06035,060350906,Avellaneda,BUENOS AIRES,190,221,389,365,754
06,06035,060350907,Avellaneda,BUENOS AIRES,285,284,487,491,978
06,06035,060350910,Avellaneda,BUENOS AIRES,402,381,723,755,1478
06,06035,060350911,Avellaneda,BUENOS AIRES,336,334,611,624,1235
06,06035,060351105,Avellaneda,BUENOS AIRES,547,567,741,633,1374
06,06035,060351210,Avellaneda,BUENOS AIRES,397,494,462,327,789
06,06035,060351304,Avellaneda,BUENOS AIRES,302,375,410,380,790
06,06035,060351305,Avellaneda,BUENOS AIRES,245,249,374,347,721
06,06035,060351310,Avellaneda,BUENOS AIRES,243,287,345,282,627
06,06035,060351402,Avellaneda,BUENOS AIRES,225,265,320,234,554
06,06035,060351703,Avellaneda,BUENOS AIRES,299,326,455,411,866
06,06035,060351704,Avellaneda,BUENOS AIRES,323,356,470,396,866
06,06035,060351711,Avellaneda,BUENOS AIRES,232,241,361,304,665
06,06035,060351811,Avellaneda,BUENOS AIRES,320,347,503,404,907
06,06035,060351905,Avellaneda,BUENOS AIRES,324,387,507,408,915
06,06035,060352109,Avellaneda,BUENOS AIRES,249,275,362,329,691
06,06035,060352308,Avellaneda,BUENOS AIRES,212,205,425,415,840
06,06035,060352411,Avellaneda,BUENOS AIRES,363,289,730,668,1398
06,06035,060352505,Avellaneda,BUENOS AIRES,340,327,560,490,1050
06,06035,060352507,Avellaneda,BUENOS AIRES,301,302,457,399,856
06,06035,060352508,Avellaneda,BUENOS AIRES,307,305,503,457,960
06,06035,060352607,Avellaneda,BUENOS AIRES,277,292,537,480,1017
06,06035,060352609,Avellaneda,BUENOS AIRES,303,277,603,589,1192
06,06035,060352713,Avellaneda,BUENOS AIRES,230,214,429,349,778
06,06035,060352903,Avellaneda,BUENOS AIRES,345,346,526,483,1009
06,06035,060353008,Avellaneda,BUENOS AIRES,356,373,559,478,1037
06,06035,060353202,Avellaneda,BUENOS AIRES,258,287,400,350,750
06,06035,060353306,Avellaneda,BUENOS AIRES,291,342,435,371,806
06,06035,060353401,Avellaneda,BUENOS AIRES,264,278,417,383,800
06,06035,060353402,Avellaneda,BUENOS AIRES,240,235,422,353,775
06,06035,060353404,Avellaneda,BUENOS AIRES,259,263,395,350,745
06,06035,060353504,Avellaneda,BUENOS AIRES,246,263,416,384,800
06,06035,060353506,Avellaneda,BUENOS AIRES,253,248,405,381,786
06,06035,060350106,Avellaneda,BUENOS AIRES,225,212,391,351,742
06,06035,060350110,Avellaneda,BUENOS AIRES,286,268,530,486,1016
06,06035,060350111,Avellaneda,BUENOS AIRES,256,188,463,485,948
06,06035,060350301,Avellaneda,BUENOS AIRES,308,316,511,488,999
06,06035,060350405,Avellaneda,BUENOS AIRES,356,367,605,540,1145
06,06035,060350408,Avellaneda,BUENOS AIRES,250,257,456,408,864
06,06035,060351302,Avellaneda,BUENOS AIRES,338,418,469,433,902
06,06035,060350608,Avellaneda,BUENOS AIRES,303,337,472,408,880
06,06035,060350802,Avellaneda,BUENOS AIRES,174,189,335,338,673
06,06035,060350808,Avellaneda,BUENOS AIRES,215,217,360,320,680
06,06035,060350814,Avellaneda,BUENOS AIRES,222,237,348,341,689
06,06035,060350904,Avellaneda,BUENOS AIRES,711,432,1366,1244,2610
06,06035,060350912,Avellaneda,BUENOS AIRES,191,146,338,295,633
06,06035,060351610,Avellaneda,BUENOS AIRES,334,356,495,469,964
06,06035,060351706,Avellaneda,BUENOS AIRES,266,293,394,354,748
06,06035,060351710,Avellaneda,BUENOS AIRES,351,384,581,489,1070
06,06035,060351801,Avellaneda,BUENOS AIRES,286,335,456,387,843
06,06035,060352304,Avellaneda,BUENOS AIRES,131,307,192,168,360
06,06035,060352006,Avellaneda,BUENOS AIRES,287,320,481,415,896
06,06035,060352008,Avellaneda,BUENOS AIRES,343,356,505,477,982
06,06035,060352305,Avellaneda,BUENOS AIRES,381,483,547,472,1019
06,06035,060352101,Avellaneda,BUENOS AIRES,404,440,591,544,1135
06,06035,060352110,Avellaneda,BUENOS AIRES,299,361,433,348,781
06,06035,060352204,Avellaneda,BUENOS AIRES,192,256,254,195,449
06,06035,060352207,Avellaneda,BUENOS AIRES,274,365,354,292,646
06,06035,060352302,Avellaneda,BUENOS AIRES,173,504,251,218,469
06,06035,060352312,Avellaneda,BUENOS AIRES,363,325,685,667,1352
06,06035,060352608,Avellaneda,BUENOS AIRES,235,213,434,422,856
06,06035,060352610,Avellaneda,BUENOS AIRES,484,441,979,917,1896
06,06035,060352701,Avellaneda,BUENOS AIRES,69,69,143,149,292
06,06035,060352706,Avellaneda,BUENOS AIRES,482,371,848,874,1722
06,06035,060352804,Avellaneda,BUENOS AIRES,272,295,405,357,762
06,06035,060352904,Avellaneda,BUENOS AIRES,267,261,440,385,825
06,06035,060353109,Avellaneda,BUENOS AIRES,219,201,305,278,583
06,06035,060353406,Avellaneda,BUENOS AIRES,341,390,520,487,1007
06,06035,060353507,Avellaneda,BUENOS AIRES,242,245,375,335,710
06,06035,060351403,Avellaneda,BUENOS AIRES,335,367,496,441,937
06,06035,060352902,Avellaneda,BUENOS AIRES,304,318,478,439,917
06,06035,060353010,Avellaneda,BUENOS AIRES,300,344,430,399,829
06,06035,060350103,Avellaneda,BUENOS AIRES,239,238,394,363,757
06,06035,060350308,Avellaneda,BUENOS AIRES,291,306,440,380,820
06,06035,060350311,Avellaneda,BUENOS AIRES,334,345,517,465,982
06,06035,060350407,Avellaneda,BUENOS AIRES,348,364,585,486,1071
06,06035,060350413,Avellaneda,BUENOS AIRES,327,343,508,443,951
06,06035,060350504,Avellaneda,BUENOS AIRES,375,386,617,526,1143
06,06035,060350711,Avellaneda,BUENOS AIRES,191,328,374,267,641
06,06035,060350801,Avellaneda,BUENOS AIRES,274,304,536,450,986
06,06035,060350908,Avellaneda,BUENOS AIRES,342,440,619,644,1263
06,06035,060351003,Avellaneda,BUENOS AIRES,297,323,488,428,916
06,06035,060351107,Avellaneda,BUENOS AIRES,107,120,180,164,344
06,06035,060351201,Avellaneda,BUENOS AIRES,250,287,360,293,653
06,06035,060351408,Avellaneda,BUENOS AIRES,294,349,470,421,891
06,06035,060351412,Avellaneda,BUENOS AIRES,216,237,333,306,639
06,06035,060351509,Avellaneda,BUENOS AIRES,261,278,433,317,750
06,06035,060351511,Avellaneda,BUENOS AIRES,264,304,430,340,770
06,06035,060351606,Avellaneda,BUENOS AIRES,267,302,432,388,820
06,06035,060351701,Avellaneda,BUENOS AIRES,296,332,449,364,813
06,06035,060351702,Avellaneda,BUENOS AIRES,262,266,436,359,795
06,06035,060351807,Avellaneda,BUENOS AIRES,248,301,359,306,665
06,06035,060351809,Avellaneda,BUENOS AIRES,306,337,431,409,840
06,06035,060351907,Avellaneda,BUENOS AIRES,289,225,437,384,821
06,06035,060352003,Avellaneda,BUENOS AIRES,438,531,579,510,1089
06,06035,060352005,Avellaneda,BUENOS AIRES,304,294,446,422,868
06,06035,060352102,Avellaneda,BUENOS AIRES,391,408,566,477,1043
06,06035,060352103,Avellaneda,BUENOS AIRES,205,238,312,273,585
06,06035,060352205,Avellaneda,BUENOS AIRES,201,251,294,239,533
06,06035,060352311,Avellaneda,BUENOS AIRES,323,336,536,457,993
06,06035,060352402,Avellaneda,BUENOS AIRES,315,303,475,465,940
06,06035,060352403,Avellaneda,BUENOS AIRES,406,374,663,612,1275
06,06035,060352406,Avellaneda,BUENOS AIRES,307,327,490,419,909
06,06035,060352407,Avellaneda,BUENOS AIRES,317,292,501,419,920
06,06035,060352504,Avellaneda,BUENOS AIRES,277,324,431,382,813
06,06035,060352603,Avellaneda,BUENOS AIRES,208,219,390,383,773
06,06035,060352605,Avellaneda,BUENOS AIRES,593,613,1041,972,2013
06,06035,060352614,Avellaneda,BUENOS AIRES,267,252,463,476,939
06,06035,060352702,Avellaneda,BUENOS AIRES,261,277,458,388,846
06,06035,060352708,Avellaneda,BUENOS AIRES,128,118,205,202,407
06,06035,060352712,Avellaneda,BUENOS AIRES,412,323,763,665,1428
06,06035,060352714,Avellaneda,BUENOS AIRES,297,275,611,630,1241
06,06035,060353006,Avellaneda,BUENOS AIRES,333,375,514,414,928
06,06035,060353201,Avellaneda,BUENOS AIRES,353,358,544,482,1026
06,06035,060353403,Avellaneda,BUENOS AIRES,223,237,322,281,603
06,06035,060353409,Avellaneda,BUENOS AIRES,252,247,372,320,692
06,06035,060353508,Avellaneda,BUENOS AIRES,247,284,378,354,732
06,06035,060351204,Avellaneda,BUENOS AIRES,146,168,212,152,364
06,06035,060352803,Avellaneda,BUENOS AIRES,298,304,471,444,915
06,06035,060350108,Avellaneda,BUENOS AIRES,175,159,263,242,505
06,06035,060350104,Avellaneda,BUENOS AIRES,217,162,361,362,723
06,06035,060350302,Avellaneda,BUENOS AIRES,341,298,650,622,1272
06,06035,060351413,Avellaneda,BUENOS AIRES,210,222,324,290,614
06,06035,060350312,Avellaneda,BUENOS AIRES,248,254,406,344,750
06,06035,060350503,Avellaneda,BUENOS AIRES,291,329,396,334,730
06,06035,060350505,Avellaneda,BUENOS AIRES,830,716,1646,1586,3232
06,06035,060350603,Avellaneda,BUENOS AIRES,337,376,526,426,952
06,06035,060350610,Avellaneda,BUENOS AIRES,266,267,492,425,917
06,06035,060350708,Avellaneda,BUENOS AIRES,117,297,169,149,318
06,06035,060350805,Avellaneda,BUENOS AIRES,112,116,222,192,414
06,06035,060350806,Avellaneda,BUENOS AIRES,233,228,390,347,737
06,06035,060350810,Avellaneda,BUENOS AIRES,180,151,305,298,603
06,06035,060350901,Avellaneda,BUENOS AIRES,229,149,387,393,780
06,06035,060350913,Avellaneda,BUENOS AIRES,294,267,448,423,871
06,06035,060351001,Avellaneda,BUENOS AIRES,256,270,342,402,744
06,06035,060351002,Avellaneda,BUENOS AIRES,905,1150,1138,975,2113
06,06035,060351010,Avellaneda,BUENOS AIRES,299,376,397,345,742
06,06035,060351012,Avellaneda,BUENOS AIRES,283,310,376,271,647
06,06035,060351407,Avellaneda,BUENOS AIRES,174,213,283,245,528
06,06035,060351409,Avellaneda,BUENOS AIRES,285,366,373,292,665
06,06035,060351608,Avellaneda,BUENOS AIRES,357,360,537,483,1020
06,06035,060351808,Avellaneda,BUENOS AIRES,229,264,363,291,654
06,06035,060351904,Avellaneda,BUENOS AIRES,272,316,391,343,734
06,06035,060351906,Avellaneda,BUENOS AIRES,319,304,505,420,925
06,06035,060352107,Avellaneda,BUENOS AIRES,212,251,307,314,621
06,06035,060352201,Avellaneda,BUENOS AIRES,421,365,754,696,1450
06,06035,060352210,Avellaneda,BUENOS AIRES,260,288,388,354,742
06,06035,060352511,Avellaneda,BUENOS AIRES,385,410,644,559,1203
06,06035,060352709,Avellaneda,BUENOS AIRES,303,300,503,470,973
06,06035,060352802,Avellaneda,BUENOS AIRES,340,346,561,521,1082
06,06035,060352806,Avellaneda,BUENOS AIRES,321,344,519,426,945
06,06035,060352808,Avellaneda,BUENOS AIRES,340,356,523,457,980
06,06035,060352909,Avellaneda,BUENOS AIRES,219,242,322,286,608
06,06035,060353203,Avellaneda,BUENOS AIRES,325,339,503,428,931
06,06035,060353205,Avellaneda,BUENOS AIRES,244,308,365,312,677
06,06035,060353208,Avellaneda,BUENOS AIRES,286,370,418,364,782
06,06035,060353302,Avellaneda,BUENOS AIRES,311,359,437,407,844
06,06035,060353408,Avellaneda,BUENOS AIRES,251,296,433,382,815
06,06035,060350107,Avellaneda,BUENOS AIRES,245,240,391,384,775
06,06035,060350305,Avellaneda,BUENOS AIRES,252,271,391,336,727
06,06035,060350403,Avellaneda,BUENOS AIRES,325,305,555,526,1081
06,06035,060350412,Avellaneda,BUENOS AIRES,273,263,467,451,918
06,06035,060350507,Avellaneda,BUENOS AIRES,438,307,783,707,1490
06,06035,060350511,Avellaneda,BUENOS AIRES,269,306,405,355,760
06,06035,060350606,Avellaneda,BUENOS AIRES,321,365,512,449,961
06,06035,060350701,Avellaneda,BUENOS AIRES,225,210,384,334,718
06,06035,060350704,Avellaneda,BUENOS AIRES,267,285,419,421,840
06,06035,060350709,Avellaneda,BUENOS AIRES,124,275,184,153,337
06,06035,060350811,Avellaneda,BUENOS AIRES,238,241,393,406,799
06,06035,060350812,Avellaneda,BUENOS AIRES,1116,1150,1780,1430,3210
06,06035,060350905,Avellaneda,BUENOS AIRES,231,231,445,430,875
06,06035,060351005,Avellaneda,BUENOS AIRES,195,233,322,247,569
06,06035,060351007,Avellaneda,BUENOS AIRES,345,454,460,354,814
06,06035,060351008,Avellaneda,BUENOS AIRES,230,308,253,203,456
06,06035,060351011,Avellaneda,BUENOS AIRES,249,264,358,292,650
06,06035,060351202,Avellaneda,BUENOS AIRES,330,363,464,386,850
06,06035,060351309,Avellaneda,BUENOS AIRES,192,213,259,216,475
06,06035,060351411,Avellaneda,BUENOS AIRES,150,175,277,282,559
06,06035,060351601,Avellaneda,BUENOS AIRES,187,243,261,213,474
06,06035,060351602,Avellaneda,BUENOS AIRES,333,386,515,413,928
06,06035,060351604,Avellaneda,BUENOS AIRES,136,158,212,179,391
06,06035,060351707,Avellaneda,BUENOS AIRES,302,325,476,406,882
06,06035,060351708,Avellaneda,BUENOS AIRES,288,316,423,355,778
06,06035,060351709,Avellaneda,BUENOS AIRES,273,295,389,353,742
06,06035,060351901,Avellaneda,BUENOS AIRES,292,347,443,401,844
06,06035,060351909,Avellaneda,BUENOS AIRES,296,304,450,421,871
06,06035,060351910,Avellaneda,BUENOS AIRES,389,441,609,560,1169
06,06035,060351911,Avellaneda,BUENOS AIRES,343,384,555,516,1071
06,06035,060352002,Avellaneda,BUENOS AIRES,391,433,531,460,991
06,06035,060352007,Avellaneda,BUENOS AIRES,358,376,526,465,991
06,06035,060352104,Avellaneda,BUENOS AIRES,204,278,283,237,520
06,06035,060352106,Avellaneda,BUENOS AIRES,180,236,254,215,469
06,06035,060352212,Avellaneda,BUENOS AIRES,49,234,73,54,127
06,06035,060352303,Avellaneda,BUENOS AIRES,255,402,346,275,621
06,06035,060352309,Avellaneda,BUENOS AIRES,280,297,436,364,800
06,06035,060352401,Avellaneda,BUENOS AIRES,331,313,529,420,949
06,06035,060352410,Avellaneda,BUENOS AIRES,347,365,578,489,1067
06,06035,060352501,Avellaneda,BUENOS AIRES,194,193,341,320,661
06,06035,060352502,Avellaneda,BUENOS AIRES,266,286,454,427,881
06,06035,060352509,Avellaneda,BUENOS AIRES,316,334,504,446,950
06,06035,060352611,Avellaneda,BUENOS AIRES,436,375,836,748,1584
06,06035,060352615,Avellaneda,BUENOS AIRES,332,350,541,470,1011
06,06035,060352707,Avellaneda,BUENOS AIRES,374,272,768,789,1557
06,06035,060352805,Avellaneda,BUENOS AIRES,299,304,459,436,895
06,06035,060352908,Avellaneda,BUENOS AIRES,242,269,390,362,752
06,06035,060353001,Avellaneda,BUENOS AIRES,347,380,559,483,1042
06,06035,060353101,Avellaneda,BUENOS AIRES,156,192,227,196,423
06,06035,060353102,Avellaneda,BUENOS AIRES,161,231,251,209,460
06,06035,060353104,Avellaneda,BUENOS AIRES,401,515,520,435,955
06,06035,060353308,Avellaneda,BUENOS AIRES,254,303,404,341,745
06,06035,060353405,Avellaneda,BUENOS AIRES,244,300,412,388,800
06,06035,060353407,Avellaneda,BUENOS AIRES,242,300,328,271,599
06,06035,060350306,Avellaneda,BUENOS AIRES,363,366,555,481,1036
06,06035,060352613,Avellaneda,BUENOS AIRES,207,180,393,395,788
06,06035,060350109,Avellaneda,BUENOS AIRES,142,113,237,239,476
06,06035,060350309,Avellaneda,BUENOS AIRES,180,183,282,258,540
06,06035,060350310,Avellaneda,BUENOS AIRES,223,235,341,329,670
06,06035,060350313,Avellaneda,BUENOS AIRES,334,341,550,499,1049
06,06035,060350401,Avellaneda,BUENOS AIRES,406,322,732,685,1417
06,06035,060350404,Avellaneda,BUENOS AIRES,365,288,701,661,1362
06,06035,060350509,Avellaneda,BUENOS AIRES,319,335,458,418,876
06,06035,060350510,Avellaneda,BUENOS AIRES,295,309,469,383,852
06,06035,060350604,Avellaneda,BUENOS AIRES,269,279,432,363,795
06,06035,060350607,Avellaneda,BUENOS AIRES,207,259,305,284,589
06,06035,060350710,Avellaneda,BUENOS AIRES,138,320,211,192,403
06,06035,060350804,Avellaneda,BUENOS AIRES,321,340,565,459,1024
06,06035,060350813,Avellaneda,BUENOS AIRES,344,296,671,646,1317
06,06035,060351609,Avellaneda,BUENOS AIRES,325,388,470,437,907
06,06035,060350903,Avellaneda,BUENOS AIRES,159,139,292,300,592
06,06035,060350909,Avellaneda,BUENOS AIRES,193,195,340,284,624
06,06035,060351004,Avellaneda,BUENOS AIRES,310,322,510,457,967
06,06035,060351101,Avellaneda,BUENOS AIRES,203,194,286,293,579
06,06035,060351109,Avellaneda,BUENOS AIRES,275,373,336,225,561
06,06035,060351303,Avellaneda,BUENOS AIRES,291,345,419,327,746
06,06035,060351307,Avellaneda,BUENOS AIRES,219,259,339,299,638
06,06035,060351405,Avellaneda,BUENOS AIRES,246,295,348,287,635
06,06035,060351501,Avellaneda,BUENOS AIRES,207,206,402,377,779
06,06035,060351504,Avellaneda,BUENOS AIRES,277,263,394,377,771
06,06035,060351505,Avellaneda,BUENOS AIRES,256,254,533,485,1018
06,06035,060351605,Avellaneda,BUENOS AIRES,264,302,415,388,803
06,06035,060351803,Avellaneda,BUENOS AIRES,264,276,386,367,753
06,06035,060351902,Avellaneda,BUENOS AIRES,333,357,512,460,972
06,06035,060351908,Avellaneda,BUENOS AIRES,273,302,441,391,832
06,06035,060352001,Avellaneda,BUENOS AIRES,365,409,531,461,992
06,06035,060352009,Avellaneda,BUENOS AIRES,312,309,461,411,872
06,06035,060352202,Avellaneda,BUENOS AIRES,262,289,347,303,650
06,06035,060352206,Avellaneda,BUENOS AIRES,275,345,384,327,711
06,06035,060352209,Avellaneda,BUENOS AIRES,227,286,333,276,609
06,06035,060352404,Avellaneda,BUENOS AIRES,347,354,528,481,1009
06,06035,060352601,Avellaneda,BUENOS AIRES,410,418,729,658,1387
06,06035,060352704,Avellaneda,BUENOS AIRES,611,532,1161,1173,2334
06,06035,060352801,Avellaneda,BUENOS AIRES,354,382,572,500,1072
06,06035,060352906,Avellaneda,BUENOS AIRES,296,337,441,394,835
06,06035,060352907,Avellaneda,BUENOS AIRES,263,301,426,328,754
06,06035,060353007,Avellaneda,BUENOS AIRES,341,351,507,505,1012
06,06035,060353009,Avellaneda,BUENOS AIRES,284,298,451,410,861
06,06035,060353204,Avellaneda,BUENOS AIRES,301,337,448,392,840
06,06035,060353501,Avellaneda,BUENOS AIRES,332,332,560,497,1057
06,06035,060353502,Avellaneda,BUENOS AIRES,288,305,444,428,872
06,06035,060353505,Avellaneda,BUENOS AIRES,463,454,806,745,1551
06,06588,065881704,9 de Julio,BUENOS AIRES,318,349,472,473,945
06,06588,065881706,9 de Julio,BUENOS AIRES,326,401,421,371,792
06,06588,065881707,9 de Julio,BUENOS AIRES,237,292,304,241,545
06,06588,065881708,9 de Julio,BUENOS AIRES,211,282,320,264,584
06,06588,065880114,9 de Julio,BUENOS AIRES,247,270,339,329,668
06,06588,065880201,9 de Julio,BUENOS AIRES,342,393,535,460,995
06,06588,065880901,9 de Julio,BUENOS AIRES,266,328,451,397,848
06,06588,065880902,9 de Julio,BUENOS AIRES,342,377,556,492,1048
06,06588,065880906,9 de Julio,BUENOS AIRES,122,192,175,177,352
06,06588,065880907,9 de Julio,BUENOS AIRES,190,219,308,323,631
06,06588,065881705,9 de Julio,BUENOS AIRES,322,377,471,355,826
06,06588,065880503,9 de Julio,BUENOS AIRES,12,28,8,19,27
06,06588,065881102,9 de Julio,BUENOS AIRES,14,25,14,26,40
06,06588,065881203,9 de Julio,BUENOS AIRES,34,37,59,66,125
06,06588,065880102,9 de Julio,BUENOS AIRES,294,382,382,356,738
06,06588,065880105,9 de Julio,BUENOS AIRES,314,417,413,314,727
06,06588,065880112,9 de Julio,BUENOS AIRES,240,227,375,371,746
06,06588,065880802,9 de Julio,BUENOS AIRES,29,41,33,43,76
06,06588,065880910,9 de Julio,BUENOS AIRES,277,315,471,426,897
06,06588,065880401,9 de Julio,BUENOS AIRES,22,40,35,42,77
06,06588,065880504,9 de Julio,BUENOS AIRES,8,10,14,14,28
06,06588,065880801,9 de Julio,BUENOS AIRES,59,134,93,115,208
06,06588,065880904,9 de Julio,BUENOS AIRES,127,226,161,203,364
06,06588,065881007,9 de Julio,BUENOS AIRES,29,42,46,48,94
06,06588,065881303,9 de Julio,BUENOS AIRES,24,46,39,48,87
06,06588,065880903,9 de Julio,BUENOS AIRES,149,253,210,217,427
06,06588,065880101,9 de Julio,BUENOS AIRES,357,411,450,360,810
06,06588,065880107,9 de Julio,BUENOS AIRES,234,276,303,286,589
06,06588,065880116,9 de Julio,BUENOS AIRES,242,287,385,371,756
06,06588,065880117,9 de Julio,BUENOS AIRES,237,276,333,312,645
06,06588,065880203,9 de Julio,BUENOS AIRES,243,272,391,390,781
06,06588,065880206,9 de Julio,BUENOS AIRES,198,259,276,223,499
06,06588,065880301,9 de Julio,BUENOS AIRES,153,187,225,239,464
06,06588,065880908,9 de Julio,BUENOS AIRES,310,340,465,455,920
06,06588,065880909,9 de Julio,BUENOS AIRES,291,344,437,405,842
06,06588,065880912,9 de Julio,BUENOS AIRES,346,376,758,687,1445
06,06588,065881501,9 de Julio,BUENOS AIRES,122,158,173,174,347
06,06588,065881701,9 de Julio,BUENOS AIRES,298,352,419,371,790
06,06588,065881004,9 de Julio,BUENOS AIRES,5,20,7,8,15
06,06588,065880308,9 de Julio,BUENOS AIRES,17,27,18,21,39
06,06588,065880309,9 de Julio,BUENOS AIRES,42,69,64,84,148
06,06588,065881006,9 de Julio,BUENOS AIRES,19,55,22,27,49
06,06588,065881008,9 de Julio,BUENOS AIRES,20,40,20,25,45
06,06588,065881304,9 de Julio,BUENOS AIRES,23,60,20,38,58
06,06588,065880911,9 de Julio,BUENOS AIRES,375,468,749,747,1496
06,06588,065880106,9 de Julio,BUENOS AIRES,305,371,426,353,779
06,06588,065880110,9 de Julio,BUENOS AIRES,210,241,337,246,583
06,06588,065880205,9 de Julio,BUENOS AIRES,103,110,205,201,406
06,06588,065880302,9 de Julio,BUENOS AIRES,191,227,253,260,513
06,06588,065880303,9 de Julio,BUENOS AIRES,231,267,339,289,628
06,06588,065881002,9 de Julio,BUENOS AIRES,77,118,117,102,219
06,06588,065881301,9 de Julio,BUENOS AIRES,181,207,291,275,566
06,06588,065881402,9 de Julio,BUENOS AIRES,132,191,221,226,447
06,06588,065881604,9 de Julio,BUENOS AIRES,11,31,18,21,39
06,06588,065880502,9 de Julio,BUENOS AIRES,17,48,16,32,48
06,06588,065881202,9 de Julio,BUENOS AIRES,9,16,10,13,23
06,06588,065881305,9 de Julio,BUENOS AIRES,26,51,27,44,71
06,06588,065881605,9 de Julio,BUENOS AIRES,5,20,3,4,7
06,06588,065881606,9 de Julio,BUENOS AIRES,12,27,18,21,39
06,06588,065881608,9 de Julio,BUENOS AIRES,10,23,18,15,33
06,06588,065881609,9 de Julio,BUENOS AIRES,3,14,2,6,8
06,06588,065880111,9 de Julio,BUENOS AIRES,416,480,589,534,1123
06,06588,065880103,9 de Julio,BUENOS AIRES,381,465,546,460,1006
06,06588,065880109,9 de Julio,BUENOS AIRES,233,271,345,308,653
06,06588,065880202,9 de Julio,BUENOS AIRES,336,378,497,451,948
06,06588,065881012,9 de Julio,BUENOS AIRES,137,183,215,180,395
06,06588,065881401,9 de Julio,BUENOS AIRES,101,169,151,147,298
06,06588,065881602,9 de Julio,BUENOS AIRES,336,391,498,488,986
06,06588,065880306,9 de Julio,BUENOS AIRES,17,32,21,36,57
06,06588,065881005,9 de Julio,BUENOS AIRES,39,55,51,86,137
06,06588,065881010,9 de Julio,BUENOS AIRES,8,28,8,17,25
06,06588,065881101,9 de Julio,BUENOS AIRES,10,10,11,22,33
06,06588,065880113,9 de Julio,BUENOS AIRES,249,295,381,350,731
06,06588,065880208,9 de Julio,BUENOS AIRES,256,336,319,265,584
06,06588,065880304,9 de Julio,BUENOS AIRES,87,110,133,115,248
06,06588,065880501,9 de Julio,BUENOS AIRES,175,212,262,269,531
06,06588,065880702,9 de Julio,BUENOS AIRES,89,125,117,118,235
06,06588,065880915,9 de Julio,BUENOS AIRES,234,311,428,466,894
06,06588,065881702,9 de Julio,BUENOS AIRES,296,307,496,437,933
06,06588,065880307,9 de Julio,BUENOS AIRES,12,19,14,26,40
06,06588,065881404,9 de Julio,BUENOS AIRES,19,45,26,32,58
06,06588,065881503,9 de Julio,BUENOS AIRES,7,12,6,10,16
06,06588,065880104,9 de Julio,BUENOS AIRES,334,411,468,402,870
06,06588,065880115,9 de Julio,BUENOS AIRES,213,262,316,245,561
06,06588,065880207,9 de Julio,BUENOS AIRES,226,294,318,272,590
06,06588,065880703,9 de Julio,BUENOS AIRES,95,120,128,134,262
06,06588,065880914,9 de Julio,BUENOS AIRES,184,194,323,304,627
06,06588,065881601,9 de Julio,BUENOS AIRES,279,323,385,371,756
06,06588,065881703,9 de Julio,BUENOS AIRES,240,274,347,328,675
06,06588,065880601,9 de Julio,BUENOS AIRES,59,125,61,85,146
06,06588,065880701,9 de Julio,BUENOS AIRES,49,79,47,61,108
06,06588,065881003,9 de Julio,BUENOS AIRES,17,24,13,22,35
06,06588,065881607,9 de Julio,BUENOS AIRES,0,1,0,0,0
06,06588,065880204,9 de Julio,BUENOS AIRES,333,353,507,493,1000
06,06588,065880905,9 de Julio,BUENOS AIRES,103,203,152,157,309
06,06588,065880913,9 de Julio,BUENOS AIRES,345,347,688,695,1383
06,06588,065881001,9 de Julio,BUENOS AIRES,129,151,173,180,353
06,06588,065881302,9 de Julio,BUENOS AIRES,21,22,29,28,57
06,06588,065881603,9 de Julio,BUENOS AIRES,242,270,466,462,928
06,06588,065881009,9 de Julio,BUENOS AIRES,4,8,2,7,9
06,06588,065880108,9 de Julio,BUENOS AIRES,230,249,351,315,666
06,06588,065880305,9 de Julio,BUENOS AIRES,16,42,11,22,33
06,06588,065880505,9 de Julio,BUENOS AIRES,62,78,72,100,172
06,06588,065881011,9 de Julio,BUENOS AIRES,9,18,12,13,25
06,06588,065881201,9 de Julio,BUENOS AIRES,35,86,43,55,98
06,06588,065881403,9 de Julio,BUENOS AIRES,6,19,6,8,14
06,06588,065881502,9 de Julio,BUENOS AIRES,11,25,10,20,30
06,06588,065881504,9 de Julio,BUENOS AIRES,18,50,19,23,42
06,06595,065950109,Olavarría,BUENOS AIRES,260,279,426,414,840
06,06595,065950205,Olavarría,BUENOS AIRES,224,264,264,204,468
06,06595,065950207,Olavarría,BUENOS AIRES,305,346,390,329,719
06,06595,065950411,Olavarría,BUENOS AIRES,243,273,379,355,734
06,06595,065951907,Olavarría,BUENOS AIRES,105,138,159,159,318
06,06595,065952001,Olavarría,BUENOS AIRES,256,280,372,359,731
06,06595,065952502,Olavarría,BUENOS AIRES,262,297,340,306,646
06,06595,065952602,Olavarría,BUENOS AIRES,421,444,919,853,1772
06,06595,065952609,Olavarría,BUENOS AIRES,247,258,418,410,828
06,06595,065952702,Olavarría,BUENOS AIRES,444,485,775,777,1552
06,06595,065952710,Olavarría,BUENOS AIRES,193,209,284,259,543
06,06595,065952201,Olavarría,BUENOS AIRES,71,101,107,116,223
06,06595,065950603,Olavarría,BUENOS AIRES,109,147,150,151,301
06,06595,065951605,Olavarría,BUENOS AIRES,38,122,56,59,115
06,06595,065950212,Olavarría,BUENOS AIRES,255,348,367,283,650
06,06595,065950303,Olavarría,BUENOS AIRES,300,420,409,319,728
06,06595,065950311,Olavarría,BUENOS AIRES,341,394,472,430,902
06,06595,065950404,Olavarría,BUENOS AIRES,338,377,556,536,1092
06,06595,065951603,Olavarría,BUENOS AIRES,391,419,688,724,1412
06,06595,065951608,Olavarría,BUENOS AIRES,468,490,838,805,1643
06,06595,065951908,Olavarría,BUENOS AIRES,205,230,268,281,549
06,06595,065951914,Olavarría,BUENOS AIRES,350,381,445,457,902
06,06595,065952501,Olavarría,BUENOS AIRES,367,377,568,508,1076
06,06595,065952712,Olavarría,BUENOS AIRES,186,218,272,255,527
06,06595,065951804,Olavarría,BUENOS AIRES,3,9,8,4,12
06,06595,065952601,Olavarría,BUENOS AIRES,107,168,134,204,338
06,06595,065952707,Olavarría,BUENOS AIRES,214,262,328,354,682
06,06595,065950105,Olavarría,BUENOS AIRES,359,431,508,447,955
06,06595,065950214,Olavarría,BUENOS AIRES,205,216,357,268,625
06,06595,065950215,Olavarría,BUENOS AIRES,201,217,280,215,495
06,06595,065950401,Olavarría,BUENOS AIRES,227,252,355,342,697
06,06595,065951610,Olavarría,BUENOS AIRES,194,209,296,245,541
06,06595,065951613,Olavarría,BUENOS AIRES,189,211,307,246,553
06,06595,065951801,Olavarría,BUENOS AIRES,6,26,1,9,10
06,06595,065951902,Olavarría,BUENOS AIRES,196,238,306,306,612
06,06595,065951903,Olavarría,BUENOS AIRES,317,342,584,600,1184
06,06595,065951906,Olavarría,BUENOS AIRES,94,102,145,164,309
06,06595,065952105,Olavarría,BUENOS AIRES,285,316,444,403,847
06,06595,065952412,Olavarría,BUENOS AIRES,272,315,421,418,839
06,06595,065952508,Olavarría,BUENOS AIRES,299,337,416,417,833
06,06595,065952509,Olavarría,BUENOS AIRES,255,302,363,302,665
06,06595,065952510,Olavarría,BUENOS AIRES,267,312,418,397,815
06,06595,065952512,Olavarría,BUENOS AIRES,213,246,362,359,721
06,06595,065952603,Olavarría,BUENOS AIRES,239,291,451,492,943
06,06595,065952610,Olavarría,BUENOS AIRES,325,356,636,603,1239
06,06595,065952612,Olavarría,BUENOS AIRES,391,438,636,642,1278
06,06595,065952703,Olavarría,BUENOS AIRES,198,293,359,363,722
06,06595,065952614,Olavarría,BUENOS AIRES,175,218,268,289,557
06,06595,065950701,Olavarría,BUENOS AIRES,64,102,82,106,188
06,06595,065950901,Olavarría,BUENOS AIRES,65,94,64,93,157
06,06595,065951201,Olavarría,BUENOS AIRES,34,62,47,58,105
06,06595,065950601,Olavarría,BUENOS AIRES,83,114,86,112,198
06,06595,065950106,Olavarría,BUENOS AIRES,272,290,414,337,751
06,06595,065950202,Olavarría,BUENOS AIRES,315,371,436,398,834
06,06595,065950204,Olavarría,BUENOS AIRES,324,444,411,287,698
06,06595,065950302,Olavarría,BUENOS AIRES,303,340,404,327,731
06,06595,065950304,Olavarría,BUENOS AIRES,317,423,385,320,705
06,06595,065950305,Olavarría,BUENOS AIRES,261,322,349,325,674
06,06595,065950308,Olavarría,BUENOS AIRES,255,342,310,260,570
06,06595,065950403,Olavarría,BUENOS AIRES,298,328,434,420,854
06,06595,065951602,Olavarría,BUENOS AIRES,357,385,634,596,1230
06,06595,065951904,Olavarría,BUENOS AIRES,134,162,204,317,521
06,06595,065951909,Olavarría,BUENOS AIRES,132,155,173,175,348
06,06595,065952406,Olavarría,BUENOS AIRES,276,331,398,331,729
06,06595,065952706,Olavarría,BUENOS AIRES,60,75,86,91,177
06,06595,065952607,Olavarría,BUENOS AIRES,326,372,546,515,1061
06,06595,065952404,Olavarría,BUENOS AIRES,283,340,384,336,720
06,06595,065950501,Olavarría,BUENOS AIRES,60,102,54,90,144
06,06595,065952301,Olavarría,BUENOS AIRES,97,163,110,148,258
06,06595,065950301,Olavarría,BUENOS AIRES,226,248,324,311,635
06,06595,065950312,Olavarría,BUENOS AIRES,256,339,321,266,587
06,06595,065950405,Olavarría,BUENOS AIRES,343,384,557,514,1071
06,06595,065950406,Olavarría,BUENOS AIRES,221,247,375,362,737
06,06595,065950410,Olavarría,BUENOS AIRES,276,286,459,433,892
06,06595,065950412,Olavarría,BUENOS AIRES,368,413,544,493,1037
06,06595,065951611,Olavarría,BUENOS AIRES,206,214,321,297,618
06,06595,065952102,Olavarría,BUENOS AIRES,215,249,327,332,659
06,06595,065952103,Olavarría,BUENOS AIRES,161,180,232,207,439
06,06595,065952408,Olavarría,BUENOS AIRES,427,487,708,670,1378
06,06595,065952411,Olavarría,BUENOS AIRES,222,239,418,366,784
06,06595,065952507,Olavarría,BUENOS AIRES,252,275,373,355,728
06,06595,065952611,Olavarría,BUENOS AIRES,371,415,607,603,1210
06,06595,065952613,Olavarría,BUENOS AIRES,234,255,378,385,763
06,06595,065952711,Olavarría,BUENOS AIRES,242,280,331,327,658
06,06595,065950101,Olavarría,BUENOS AIRES,291,310,550,518,1068
06,06595,065950602,Olavarría,BUENOS AIRES,22,23,32,33,65
06,06595,065951911,Olavarría,BUENOS AIRES,313,371,473,480,953
06,06595,065952405,Olavarría,BUENOS AIRES,277,347,380,334,714
06,06595,065950802,Olavarría,BUENOS AIRES,58,111,84,109,193
06,06595,065951701,Olavarría,BUENOS AIRES,46,62,62,71,133
06,06595,065951901,Olavarría,BUENOS AIRES,157,208,269,2353,2622
06,06595,065952403,Olavarría,BUENOS AIRES,289,350,382,315,697
06,06595,065951301,Olavarría,BUENOS AIRES,53,86,65,85,150
06,06595,065951802,Olavarría,BUENOS AIRES,9,16,10,11,21
06,06595,065951803,Olavarría,BUENOS AIRES,21,35,28,33,61
06,06595,065952705,Olavarría,BUENOS AIRES,19,34,25,29,54
06,06595,065951912,Olavarría,BUENOS AIRES,175,220,298,269,567
06,06595,065950203,Olavarría,BUENOS AIRES,289,350,367,325,692
06,06595,065950206,Olavarría,BUENOS AIRES,291,410,392,275,667
06,06595,065950208,Olavarría,BUENOS AIRES,362,445,544,486,1030
06,06595,065950209,Olavarría,BUENOS AIRES,216,241,321,263,584
06,06595,065950307,Olavarría,BUENOS AIRES,258,407,341,267,608
06,06595,065950402,Olavarría,BUENOS AIRES,400,493,568,433,1001
06,06595,065950407,Olavarría,BUENOS AIRES,261,305,393,350,743
06,06595,065950408,Olavarría,BUENOS AIRES,253,275,360,330,690
06,06595,065950801,Olavarría,BUENOS AIRES,173,219,241,251,492
06,06595,065951601,Olavarría,BUENOS AIRES,262,293,568,559,1127
06,06595,065951612,Olavarría,BUENOS AIRES,224,247,342,308,650
06,06595,065951905,Olavarría,BUENOS AIRES,95,120,148,121,269
06,06595,065951910,Olavarría,BUENOS AIRES,189,192,301,301,602
06,06595,065952104,Olavarría,BUENOS AIRES,224,251,339,323,662
06,06595,065952407,Olavarría,BUENOS AIRES,352,398,501,451,952
06,06595,065952409,Olavarría,BUENOS AIRES,301,324,426,410,836
06,06595,065952410,Olavarría,BUENOS AIRES,256,278,444,439,883
06,06595,065952504,Olavarría,BUENOS AIRES,379,422,506,478,984
06,06595,065952505,Olavarría,BUENOS AIRES,294,352,388,387,775
06,06595,065952513,Olavarría,BUENOS AIRES,215,225,380,406,786
06,06595,065952704,Olavarría,BUENOS AIRES,232,319,411,461,872
06,06595,065952709,Olavarría,BUENOS AIRES,242,261,381,420,801
06,06595,065951001,Olavarría,BUENOS AIRES,54,87,58,91,149
06,06595,065951401,Olavarría,BUENOS AIRES,100,157,111,158,269
06,06595,065952107,Olavarría,BUENOS AIRES,60,98,130,176,306
06,06595,065952708,Olavarría,BUENOS AIRES,98,136,171,174,345
06,06595,065950108,Olavarría,BUENOS AIRES,373,397,533,493,1026
06,06595,065950110,Olavarría,BUENOS AIRES,371,443,566,496,1062
06,06595,065950210,Olavarría,BUENOS AIRES,424,485,595,532,1127
06,06595,065950306,Olavarría,BUENOS AIRES,295,356,384,306,690
06,06595,065950409,Olavarría,BUENOS AIRES,333,356,512,495,1007
06,06595,065951606,Olavarría,BUENOS AIRES,241,264,379,360,739
06,06595,065952605,Olavarría,BUENOS AIRES,361,409,656,638,1294
06,06595,065952101,Olavarría,BUENOS AIRES,175,189,308,275,583
06,06595,065952402,Olavarría,BUENOS AIRES,307,372,416,311,727
06,06595,065952506,Olavarría,BUENOS AIRES,274,299,431,385,816
06,06595,065952604,Olavarría,BUENOS AIRES,239,246,410,406,816
06,06595,065952701,Olavarría,BUENOS AIRES,333,364,573,594,1167
06,06595,065950413,Olavarría,BUENOS AIRES,346,368,561,491,1052
06,06595,065952106,Olavarría,BUENOS AIRES,1,2,1,1,2
06,06595,065951101,Olavarría,BUENOS AIRES,45,74,42,65,107
06,06595,065951501,Olavarría,BUENOS AIRES,50,89,60,71,131
06,06595,065951604,Olavarría,BUENOS AIRES,90,114,147,176,323
06,06595,065952002,Olavarría,BUENOS AIRES,13,20,16,18,34
06,06595,065950102,Olavarría,BUENOS AIRES,244,261,407,372,779
06,06595,065950103,Olavarría,BUENOS AIRES,400,422,661,616,1277
06,06595,065950104,Olavarría,BUENOS AIRES,367,390,610,577,1187
06,06595,065950107,Olavarría,BUENOS AIRES,302,326,440,421,861
06,06595,065950201,Olavarría,BUENOS AIRES,278,360,408,362,770
06,06595,065950211,Olavarría,BUENOS AIRES,217,260,284,242,526
06,06595,065950213,Olavarría,BUENOS AIRES,197,228,262,201,463
06,06595,065950309,Olavarría,BUENOS AIRES,234,282,300,297,597
06,06595,065950310,Olavarría,BUENOS AIRES,386,451,552,493,1045
06,06595,065950313,Olavarría,BUENOS AIRES,221,247,308,279,587
06,06595,065951607,Olavarría,BUENOS AIRES,262,292,488,514,1002
06,06595,065951609,Olavarría,BUENOS AIRES,237,257,362,313,675
06,06595,065952606,Olavarría,BUENOS AIRES,172,335,289,263,552
06,06595,065952401,Olavarría,BUENOS AIRES,285,340,395,329,724
06,06595,065952503,Olavarría,BUENOS AIRES,364,455,516,441,957
06,06595,065952511,Olavarría,BUENOS AIRES,302,331,470,486,956
06,06595,065952608,Olavarría,BUENOS AIRES,323,327,615,614,1229
06,06595,065951913,Olavarría,BUENOS AIRES,47,73,82,71,153
06,06826,068260403,Trenque Lauquen,BUENOS AIRES,281,341,428,346,774
06,06826,068260706,Trenque Lauquen,BUENOS AIRES,383,458,613,602,1215
06,06826,068260108,Trenque Lauquen,BUENOS AIRES,321,325,501,484,985
06,06826,068260120,Trenque Lauquen,BUENOS AIRES,276,307,406,352,758
06,06826,068260202,Trenque Lauquen,BUENOS AIRES,404,471,644,647,1291
06,06826,068260212,Trenque Lauquen,BUENOS AIRES,291,376,369,273,642
06,06826,068261610,Trenque Lauquen,BUENOS AIRES,207,247,290,270,560
06,06826,068261902,Trenque Lauquen,BUENOS AIRES,308,372,428,366,794
06,06826,068260302,Trenque Lauquen,BUENOS AIRES,6,14,2,7,9
06,06826,068260602,Trenque Lauquen,BUENOS AIRES,26,47,21,37,58
06,06826,068260801,Trenque Lauquen,BUENOS AIRES,65,83,83,109,192
06,06826,068260901,Trenque Lauquen,BUENOS AIRES,20,32,36,32,68
06,06826,068261001,Trenque Lauquen,BUENOS AIRES,47,80,76,83,159
06,06826,068261002,Trenque Lauquen,BUENOS AIRES,33,42,31,47,78
06,06826,068261502,Trenque Lauquen,BUENOS AIRES,25,37,33,36,69
06,06826,068261804,Trenque Lauquen,BUENOS AIRES,42,68,67,80,147
06,06826,068260213,Trenque Lauquen,BUENOS AIRES,101,150,118,101,219
06,06826,068260102,Trenque Lauquen,BUENOS AIRES,283,308,492,459,951
06,06826,068260116,Trenque Lauquen,BUENOS AIRES,159,174,241,219,460
06,06826,068260203,Trenque Lauquen,BUENOS AIRES,231,246,467,450,917
06,06826,068260207,Trenque Lauquen,BUENOS AIRES,154,205,199,166,365
06,06826,068261605,Trenque Lauquen,BUENOS AIRES,113,86,216,229,445
06,06826,068260301,Trenque Lauquen,BUENOS AIRES,14,20,11,23,34
06,06826,068260902,Trenque Lauquen,BUENOS AIRES,24,37,33,51,84
06,06826,068261301,Trenque Lauquen,BUENOS AIRES,33,40,22,57,79
06,06826,068261601,Trenque Lauquen,BUENOS AIRES,49,64,55,95,150
06,06826,068261803,Trenque Lauquen,BUENOS AIRES,30,49,33,54,87
06,06826,068260118,Trenque Lauquen,BUENOS AIRES,214,224,400,430,830
06,06826,068260103,Trenque Lauquen,BUENOS AIRES,326,293,569,559,1128
06,06826,068260106,Trenque Lauquen,BUENOS AIRES,252,322,338,281,619
06,06826,068260115,Trenque Lauquen,BUENOS AIRES,248,310,339,269,608
06,06826,068260204,Trenque Lauquen,BUENOS AIRES,189,196,314,312,626
06,06826,068260702,Trenque Lauquen,BUENOS AIRES,183,207,286,265,551
06,06826,068261607,Trenque Lauquen,BUENOS AIRES,195,241,265,241,506
06,06826,068261901,Trenque Lauquen,BUENOS AIRES,284,366,383,310,693
06,06826,068261903,Trenque Lauquen,BUENOS AIRES,194,230,284,255,539
06,06826,068261906,Trenque Lauquen,BUENOS AIRES,220,250,401,367,768
06,06826,068261908,Trenque Lauquen,BUENOS AIRES,215,211,367,373,740
06,06826,068261910,Trenque Lauquen,BUENOS AIRES,251,291,343,341,684
06,06826,068261101,Trenque Lauquen,BUENOS AIRES,32,60,44,143,187
06,06826,068261401,Trenque Lauquen,BUENOS AIRES,22,36,24,36,60
06,06826,068261501,Trenque Lauquen,BUENOS AIRES,40,46,53,79,132
06,06826,068261602,Trenque Lauquen,BUENOS AIRES,42,49,57,78,135
06,06826,068261805,Trenque Lauquen,BUENOS AIRES,17,27,35,33,68
06,06826,068260119,Trenque Lauquen,BUENOS AIRES,195,215,312,325,637
06,06826,068260214,Trenque Lauquen,BUENOS AIRES,109,157,144,131,275
06,06826,068260501,Trenque Lauquen,BUENOS AIRES,88,110,133,141,274
06,06826,068260701,Trenque Lauquen,BUENOS AIRES,395,390,686,645,1331
06,06826,068261606,Trenque Lauquen,BUENOS AIRES,238,290,391,389,780
06,06826,068260303,Trenque Lauquen,BUENOS AIRES,14,30,16,25,41
06,06826,068260503,Trenque Lauquen,BUENOS AIRES,8,16,9,12,21
06,06826,068260703,Trenque Lauquen,BUENOS AIRES,50,68,76,85,161
06,06826,068261402,Trenque Lauquen,BUENOS AIRES,10,12,7,22,29
06,06826,068261701,Trenque Lauquen,BUENOS AIRES,17,41,23,39,62
06,06826,068261703,Trenque Lauquen,BUENOS AIRES,15,42,23,26,49
06,06826,068260402,Trenque Lauquen,BUENOS AIRES,42,70,55,46,101
06,06826,068260101,Trenque Lauquen,BUENOS AIRES,627,507,1120,1052,2172
06,06826,068260109,Trenque Lauquen,BUENOS AIRES,189,258,222,179,401
06,06826,068260113,Trenque Lauquen,BUENOS AIRES,228,238,359,370,729
06,06826,068260206,Trenque Lauquen,BUENOS AIRES,150,177,212,179,391
06,06826,068260208,Trenque Lauquen,BUENOS AIRES,152,241,180,163,343
06,06826,068260209,Trenque Lauquen,BUENOS AIRES,270,338,429,336,765
06,06826,068260210,Trenque Lauquen,BUENOS AIRES,158,187,223,199,422
06,06826,068261907,Trenque Lauquen,BUENOS AIRES,179,227,321,317,638
06,06826,068261802,Trenque Lauquen,BUENOS AIRES,24,43,26,41,67
06,06826,068261702,Trenque Lauquen,BUENOS AIRES,21,25,14,34,48
06,06826,068261704,Trenque Lauquen,BUENOS AIRES,6,17,7,9,16
06,06826,068260110,Trenque Lauquen,BUENOS AIRES,131,189,159,116,275
06,06826,068260211,Trenque Lauquen,BUENOS AIRES,145,157,219,215,434
06,06826,068260704,Trenque Lauquen,BUENOS AIRES,179,278,318,282,600
06,06826,068261904,Trenque Lauquen,BUENOS AIRES,190,216,289,273,562
06,06826,068261905,Trenque Lauquen,BUENOS AIRES,165,198,253,228,481
06,06826,068261909,Trenque Lauquen,BUENOS AIRES,339,377,535,502,1037
06,06826,068260707,Trenque Lauquen,BUENOS AIRES,20,42,24,31,55
06,06826,068260709,Trenque Lauquen,BUENOS AIRES,55,78,77,99,176
06,06826,068260802,Trenque Lauquen,BUENOS AIRES,14,14,30,19,49
06,06826,068261603,Trenque Lauquen,BUENOS AIRES,37,45,39,57,96
06,06826,068261303,Trenque Lauquen,BUENOS AIRES,46,67,71,84,155
06,06826,068260205,Trenque Lauquen,BUENOS AIRES,151,174,212,194,406
06,06826,068260104,Trenque Lauquen,BUENOS AIRES,176,202,257,243,500
06,06826,068260105,Trenque Lauquen,BUENOS AIRES,184,202,260,258,518
06,06826,068260201,Trenque Lauquen,BUENOS AIRES,281,305,386,351,737
06,06826,068260708,Trenque Lauquen,BUENOS AIRES,48,138,82,72,154
06,06826,068261609,Trenque Lauquen,BUENOS AIRES,159,186,220,192,412
06,06826,068261611,Trenque Lauquen,BUENOS AIRES,196,222,279,290,569
06,06826,068261801,Trenque Lauquen,BUENOS AIRES,58,88,72,89,161
06,06826,068260601,Trenque Lauquen,BUENOS AIRES,28,59,28,52,80
06,06826,068260117,Trenque Lauquen,BUENOS AIRES,165,179,264,236,500
06,06826,068260107,Trenque Lauquen,BUENOS AIRES,313,371,490,386,876
06,06826,068260111,Trenque Lauquen,BUENOS AIRES,200,230,255,246,501
06,06826,068260112,Trenque Lauquen,BUENOS AIRES,204,225,280,264,544
06,06826,068260114,Trenque Lauquen,BUENOS AIRES,196,220,271,249,520
06,06826,068261604,Trenque Lauquen,BUENOS AIRES,89,97,153,134,287
06,06826,068261608,Trenque Lauquen,BUENOS AIRES,394,478,613,605,1218
06,06826,068261911,Trenque Lauquen,BUENOS AIRES,194,212,267,259,526
06,06826,068260401,Trenque Lauquen,BUENOS AIRES,19,32,14,33,47
06,06826,068260502,Trenque Lauquen,BUENOS AIRES,12,17,14,20,34
06,06826,068260705,Trenque Lauquen,BUENOS AIRES,25,53,34,38,72
06,06826,068261201,Trenque Lauquen,BUENOS AIRES,23,25,27,39,66
06,06826,068261102,Trenque Lauquen,BUENOS AIRES,23,47,28,41,69
06,06826,068261302,Trenque Lauquen,BUENOS AIRES,25,37,42,45,87
06,06833,068330801,Tres Arroyos,BUENOS AIRES,23,59,32,31,63
06,06833,068330802,Tres Arroyos,BUENOS AIRES,32,52,32,44,76
06,06833,068331405,Tres Arroyos,BUENOS AIRES,35,50,55,48,103
06,06833,068330103,Tres Arroyos,BUENOS AIRES,266,426,363,266,629
06,06833,068330115,Tres Arroyos,BUENOS AIRES,78,79,110,107,217
06,06833,068330208,Tres Arroyos,BUENOS AIRES,333,464,392,316,708
06,06833,068331012,Tres Arroyos,BUENOS AIRES,523,575,883,866,1749
06,06833,068331701,Tres Arroyos,BUENOS AIRES,141,163,238,212,450
06,06833,068331806,Tres Arroyos,BUENOS AIRES,52,405,60,52,112
06,06833,068331908,Tres Arroyos,BUENOS AIRES,296,368,474,451,925
06,06833,068330704,Tres Arroyos,BUENOS AIRES,18,30,24,24,48
06,06833,068330901,Tres Arroyos,BUENOS AIRES,11,21,14,20,34
06,06833,068330902,Tres Arroyos,BUENOS AIRES,14,39,10,22,32
06,06833,068331707,Tres Arroyos,BUENOS AIRES,13,31,22,18,40
06,06833,068331810,Tres Arroyos,BUENOS AIRES,11,37,7,16,23
06,06833,068330107,Tres Arroyos,BUENOS AIRES,364,465,491,394,885
06,06833,068330108,Tres Arroyos,BUENOS AIRES,317,402,514,398,912
06,06833,068330701,Tres Arroyos,BUENOS AIRES,9,12,8,9,17
06,06833,068331008,Tres Arroyos,BUENOS AIRES,488,399,904,958,1862
06,06833,068331101,Tres Arroyos,BUENOS AIRES,192,261,276,291,567
06,06833,068331408,Tres Arroyos,BUENOS AIRES,137,161,179,178,357
06,06833,068331703,Tres Arroyos,BUENOS AIRES,185,214,245,246,491
06,06833,068330305,Tres Arroyos,BUENOS AIRES,5,12,7,10,17
06,06833,068330401,Tres Arroyos,BUENOS AIRES,31,56,33,35,68
06,06833,068330604,Tres Arroyos,BUENOS AIRES,8,13,10,10,20
06,06833,068330702,Tres Arroyos,BUENOS AIRES,13,20,11,12,23
06,06833,068331403,Tres Arroyos,BUENOS AIRES,5,29,3,5,8
06,06833,068330706,Tres Arroyos,BUENOS AIRES,20,36,19,35,54
06,06833,068331013,Tres Arroyos,BUENOS AIRES,49,67,58,81,139
06,06833,068331103,Tres Arroyos,BUENOS AIRES,9,23,7,9,16
06,06833,068331201,Tres Arroyos,BUENOS AIRES,12,19,13,15,28
06,06833,068331202,Tres Arroyos,BUENOS AIRES,10,24,18,16,34
06,06833,068331503,Tres Arroyos,BUENOS AIRES,11,17,10,21,31
06,06833,068331604,Tres Arroyos,BUENOS AIRES,2,8,1,2,3
06,06833,068331808,Tres Arroyos,BUENOS AIRES,26,61,33,36,69
06,06833,068331505,Tres Arroyos,BUENOS AIRES,9,21,12,14,26
06,06833,068331304,Tres Arroyos,BUENOS AIRES,54,244,76,80,156
06,06833,068331302,Tres Arroyos,BUENOS AIRES,106,643,133,147,280
06,06833,068331809,Tres Arroyos,BUENOS AIRES,127,237,189,207,396
06,06833,068331904,Tres Arroyos,BUENOS AIRES,256,324,401,371,772
06,06833,068330105,Tres Arroyos,BUENOS AIRES,225,267,310,282,592
06,06833,068330111,Tres Arroyos,BUENOS AIRES,311,400,438,348,786
06,06833,068330113,Tres Arroyos,BUENOS AIRES,450,490,631,611,1242
06,06833,068330116,Tres Arroyos,BUENOS AIRES,210,240,268,248,516
06,06833,068330206,Tres Arroyos,BUENOS AIRES,196,310,272,201,473
06,06833,068331002,Tres Arroyos,BUENOS AIRES,229,273,412,416,828
06,06833,068331003,Tres Arroyos,BUENOS AIRES,6,6,14,16,30
06,06833,068331004,Tres Arroyos,BUENOS AIRES,427,483,617,568,1185
06,06833,068331702,Tres Arroyos,BUENOS AIRES,212,252,309,315,624
06,06833,068331804,Tres Arroyos,BUENOS AIRES,68,445,79,72,151
06,06833,068331802,Tres Arroyos,BUENOS AIRES,164,605,225,231,456
06,06833,068331905,Tres Arroyos,BUENOS AIRES,446,510,679,665,1344
06,06833,068331907,Tres Arroyos,BUENOS AIRES,306,331,465,545,1010
06,06833,068331910,Tres Arroyos,BUENOS AIRES,238,251,414,415,829
06,06833,068331912,Tres Arroyos,BUENOS AIRES,222,240,357,361,718
06,06833,068330502,Tres Arroyos,BUENOS AIRES,9,28,11,12,23
06,06833,068330903,Tres Arroyos,BUENOS AIRES,26,46,30,37,67
06,06833,068331605,Tres Arroyos,BUENOS AIRES,19,33,19,45,64
06,06833,068331705,Tres Arroyos,BUENOS AIRES,79,105,99,125,224
06,06833,068331708,Tres Arroyos,BUENOS AIRES,16,26,17,20,37
06,06833,068330104,Tres Arroyos,BUENOS AIRES,354,428,496,452,948
06,06833,068330112,Tres Arroyos,BUENOS AIRES,437,496,607,553,1160
06,06833,068330204,Tres Arroyos,BUENOS AIRES,305,388,422,323,745
06,06833,068330207,Tres Arroyos,BUENOS AIRES,310,414,416,337,753
06,06833,068331801,Tres Arroyos,BUENOS AIRES,69,370,109,126,235
06,06833,068330403,Tres Arroyos,BUENOS AIRES,17,24,23,26,49
06,06833,068331901,Tres Arroyos,BUENOS AIRES,272,298,474,482,956
06,06833,068330109,Tres Arroyos,BUENOS AIRES,323,448,442,371,813
06,06833,068330101,Tres Arroyos,BUENOS AIRES,215,240,297,251,548
06,06833,068330110,Tres Arroyos,BUENOS AIRES,373,468,490,455,945
06,06833,068330209,Tres Arroyos,BUENOS AIRES,266,394,407,297,704
06,06833,068330211,Tres Arroyos,BUENOS AIRES,343,407,456,367,823
06,06833,068331011,Tres Arroyos,BUENOS AIRES,314,356,493,511,1004
06,06833,068331006,Tres Arroyos,BUENOS AIRES,358,392,602,535,1137
06,06833,068331010,Tres Arroyos,BUENOS AIRES,224,251,337,308,645
06,06833,068331401,Tres Arroyos,BUENOS AIRES,204,252,299,298,597
06,06833,068331709,Tres Arroyos,BUENOS AIRES,188,221,241,257,498
06,06833,068331807,Tres Arroyos,BUENOS AIRES,77,433,92,99,191
06,06833,068331906,Tres Arroyos,BUENOS AIRES,309,356,530,580,1110
06,06833,068331911,Tres Arroyos,BUENOS AIRES,268,275,533,498,1031
06,06833,068330303,Tres Arroyos,BUENOS AIRES,4,8,4,6,10
06,06833,068330601,Tres Arroyos,BUENOS AIRES,5,6,4,14,18
06,06833,068330603,Tres Arroyos,BUENOS AIRES,11,21,8,15,23
06,06833,068330703,Tres Arroyos,BUENOS AIRES,18,22,29,36,65
06,06833,068331102,Tres Arroyos,BUENOS AIRES,3,7,4,3,7
06,06833,068331104,Tres Arroyos,BUENOS AIRES,8,17,7,7,14
06,06833,068331301,Tres Arroyos,BUENOS AIRES,7,31,5,10,15
06,06833,068331602,Tres Arroyos,BUENOS AIRES,9,17,8,11,19
06,06833,068331903,Tres Arroyos,BUENOS AIRES,376,405,583,555,1138
06,06833,068330106,Tres Arroyos,BUENOS AIRES,337,412,488,402,890
06,06833,068330205,Tres Arroyos,BUENOS AIRES,271,384,341,255,596
06,06833,068330210,Tres Arroyos,BUENOS AIRES,320,411,442,327,769
06,06833,068330213,Tres Arroyos,BUENOS AIRES,349,419,500,452,952
06,06833,068331007,Tres Arroyos,BUENOS AIRES,418,456,587,582,1169
06,06833,068331009,Tres Arroyos,BUENOS AIRES,374,410,566,545,1111
06,06833,068331501,Tres Arroyos,BUENOS AIRES,76,103,95,103,198
06,06833,068331506,Tres Arroyos,BUENOS AIRES,119,166,157,168,325
06,06833,068331909,Tres Arroyos,BUENOS AIRES,300,334,499,511,1010
06,06833,068330304,Tres Arroyos,BUENOS AIRES,4,18,6,7,13
06,06833,068331404,Tres Arroyos,BUENOS AIRES,5,10,6,8,14
06,06833,068331105,Tres Arroyos,BUENOS AIRES,4,23,0,4,4
06,06833,068331502,Tres Arroyos,BUENOS AIRES,15,27,18,29,47
06,06833,068331504,Tres Arroyos,BUENOS AIRES,12,28,17,20,37
06,06833,068330102,Tres Arroyos,BUENOS AIRES,327,392,426,392,818
06,06833,068330114,Tres Arroyos,BUENOS AIRES,395,478,533,444,977
06,06833,068330201,Tres Arroyos,BUENOS AIRES,291,365,382,339,721
06,06833,068330202,Tres Arroyos,BUENOS AIRES,378,424,547,478,1025
06,06833,068330203,Tres Arroyos,BUENOS AIRES,339,399,436,386,822
06,06833,068330212,Tres Arroyos,BUENOS AIRES,381,487,518,474,992
06,06833,068331005,Tres Arroyos,BUENOS AIRES,420,486,603,612,1215
06,06833,068331303,Tres Arroyos,BUENOS AIRES,40,276,41,57,98
06,06833,068331704,Tres Arroyos,BUENOS AIRES,33,287,38,39,77
06,06833,068330301,Tres Arroyos,BUENOS AIRES,1,6,1,1,2
06,06833,068330503,Tres Arroyos,BUENOS AIRES,5,19,7,9,16
06,06833,068330803,Tres Arroyos,BUENOS AIRES,7,28,8,13,21
06,06833,068331407,Tres Arroyos,BUENOS AIRES,7,11,5,9,14
06,06833,068331203,Tres Arroyos,BUENOS AIRES,6,17,7,7,14
06,06833,068331706,Tres Arroyos,BUENOS AIRES,12,34,7,15,22
06,06833,068331915,Tres Arroyos,BUENOS AIRES,50,67,89,85,174
06,06833,068331601,Tres Arroyos,BUENOS AIRES,14,21,15,23,38
06,06833,068331001,Tres Arroyos,BUENOS AIRES,72,178,120,131,251
06,06833,068331803,Tres Arroyos,BUENOS AIRES,105,462,133,133,266
06,06833,068331805,Tres Arroyos,BUENOS AIRES,97,453,95,118,213
06,06833,068331811,Tres Arroyos,BUENOS AIRES,58,406,77,67,144
06,06833,068331913,Tres Arroyos,BUENOS AIRES,373,498,642,589,1231
06,06833,068331914,Tres Arroyos,BUENOS AIRES,110,116,248,220,468
06,06833,068330302,Tres Arroyos,BUENOS AIRES,6,13,6,9,15
06,06833,068330402,Tres Arroyos,BUENOS AIRES,22,44,21,26,47
06,06833,068330602,Tres Arroyos,BUENOS AIRES,3,8,3,3,6
06,06833,068330705,Tres Arroyos,BUENOS AIRES,21,50,25,38,63
06,06833,068331402,Tres Arroyos,BUENOS AIRES,34,51,48,56,104
06,06833,068331603,Tres Arroyos,BUENOS AIRES,6,14,5,9,14
06,06833,068331902,Tres Arroyos,BUENOS AIRES,73,116,120,126,246
06,06833,068330501,Tres Arroyos,BUENOS AIRES,7,19,11,10,21
06,06833,068331406,Tres Arroyos,BUENOS AIRES,0,3,0,0,0
06,06602,066020308,Patagones,BUENOS AIRES,437,478,705,692,1397
06,06602,066020806,Patagones,BUENOS AIRES,15,37,22,18,40
06,06602,066021108,Patagones,BUENOS AIRES,429,482,680,604,1284
06,06602,066021110,Patagones,BUENOS AIRES,10,10,7,12,19
06,06602,066021604,Patagones,BUENOS AIRES,229,277,386,365,751
06,06602,066021606,Patagones,BUENOS AIRES,300,321,446,397,843
06,06602,066021607,Patagones,BUENOS AIRES,279,298,366,334,700
06,06602,066020304,Patagones,BUENOS AIRES,179,327,319,327,646
06,06602,066021107,Patagones,BUENOS AIRES,261,291,425,353,778
06,06602,066021109,Patagones,BUENOS AIRES,437,471,727,615,1342
06,06602,066020701,Patagones,BUENOS AIRES,10,69,2,13,15
06,06602,066020302,Patagones,BUENOS AIRES,207,215,312,368,680
06,06602,066020803,Patagones,BUENOS AIRES,117,152,153,129,282
06,06602,066021603,Patagones,BUENOS AIRES,411,462,762,760,1522
06,06602,066021403,Patagones,BUENOS AIRES,50,161,61,87,148
06,06602,066020307,Patagones,BUENOS AIRES,8,14,6,13,19
06,06602,066020501,Patagones,BUENOS AIRES,11,21,2,17,19
06,06602,066020203,Patagones,BUENOS AIRES,73,121,88,132,220
06,06602,066020305,Patagones,BUENOS AIRES,12,57,7,17,24
06,06602,066021201,Patagones,BUENOS AIRES,43,84,36,70,106
06,06602,066021301,Patagones,BUENOS AIRES,69,158,46,97,143
06,06602,066020201,Patagones,BUENOS AIRES,152,233,258,263,521
06,06602,066021406,Patagones,BUENOS AIRES,44,120,70,68,138
06,06602,066021608,Patagones,BUENOS AIRES,255,301,327,244,571
06,06602,066021610,Patagones,BUENOS AIRES,314,367,450,387,837
06,06602,066020205,Patagones,BUENOS AIRES,38,68,38,65,103
06,06602,066020903,Patagones,BUENOS AIRES,11,39,7,15,22
06,06602,066021106,Patagones,BUENOS AIRES,247,291,425,379,804
06,06602,066021113,Patagones,BUENOS AIRES,289,341,437,418,855
06,06602,066021601,Patagones,BUENOS AIRES,196,328,379,391,770
06,06602,066021609,Patagones,BUENOS AIRES,334,366,532,525,1057
06,06602,066021001,Patagones,BUENOS AIRES,13,47,5,13,18
06,06602,066021401,Patagones,BUENOS AIRES,38,114,34,57,91
06,06602,066021501,Patagones,BUENOS AIRES,1,3,0,1,1
06,06602,066020206,Patagones,BUENOS AIRES,19,34,15,26,41
06,06602,066020207,Patagones,BUENOS AIRES,34,69,24,60,84
06,06602,066020301,Patagones,BUENOS AIRES,420,449,618,649,1267
06,06602,066021101,Patagones,BUENOS AIRES,298,312,596,570,1166
06,06602,066020802,Patagones,BUENOS AIRES,265,318,348,357,705
06,06602,066020804,Patagones,BUENOS AIRES,125,154,163,157,320
06,06602,066021611,Patagones,BUENOS AIRES,234,266,421,411,832
06,06602,066021111,Patagones,BUENOS AIRES,355,438,512,400,912
06,06602,066021112,Patagones,BUENOS AIRES,279,364,399,358,757
06,06602,066020101,Patagones,BUENOS AIRES,99,111,38,125,163
06,06602,066020204,Patagones,BUENOS AIRES,23,30,15,30,45
06,06602,066020805,Patagones,BUENOS AIRES,97,239,83,152,235
06,06602,066020309,Patagones,BUENOS AIRES,248,282,383,365,748
06,06602,066020901,Patagones,BUENOS AIRES,34,67,42,47,89
06,06602,066021103,Patagones,BUENOS AIRES,378,418,581,591,1172
06,06602,066021105,Patagones,BUENOS AIRES,224,267,320,236,556
06,06602,066021602,Patagones,BUENOS AIRES,175,197,294,302,596
06,06602,066021405,Patagones,BUENOS AIRES,43,143,61,65,126
06,06602,066021605,Patagones,BUENOS AIRES,281,289,391,379,770
06,06602,066021612,Patagones,BUENOS AIRES,16,23,14,21,35
06,06602,066020202,Patagones,BUENOS AIRES,52,79,79,84,163
06,06602,066020306,Patagones,BUENOS AIRES,32,68,25,48,73
06,06602,066020601,Patagones,BUENOS AIRES,12,44,2,18,20
06,06602,066020902,Patagones,BUENOS AIRES,28,89,14,32,46
06,06602,066021002,Patagones,BUENOS AIRES,6,16,4,7,11
06,06602,066020801,Patagones,BUENOS AIRES,240,293,309,336,645
06,06602,066021102,Patagones,BUENOS AIRES,207,290,339,355,694
06,06602,066021104,Patagones,BUENOS AIRES,325,329,490,420,910
06,06602,066021402,Patagones,BUENOS AIRES,40,147,41,53,94
06,06602,066021404,Patagones,BUENOS AIRES,41,195,49,56,105
06,06602,066020303,Patagones,BUENOS AIRES,14,18,9,17,26
06,06602,066020401,Patagones,BUENOS AIRES,20,72,8,27,35
06,06609,066090101,Pehuajó,BUENOS AIRES,408,407,708,694,1402
06,06609,066090203,Pehuajó,BUENOS AIRES,204,270,261,207,468
06,06609,066090205,Pehuajó,BUENOS AIRES,329,391,452,374,826
06,06609,066090213,Pehuajó,BUENOS AIRES,433,458,700,696,1396
06,06609,066090401,Pehuajó,BUENOS AIRES,90,120,149,133,282
06,06609,066090613,Pehuajó,BUENOS AIRES,71,200,102,109,211
06,06609,066091101,Pehuajó,BUENOS AIRES,13,15,21,28,49
06,06609,066091005,Pehuajó,BUENOS AIRES,29,50,30,45,75
06,06609,066090106,Pehuajó,BUENOS AIRES,217,259,315,285,600
06,06609,066090902,Pehuajó,BUENOS AIRES,242,289,334,320,654
06,06609,066091501,Pehuajó,BUENOS AIRES,73,125,93,102,195
06,06609,066091909,Pehuajó,BUENOS AIRES,255,279,461,403,864
06,06609,066090301,Pehuajó,BUENOS AIRES,5,23,3,12,15
06,06609,066090602,Pehuajó,BUENOS AIRES,6,21,4,7,11
06,06609,066091604,Pehuajó,BUENOS AIRES,0,1,0,0,0
06,06609,066091708,Pehuajó,BUENOS AIRES,13,27,22,21,43
06,06609,066090608,Pehuajó,BUENOS AIRES,80,97,112,98,210
06,06609,066090207,Pehuajó,BUENOS AIRES,209,234,341,288,629
06,06609,066090104,Pehuajó,BUENOS AIRES,272,348,410,300,710
06,06609,066090607,Pehuajó,BUENOS AIRES,87,188,115,141,256
06,06609,066091001,Pehuajó,BUENOS AIRES,178,230,278,274,552
06,06609,066091002,Pehuajó,BUENOS AIRES,138,168,207,176,383
06,06609,066091702,Pehuajó,BUENOS AIRES,284,340,431,413,844
06,06609,066091906,Pehuajó,BUENOS AIRES,338,437,461,372,833
06,06609,066090501,Pehuajó,BUENOS AIRES,10,21,10,24,34
06,06609,066091003,Pehuajó,BUENOS AIRES,10,28,7,14,21
06,06609,066091709,Pehuajó,BUENOS AIRES,8,21,11,14,25
06,06609,066090802,Pehuajó,BUENOS AIRES,3,17,5,4,9
06,06609,066090803,Pehuajó,BUENOS AIRES,1,15,1,1,2
06,06609,066091202,Pehuajó,BUENOS AIRES,15,23,23,28,51
06,06609,066091303,Pehuajó,BUENOS AIRES,4,15,4,7,11
06,06609,066091502,Pehuajó,BUENOS AIRES,7,10,8,15,23
06,06609,066090210,Pehuajó,BUENOS AIRES,255,311,335,294,629
06,06609,066090103,Pehuajó,BUENOS AIRES,330,395,479,408,887
06,06609,066090105,Pehuajó,BUENOS AIRES,285,404,380,288,668
06,06609,066090211,Pehuajó,BUENOS AIRES,339,394,539,473,1012
06,06609,066091701,Pehuajó,BUENOS AIRES,325,381,434,410,844
06,06609,066091707,Pehuajó,BUENOS AIRES,23,31,40,36,76
06,06609,066091907,Pehuajó,BUENOS AIRES,372,395,518,493,1011
06,06609,066091801,Pehuajó,BUENOS AIRES,12,22,23,19,42
06,06609,066090302,Pehuajó,BUENOS AIRES,4,18,4,6,10
06,06609,066090402,Pehuajó,BUENOS AIRES,10,18,20,19,39
06,06609,066090611,Pehuajó,BUENOS AIRES,15,31,18,23,41
06,06609,066090612,Pehuajó,BUENOS AIRES,2,11,2,2,4
06,06609,066090702,Pehuajó,BUENOS AIRES,4,15,7,6,13
06,06609,066090901,Pehuajó,BUENOS AIRES,24,57,31,31,62
06,06609,066090906,Pehuajó,BUENOS AIRES,17,35,14,24,38
06,06609,066091401,Pehuajó,BUENOS AIRES,13,17,16,22,38
06,06609,066091704,Pehuajó,BUENOS AIRES,13,26,21,17,38
06,06609,066090404,Pehuajó,BUENOS AIRES,44,85,53,70,123
06,06609,066090601,Pehuajó,BUENOS AIRES,28,36,39,53,92
06,06609,066090610,Pehuajó,BUENOS AIRES,58,57,110,114,224
06,06609,066090904,Pehuajó,BUENOS AIRES,178,218,256,228,484
06,06609,066091007,Pehuajó,BUENOS AIRES,140,172,225,229,454
06,06609,066091904,Pehuajó,BUENOS AIRES,251,315,346,286,632
06,06609,066091908,Pehuajó,BUENOS AIRES,391,439,605,603,1208
06,06609,066090604,Pehuajó,BUENOS AIRES,6,13,5,6,11
06,06609,066090701,Pehuajó,BUENOS AIRES,4,11,5,7,12
06,06609,066090804,Pehuajó,BUENOS AIRES,5,8,7,6,13
06,06609,066091102,Pehuajó,BUENOS AIRES,18,24,24,35,59
06,06609,066091302,Pehuajó,BUENOS AIRES,11,33,14,19,33
06,06609,066091402,Pehuajó,BUENOS AIRES,20,36,24,30,54
06,06609,066091304,Pehuajó,BUENOS AIRES,25,39,37,42,79
06,06609,066090304,Pehuajó,BUENOS AIRES,15,22,16,34,50
06,06609,066090603,Pehuajó,BUENOS AIRES,14,36,7,20,27
06,06609,066090801,Pehuajó,BUENOS AIRES,2,10,2,6,8
06,06609,066091503,Pehuajó,BUENOS AIRES,3,23,2,5,7
06,06609,066091602,Pehuajó,BUENOS AIRES,10,21,17,22,39
06,06609,066091703,Pehuajó,BUENOS AIRES,26,45,26,40,66
06,06609,066090209,Pehuajó,BUENOS AIRES,405,443,576,494,1070
06,06609,066090110,Pehuajó,BUENOS AIRES,322,345,556,488,1044
06,06609,066090202,Pehuajó,BUENOS AIRES,274,381,362,294,656
06,06609,066090212,Pehuajó,BUENOS AIRES,318,353,522,498,1020
06,06609,066090215,Pehuajó,BUENOS AIRES,218,254,349,335,684
06,06609,066090905,Pehuajó,BUENOS AIRES,152,190,223,222,445
06,06609,066091301,Pehuajó,BUENOS AIRES,74,103,107,99,206
06,06609,066091905,Pehuajó,BUENOS AIRES,203,256,256,236,492
06,06609,066090605,Pehuajó,BUENOS AIRES,24,46,17,35,52
06,06609,066091305,Pehuajó,BUENOS AIRES,9,16,11,21,32
06,06609,066090703,Pehuajó,BUENOS AIRES,6,12,6,7,13
06,06609,066091705,Pehuajó,BUENOS AIRES,2,7,4,3,7
06,06609,066091706,Pehuajó,BUENOS AIRES,5,8,5,9,14
06,06609,066091802,Pehuajó,BUENOS AIRES,3,24,1,3,4
06,06609,066090206,Pehuajó,BUENOS AIRES,418,484,651,636,1287
06,06609,066090903,Pehuajó,BUENOS AIRES,219,274,298,295,593
06,06609,066090502,Pehuajó,BUENOS AIRES,29,41,48,64,112
06,06609,066090503,Pehuajó,BUENOS AIRES,37,56,40,69,109
06,06609,066090606,Pehuajó,BUENOS AIRES,25,54,42,41,83
06,06609,066091306,Pehuajó,BUENOS AIRES,24,49,29,33,62
06,06609,066091601,Pehuajó,BUENOS AIRES,7,23,6,14,20
06,06609,066091603,Pehuajó,BUENOS AIRES,16,37,18,27,45
06,06609,066090705,Pehuajó,BUENOS AIRES,22,39,32,36,68
06,06609,066090208,Pehuajó,BUENOS AIRES,450,496,684,676,1360
06,06609,066090102,Pehuajó,BUENOS AIRES,402,434,604,529,1133
06,06609,066090107,Pehuajó,BUENOS AIRES,321,334,489,457,946
06,06609,066090108,Pehuajó,BUENOS AIRES,215,239,332,334,666
06,06609,066090109,Pehuajó,BUENOS AIRES,297,325,496,526,1022
06,06609,066090201,Pehuajó,BUENOS AIRES,347,419,442,425,867
06,06609,066090204,Pehuajó,BUENOS AIRES,272,342,368,282,650
06,06609,066090214,Pehuajó,BUENOS AIRES,257,289,391,396,787
06,06609,066091901,Pehuajó,BUENOS AIRES,425,463,832,782,1614
06,06609,066091902,Pehuajó,BUENOS AIRES,210,240,307,283,590
06,06609,066091903,Pehuajó,BUENOS AIRES,402,463,548,468,1016
06,06609,066090303,Pehuajó,BUENOS AIRES,5,17,7,12,19
06,06609,066090403,Pehuajó,BUENOS AIRES,14,31,15,18,33
06,06609,066090609,Pehuajó,BUENOS AIRES,17,41,33,30,63
06,06609,066090704,Pehuajó,BUENOS AIRES,5,8,3,7,10
06,06609,066091004,Pehuajó,BUENOS AIRES,11,25,11,16,27
06,06609,066091006,Pehuajó,BUENOS AIRES,5,14,6,5,11
06,06609,066091201,Pehuajó,BUENOS AIRES,14,35,15,18,33
06,06616,066160301,Pellegrini,BUENOS AIRES,230,253,339,355,694
06,06616,066160305,Pellegrini,BUENOS AIRES,227,277,378,333,711
06,06616,066160106,Pellegrini,BUENOS AIRES,1,5,1,2,3
06,06616,066160110,Pellegrini,BUENOS AIRES,28,44,37,41,78
06,06616,066160302,Pellegrini,BUENOS AIRES,289,326,414,417,831
06,06616,066160303,Pellegrini,BUENOS AIRES,256,277,359,328,687
06,06616,066160107,Pellegrini,BUENOS AIRES,40,82,60,67,127
06,06616,066160201,Pellegrini,BUENOS AIRES,10,30,13,11,24
06,06616,066160202,Pellegrini,BUENOS AIRES,8,14,7,10,17
06,06616,066160104,Pellegrini,BUENOS AIRES,64,71,50,89,139
06,06616,066160102,Pellegrini,BUENOS AIRES,24,40,31,42,73
06,06616,066160105,Pellegrini,BUENOS AIRES,26,37,34,39,73
06,06616,066160103,Pellegrini,BUENOS AIRES,33,44,41,55,96
06,06616,066160108,Pellegrini,BUENOS AIRES,19,40,17,30,47
06,06616,066160306,Pellegrini,BUENOS AIRES,175,222,237,198,435
06,06616,066160309,Pellegrini,BUENOS AIRES,150,177,191,202,393
06,06616,066160308,Pellegrini,BUENOS AIRES,42,66,58,63,121
06,06616,066160101,Pellegrini,BUENOS AIRES,25,31,32,30,62
06,06616,066160304,Pellegrini,BUENOS AIRES,254,266,403,358,761
06,06616,066160307,Pellegrini,BUENOS AIRES,188,216,259,227,486
06,06616,066160109,Pellegrini,BUENOS AIRES,11,27,10,19,29
06,06623,066230103,Pergamino,BUENOS AIRES,400,442,618,528,1146
06,06623,066232103,Pergamino,BUENOS AIRES,5,6,7,10,17
06,06623,066232203,Pergamino,BUENOS AIRES,261,282,392,311,703
06,06623,066230101,Pergamino,BUENOS AIRES,257,272,428,411,839
06,06623,066230201,Pergamino,BUENOS AIRES,258,284,369,326,695
06,06623,066230203,Pergamino,BUENOS AIRES,309,391,434,344,778
06,06623,066230301,Pergamino,BUENOS AIRES,184,238,267,233,500
06,06623,066230403,Pergamino,BUENOS AIRES,301,346,461,333,794
06,06623,066230507,Pergamino,BUENOS AIRES,393,387,725,563,1288
06,06623,066230801,Pergamino,BUENOS AIRES,58,100,86,82,168
06,06623,066231802,Pergamino,BUENOS AIRES,125,138,207,187,394
06,06623,066232003,Pergamino,BUENOS AIRES,299,317,479,472,951
06,06623,066232006,Pergamino,BUENOS AIRES,258,272,489,481,970
06,06623,066232009,Pergamino,BUENOS AIRES,364,369,629,612,1241
06,06623,066232012,Pergamino,BUENOS AIRES,158,172,277,286,563
06,06623,066232506,Pergamino,BUENOS AIRES,102,139,156,181,337
06,06623,066232805,Pergamino,BUENOS AIRES,341,381,497,400,897
06,06623,066232809,Pergamino,BUENOS AIRES,371,393,626,558,1184
06,06623,066232812,Pergamino,BUENOS AIRES,379,414,619,592,1211
06,06623,066232813,Pergamino,BUENOS AIRES,449,459,813,737,1550
06,06623,066232906,Pergamino,BUENOS AIRES,337,344,564,553,1117
06,06623,066231202,Pergamino,BUENOS AIRES,9,34,9,13,22
06,06623,066231702,Pergamino,BUENOS AIRES,6,24,6,10,16
06,06623,066231703,Pergamino,BUENOS AIRES,12,22,11,18,29
06,06623,066231901,Pergamino,BUENOS AIRES,6,17,8,9,17
06,06623,066232403,Pergamino,BUENOS AIRES,16,26,26,25,51
06,06623,066232102,Pergamino,BUENOS AIRES,82,202,117,143,260
06,06623,066232208,Pergamino,BUENOS AIRES,390,384,695,544,1239
06,06623,066232903,Pergamino,BUENOS AIRES,292,310,564,578,1142
06,06623,066232908,Pergamino,BUENOS AIRES,198,152,430,424,854
06,06623,066230112,Pergamino,BUENOS AIRES,242,261,376,331,707
06,06623,066230208,Pergamino,BUENOS AIRES,291,313,371,319,690
06,06623,066230304,Pergamino,BUENOS AIRES,215,275,299,168,467
06,06623,066230306,Pergamino,BUENOS AIRES,287,428,378,254,632
06,06623,066230410,Pergamino,BUENOS AIRES,282,293,480,419,899
06,06623,066230508,Pergamino,BUENOS AIRES,327,332,584,446,1030
06,06623,066231501,Pergamino,BUENOS AIRES,79,96,101,110,211
06,06623,066232007,Pergamino,BUENOS AIRES,446,458,708,635,1343
06,06623,066232011,Pergamino,BUENOS AIRES,538,551,1025,999,2024
06,06623,066232104,Pergamino,BUENOS AIRES,239,305,430,404,834
06,06623,066232201,Pergamino,BUENOS AIRES,267,286,412,324,736
06,06623,066232206,Pergamino,BUENOS AIRES,298,308,483,376,859
06,06623,066232701,Pergamino,BUENOS AIRES,143,199,201,192,393
06,06623,066232802,Pergamino,BUENOS AIRES,378,419,622,644,1266
06,06623,066232804,Pergamino,BUENOS AIRES,330,344,511,418,929
06,06623,066230702,Pergamino,BUENOS AIRES,219,245,312,311,623
06,06623,066230704,Pergamino,BUENOS AIRES,16,37,27,25,52
06,06623,066230901,Pergamino,BUENOS AIRES,20,28,24,38,62
06,06623,066231603,Pergamino,BUENOS AIRES,15,25,18,24,42
06,06623,066232302,Pergamino,BUENOS AIRES,12,21,20,19,39
06,06623,066230102,Pergamino,BUENOS AIRES,379,403,569,496,1065
06,06623,066230108,Pergamino,BUENOS AIRES,389,420,554,533,1087
06,06623,066230109,Pergamino,BUENOS AIRES,282,288,426,400,826
06,06623,066230204,Pergamino,BUENOS AIRES,313,402,435,320,755
06,06623,066230305,Pergamino,BUENOS AIRES,255,344,394,282,676
06,06623,066230402,Pergamino,BUENOS AIRES,320,380,453,355,808
06,06623,066231104,Pergamino,BUENOS AIRES,179,211,269,274,543
06,06623,066231803,Pergamino,BUENOS AIRES,215,253,303,296,599
06,06623,066232101,Pergamino,BUENOS AIRES,139,145,263,269,532
06,06623,066232204,Pergamino,BUENOS AIRES,294,300,493,383,876
06,06623,066232811,Pergamino,BUENOS AIRES,179,235,272,272,544
06,06623,066232904,Pergamino,BUENOS AIRES,184,184,307,316,623
06,06623,066232907,Pergamino,BUENOS AIRES,328,341,618,610,1228
06,06623,066232002,Pergamino,BUENOS AIRES,400,442,754,721,1475
06,06623,066232702,Pergamino,BUENOS AIRES,4,15,3,5,8
06,06623,066230705,Pergamino,BUENOS AIRES,9,23,8,14,22
06,06623,066231604,Pergamino,BUENOS AIRES,22,38,22,27,49
06,06623,066232106,Pergamino,BUENOS AIRES,71,77,138,138,276
06,06623,066232212,Pergamino,BUENOS AIRES,18,31,33,27,60
06,06623,066232704,Pergamino,BUENOS AIRES,9,26,12,11,23
06,06623,066232601,Pergamino,BUENOS AIRES,25,42,32,37,69
06,06623,066230106,Pergamino,BUENOS AIRES,365,419,531,449,980
06,06623,066230404,Pergamino,BUENOS AIRES,259,298,367,304,671
06,06623,066231402,Pergamino,BUENOS AIRES,258,291,410,371,781
06,06623,066232501,Pergamino,BUENOS AIRES,118,149,186,172,358
06,06623,066232901,Pergamino,BUENOS AIRES,378,392,668,675,1343
06,06623,066232910,Pergamino,BUENOS AIRES,250,236,529,488,1017
06,06623,066230504,Pergamino,BUENOS AIRES,322,327,540,418,958
06,06623,066232905,Pergamino,BUENOS AIRES,247,271,445,396,841
06,06623,066230601,Pergamino,BUENOS AIRES,4,25,5,4,9
06,06623,066230802,Pergamino,BUENOS AIRES,9,14,9,14,23
06,06623,066231403,Pergamino,BUENOS AIRES,25,51,35,40,75
06,06623,066231503,Pergamino,BUENOS AIRES,13,25,18,24,42
06,06623,066232105,Pergamino,BUENOS AIRES,22,25,33,31,64
06,06623,066232001,Pergamino,BUENOS AIRES,227,367,317,408,725
06,06623,066232209,Pergamino,BUENOS AIRES,83,97,142,109,251
06,06623,066232504,Pergamino,BUENOS AIRES,76,98,119,117,236
06,06623,066230104,Pergamino,BUENOS AIRES,364,424,515,454,969
06,06623,066230202,Pergamino,BUENOS AIRES,247,320,384,287,671
06,06623,066230307,Pergamino,BUENOS AIRES,257,372,328,204,532
06,06623,066230405,Pergamino,BUENOS AIRES,332,360,502,429,931
06,06623,066230406,Pergamino,BUENOS AIRES,404,429,613,517,1130
06,06623,066230409,Pergamino,BUENOS AIRES,302,325,544,519,1063
06,06623,066230506,Pergamino,BUENOS AIRES,405,427,686,545,1231
06,06623,066230903,Pergamino,BUENOS AIRES,95,105,149,137,286
06,06623,066232005,Pergamino,BUENOS AIRES,294,297,596,555,1151
06,06623,066232010,Pergamino,BUENOS AIRES,258,274,453,448,901
06,06623,066232207,Pergamino,BUENOS AIRES,328,353,535,438,973
06,06623,066232807,Pergamino,BUENOS AIRES,345,357,572,504,1076
06,06623,066232808,Pergamino,BUENOS AIRES,363,376,635,636,1271
06,06623,066232909,Pergamino,BUENOS AIRES,274,256,437,470,907
06,06623,066232911,Pergamino,BUENOS AIRES,230,249,416,419,835
06,06623,066232806,Pergamino,BUENOS AIRES,424,444,647,562,1209
06,06623,066230602,Pergamino,BUENOS AIRES,10,33,13,17,30
06,06623,066230603,Pergamino,BUENOS AIRES,0,14,0,0,0
06,06623,066231201,Pergamino,BUENOS AIRES,12,24,15,16,31
06,06623,066231502,Pergamino,BUENOS AIRES,16,26,23,22,45
06,06623,066231801,Pergamino,BUENOS AIRES,18,33,20,31,51
06,06623,066232211,Pergamino,BUENOS AIRES,10,13,17,14,31
06,06623,066232505,Pergamino,BUENOS AIRES,13,17,14,21,35
06,06623,066230110,Pergamino,BUENOS AIRES,169,166,292,296,588
06,06623,066230111,Pergamino,BUENOS AIRES,250,272,396,317,713
06,06623,066230206,Pergamino,BUENOS AIRES,295,375,401,332,733
06,06623,066230207,Pergamino,BUENOS AIRES,269,321,394,337,731
06,06623,066230303,Pergamino,BUENOS AIRES,240,317,303,249,552
06,06623,066230310,Pergamino,BUENOS AIRES,291,393,362,293,655
06,06623,066230401,Pergamino,BUENOS AIRES,345,411,457,384,841
06,06623,066230408,Pergamino,BUENOS AIRES,392,437,622,553,1175
06,06623,066231601,Pergamino,BUENOS AIRES,129,159,204,208,412
06,06623,066232810,Pergamino,BUENOS AIRES,268,314,411,367,778
06,06623,066232902,Pergamino,BUENOS AIRES,402,414,671,652,1323
06,06623,066232004,Pergamino,BUENOS AIRES,106,131,203,208,411
06,06623,066232404,Pergamino,BUENOS AIRES,8,10,14,9,23
06,06623,066230703,Pergamino,BUENOS AIRES,22,57,32,48,80
06,06623,066230803,Pergamino,BUENOS AIRES,10,12,11,11,22
06,06623,066230904,Pergamino,BUENOS AIRES,28,45,50,48,98
06,06623,066231101,Pergamino,BUENOS AIRES,21,34,29,27,56
06,06623,066231301,Pergamino,BUENOS AIRES,3,8,3,4,7
06,06623,066231302,Pergamino,BUENOS AIRES,8,11,14,11,25
06,06623,066231602,Pergamino,BUENOS AIRES,15,24,18,21,39
06,06623,066231804,Pergamino,BUENOS AIRES,15,28,21,22,43
06,06623,066231902,Pergamino,BUENOS AIRES,20,31,24,29,53
06,06623,066230105,Pergamino,BUENOS AIRES,331,384,518,412,930
06,06623,066230209,Pergamino,BUENOS AIRES,326,367,460,404,864
06,06623,066230308,Pergamino,BUENOS AIRES,236,317,331,234,565
06,06623,066230309,Pergamino,BUENOS AIRES,223,306,328,248,576
06,06623,066230501,Pergamino,BUENOS AIRES,337,363,521,404,925
06,06623,066230502,Pergamino,BUENOS AIRES,254,277,400,310,710
06,06623,066230505,Pergamino,BUENOS AIRES,423,433,682,534,1216
06,06623,066230509,Pergamino,BUENOS AIRES,270,288,452,357,809
06,06623,066230510,Pergamino,BUENOS AIRES,370,402,580,452,1032
06,06623,066230902,Pergamino,BUENOS AIRES,170,183,248,240,488
06,06623,066231401,Pergamino,BUENOS AIRES,277,315,381,337,718
06,06623,066231605,Pergamino,BUENOS AIRES,230,256,343,323,666
06,06623,066232202,Pergamino,BUENOS AIRES,245,263,384,304,688
06,06623,066232214,Pergamino,BUENOS AIRES,56,71,92,77,169
06,06623,066232301,Pergamino,BUENOS AIRES,181,227,279,238,517
06,06623,066232304,Pergamino,BUENOS AIRES,119,181,183,182,365
06,06623,066232801,Pergamino,BUENOS AIRES,432,418,849,816,1665
06,06623,066231001,Pergamino,BUENOS AIRES,7,19,7,9,16
06,06623,066231404,Pergamino,BUENOS AIRES,65,77,99,93,192
06,06623,066231701,Pergamino,BUENOS AIRES,19,39,23,36,59
06,06623,066232401,Pergamino,BUENOS AIRES,20,33,21,29,50
06,06623,066232502,Pergamino,BUENOS AIRES,17,30,21,28,49
06,06623,066232503,Pergamino,BUENOS AIRES,11,21,13,16,29
06,06623,066231102,Pergamino,BUENOS AIRES,29,36,49,39,88
06,06623,066232210,Pergamino,BUENOS AIRES,170,186,307,237,544
06,06623,066230107,Pergamino,BUENOS AIRES,354,386,506,477,983
06,06623,066230302,Pergamino,BUENOS AIRES,383,419,601,526,1127
06,06623,066230311,Pergamino,BUENOS AIRES,231,270,316,310,626
06,06623,066230407,Pergamino,BUENOS AIRES,332,363,449,393,842
06,06623,066230503,Pergamino,BUENOS AIRES,343,358,544,424,968
06,06623,066230701,Pergamino,BUENOS AIRES,180,224,257,264,521
06,06623,066231103,Pergamino,BUENOS AIRES,159,180,246,220,466
06,06623,066232008,Pergamino,BUENOS AIRES,396,434,601,522,1123
06,06623,066232107,Pergamino,BUENOS AIRES,142,162,253,255,508
06,06623,066232205,Pergamino,BUENOS AIRES,321,337,504,396,900
06,06623,066232213,Pergamino,BUENOS AIRES,201,216,326,264,590
06,06623,066232306,Pergamino,BUENOS AIRES,160,182,242,217,459
06,06623,066232803,Pergamino,BUENOS AIRES,174,213,300,258,558
06,06623,066230205,Pergamino,BUENOS AIRES,232,314,313,257,570
06,06623,066231002,Pergamino,BUENOS AIRES,15,28,18,24,42
06,06623,066231003,Pergamino,BUENOS AIRES,6,18,6,11,17
06,06623,066232303,Pergamino,BUENOS AIRES,13,16,17,70,87
06,06623,066232305,Pergamino,BUENOS AIRES,25,67,41,47,88
06,06623,066232402,Pergamino,BUENOS AIRES,6,19,5,10,15
06,06623,066232602,Pergamino,BUENOS AIRES,26,35,36,45,81
06,06623,066232703,Pergamino,BUENOS AIRES,10,28,22,21,43
06,06568,065681303,Morón,BUENOS AIRES,272,323,404,351,755
06,06568,065681309,Morón,BUENOS AIRES,372,388,586,548,1134
06,06568,065681607,Morón,BUENOS AIRES,254,264,390,334,724
06,06568,065681608,Morón,BUENOS AIRES,228,237,338,288,626
06,06568,065681703,Morón,BUENOS AIRES,251,250,411,380,791
06,06568,065681801,Morón,BUENOS AIRES,229,309,289,238,527
06,06568,065682010,Morón,BUENOS AIRES,305,359,497,387,884
06,06568,065682102,Morón,BUENOS AIRES,147,303,163,159,322
06,06568,065682103,Morón,BUENOS AIRES,150,228,168,153,321
06,06568,065682108,Morón,BUENOS AIRES,134,285,156,121,277
06,06568,065682206,Morón,BUENOS AIRES,240,291,337,328,665
06,06568,065682302,Morón,BUENOS AIRES,231,283,367,308,675
06,06568,065682408,Morón,BUENOS AIRES,399,419,708,591,1299
06,06568,065682501,Morón,BUENOS AIRES,177,183,268,235,503
06,06568,065682506,Morón,BUENOS AIRES,463,431,782,712,1494
06,06568,065682507,Morón,BUENOS AIRES,434,406,778,748,1526
06,06568,065682611,Morón,BUENOS AIRES,365,380,611,558,1169
06,06568,065682701,Morón,BUENOS AIRES,15,12,27,26,53
06,06568,065682706,Morón,BUENOS AIRES,292,313,506,477,983
06,06568,065682802,Morón,BUENOS AIRES,367,390,635,551,1186
06,06568,065682803,Morón,BUENOS AIRES,500,523,882,856,1738
06,06568,065682809,Morón,BUENOS AIRES,373,376,658,638,1296
06,06568,065682901,Morón,BUENOS AIRES,338,349,606,534,1140
06,06568,065683001,Morón,BUENOS AIRES,376,366,650,637,1287
06,06568,065683105,Morón,BUENOS AIRES,344,347,655,622,1277
06,06568,065683106,Morón,BUENOS AIRES,322,310,658,589,1247
06,06568,065683108,Morón,BUENOS AIRES,225,239,360,337,697
06,06568,065683109,Morón,BUENOS AIRES,328,323,585,563,1148
06,06568,065683112,Morón,BUENOS AIRES,384,326,691,649,1340
06,06568,065680208,Morón,BUENOS AIRES,351,367,599,504,1103
06,06568,065680201,Morón,BUENOS AIRES,299,363,400,518,918
06,06568,065680202,Morón,BUENOS AIRES,204,241,331,282,613
06,06568,065680304,Morón,BUENOS AIRES,259,248,437,407,844
06,06568,065680508,Morón,BUENOS AIRES,359,413,589,476,1065
06,06568,065680510,Morón,BUENOS AIRES,210,258,331,300,631
06,06568,065680701,Morón,BUENOS AIRES,310,364,475,388,863
06,06568,065681005,Morón,BUENOS AIRES,299,326,422,444,866
06,06568,065681009,Morón,BUENOS AIRES,309,348,495,424,919
06,06568,065681014,Morón,BUENOS AIRES,277,337,373,306,679
06,06568,065681108,Morón,BUENOS AIRES,343,378,523,471,994
06,06568,065681206,Morón,BUENOS AIRES,398,421,581,531,1112
06,06568,065681408,Morón,BUENOS AIRES,242,257,366,311,677
06,06568,065681501,Morón,BUENOS AIRES,272,284,415,376,791
06,06568,065681504,Morón,BUENOS AIRES,410,423,694,606,1300
06,06568,065681506,Morón,BUENOS AIRES,332,308,451,449,900
06,06568,065681509,Morón,BUENOS AIRES,220,229,327,267,594
06,06568,065681601,Morón,BUENOS AIRES,372,329,601,544,1145
06,06568,065681702,Morón,BUENOS AIRES,321,326,616,565,1181
06,06568,065681705,Morón,BUENOS AIRES,388,433,624,571,1195
06,06568,065681708,Morón,BUENOS AIRES,369,384,567,512,1079
06,06568,065681709,Morón,BUENOS AIRES,268,270,396,335,731
06,06568,065681901,Morón,BUENOS AIRES,255,264,379,339,718
06,06568,065681903,Morón,BUENOS AIRES,427,459,643,558,1201
06,06568,065682005,Morón,BUENOS AIRES,274,367,322,274,596
06,06568,065682012,Morón,BUENOS AIRES,333,356,596,515,1111
06,06568,065682104,Morón,BUENOS AIRES,266,382,287,244,531
06,06568,065682107,Morón,BUENOS AIRES,41,158,39,28,67
06,06568,065682109,Morón,BUENOS AIRES,167,417,185,178,363
06,06568,065682208,Morón,BUENOS AIRES,197,233,275,280,555
06,06568,065682212,Morón,BUENOS AIRES,172,227,252,244,496
06,06568,065682215,Morón,BUENOS AIRES,160,193,222,234,456
06,06568,065682301,Morón,BUENOS AIRES,201,211,368,337,705
06,06568,065682603,Morón,BUENOS AIRES,356,345,528,535,1063
06,06568,065682604,Morón,BUENOS AIRES,212,222,322,304,626
06,06568,065682605,Morón,BUENOS AIRES,175,184,268,237,505
06,06568,065682610,Morón,BUENOS AIRES,379,396,603,576,1179
06,06568,065682708,Morón,BUENOS AIRES,273,292,434,437,871
06,06568,065682810,Morón,BUENOS AIRES,398,399,737,708,1445
06,06568,065682912,Morón,BUENOS AIRES,352,304,640,652,1292
06,06568,065682913,Morón,BUENOS AIRES,280,266,537,537,1074
06,06568,065683006,Morón,BUENOS AIRES,289,303,499,464,963
06,06568,065683008,Morón,BUENOS AIRES,380,348,659,600,1259
06,06568,065680101,Morón,BUENOS AIRES,134,141,227,322,549
06,06568,065680210,Morón,BUENOS AIRES,230,250,358,316,674
06,06568,065680301,Morón,BUENOS AIRES,339,358,509,473,982
06,06568,065680403,Morón,BUENOS AIRES,231,259,372,295,667
06,06568,065680405,Morón,BUENOS AIRES,341,376,499,456,955
06,06568,065680504,Morón,BUENOS AIRES,229,254,348,299,647
06,06568,065680605,Morón,BUENOS AIRES,316,370,447,417,864
06,06568,065680610,Morón,BUENOS AIRES,227,304,243,236,479
06,06568,065680702,Morón,BUENOS AIRES,302,331,455,407,862
06,06568,065680704,Morón,BUENOS AIRES,244,277,390,335,725
06,06568,065680802,Morón,BUENOS AIRES,327,351,486,468,954
06,06568,065680806,Morón,BUENOS AIRES,355,374,612,493,1105
06,06568,065680903,Morón,BUENOS AIRES,408,432,618,566,1184
06,06568,065680904,Morón,BUENOS AIRES,233,245,371,318,689
06,06568,065681008,Morón,BUENOS AIRES,339,353,558,498,1056
06,06568,065681202,Morón,BUENOS AIRES,334,400,462,435,897
06,06568,065681208,Morón,BUENOS AIRES,232,260,333,297,630
06,06568,065681305,Morón,BUENOS AIRES,330,370,481,423,904
06,06568,065680314,Morón,BUENOS AIRES,602,578,1529,1436,2965
06,06568,065680602,Morón,BUENOS AIRES,316,346,452,394,846
06,06568,065681409,Morón,BUENOS AIRES,348,443,448,427,875
06,06568,065681810,Morón,BUENOS AIRES,318,363,530,401,931
06,06568,065681603,Morón,BUENOS AIRES,267,232,434,390,824
06,06568,065681610,Morón,BUENOS AIRES,374,395,559,528,1087
06,06568,065681701,Morón,BUENOS AIRES,346,372,627,556,1183
06,06568,065681814,Morón,BUENOS AIRES,223,257,337,292,629
06,06568,065681904,Morón,BUENOS AIRES,241,256,379,320,699
06,06568,065681910,Morón,BUENOS AIRES,222,250,342,309,651
06,06568,065682014,Morón,BUENOS AIRES,244,273,368,363,731
06,06568,065682105,Morón,BUENOS AIRES,142,317,154,128,282
06,06568,065682113,Morón,BUENOS AIRES,371,459,474,422,896
06,06568,065682210,Morón,BUENOS AIRES,188,196,251,260,511
06,06568,065682308,Morón,BUENOS AIRES,412,448,639,569,1208
06,06568,065682309,Morón,BUENOS AIRES,336,362,477,436,913
06,06568,065682310,Morón,BUENOS AIRES,254,257,403,338,741
06,06568,065682404,Morón,BUENOS AIRES,384,441,599,526,1125
06,06568,065682405,Morón,BUENOS AIRES,359,393,548,478,1026
06,06568,065682505,Morón,BUENOS AIRES,216,234,370,310,680
06,06568,065682601,Morón,BUENOS AIRES,233,226,363,286,649
06,06568,065682608,Morón,BUENOS AIRES,227,251,364,321,685
06,06568,065682703,Morón,BUENOS AIRES,305,313,543,563,1106
06,06568,065682801,Morón,BUENOS AIRES,445,480,783,666,1449
06,06568,065682805,Morón,BUENOS AIRES,445,416,800,747,1547
06,06568,065682904,Morón,BUENOS AIRES,287,268,539,488,1027
06,06568,065682910,Morón,BUENOS AIRES,281,279,569,544,1113
06,06568,065683110,Morón,BUENOS AIRES,296,262,533,520,1053
06,06568,065680207,Morón,BUENOS AIRES,338,357,522,453,975
06,06568,065680315,Morón,BUENOS AIRES,558,524,1076,1007,2083
06,06568,065680204,Morón,BUENOS AIRES,252,256,391,374,765
06,06568,065680306,Morón,BUENOS AIRES,254,238,398,360,758
06,06568,065680503,Morón,BUENOS AIRES,245,272,379,316,695
06,06568,065680505,Morón,BUENOS AIRES,369,437,569,473,1042
06,06568,065680604,Morón,BUENOS AIRES,334,396,447,425,872
06,06568,065680608,Morón,BUENOS AIRES,292,356,432,342,774
06,06568,065680803,Morón,BUENOS AIRES,241,259,445,419,864
06,06568,065680905,Morón,BUENOS AIRES,208,221,323,303,626
06,06568,065680906,Morón,BUENOS AIRES,277,307,409,365,774
06,06568,065680909,Morón,BUENOS AIRES,263,309,376,352,728
06,06568,065681004,Morón,BUENOS AIRES,298,329,451,414,865
06,06568,065681010,Morón,BUENOS AIRES,225,252,363,297,660
06,06568,065681011,Morón,BUENOS AIRES,224,252,323,306,629
06,06568,065681015,Morón,BUENOS AIRES,265,300,387,323,710
06,06568,065681102,Morón,BUENOS AIRES,368,383,548,506,1054
06,06568,065681107,Morón,BUENOS AIRES,277,323,441,404,845
06,06568,065681112,Morón,BUENOS AIRES,322,382,470,407,877
06,06568,065681304,Morón,BUENOS AIRES,330,380,450,417,867
06,06568,065681813,Morón,BUENOS AIRES,255,291,402,348,750
06,06568,065681402,Morón,BUENOS AIRES,304,361,490,375,865
06,06568,065681507,Morón,BUENOS AIRES,353,362,535,466,1001
06,06568,065681707,Morón,BUENOS AIRES,371,431,554,543,1097
06,06568,065681710,Morón,BUENOS AIRES,292,340,415,389,804
06,06568,065681802,Morón,BUENOS AIRES,166,302,177,136,313
06,06568,065681907,Morón,BUENOS AIRES,347,368,529,537,1066
06,06568,065682003,Morón,BUENOS AIRES,314,414,403,307,710
06,06568,065682013,Morón,BUENOS AIRES,261,281,405,342,747
06,06568,065682201,Morón,BUENOS AIRES,184,226,261,267,528
06,06568,065682203,Morón,BUENOS AIRES,141,204,204,196,400
06,06568,065682306,Morón,BUENOS AIRES,370,404,542,493,1035
06,06568,065682307,Morón,BUENOS AIRES,376,370,549,477,1026
06,06568,065682409,Morón,BUENOS AIRES,236,233,396,346,742
06,06568,065682504,Morón,BUENOS AIRES,403,423,641,582,1223
06,06568,065682710,Morón,BUENOS AIRES,278,300,445,405,850
06,06568,065682905,Morón,BUENOS AIRES,263,256,473,440,913
06,06568,065682906,Morón,BUENOS AIRES,273,277,451,461,912
06,06568,065682909,Morón,BUENOS AIRES,326,319,569,569,1138
06,06568,065683111,Morón,BUENOS AIRES,204,219,378,320,698
06,06568,065680102,Morón,BUENOS AIRES,268,293,523,533,1056
06,06568,065680211,Morón,BUENOS AIRES,356,403,565,479,1044
06,06568,065680303,Morón,BUENOS AIRES,353,390,524,496,1020
06,06568,065680313,Morón,BUENOS AIRES,423,456,659,632,1291
06,06568,065680404,Morón,BUENOS AIRES,288,307,433,380,813
06,06568,065680407,Morón,BUENOS AIRES,285,318,433,354,787
06,06568,065680506,Morón,BUENOS AIRES,321,387,443,400,843
06,06568,065680509,Morón,BUENOS AIRES,222,264,334,313,647
06,06568,065680611,Morón,BUENOS AIRES,162,235,191,174,365
06,06568,065680805,Morón,BUENOS AIRES,378,433,622,559,1181
06,06568,065680807,Morón,BUENOS AIRES,353,341,521,469,990
06,06568,065680911,Morón,BUENOS AIRES,224,264,317,298,615
06,06568,065681101,Morón,BUENOS AIRES,291,345,408,350,758
06,06568,065681103,Morón,BUENOS AIRES,241,282,359,313,672
06,06568,065681105,Morón,BUENOS AIRES,282,461,349,270,619
06,06568,065681106,Morón,BUENOS AIRES,276,308,420,390,810
06,06568,065681109,Morón,BUENOS AIRES,243,294,300,279,579
06,06568,065681306,Morón,BUENOS AIRES,380,443,588,548,1136
06,06568,065681307,Morón,BUENOS AIRES,435,488,660,576,1236
06,06568,065681308,Morón,BUENOS AIRES,368,386,591,505,1096
06,06568,065681704,Morón,BUENOS AIRES,234,219,356,305,661
06,06568,065681403,Morón,BUENOS AIRES,447,506,660,591,1251
06,06568,065681406,Morón,BUENOS AIRES,207,250,296,273,569
06,06568,065681510,Morón,BUENOS AIRES,305,328,458,420,878
06,06568,065681606,Morón,BUENOS AIRES,350,371,556,486,1042
06,06568,065681711,Morón,BUENOS AIRES,311,354,476,399,875
06,06568,065681803,Morón,BUENOS AIRES,178,271,231,191,422
06,06568,065682001,Morón,BUENOS AIRES,344,420,553,463,1016
06,06568,065682009,Morón,BUENOS AIRES,409,449,645,565,1210
06,06568,065682110,Morón,BUENOS AIRES,174,276,199,157,356
06,06568,065682112,Morón,BUENOS AIRES,246,382,247,227,474
06,06568,065682402,Morón,BUENOS AIRES,310,336,470,461,931
06,06568,065682509,Morón,BUENOS AIRES,316,302,587,555,1142
06,06568,065682512,Morón,BUENOS AIRES,403,411,678,633,1311
06,06568,065682606,Morón,BUENOS AIRES,218,220,336,315,651
06,06568,065682607,Morón,BUENOS AIRES,412,405,693,616,1309
06,06568,065682806,Morón,BUENOS AIRES,353,359,661,659,1320
06,06568,065682808,Morón,BUENOS AIRES,289,293,540,499,1039
06,06568,065682903,Morón,BUENOS AIRES,259,253,443,464,907
06,06568,065682914,Morón,BUENOS AIRES,262,263,527,516,1043
06,06568,065683003,Morón,BUENOS AIRES,441,442,777,686,1463
06,06568,065683004,Morón,BUENOS AIRES,457,456,783,725,1508
06,06568,065680305,Morón,BUENOS AIRES,244,219,400,374,774
06,06568,065680310,Morón,BUENOS AIRES,227,222,505,455,960
06,06568,065680311,Morón,BUENOS AIRES,395,378,648,566,1214
06,06568,065680406,Morón,BUENOS AIRES,186,214,292,260,552
06,06568,065680408,Morón,BUENOS AIRES,340,376,506,436,942
06,06568,065680410,Morón,BUENOS AIRES,295,342,438,393,831
06,06568,065680706,Morón,BUENOS AIRES,367,416,572,529,1101
06,06568,065680901,Morón,BUENOS AIRES,194,207,309,260,569
06,06568,065681001,Morón,BUENOS AIRES,335,353,558,488,1046
06,06568,065681007,Morón,BUENOS AIRES,204,221,312,294,606
06,06568,065681012,Morón,BUENOS AIRES,339,364,494,447,941
06,06568,065681017,Morón,BUENOS AIRES,266,240,435,428,863
06,06568,065681104,Morón,BUENOS AIRES,192,281,265,224,489
06,06568,065681203,Morón,BUENOS AIRES,327,372,481,442,923
06,06568,065681301,Morón,BUENOS AIRES,221,269,307,300,607
06,06568,065681508,Morón,BUENOS AIRES,416,455,609,561,1170
06,06568,065682305,Morón,BUENOS AIRES,224,271,301,243,544
06,06568,065681404,Morón,BUENOS AIRES,262,324,300,290,590
06,06568,065681407,Morón,BUENOS AIRES,328,453,439,417,856
06,06568,065681503,Morón,BUENOS AIRES,334,361,450,415,865
06,06568,065681609,Morón,BUENOS AIRES,423,434,642,615,1257
06,06568,065681612,Morón,BUENOS AIRES,388,401,564,469,1033
06,06568,065681804,Morón,BUENOS AIRES,238,358,240,212,452
06,06568,065681805,Morón,BUENOS AIRES,258,328,322,296,618
06,06568,065681807,Morón,BUENOS AIRES,333,407,492,426,918
06,06568,065681808,Morón,BUENOS AIRES,256,282,377,333,710
06,06568,065681905,Morón,BUENOS AIRES,267,290,404,370,774
06,06568,065681906,Morón,BUENOS AIRES,419,461,676,571,1247
06,06568,065681908,Morón,BUENOS AIRES,373,390,577,531,1108
06,06568,065681909,Morón,BUENOS AIRES,392,378,599,532,1131
06,06568,065682004,Morón,BUENOS AIRES,298,372,418,348,766
06,06568,065682008,Morón,BUENOS AIRES,361,433,531,457,988
06,06568,065682202,Morón,BUENOS AIRES,138,160,186,186,372
06,06568,065682204,Morón,BUENOS AIRES,184,206,283,260,543
06,06568,065682211,Morón,BUENOS AIRES,144,146,190,196,386
06,06568,065682213,Morón,BUENOS AIRES,280,375,394,383,777
06,06568,065682216,Morón,BUENOS AIRES,211,264,318,314,632
06,06568,065682304,Morón,BUENOS AIRES,236,266,312,320,632
06,06568,065682403,Morón,BUENOS AIRES,202,223,256,250,506
06,06568,065682407,Morón,BUENOS AIRES,269,302,390,402,792
06,06568,065682410,Morón,BUENOS AIRES,228,237,391,344,735
06,06568,065682602,Morón,BUENOS AIRES,359,396,539,490,1029
06,06568,065682705,Morón,BUENOS AIRES,247,266,433,405,838
06,06568,065682707,Morón,BUENOS AIRES,359,381,604,589,1193
06,06568,065682709,Morón,BUENOS AIRES,327,333,531,487,1018
06,06568,065682902,Morón,BUENOS AIRES,328,335,542,487,1029
06,06568,065682908,Morón,BUENOS AIRES,280,244,587,500,1087
06,06568,065682911,Morón,BUENOS AIRES,536,427,1098,1040,2138
06,06568,065683005,Morón,BUENOS AIRES,265,276,488,417,905
06,06568,065683103,Morón,BUENOS AIRES,334,293,613,567,1180
06,06568,065683104,Morón,BUENOS AIRES,472,473,844,769,1613
06,06568,065680103,Morón,BUENOS AIRES,349,376,550,489,1039
06,06568,065680203,Morón,BUENOS AIRES,324,388,492,454,946
06,06568,065680402,Morón,BUENOS AIRES,233,268,332,307,639
06,06568,065680411,Morón,BUENOS AIRES,371,456,520,456,976
06,06568,065680603,Morón,BUENOS AIRES,294,336,429,379,808
06,06568,065680708,Morón,BUENOS AIRES,281,306,423,381,804
06,06568,065680801,Morón,BUENOS AIRES,337,356,516,487,1003
06,06568,065680907,Morón,BUENOS AIRES,393,430,570,514,1084
06,06568,065680908,Morón,BUENOS AIRES,180,197,243,242,485
06,06568,065680912,Morón,BUENOS AIRES,204,235,325,274,599
06,06568,065681013,Morón,BUENOS AIRES,363,385,530,470,1000
06,06568,065681201,Morón,BUENOS AIRES,265,284,397,333,730
06,06568,065681205,Morón,BUENOS AIRES,387,404,523,490,1013
06,06568,065681207,Morón,BUENOS AIRES,401,435,587,517,1104
06,06568,065681110,Morón,BUENOS AIRES,226,337,319,262,581
06,06568,065681405,Morón,BUENOS AIRES,184,202,322,276,598
06,06568,065681502,Morón,BUENOS AIRES,356,377,541,484,1025
06,06568,065681505,Morón,BUENOS AIRES,312,324,470,432,902
06,06568,065681602,Morón,BUENOS AIRES,337,318,572,531,1103
06,06568,065681604,Morón,BUENOS AIRES,438,444,687,628,1315
06,06568,065681811,Morón,BUENOS AIRES,304,348,449,403,852
06,06568,065681706,Morón,BUENOS AIRES,399,435,655,608,1263
06,06568,065681712,Morón,BUENOS AIRES,284,317,421,380,801
06,06568,065681806,Morón,BUENOS AIRES,179,253,229,179,408
06,06568,065681809,Morón,BUENOS AIRES,361,395,515,481,996
06,06568,065681911,Morón,BUENOS AIRES,381,394,669,648,1317
06,06568,065682006,Morón,BUENOS AIRES,223,280,293,226,519
06,06568,065682007,Morón,BUENOS AIRES,219,261,319,304,623
06,06568,065682011,Morón,BUENOS AIRES,422,466,611,597,1208
06,06568,065682205,Morón,BUENOS AIRES,117,170,191,169,360
06,06568,065682209,Morón,BUENOS AIRES,169,197,269,242,511
06,06568,065682217,Morón,BUENOS AIRES,199,223,287,296,583
06,06568,065682303,Morón,BUENOS AIRES,286,363,408,349,757
06,06568,065682406,Morón,BUENOS AIRES,249,288,395,351,746
06,06568,065682502,Morón,BUENOS AIRES,314,344,530,457,987
06,06568,065682508,Morón,BUENOS AIRES,378,375,687,660,1347
06,06568,065682511,Morón,BUENOS AIRES,420,357,734,697,1431
06,06568,065682609,Morón,BUENOS AIRES,229,220,352,317,669
06,06568,065682612,Morón,BUENOS AIRES,367,403,578,524,1102
06,06568,065682704,Morón,BUENOS AIRES,307,277,553,537,1090
06,06568,065683007,Morón,BUENOS AIRES,435,415,759,726,1485
06,06568,065683011,Morón,BUENOS AIRES,427,388,724,659,1383
06,06568,065683102,Morón,BUENOS AIRES,398,427,658,604,1262
06,06568,065683107,Morón,BUENOS AIRES,402,401,639,604,1243
06,06568,065680302,Morón,BUENOS AIRES,368,399,570,518,1088
06,06568,065680307,Morón,BUENOS AIRES,228,223,367,318,685
06,06568,065680401,Morón,BUENOS AIRES,244,261,365,331,696
06,06568,065680502,Morón,BUENOS AIRES,435,494,657,603,1260
06,06568,065680606,Morón,BUENOS AIRES,373,513,470,401,871
06,06568,065680609,Morón,BUENOS AIRES,379,401,567,456,1023
06,06568,065680703,Morón,BUENOS AIRES,215,225,339,307,646
06,06568,065680705,Morón,BUENOS AIRES,296,320,425,388,813
06,06568,065680804,Morón,BUENOS AIRES,362,392,575,501,1076
06,06568,065680910,Morón,BUENOS AIRES,385,440,549,511,1060
06,06568,065681002,Morón,BUENOS AIRES,161,162,273,237,510
06,06568,065681003,Morón,BUENOS AIRES,160,157,263,248,511
06,06568,065681006,Morón,BUENOS AIRES,216,217,348,303,651
06,06568,065681016,Morón,BUENOS AIRES,297,343,398,390,788
06,06568,065681204,Morón,BUENOS AIRES,245,271,419,372,791
06,06568,065681210,Morón,BUENOS AIRES,280,315,418,381,799
06,06568,065681302,Morón,BUENOS AIRES,206,244,332,275,607
06,06568,065681812,Morón,BUENOS AIRES,322,386,454,406,860
06,06568,065681310,Morón,BUENOS AIRES,347,351,635,653,1288
06,06568,065682218,Morón,BUENOS AIRES,129,199,182,175,357
06,06568,065682510,Morón,BUENOS AIRES,326,304,588,575,1163
06,06568,065682807,Morón,BUENOS AIRES,243,226,423,387,810
06,06568,065681111,Morón,BUENOS AIRES,259,287,401,320,721
06,06568,065681410,Morón,BUENOS AIRES,363,420,497,420,917
06,06568,065681605,Morón,BUENOS AIRES,328,352,495,439,934
06,06568,065681611,Morón,BUENOS AIRES,315,334,481,420,901
06,06568,065681902,Morón,BUENOS AIRES,356,400,589,496,1085
06,06568,065682002,Morón,BUENOS AIRES,239,292,317,263,580
06,06568,065682101,Morón,BUENOS AIRES,175,327,197,164,361
06,06568,065682106,Morón,BUENOS AIRES,121,360,125,94,219
06,06568,065682111,Morón,BUENOS AIRES,119,248,158,116,274
06,06568,065682207,Morón,BUENOS AIRES,143,193,208,211,419
06,06568,065682214,Morón,BUENOS AIRES,351,412,540,517,1057
06,06568,065682311,Morón,BUENOS AIRES,250,259,388,352,740
06,06568,065682401,Morón,BUENOS AIRES,365,381,569,528,1097
06,06568,065682503,Morón,BUENOS AIRES,358,375,548,473,1021
06,06568,065682702,Morón,BUENOS AIRES,338,363,720,665,1385
06,06568,065682711,Morón,BUENOS AIRES,323,329,521,492,1013
06,06568,065682804,Morón,BUENOS AIRES,257,247,449,430,879
06,06568,065682907,Morón,BUENOS AIRES,334,279,583,572,1155
06,06568,065683002,Morón,BUENOS AIRES,440,454,751,665,1416
06,06568,065683009,Morón,BUENOS AIRES,314,300,530,534,1064
06,06568,065683010,Morón,BUENOS AIRES,429,420,745,712,1457
06,06568,065683101,Morón,BUENOS AIRES,416,430,705,623,1328
06,06568,065680206,Morón,BUENOS AIRES,348,376,480,472,952
06,06568,065680205,Morón,BUENOS AIRES,297,317,415,412,827
06,06568,065680209,Morón,BUENOS AIRES,451,380,653,691,1344
06,06568,065680212,Morón,BUENOS AIRES,271,282,422,397,819
06,06568,065680308,Morón,BUENOS AIRES,314,309,484,459,943
06,06568,065680309,Morón,BUENOS AIRES,324,312,501,480,981
06,06568,065680312,Morón,BUENOS AIRES,337,375,508,480,988
06,06568,065680316,Morón,BUENOS AIRES,330,303,723,739,1462
06,06568,065680409,Morón,BUENOS AIRES,381,417,580,502,1082
06,06568,065680507,Morón,BUENOS AIRES,338,371,464,432,896
06,06568,065680601,Morón,BUENOS AIRES,400,453,649,593,1242
06,06568,065680607,Morón,BUENOS AIRES,391,494,554,460,1014
06,06568,065680808,Morón,BUENOS AIRES,345,381,544,487,1031
06,06568,065680902,Morón,BUENOS AIRES,251,280,394,337,731
06,06568,065681209,Morón,BUENOS AIRES,238,264,339,324,663
06,06568,065681401,Morón,BUENOS AIRES,191,185,383,348,731
06,06568,065680501,Morón,BUENOS AIRES,300,332,420,395,815
06,06568,065680707,Morón,BUENOS AIRES,302,341,410,423,833
06,06651,066510708,Puán,BUENOS AIRES,4,19,7,6,13
06,06651,066510111,Puán,BUENOS AIRES,182,223,219,197,416
06,06651,066510110,Puán,BUENOS AIRES,277,349,341,285,626
06,06651,066510703,Puán,BUENOS AIRES,8,14,8,11,19
06,06651,066510404,Puán,BUENOS AIRES,10,17,8,15,23
06,06651,066510407,Puán,BUENOS AIRES,14,26,13,19,32
06,06651,066510711,Puán,BUENOS AIRES,5,17,4,7,11
06,06651,066510804,Puán,BUENOS AIRES,7,14,5,8,13
06,06651,066510806,Puán,BUENOS AIRES,3,9,2,4,6
06,06651,066510811,Puán,BUENOS AIRES,4,11,4,4,8
06,06651,066510814,Puán,BUENOS AIRES,4,4,7,6,13
06,06651,066511003,Puán,BUENOS AIRES,11,28,7,14,21
06,06651,066511304,Puán,BUENOS AIRES,11,19,18,21,39
06,06651,066510508,Puán,BUENOS AIRES,363,451,447,379,826
06,06651,066510715,Puán,BUENOS AIRES,255,337,332,320,652
06,06651,066510302,Puán,BUENOS AIRES,9,22,9,14,23
06,06651,066510402,Puán,BUENOS AIRES,9,31,5,11,16
06,06651,066510403,Puán,BUENOS AIRES,15,27,15,23,38
06,06651,066511101,Puán,BUENOS AIRES,9,27,11,13,24
06,06651,066511103,Puán,BUENOS AIRES,7,10,7,11,18
06,06651,066511311,Puán,BUENOS AIRES,15,21,17,17,34
06,06651,066510106,Puán,BUENOS AIRES,205,231,240,232,472
06,06651,066510714,Puán,BUENOS AIRES,254,360,312,278,590
06,06651,066510818,Puán,BUENOS AIRES,155,221,218,190,408
06,06651,066511310,Puán,BUENOS AIRES,75,98,110,91,201
06,06651,066510103,Puán,BUENOS AIRES,27,46,24,41,65
06,06651,066510304,Puán,BUENOS AIRES,7,28,7,13,20
06,06651,066510405,Puán,BUENOS AIRES,6,15,7,6,13
06,06651,066510709,Puán,BUENOS AIRES,3,14,2,4,6
06,06651,066510809,Puán,BUENOS AIRES,8,8,7,11,18
06,06651,066510810,Puán,BUENOS AIRES,11,19,16,14,30
06,06651,066510815,Puán,BUENOS AIRES,5,13,6,6,12
06,06651,066511102,Puán,BUENOS AIRES,7,23,2,7,9
06,06651,066511306,Puán,BUENOS AIRES,15,25,18,22,40
06,06651,066510104,Puán,BUENOS AIRES,204,250,352,307,659
06,06651,066510505,Puán,BUENOS AIRES,189,220,261,271,532
06,06651,066510506,Puán,BUENOS AIRES,326,392,370,388,758
06,06651,066510507,Puán,BUENOS AIRES,236,292,285,253,538
06,06651,066510509,Puán,BUENOS AIRES,314,374,385,362,747
06,06651,066510510,Puán,BUENOS AIRES,271,346,363,309,672
06,06651,066511002,Puán,BUENOS AIRES,4,18,0,6,6
06,06651,066510706,Puán,BUENOS AIRES,8,29,6,10,16
06,06651,066510112,Puán,BUENOS AIRES,6,12,6,13,19
06,06651,066510301,Puán,BUENOS AIRES,11,18,14,14,28
06,06651,066510501,Puán,BUENOS AIRES,3,3,2,5,7
06,06651,066510502,Puán,BUENOS AIRES,3,10,4,5,9
06,06651,066510702,Puán,BUENOS AIRES,12,21,11,18,29
06,06651,066510602,Puán,BUENOS AIRES,7,29,7,9,16
06,06651,066510604,Puán,BUENOS AIRES,10,20,7,15,22
06,06651,066510606,Puán,BUENOS AIRES,9,18,16,19,35
06,06651,066510607,Puán,BUENOS AIRES,13,16,16,18,34
06,06651,066510808,Puán,BUENOS AIRES,11,18,14,16,30
06,06651,066510816,Puán,BUENOS AIRES,3,14,1,3,4
06,06651,066511104,Puán,BUENOS AIRES,10,17,10,11,21
06,06651,066511202,Puán,BUENOS AIRES,9,9,13,16,29
06,06651,066510107,Puán,BUENOS AIRES,183,211,273,230,503
06,06651,066510109,Puán,BUENOS AIRES,227,257,294,268,562
06,06651,066510504,Puán,BUENOS AIRES,211,257,309,275,584
06,06651,066510701,Puán,BUENOS AIRES,141,169,187,172,359
06,06651,066511308,Puán,BUENOS AIRES,122,157,145,161,306
06,06651,066511312,Puán,BUENOS AIRES,9,14,9,13,22
06,06651,066510101,Puán,BUENOS AIRES,7,18,9,11,20
06,06651,066510102,Puán,BUENOS AIRES,8,12,7,11,18
06,06651,066510406,Puán,BUENOS AIRES,3,8,4,4,8
06,06651,066510601,Puán,BUENOS AIRES,8,17,3,10,13
06,06651,066510608,Puán,BUENOS AIRES,4,5,1,4,5
06,06651,066510610,Puán,BUENOS AIRES,6,15,9,12,21
06,06651,066510712,Puán,BUENOS AIRES,6,20,5,10,15
06,06651,066510807,Puán,BUENOS AIRES,2,11,4,3,7
06,06651,066511005,Puán,BUENOS AIRES,3,10,3,5,8
06,06651,066510902,Puán,BUENOS AIRES,16,26,15,24,39
06,06651,066510803,Puán,BUENOS AIRES,1,8,1,1,2
06,06651,066510901,Puán,BUENOS AIRES,7,12,11,14,25
06,06651,066510503,Puán,BUENOS AIRES,10,16,8,12,20
06,06651,066510603,Puán,BUENOS AIRES,8,19,6,10,16
06,06651,066510813,Puán,BUENOS AIRES,8,8,4,9,13
06,06651,066511203,Puán,BUENOS AIRES,15,25,10,18,28
06,06651,066510105,Puán,BUENOS AIRES,274,304,338,342,680
06,06651,066510108,Puán,BUENOS AIRES,339,376,453,407,860
06,06651,066510401,Puán,BUENOS AIRES,11,19,13,18,31
06,06651,066510511,Puán,BUENOS AIRES,323,354,464,426,890
06,06651,066510716,Puán,BUENOS AIRES,119,160,124,133,257
06,06651,066511302,Puán,BUENOS AIRES,36,68,47,48,95
06,06651,066510303,Puán,BUENOS AIRES,6,21,6,9,15
06,06651,066510609,Puán,BUENOS AIRES,7,7,9,12,21
06,06651,066510713,Puán,BUENOS AIRES,11,25,10,22,32
06,06651,066510817,Puán,BUENOS AIRES,15,19,12,15,27
06,06651,066511004,Puán,BUENOS AIRES,4,15,5,6,11
06,06651,066511307,Puán,BUENOS AIRES,18,35,15,19,34
06,06651,066510801,Puán,BUENOS AIRES,91,126,105,113,218
06,06651,066510802,Puán,BUENOS AIRES,137,174,167,152,319
06,06651,066511001,Puán,BUENOS AIRES,52,82,67,85,152
06,06651,066511309,Puán,BUENOS AIRES,141,184,180,165,345
06,06651,066510705,Puán,BUENOS AIRES,4,16,5,3,8
06,06651,066510704,Puán,BUENOS AIRES,5,13,9,8,17
06,06651,066510805,Puán,BUENOS AIRES,2,10,3,4,7
06,06651,066511305,Puán,BUENOS AIRES,9,29,10,13,23
06,06651,066510201,Puán,BUENOS AIRES,13,54,19,16,35
06,06651,066510605,Puán,BUENOS AIRES,3,6,3,5,8
06,06651,066510707,Puán,BUENOS AIRES,11,30,9,15,24
06,06651,066510710,Puán,BUENOS AIRES,5,12,3,10,13
06,06651,066510812,Puán,BUENOS AIRES,3,11,2,4,6
06,06651,066511201,Puán,BUENOS AIRES,7,16,5,7,12
06,06651,066511301,Puán,BUENOS AIRES,3,14,5,3,8
06,06651,066511303,Puán,BUENOS AIRES,15,39,16,19,35
06,06875,068751402,Villarino,BUENOS AIRES,46,102,41,68,109
06,06875,068750607,Villarino,BUENOS AIRES,24,34,37,34,71
06,06875,068750604,Villarino,BUENOS AIRES,417,491,614,563,1177
06,06875,068750609,Villarino,BUENOS AIRES,176,214,235,197,432
06,06875,068750802,Villarino,BUENOS AIRES,159,208,222,223,445
06,06875,068751603,Villarino,BUENOS AIRES,525,572,978,950,1928
06,06875,068751401,Villarino,BUENOS AIRES,53,100,72,73,145
06,06875,068750701,Villarino,BUENOS AIRES,42,91,40,53,93
06,06875,068750605,Villarino,BUENOS AIRES,270,347,482,479,961
06,06875,068750601,Villarino,BUENOS AIRES,258,322,404,370,774
06,06875,068751608,Villarino,BUENOS AIRES,255,276,364,345,709
06,06875,068751503,Villarino,BUENOS AIRES,112,118,189,178,367
06,06875,068750801,Villarino,BUENOS AIRES,66,183,71,84,155
06,06875,068751614,Villarino,BUENOS AIRES,294,314,483,513,996
06,06875,068750301,Villarino,BUENOS AIRES,58,116,61,84,145
06,06875,068750502,Villarino,BUENOS AIRES,47,83,46,71,117
06,06875,068750606,Villarino,BUENOS AIRES,98,122,157,183,340
06,06875,068751302,Villarino,BUENOS AIRES,70,122,71,96,167
06,06875,068751701,Villarino,BUENOS AIRES,153,193,173,255,428
06,06875,068750603,Villarino,BUENOS AIRES,114,132,174,149,323
06,06875,068751507,Villarino,BUENOS AIRES,303,327,549,500,1049
06,06875,068751604,Villarino,BUENOS AIRES,272,415,447,532,979
06,06875,068751605,Villarino,BUENOS AIRES,387,584,542,577,1119
06,06875,068750401,Villarino,BUENOS AIRES,53,64,64,84,148
06,06875,068750608,Villarino,BUENOS AIRES,323,368,507,489,996
06,06875,068750803,Villarino,BUENOS AIRES,138,174,204,166,370
06,06875,068750101,Villarino,BUENOS AIRES,11,24,11,14,25
06,06875,068751101,Villarino,BUENOS AIRES,12,29,6,24,30
06,06875,068750402,Villarino,BUENOS AIRES,38,95,53,55,108
06,06875,068751601,Villarino,BUENOS AIRES,138,200,203,243,446
06,06875,068750901,Villarino,BUENOS AIRES,78,100,104,100,204
06,06875,068751501,Villarino,BUENOS AIRES,243,288,325,316,641
06,06875,068751502,Villarino,BUENOS AIRES,125,135,165,167,332
06,06875,068751508,Villarino,BUENOS AIRES,291,324,447,415,862
06,06875,068751509,Villarino,BUENOS AIRES,187,213,297,295,592
06,06875,068751607,Villarino,BUENOS AIRES,233,271,349,344,693
06,06875,068751609,Villarino,BUENOS AIRES,197,233,269,267,536
06,06875,068751615,Villarino,BUENOS AIRES,391,389,791,763,1554
06,06875,068750501,Villarino,BUENOS AIRES,11,19,19,12,31
06,06875,068751504,Villarino,BUENOS AIRES,163,173,313,360,673
06,06875,068751602,Villarino,BUENOS AIRES,437,512,666,655,1321
06,06875,068751606,Villarino,BUENOS AIRES,297,319,529,504,1033
06,06875,068751505,Villarino,BUENOS AIRES,41,56,38,52,90
06,06875,068751506,Villarino,BUENOS AIRES,366,419,619,737,1356
06,06875,068750201,Villarino,BUENOS AIRES,71,169,64,90,154
06,06875,068750902,Villarino,BUENOS AIRES,48,107,34,66,100
06,06875,068751201,Villarino,BUENOS AIRES,120,182,148,196,344
06,06875,068751801,Villarino,BUENOS AIRES,24,70,17,46,63
06,06875,068750602,Villarino,BUENOS AIRES,189,207,320,262,582
06,06875,068751611,Villarino,BUENOS AIRES,195,227,287,250,537
06,06875,068751613,Villarino,BUENOS AIRES,279,326,473,519,992
06,06875,068751001,Villarino,BUENOS AIRES,27,70,17,44,61
06,06875,068750403,Villarino,BUENOS AIRES,50,86,64,60,124
06,06875,068750804,Villarino,BUENOS AIRES,167,218,277,231,508
06,06875,068750805,Villarino,BUENOS AIRES,137,182,209,211,420
06,06875,068751610,Villarino,BUENOS AIRES,386,419,643,675,1318
06,06875,068751612,Villarino,BUENOS AIRES,207,235,346,366,712
06,06875,068751301,Villarino,BUENOS AIRES,18,32,7,22,29
06,06007,060070114,Adolfo Alsina,BUENOS AIRES,21,34,25,33,58
06,06007,060070107,Adolfo Alsina,BUENOS AIRES,64,97,112,104,216
06,06007,060070516,Adolfo Alsina,BUENOS AIRES,3,13,3,7,10
06,06007,060070805,Adolfo Alsina,BUENOS AIRES,176,218,252,237,489
06,06007,060070801,Adolfo Alsina,BUENOS AIRES,32,32,49,50,99
06,06007,060070201,Adolfo Alsina,BUENOS AIRES,8,8,16,19,35
06,06007,060070308,Adolfo Alsina,BUENOS AIRES,11,16,9,14,23
06,06007,060070511,Adolfo Alsina,BUENOS AIRES,4,7,7,5,12
06,06007,060070611,Adolfo Alsina,BUENOS AIRES,7,10,7,9,16
06,06007,060071107,Adolfo Alsina,BUENOS AIRES,5,10,3,9,12
06,06007,060071004,Adolfo Alsina,BUENOS AIRES,4,15,4,7,11
06,06007,060071012,Adolfo Alsina,BUENOS AIRES,5,20,2,6,8
06,06007,060071104,Adolfo Alsina,BUENOS AIRES,9,16,11,15,26
06,06007,060070513,Adolfo Alsina,BUENOS AIRES,2,15,1,2,3
06,06007,060070402,Adolfo Alsina,BUENOS AIRES,56,74,90,98,188
06,06007,060070502,Adolfo Alsina,BUENOS AIRES,0,2,0,0,0
06,06007,060070802,Adolfo Alsina,BUENOS AIRES,110,133,161,192,353
06,06007,060070811,Adolfo Alsina,BUENOS AIRES,222,237,315,307,622
06,06007,060070812,Adolfo Alsina,BUENOS AIRES,187,214,277,240,517
06,06007,060070106,Adolfo Alsina,BUENOS AIRES,5,15,5,10,15
06,06007,060070205,Adolfo Alsina,BUENOS AIRES,7,14,6,11,17
06,06007,060070304,Adolfo Alsina,BUENOS AIRES,12,23,12,22,34
06,06007,060070409,Adolfo Alsina,BUENOS AIRES,4,14,9,6,15
06,06007,060070503,Adolfo Alsina,BUENOS AIRES,4,10,7,8,15
06,06007,060070506,Adolfo Alsina,BUENOS AIRES,4,10,3,8,11
06,06007,060070701,Adolfo Alsina,BUENOS AIRES,9,11,18,14,32
06,06007,060070902,Adolfo Alsina,BUENOS AIRES,9,11,15,13,28
06,06007,060071003,Adolfo Alsina,BUENOS AIRES,5,13,6,7,13
06,06007,060071005,Adolfo Alsina,BUENOS AIRES,13,26,15,19,34
06,06007,060070413,Adolfo Alsina,BUENOS AIRES,6,14,8,6,14
06,06007,060070809,Adolfo Alsina,BUENOS AIRES,358,400,497,430,927
06,06007,060071001,Adolfo Alsina,BUENOS AIRES,12,17,8,13,21
06,06007,060070104,Adolfo Alsina,BUENOS AIRES,1,2,1,1,2
06,06007,060070203,Adolfo Alsina,BUENOS AIRES,12,14,18,21,39
06,06007,060070204,Adolfo Alsina,BUENOS AIRES,4,17,9,7,16
06,06007,060070208,Adolfo Alsina,BUENOS AIRES,4,10,3,6,9
06,06007,060070302,Adolfo Alsina,BUENOS AIRES,7,16,7,13,20
06,06007,060070306,Adolfo Alsina,BUENOS AIRES,19,23,27,37,64
06,06007,060070411,Adolfo Alsina,BUENOS AIRES,3,8,7,7,14
06,06007,060070504,Adolfo Alsina,BUENOS AIRES,10,12,11,12,23
06,06007,060070508,Adolfo Alsina,BUENOS AIRES,2,9,3,3,6
06,06007,060070603,Adolfo Alsina,BUENOS AIRES,10,22,5,12,17
06,06007,060070606,Adolfo Alsina,BUENOS AIRES,14,21,15,21,36
06,06007,060070613,Adolfo Alsina,BUENOS AIRES,8,13,8,10,18
06,06007,060070906,Adolfo Alsina,BUENOS AIRES,5,6,8,6,14
06,06007,060071007,Adolfo Alsina,BUENOS AIRES,6,10,6,9,15
06,06007,060071009,Adolfo Alsina,BUENOS AIRES,6,28,9,7,16
06,06007,060070702,Adolfo Alsina,BUENOS AIRES,213,253,336,356,692
06,06007,060070113,Adolfo Alsina,BUENOS AIRES,15,27,16,23,39
06,06007,060070102,Adolfo Alsina,BUENOS AIRES,253,275,353,324,677
06,06007,060070405,Adolfo Alsina,BUENOS AIRES,332,392,437,406,843
06,06007,060070612,Adolfo Alsina,BUENOS AIRES,50,71,59,63,122
06,06007,060070810,Adolfo Alsina,BUENOS AIRES,309,383,399,366,765
06,06007,060070305,Adolfo Alsina,BUENOS AIRES,4,11,3,4,7
06,06007,060070510,Adolfo Alsina,BUENOS AIRES,3,10,3,5,8
06,06007,060070903,Adolfo Alsina,BUENOS AIRES,7,20,5,9,14
06,06007,060070904,Adolfo Alsina,BUENOS AIRES,6,10,4,6,10
06,06007,060070905,Adolfo Alsina,BUENOS AIRES,3,11,0,4,4
06,06007,060071010,Adolfo Alsina,BUENOS AIRES,10,13,15,16,31
06,06007,060071102,Adolfo Alsina,BUENOS AIRES,0,7,0,0,0
06,06007,060071105,Adolfo Alsina,BUENOS AIRES,4,7,5,9,14
06,06007,060070101,Adolfo Alsina,BUENOS AIRES,178,213,239,240,479
06,06007,060070403,Adolfo Alsina,BUENOS AIRES,234,279,304,260,564
06,06007,060070404,Adolfo Alsina,BUENOS AIRES,253,296,348,344,692
06,06007,060070108,Adolfo Alsina,BUENOS AIRES,11,23,11,13,24
06,06007,060070207,Adolfo Alsina,BUENOS AIRES,3,8,0,3,3
06,06007,060070303,Adolfo Alsina,BUENOS AIRES,15,24,20,28,48
06,06007,060070401,Adolfo Alsina,BUENOS AIRES,13,31,12,13,25
06,06007,060070412,Adolfo Alsina,BUENOS AIRES,2,7,0,2,2
06,06007,060070609,Adolfo Alsina,BUENOS AIRES,8,13,12,8,20
06,06007,060070614,Adolfo Alsina,BUENOS AIRES,4,10,4,6,10
06,06007,060071109,Adolfo Alsina,BUENOS AIRES,0,5,0,0,0
06,06007,060070103,Adolfo Alsina,BUENOS AIRES,13,23,11,16,27
06,06007,060070209,Adolfo Alsina,BUENOS AIRES,6,4,7,9,16
06,06007,060070803,Adolfo Alsina,BUENOS AIRES,257,284,392,375,767
06,06007,060070807,Adolfo Alsina,BUENOS AIRES,313,376,438,343,781
06,06007,060070813,Adolfo Alsina,BUENOS AIRES,205,242,330,319,649
06,06007,060070105,Adolfo Alsina,BUENOS AIRES,12,29,10,24,34
06,06007,060070110,Adolfo Alsina,BUENOS AIRES,11,13,7,13,20
06,06007,060070111,Adolfo Alsina,BUENOS AIRES,8,15,6,11,17
06,06007,060070307,Adolfo Alsina,BUENOS AIRES,5,25,7,9,16
06,06007,060070408,Adolfo Alsina,BUENOS AIRES,6,14,10,12,22
06,06007,060070410,Adolfo Alsina,BUENOS AIRES,2,8,1,4,5
06,06007,060070505,Adolfo Alsina,BUENOS AIRES,3,5,3,4,7
06,06007,060070602,Adolfo Alsina,BUENOS AIRES,7,17,7,13,20
06,06007,060070610,Adolfo Alsina,BUENOS AIRES,9,10,8,11,19
06,06007,060070901,Adolfo Alsina,BUENOS AIRES,5,13,3,5,8
06,06007,060070115,Adolfo Alsina,BUENOS AIRES,140,167,191,200,391
06,06007,060070406,Adolfo Alsina,BUENOS AIRES,161,194,202,194,396
06,06007,060070407,Adolfo Alsina,BUENOS AIRES,195,222,257,277,534
06,06007,060070501,Adolfo Alsina,BUENOS AIRES,43,61,49,55,104
06,06007,060070804,Adolfo Alsina,BUENOS AIRES,227,265,325,290,615
06,06007,060070806,Adolfo Alsina,BUENOS AIRES,289,357,405,382,787
06,06007,060070808,Adolfo Alsina,BUENOS AIRES,251,323,355,263,618
06,06007,060070814,Adolfo Alsina,BUENOS AIRES,312,333,545,497,1042
06,06007,060070109,Adolfo Alsina,BUENOS AIRES,8,15,7,13,20
06,06007,060070112,Adolfo Alsina,BUENOS AIRES,7,10,10,4,14
06,06007,060070301,Adolfo Alsina,BUENOS AIRES,5,17,5,8,13
06,06007,060070512,Adolfo Alsina,BUENOS AIRES,5,17,6,9,15
06,06007,060070515,Adolfo Alsina,BUENOS AIRES,11,15,14,17,31
06,06007,060070605,Adolfo Alsina,BUENOS AIRES,9,15,8,13,21
06,06007,060070608,Adolfo Alsina,BUENOS AIRES,6,9,5,8,13
06,06007,060070615,Adolfo Alsina,BUENOS AIRES,8,10,7,15,22
06,06007,060071006,Adolfo Alsina,BUENOS AIRES,13,27,14,15,29
06,06007,060071101,Adolfo Alsina,BUENOS AIRES,11,19,13,25,38
06,06007,060070202,Adolfo Alsina,BUENOS AIRES,7,8,5,12,17
06,06007,060070509,Adolfo Alsina,BUENOS AIRES,6,13,10,7,17
06,06007,060070703,Adolfo Alsina,BUENOS AIRES,6,16,5,10,15
06,06007,060070601,Adolfo Alsina,BUENOS AIRES,165,206,224,217,441
06,06007,060070206,Adolfo Alsina,BUENOS AIRES,15,15,17,17,34
06,06007,060070507,Adolfo Alsina,BUENOS AIRES,4,7,6,5,11
06,06007,060070514,Adolfo Alsina,BUENOS AIRES,8,37,13,13,26
06,06007,060070604,Adolfo Alsina,BUENOS AIRES,1,8,0,1,1
06,06007,060070607,Adolfo Alsina,BUENOS AIRES,1,6,0,1,1
06,06007,060070704,Adolfo Alsina,BUENOS AIRES,5,13,4,6,10
06,06007,060071002,Adolfo Alsina,BUENOS AIRES,3,12,2,3,5
06,06007,060071008,Adolfo Alsina,BUENOS AIRES,2,14,2,4,6
06,06007,060071011,Adolfo Alsina,BUENOS AIRES,9,13,14,12,26
06,06007,060071103,Adolfo Alsina,BUENOS AIRES,6,11,6,7,13
06,06007,060071106,Adolfo Alsina,BUENOS AIRES,3,10,3,3,6
06,06007,060071108,Adolfo Alsina,BUENOS AIRES,6,12,6,14,20
06,06007,060071110,Adolfo Alsina,BUENOS AIRES,6,11,8,9,17
06,06007,060071111,Adolfo Alsina,BUENOS AIRES,6,7,9,10,19
06,06490,064905010,Lomas de Zamora,BUENOS AIRES,408,404,641,620,1261
06,06490,064905111,Lomas de Zamora,BUENOS AIRES,181,211,248,217,465
06,06490,064904902,Lomas de Zamora,BUENOS AIRES,336,342,585,459,1044
06,06490,064905005,Lomas de Zamora,BUENOS AIRES,221,229,384,372,756
06,06490,064905104,Lomas de Zamora,BUENOS AIRES,192,197,314,279,593
06,06490,064905106,Lomas de Zamora,BUENOS AIRES,358,369,555,484,1039
06,06490,064900501,Lomas de Zamora,BUENOS AIRES,264,243,546,490,1036
06,06490,064900109,Lomas de Zamora,BUENOS AIRES,243,178,457,421,878
06,06490,064900114,Lomas de Zamora,BUENOS AIRES,214,166,462,406,868
06,06490,064900201,Lomas de Zamora,BUENOS AIRES,458,392,909,855,1764
06,06490,064900207,Lomas de Zamora,BUENOS AIRES,441,388,907,888,1795
06,06490,064900506,Lomas de Zamora,BUENOS AIRES,300,223,540,514,1054
06,06490,064900511,Lomas de Zamora,BUENOS AIRES,329,274,579,519,1098
06,06490,064900602,Lomas de Zamora,BUENOS AIRES,368,413,576,497,1073
06,06490,064900604,Lomas de Zamora,BUENOS AIRES,343,397,519,517,1036
06,06490,064900701,Lomas de Zamora,BUENOS AIRES,242,203,400,406,806
06,06490,064900908,Lomas de Zamora,BUENOS AIRES,262,303,404,360,764
06,06490,064900909,Lomas de Zamora,BUENOS AIRES,215,260,320,253,573
06,06490,064901010,Lomas de Zamora,BUENOS AIRES,317,365,478,448,926
06,06490,064901108,Lomas de Zamora,BUENOS AIRES,169,253,182,146,328
06,06490,064901110,Lomas de Zamora,BUENOS AIRES,216,299,251,206,457
06,06490,064901113,Lomas de Zamora,BUENOS AIRES,296,372,415,372,787
06,06490,064901114,Lomas de Zamora,BUENOS AIRES,315,357,486,393,879
06,06490,064901201,Lomas de Zamora,BUENOS AIRES,284,318,423,339,762
06,06490,064901305,Lomas de Zamora,BUENOS AIRES,229,216,377,328,705
06,06490,064901310,Lomas de Zamora,BUENOS AIRES,393,403,675,610,1285
06,06490,064901311,Lomas de Zamora,BUENOS AIRES,379,359,626,593,1219
06,06490,064901601,Lomas de Zamora,BUENOS AIRES,420,433,765,711,1476
06,06490,064901607,Lomas de Zamora,BUENOS AIRES,268,299,435,395,830
06,06490,064901803,Lomas de Zamora,BUENOS AIRES,365,371,567,490,1057
06,06490,064901812,Lomas de Zamora,BUENOS AIRES,413,429,702,635,1337
06,06490,064901902,Lomas de Zamora,BUENOS AIRES,298,326,450,391,841
06,06490,064901904,Lomas de Zamora,BUENOS AIRES,217,250,330,292,622
06,06490,064901911,Lomas de Zamora,BUENOS AIRES,235,239,388,315,703
06,06490,064902101,Lomas de Zamora,BUENOS AIRES,390,485,531,503,1034
06,06490,064902107,Lomas de Zamora,BUENOS AIRES,313,413,435,353,788
06,06490,064902207,Lomas de Zamora,BUENOS AIRES,173,363,183,135,318
06,06490,064902211,Lomas de Zamora,BUENOS AIRES,237,369,281,200,481
06,06490,064902212,Lomas de Zamora,BUENOS AIRES,46,120,59,31,90
06,06490,064902310,Lomas de Zamora,BUENOS AIRES,169,201,249,218,467
06,06490,064902312,Lomas de Zamora,BUENOS AIRES,209,294,236,184,420
06,06490,064902406,Lomas de Zamora,BUENOS AIRES,259,335,361,344,705
06,06490,064902501,Lomas de Zamora,BUENOS AIRES,323,360,511,451,962
06,06490,064902503,Lomas de Zamora,BUENOS AIRES,278,310,413,372,785
06,06490,064902703,Lomas de Zamora,BUENOS AIRES,334,342,519,422,941
06,06490,064902706,Lomas de Zamora,BUENOS AIRES,319,320,542,456,998
06,06490,064902807,Lomas de Zamora,BUENOS AIRES,241,251,380,324,704
06,06490,064902901,Lomas de Zamora,BUENOS AIRES,372,367,670,668,1338
06,06490,064902910,Lomas de Zamora,BUENOS AIRES,361,353,648,548,1196
06,06490,064902911,Lomas de Zamora,BUENOS AIRES,452,449,753,700,1453
06,06490,064903306,Lomas de Zamora,BUENOS AIRES,347,352,628,620,1248
06,06490,064903308,Lomas de Zamora,BUENOS AIRES,304,260,569,573,1142
06,06490,064903309,Lomas de Zamora,BUENOS AIRES,351,267,740,688,1428
06,06490,064903402,Lomas de Zamora,BUENOS AIRES,427,315,802,740,1542
06,06490,064903409,Lomas de Zamora,BUENOS AIRES,267,188,551,508,1059
06,06490,064903505,Lomas de Zamora,BUENOS AIRES,408,418,644,652,1296
06,06490,064903516,Lomas de Zamora,BUENOS AIRES,224,210,381,369,750
06,06490,064903604,Lomas de Zamora,BUENOS AIRES,337,223,674,661,1335
06,06490,064903710,Lomas de Zamora,BUENOS AIRES,424,277,728,690,1418
06,06490,064903711,Lomas de Zamora,BUENOS AIRES,548,473,976,921,1897
06,06490,064903712,Lomas de Zamora,BUENOS AIRES,338,272,645,601,1246
06,06490,064903801,Lomas de Zamora,BUENOS AIRES,216,171,394,387,781
06,06490,064904606,Lomas de Zamora,BUENOS AIRES,186,220,266,219,485
06,06490,064903804,Lomas de Zamora,BUENOS AIRES,222,190,460,419,879
06,06490,064903809,Lomas de Zamora,BUENOS AIRES,286,200,585,531,1116
06,06490,064903911,Lomas de Zamora,BUENOS AIRES,465,377,897,870,1767
06,06490,064903912,Lomas de Zamora,BUENOS AIRES,287,222,576,585,1161
06,06490,064903916,Lomas de Zamora,BUENOS AIRES,405,392,661,686,1347
06,06490,064904010,Lomas de Zamora,BUENOS AIRES,402,349,772,849,1621
06,06490,064904207,Lomas de Zamora,BUENOS AIRES,354,324,558,512,1070
06,06490,064904208,Lomas de Zamora,BUENOS AIRES,285,303,406,427,833
06,06490,064904307,Lomas de Zamora,BUENOS AIRES,250,256,472,474,946
06,06490,064904310,Lomas de Zamora,BUENOS AIRES,357,379,584,505,1089
06,06490,064904314,Lomas de Zamora,BUENOS AIRES,226,262,365,318,683
06,06490,064904410,Lomas de Zamora,BUENOS AIRES,256,229,425,419,844
06,06490,064904506,Lomas de Zamora,BUENOS AIRES,364,364,579,509,1088
06,06490,064904602,Lomas de Zamora,BUENOS AIRES,262,320,346,304,650
06,06490,064904608,Lomas de Zamora,BUENOS AIRES,251,284,402,352,754
06,06490,064904709,Lomas de Zamora,BUENOS AIRES,238,265,355,318,673
06,06490,064904710,Lomas de Zamora,BUENOS AIRES,247,266,391,363,754
06,06490,064904803,Lomas de Zamora,BUENOS AIRES,248,321,390,353,743
06,06490,064904901,Lomas de Zamora,BUENOS AIRES,263,297,384,365,749
06,06490,064904907,Lomas de Zamora,BUENOS AIRES,275,294,419,398,817
06,06490,064904910,Lomas de Zamora,BUENOS AIRES,333,337,473,426,899
06,06490,064905004,Lomas de Zamora,BUENOS AIRES,101,90,185,171,356
06,06490,064905101,Lomas de Zamora,BUENOS AIRES,251,278,404,353,757
06,06490,064905102,Lomas de Zamora,BUENOS AIRES,280,285,473,430,903
06,06490,064905103,Lomas de Zamora,BUENOS AIRES,203,221,358,328,686
06,06490,064905108,Lomas de Zamora,BUENOS AIRES,363,385,557,479,1036
06,06490,064905110,Lomas de Zamora,BUENOS AIRES,189,209,284,240,524
06,06490,064903310,Lomas de Zamora,BUENOS AIRES,378,300,701,742,1443
06,06490,064900204,Lomas de Zamora,BUENOS AIRES,328,264,603,622,1225
06,06490,064900108,Lomas de Zamora,BUENOS AIRES,207,181,453,419,872
06,06490,064900309,Lomas de Zamora,BUENOS AIRES,352,345,636,530,1166
06,06490,064900312,Lomas de Zamora,BUENOS AIRES,315,264,594,554,1148
06,06490,064900402,Lomas de Zamora,BUENOS AIRES,318,290,581,587,1168
06,06490,064900407,Lomas de Zamora,BUENOS AIRES,414,414,725,840,1565
06,06490,064900606,Lomas de Zamora,BUENOS AIRES,210,257,323,276,599
06,06490,064900611,Lomas de Zamora,BUENOS AIRES,284,278,399,379,778
06,06490,064900614,Lomas de Zamora,BUENOS AIRES,355,395,599,512,1111
06,06490,064900703,Lomas de Zamora,BUENOS AIRES,381,332,659,610,1269
06,06490,064900704,Lomas de Zamora,BUENOS AIRES,260,265,467,428,895
06,06490,064900708,Lomas de Zamora,BUENOS AIRES,219,201,329,302,631
06,06490,064900715,Lomas de Zamora,BUENOS AIRES,301,228,506,495,1001
06,06490,064901007,Lomas de Zamora,BUENOS AIRES,207,242,318,284,602
06,06490,064901013,Lomas de Zamora,BUENOS AIRES,331,383,528,432,960
06,06490,064901015,Lomas de Zamora,BUENOS AIRES,258,333,425,363,788
06,06490,064902605,Lomas de Zamora,BUENOS AIRES,236,251,335,300,635
06,06490,064901103,Lomas de Zamora,BUENOS AIRES,305,329,427,348,775
06,06490,064901104,Lomas de Zamora,BUENOS AIRES,315,355,460,387,847
06,06490,064901106,Lomas de Zamora,BUENOS AIRES,172,241,196,186,382
06,06490,064901203,Lomas de Zamora,BUENOS AIRES,341,388,479,414,893
06,06490,064901204,Lomas de Zamora,BUENOS AIRES,189,216,289,233,522
06,06490,064901210,Lomas de Zamora,BUENOS AIRES,332,359,483,456,939
06,06490,064901309,Lomas de Zamora,BUENOS AIRES,394,353,679,580,1259
06,06490,064901402,Lomas de Zamora,BUENOS AIRES,341,365,582,526,1108
06,06490,064901409,Lomas de Zamora,BUENOS AIRES,258,250,402,391,793
06,06490,064901507,Lomas de Zamora,BUENOS AIRES,237,165,450,398,848
06,06490,064901901,Lomas de Zamora,BUENOS AIRES,341,390,524,466,990
06,06490,064901701,Lomas de Zamora,BUENOS AIRES,388,388,638,610,1248
06,06490,064901801,Lomas de Zamora,BUENOS AIRES,393,391,606,587,1193
06,06490,064901802,Lomas de Zamora,BUENOS AIRES,322,352,513,434,947
06,06490,064901906,Lomas de Zamora,BUENOS AIRES,296,292,432,384,816
06,06490,064902001,Lomas de Zamora,BUENOS AIRES,308,342,462,440,902
06,06490,064902008,Lomas de Zamora,BUENOS AIRES,247,268,385,305,690
06,06490,064902109,Lomas de Zamora,BUENOS AIRES,213,255,312,247,559
06,06490,064902208,Lomas de Zamora,BUENOS AIRES,102,219,117,93,210
06,06490,064902303,Lomas de Zamora,BUENOS AIRES,303,342,429,384,813
06,06490,064902306,Lomas de Zamora,BUENOS AIRES,296,373,437,374,811
06,06490,064902308,Lomas de Zamora,BUENOS AIRES,112,248,118,96,214
06,06490,064902309,Lomas de Zamora,BUENOS AIRES,255,370,337,239,576
06,06490,064902401,Lomas de Zamora,BUENOS AIRES,265,302,403,362,765
06,06490,064902504,Lomas de Zamora,BUENOS AIRES,269,297,400,328,728
06,06490,064902506,Lomas de Zamora,BUENOS AIRES,288,314,432,404,836
06,06490,064902608,Lomas de Zamora,BUENOS AIRES,244,266,364,336,700
06,06490,064902612,Lomas de Zamora,BUENOS AIRES,290,277,420,389,809
06,06490,064902713,Lomas de Zamora,BUENOS AIRES,182,171,304,277,581
06,06490,064902904,Lomas de Zamora,BUENOS AIRES,359,372,672,614,1286
06,06490,064903109,Lomas de Zamora,BUENOS AIRES,328,285,579,559,1138
06,06490,064903201,Lomas de Zamora,BUENOS AIRES,455,419,914,869,1783
06,06490,064903208,Lomas de Zamora,BUENOS AIRES,422,381,803,807,1610
06,06490,064903411,Lomas de Zamora,BUENOS AIRES,354,278,702,708,1410
06,06490,064903503,Lomas de Zamora,BUENOS AIRES,429,490,677,748,1425
06,06490,064903504,Lomas de Zamora,BUENOS AIRES,462,606,691,731,1422
06,06490,064903506,Lomas de Zamora,BUENOS AIRES,519,591,816,826,1642
06,06490,064903514,Lomas de Zamora,BUENOS AIRES,395,319,824,716,1540
06,06490,064903518,Lomas de Zamora,BUENOS AIRES,395,325,660,670,1330
06,06490,064903601,Lomas de Zamora,BUENOS AIRES,446,312,830,841,1671
06,06490,064903607,Lomas de Zamora,BUENOS AIRES,315,258,594,571,1165
06,06490,064903610,Lomas de Zamora,BUENOS AIRES,426,328,789,739,1528
06,06490,064903704,Lomas de Zamora,BUENOS AIRES,252,228,473,434,907
06,06490,064903708,Lomas de Zamora,BUENOS AIRES,250,177,404,373,777
06,06490,064903713,Lomas de Zamora,BUENOS AIRES,482,444,880,824,1704
06,06490,064903806,Lomas de Zamora,BUENOS AIRES,300,281,627,633,1260
06,06490,064903814,Lomas de Zamora,BUENOS AIRES,221,193,441,445,886
06,06490,064904001,Lomas de Zamora,BUENOS AIRES,240,167,501,475,976
06,06490,064904005,Lomas de Zamora,BUENOS AIRES,291,273,554,553,1107
06,06490,064904007,Lomas de Zamora,BUENOS AIRES,377,358,806,786,1592
06,06490,064904011,Lomas de Zamora,BUENOS AIRES,322,329,620,635,1255
06,06490,064904012,Lomas de Zamora,BUENOS AIRES,516,313,1044,1297,2341
06,06490,064904102,Lomas de Zamora,BUENOS AIRES,32,21,62,55,117
06,06490,064904205,Lomas de Zamora,BUENOS AIRES,254,245,433,337,770
06,06490,064904306,Lomas de Zamora,BUENOS AIRES,315,310,531,496,1027
06,06490,064904404,Lomas de Zamora,BUENOS AIRES,378,365,613,635,1248
06,06490,064904409,Lomas de Zamora,BUENOS AIRES,439,438,839,736,1575
06,06490,064904504,Lomas de Zamora,BUENOS AIRES,412,438,636,633,1269
06,06490,064904805,Lomas de Zamora,BUENOS AIRES,177,220,267,216,483
06,06490,064904809,Lomas de Zamora,BUENOS AIRES,212,278,284,230,514
06,06490,064904911,Lomas de Zamora,BUENOS AIRES,328,346,430,404,834
06,06490,064905006,Lomas de Zamora,BUENOS AIRES,379,404,580,500,1080
06,06490,064905007,Lomas de Zamora,BUENOS AIRES,341,357,509,448,957
06,06490,064902403,Lomas de Zamora,BUENOS AIRES,199,329,358,260,618
06,06490,064904013,Lomas de Zamora,BUENOS AIRES,449,427,934,944,1878
06,06490,064900807,Lomas de Zamora,BUENOS AIRES,193,224,249,210,459
06,06490,064900102,Lomas de Zamora,BUENOS AIRES,306,318,534,545,1079
06,06490,064900104,Lomas de Zamora,BUENOS AIRES,231,234,440,439,879
06,06490,064900413,Lomas de Zamora,BUENOS AIRES,283,239,537,496,1033
06,06490,064900502,Lomas de Zamora,BUENOS AIRES,379,333,649,656,1305
06,06490,064900507,Lomas de Zamora,BUENOS AIRES,285,257,464,438,902
06,06490,064900513,Lomas de Zamora,BUENOS AIRES,209,212,362,378,740
06,06490,064900603,Lomas de Zamora,BUENOS AIRES,250,266,386,335,721
06,06490,064900607,Lomas de Zamora,BUENOS AIRES,332,374,539,514,1053
06,06490,064900702,Lomas de Zamora,BUENOS AIRES,274,236,479,464,943
06,06490,064900707,Lomas de Zamora,BUENOS AIRES,293,282,595,554,1149
06,06490,064900709,Lomas de Zamora,BUENOS AIRES,218,174,372,342,714
06,06490,064900711,Lomas de Zamora,BUENOS AIRES,211,186,389,357,746
06,06490,064900902,Lomas de Zamora,BUENOS AIRES,295,321,428,400,828
06,06490,064900904,Lomas de Zamora,BUENOS AIRES,182,161,290,272,562
06,06490,064900907,Lomas de Zamora,BUENOS AIRES,251,290,401,382,783
06,06490,064901002,Lomas de Zamora,BUENOS AIRES,388,433,576,515,1091
06,06490,064901209,Lomas de Zamora,BUENOS AIRES,314,340,470,424,894
06,06490,064901307,Lomas de Zamora,BUENOS AIRES,243,226,366,305,671
06,06490,064901312,Lomas de Zamora,BUENOS AIRES,315,292,535,474,1009
06,06490,064901315,Lomas de Zamora,BUENOS AIRES,456,433,792,707,1499
06,06490,064901503,Lomas de Zamora,BUENOS AIRES,245,188,452,414,866
06,06490,064901602,Lomas de Zamora,BUENOS AIRES,198,212,337,307,644
06,06490,064901605,Lomas de Zamora,BUENOS AIRES,356,366,593,572,1165
06,06490,064901606,Lomas de Zamora,BUENOS AIRES,257,211,426,424,850
06,06490,064901708,Lomas de Zamora,BUENOS AIRES,428,376,745,749,1494
06,06490,064901807,Lomas de Zamora,BUENOS AIRES,332,314,603,548,1151
06,06490,064901808,Lomas de Zamora,BUENOS AIRES,352,337,570,498,1068
06,06490,064901813,Lomas de Zamora,BUENOS AIRES,442,453,722,700,1422
06,06490,064901816,Lomas de Zamora,BUENOS AIRES,299,271,527,505,1032
06,06490,064901903,Lomas de Zamora,BUENOS AIRES,245,277,361,345,706
06,06490,064902002,Lomas de Zamora,BUENOS AIRES,283,301,441,409,850
06,06490,064902005,Lomas de Zamora,BUENOS AIRES,294,321,426,387,813
06,06490,064902104,Lomas de Zamora,BUENOS AIRES,247,261,394,337,731
06,06490,064902206,Lomas de Zamora,BUENOS AIRES,268,438,264,207,471
06,06490,064902304,Lomas de Zamora,BUENOS AIRES,266,268,418,344,762
06,06490,064902305,Lomas de Zamora,BUENOS AIRES,265,312,474,456,930
06,06490,064902311,Lomas de Zamora,BUENOS AIRES,198,278,254,195,449
06,06490,064902313,Lomas de Zamora,BUENOS AIRES,175,248,213,181,394
06,06490,064902603,Lomas de Zamora,BUENOS AIRES,326,355,489,444,933
06,06490,064902613,Lomas de Zamora,BUENOS AIRES,309,356,439,418,857
06,06490,064902701,Lomas de Zamora,BUENOS AIRES,301,318,451,414,865
06,06490,064902705,Lomas de Zamora,BUENOS AIRES,422,414,692,644,1336
06,06490,064902707,Lomas de Zamora,BUENOS AIRES,311,349,472,422,894
06,06490,064902801,Lomas de Zamora,BUENOS AIRES,297,269,496,487,983
06,06490,064902804,Lomas de Zamora,BUENOS AIRES,444,450,738,700,1438
06,06490,064902906,Lomas de Zamora,BUENOS AIRES,378,304,829,829,1658
06,06490,064903007,Lomas de Zamora,BUENOS AIRES,303,310,516,437,953
06,06490,064903202,Lomas de Zamora,BUENOS AIRES,432,337,848,856,1704
06,06490,064903209,Lomas de Zamora,BUENOS AIRES,238,238,461,428,889
06,06490,064903210,Lomas de Zamora,BUENOS AIRES,338,317,609,566,1175
06,06490,064903410,Lomas de Zamora,BUENOS AIRES,353,283,683,677,1360
06,06490,064903509,Lomas de Zamora,BUENOS AIRES,265,215,499,467,966
06,06490,064903510,Lomas de Zamora,BUENOS AIRES,288,235,599,607,1206
06,06490,064903609,Lomas de Zamora,BUENOS AIRES,300,222,512,522,1034
06,06490,064903612,Lomas de Zamora,BUENOS AIRES,317,214,636,592,1228
06,06490,064903701,Lomas de Zamora,BUENOS AIRES,367,325,620,664,1284
06,06490,064903702,Lomas de Zamora,BUENOS AIRES,294,181,509,514,1023
06,06490,064903802,Lomas de Zamora,BUENOS AIRES,363,292,692,642,1334
06,06490,064903813,Lomas de Zamora,BUENOS AIRES,219,167,400,384,784
06,06490,064903816,Lomas de Zamora,BUENOS AIRES,516,416,965,944,1909
06,06490,064904002,Lomas de Zamora,BUENOS AIRES,250,192,503,498,1001
06,06490,064904101,Lomas de Zamora,BUENOS AIRES,27,27,11,29,40
06,06490,064904202,Lomas de Zamora,BUENOS AIRES,351,377,484,480,964
06,06490,064904203,Lomas de Zamora,BUENOS AIRES,280,276,484,412,896
06,06490,064904407,Lomas de Zamora,BUENOS AIRES,361,397,540,502,1042
06,06490,064904304,Lomas de Zamora,BUENOS AIRES,342,373,574,514,1088
06,06490,064904411,Lomas de Zamora,BUENOS AIRES,224,211,418,402,820
06,06490,064904502,Lomas de Zamora,BUENOS AIRES,373,373,588,544,1132
06,06490,064904601,Lomas de Zamora,BUENOS AIRES,297,338,449,361,810
06,06490,064904611,Lomas de Zamora,BUENOS AIRES,356,374,594,505,1099
06,06490,064904701,Lomas de Zamora,BUENOS AIRES,71,68,265,196,461
06,06490,064904706,Lomas de Zamora,BUENOS AIRES,246,285,398,289,687
06,06490,064904808,Lomas de Zamora,BUENOS AIRES,315,360,459,411,870
06,06490,064904905,Lomas de Zamora,BUENOS AIRES,248,264,378,340,718
06,06490,064905002,Lomas de Zamora,BUENOS AIRES,408,437,591,515,1106
06,06490,064905107,Lomas de Zamora,BUENOS AIRES,362,381,627,525,1152
06,06490,064901006,Lomas de Zamora,BUENOS AIRES,210,247,287,257,544
06,06490,064902106,Lomas de Zamora,BUENOS AIRES,310,357,450,382,832
06,06490,064902203,Lomas de Zamora,BUENOS AIRES,256,368,294,257,551
06,06490,064903406,Lomas de Zamora,BUENOS AIRES,297,293,553,536,1089
06,06490,064903608,Lomas de Zamora,BUENOS AIRES,305,284,515,561,1076
06,06490,064903914,Lomas de Zamora,BUENOS AIRES,397,313,723,775,1498
06,06490,064900202,Lomas de Zamora,BUENOS AIRES,534,345,1043,1002,2045
06,06490,064900110,Lomas de Zamora,BUENOS AIRES,166,171,289,296,585
06,06490,064900208,Lomas de Zamora,BUENOS AIRES,549,452,1003,1006,2009
06,06490,064900301,Lomas de Zamora,BUENOS AIRES,342,308,608,589,1197
06,06490,064900303,Lomas de Zamora,BUENOS AIRES,277,220,491,476,967
06,06490,064900306,Lomas de Zamora,BUENOS AIRES,406,355,757,703,1460
06,06490,064900307,Lomas de Zamora,BUENOS AIRES,274,237,487,428,915
06,06490,064900310,Lomas de Zamora,BUENOS AIRES,503,513,988,980,1968
06,06490,064900311,Lomas de Zamora,BUENOS AIRES,159,142,252,238,490
06,06490,064900401,Lomas de Zamora,BUENOS AIRES,411,326,709,680,1389
06,06490,064900404,Lomas de Zamora,BUENOS AIRES,246,227,472,526,998
06,06490,064900514,Lomas de Zamora,BUENOS AIRES,320,338,575,581,1156
06,06490,064900605,Lomas de Zamora,BUENOS AIRES,222,225,344,325,669
06,06490,064900608,Lomas de Zamora,BUENOS AIRES,366,381,673,558,1231
06,06490,064900705,Lomas de Zamora,BUENOS AIRES,361,368,588,548,1136
06,06490,064900712,Lomas de Zamora,BUENOS AIRES,351,321,565,538,1103
06,06490,064900905,Lomas de Zamora,BUENOS AIRES,392,416,585,535,1120
06,06490,064901111,Lomas de Zamora,BUENOS AIRES,184,296,243,172,415
06,06490,064901116,Lomas de Zamora,BUENOS AIRES,357,446,481,422,903
06,06490,064901301,Lomas de Zamora,BUENOS AIRES,381,410,556,500,1056
06,06490,064901304,Lomas de Zamora,BUENOS AIRES,219,210,330,288,618
06,06490,064901313,Lomas de Zamora,BUENOS AIRES,316,272,522,482,1004
06,06490,064901403,Lomas de Zamora,BUENOS AIRES,212,191,379,356,735
06,06490,064901407,Lomas de Zamora,BUENOS AIRES,283,283,432,373,805
06,06490,064901412,Lomas de Zamora,BUENOS AIRES,418,246,758,763,1521
06,06490,064901505,Lomas de Zamora,BUENOS AIRES,312,199,583,517,1100
06,06490,064901509,Lomas de Zamora,BUENOS AIRES,178,105,369,315,684
06,06490,064901706,Lomas de Zamora,BUENOS AIRES,398,354,737,646,1383
06,06490,064901707,Lomas de Zamora,BUENOS AIRES,395,398,642,617,1259
06,06490,064901804,Lomas de Zamora,BUENOS AIRES,404,369,621,559,1180
06,06490,064901811,Lomas de Zamora,BUENOS AIRES,349,362,599,562,1161
06,06490,064901815,Lomas de Zamora,BUENOS AIRES,479,415,865,788,1653
06,06490,064901905,Lomas de Zamora,BUENOS AIRES,278,324,420,349,769
06,06490,064901907,Lomas de Zamora,BUENOS AIRES,381,388,583,498,1081
06,06490,064901908,Lomas de Zamora,BUENOS AIRES,253,259,395,362,757
06,06490,064902007,Lomas de Zamora,BUENOS AIRES,376,405,584,526,1110
06,06490,064902110,Lomas de Zamora,BUENOS AIRES,337,419,449,358,807
06,06490,064902204,Lomas de Zamora,BUENOS AIRES,204,326,211,134,345
06,06490,064902209,Lomas de Zamora,BUENOS AIRES,197,354,390,252,642
06,06490,064902307,Lomas de Zamora,BUENOS AIRES,234,305,328,291,619
06,06490,064902507,Lomas de Zamora,BUENOS AIRES,283,330,409,385,794
06,06490,064902601,Lomas de Zamora,BUENOS AIRES,316,352,457,421,878
06,06490,064902609,Lomas de Zamora,BUENOS AIRES,157,192,235,204,439
06,06490,064902802,Lomas de Zamora,BUENOS AIRES,227,206,378,326,704
06,06490,064902905,Lomas de Zamora,BUENOS AIRES,335,312,604,654,1258
06,06490,064902909,Lomas de Zamora,BUENOS AIRES,430,423,737,662,1399
06,06490,064903010,Lomas de Zamora,BUENOS AIRES,358,394,599,525,1124
06,06490,064903106,Lomas de Zamora,BUENOS AIRES,407,371,755,718,1473
06,06490,064903107,Lomas de Zamora,BUENOS AIRES,377,341,653,679,1332
06,06490,064903203,Lomas de Zamora,BUENOS AIRES,358,328,741,724,1465
06,06490,064903305,Lomas de Zamora,BUENOS AIRES,474,391,895,856,1751
06,06490,064903307,Lomas de Zamora,BUENOS AIRES,224,226,451,454,905
06,06490,064903403,Lomas de Zamora,BUENOS AIRES,320,258,616,532,1148
06,06490,064903407,Lomas de Zamora,BUENOS AIRES,287,232,547,516,1063
06,06490,064903408,Lomas de Zamora,BUENOS AIRES,252,165,477,430,907
06,06490,064903412,Lomas de Zamora,BUENOS AIRES,333,274,660,637,1297
06,06490,064903507,Lomas de Zamora,BUENOS AIRES,403,445,628,588,1216
06,06490,064903513,Lomas de Zamora,BUENOS AIRES,461,399,963,924,1887
06,06490,064903602,Lomas de Zamora,BUENOS AIRES,427,349,863,832,1695
06,06490,064903606,Lomas de Zamora,BUENOS AIRES,361,294,651,632,1283
06,06490,064903611,Lomas de Zamora,BUENOS AIRES,282,198,590,551,1141
06,06490,064903803,Lomas de Zamora,BUENOS AIRES,179,138,357,376,733
06,06490,064903906,Lomas de Zamora,BUENOS AIRES,472,361,807,853,1660
06,06490,064903908,Lomas de Zamora,BUENOS AIRES,287,270,558,568,1126
06,06490,064903915,Lomas de Zamora,BUENOS AIRES,640,573,1244,1186,2430
06,06490,064904006,Lomas de Zamora,BUENOS AIRES,618,432,1215,1207,2422
06,06490,064904008,Lomas de Zamora,BUENOS AIRES,423,382,852,893,1745
06,06490,064904201,Lomas de Zamora,BUENOS AIRES,282,283,415,397,812
06,06490,064904408,Lomas de Zamora,BUENOS AIRES,354,373,561,536,1097
06,06490,064904303,Lomas de Zamora,BUENOS AIRES,280,289,437,373,810
06,06490,064904311,Lomas de Zamora,BUENOS AIRES,214,224,333,272,605
06,06490,064904312,Lomas de Zamora,BUENOS AIRES,294,277,487,406,893
06,06490,064904413,Lomas de Zamora,BUENOS AIRES,286,265,548,516,1064
06,06490,064904703,Lomas de Zamora,BUENOS AIRES,209,196,323,267,590
06,06490,064904705,Lomas de Zamora,BUENOS AIRES,289,316,451,373,824
06,06490,064904713,Lomas de Zamora,BUENOS AIRES,259,307,426,390,816
06,06490,064900805,Lomas de Zamora,BUENOS AIRES,157,199,238,195,433
06,06490,064902604,Lomas de Zamora,BUENOS AIRES,160,181,225,218,443
06,06490,064900806,Lomas de Zamora,BUENOS AIRES,222,274,326,264,590
06,06490,064900103,Lomas de Zamora,BUENOS AIRES,202,221,354,365,719
06,06490,064900106,Lomas de Zamora,BUENOS AIRES,222,225,384,399,783
06,06490,064900302,Lomas de Zamora,BUENOS AIRES,390,329,685,680,1365
06,06490,064900403,Lomas de Zamora,BUENOS AIRES,281,266,529,523,1052
06,06490,064900409,Lomas de Zamora,BUENOS AIRES,208,205,452,463,915
06,06490,064900412,Lomas de Zamora,BUENOS AIRES,222,160,426,414,840
06,06490,064900512,Lomas de Zamora,BUENOS AIRES,454,455,789,750,1539
06,06490,064900515,Lomas de Zamora,BUENOS AIRES,463,353,860,815,1675
06,06490,064900612,Lomas de Zamora,BUENOS AIRES,337,417,455,378,833
06,06490,064900801,Lomas de Zamora,BUENOS AIRES,243,243,369,339,708
06,06490,064900901,Lomas de Zamora,BUENOS AIRES,369,378,584,499,1083
06,06490,064901003,Lomas de Zamora,BUENOS AIRES,300,358,451,394,845
06,06490,064901406,Lomas de Zamora,BUENOS AIRES,226,186,387,342,729
06,06490,064901501,Lomas de Zamora,BUENOS AIRES,290,253,547,540,1087
06,06490,064901508,Lomas de Zamora,BUENOS AIRES,229,168,470,422,892
06,06490,064901806,Lomas de Zamora,BUENOS AIRES,211,198,385,339,724
06,06490,064901912,Lomas de Zamora,BUENOS AIRES,200,217,317,260,577
06,06490,064902006,Lomas de Zamora,BUENOS AIRES,293,328,483,397,880
06,06490,064902102,Lomas de Zamora,BUENOS AIRES,346,389,506,484,990
06,06490,064902205,Lomas de Zamora,BUENOS AIRES,223,304,277,180,457
06,06490,064902407,Lomas de Zamora,BUENOS AIRES,211,307,276,210,486
06,06490,064902409,Lomas de Zamora,BUENOS AIRES,161,249,177,124,301
06,06490,064902410,Lomas de Zamora,BUENOS AIRES,244,423,305,197,502
06,06490,064902607,Lomas de Zamora,BUENOS AIRES,361,388,609,529,1138
06,06490,064902611,Lomas de Zamora,BUENOS AIRES,278,306,406,382,788
06,06490,064902805,Lomas de Zamora,BUENOS AIRES,314,355,484,427,911
06,06490,064902908,Lomas de Zamora,BUENOS AIRES,484,488,826,718,1544
06,06490,064903003,Lomas de Zamora,BUENOS AIRES,287,273,512,498,1010
06,06490,064903006,Lomas de Zamora,BUENOS AIRES,325,278,567,519,1086
06,06490,064903206,Lomas de Zamora,BUENOS AIRES,505,375,976,943,1919
06,06490,064903304,Lomas de Zamora,BUENOS AIRES,300,271,538,595,1133
06,06490,064903508,Lomas de Zamora,BUENOS AIRES,456,372,892,850,1742
06,06490,064903512,Lomas de Zamora,BUENOS AIRES,258,253,522,509,1031
06,06490,064903703,Lomas de Zamora,BUENOS AIRES,245,252,406,413,819
06,06490,064903706,Lomas de Zamora,BUENOS AIRES,361,352,616,633,1249
06,06490,064903714,Lomas de Zamora,BUENOS AIRES,458,377,791,806,1597
06,06490,064904009,Lomas de Zamora,BUENOS AIRES,583,578,1130,1134,2264
06,06490,064904406,Lomas de Zamora,BUENOS AIRES,408,430,650,623,1273
06,06490,064904308,Lomas de Zamora,BUENOS AIRES,193,190,396,392,788
06,06490,064904313,Lomas de Zamora,BUENOS AIRES,275,252,462,450,912
06,06490,064904401,Lomas de Zamora,BUENOS AIRES,300,337,432,384,816
06,06490,064904505,Lomas de Zamora,BUENOS AIRES,382,422,603,582,1185
06,06490,064904801,Lomas de Zamora,BUENOS AIRES,287,342,430,386,816
06,06490,064904807,Lomas de Zamora,BUENOS AIRES,286,338,414,370,784
06,06490,064904903,Lomas de Zamora,BUENOS AIRES,264,278,373,305,678
06,06490,064904904,Lomas de Zamora,BUENOS AIRES,481,512,598,439,1037
06,06490,064904909,Lomas de Zamora,BUENOS AIRES,207,209,308,282,590
06,06490,064905001,Lomas de Zamora,BUENOS AIRES,359,392,509,453,962
06,06490,064905008,Lomas de Zamora,BUENOS AIRES,325,329,487,405,892
06,06490,064905009,Lomas de Zamora,BUENOS AIRES,215,224,328,281,609
06,06490,064905011,Lomas de Zamora,BUENOS AIRES,238,209,360,349,709
06,06490,064904305,Lomas de Zamora,BUENOS AIRES,2,2,3,2,5
06,06490,064900804,Lomas de Zamora,BUENOS AIRES,175,192,269,236,505
06,06490,064900808,Lomas de Zamora,BUENOS AIRES,357,406,547,433,980
06,06490,064900105,Lomas de Zamora,BUENOS AIRES,258,258,496,497,993
06,06490,064900111,Lomas de Zamora,BUENOS AIRES,236,213,468,465,933
06,06490,064900112,Lomas de Zamora,BUENOS AIRES,286,243,561,529,1090
06,06490,064900209,Lomas de Zamora,BUENOS AIRES,455,475,825,823,1648
06,06490,064900305,Lomas de Zamora,BUENOS AIRES,179,171,309,301,610
06,06490,064900313,Lomas de Zamora,BUENOS AIRES,342,336,546,546,1092
06,06490,064900505,Lomas de Zamora,BUENOS AIRES,245,242,368,366,734
06,06490,064900516,Lomas de Zamora,BUENOS AIRES,539,471,896,869,1765
06,06490,064900610,Lomas de Zamora,BUENOS AIRES,228,248,375,337,712
06,06490,064900613,Lomas de Zamora,BUENOS AIRES,381,411,530,429,959
06,06490,064900706,Lomas de Zamora,BUENOS AIRES,348,347,640,564,1204
06,06490,064900802,Lomas de Zamora,BUENOS AIRES,238,263,369,315,684
06,06490,064900809,Lomas de Zamora,BUENOS AIRES,385,425,550,532,1082
06,06490,064900906,Lomas de Zamora,BUENOS AIRES,347,386,507,441,948
06,06490,064901004,Lomas de Zamora,BUENOS AIRES,351,412,497,438,935
06,06490,064901012,Lomas de Zamora,BUENOS AIRES,310,367,483,385,868
06,06490,064901101,Lomas de Zamora,BUENOS AIRES,173,235,251,211,462
06,06490,064901105,Lomas de Zamora,BUENOS AIRES,352,428,475,392,867
06,06490,064901115,Lomas de Zamora,BUENOS AIRES,229,276,353,282,635
06,06490,064901117,Lomas de Zamora,BUENOS AIRES,330,451,428,339,767
06,06490,064901202,Lomas de Zamora,BUENOS AIRES,389,379,565,493,1058
06,06490,064901208,Lomas de Zamora,BUENOS AIRES,293,324,434,385,819
06,06490,064901303,Lomas de Zamora,BUENOS AIRES,320,324,481,451,932
06,06490,064901306,Lomas de Zamora,BUENOS AIRES,358,342,604,542,1146
06,06490,064901308,Lomas de Zamora,BUENOS AIRES,276,286,420,378,798
06,06490,064901314,Lomas de Zamora,BUENOS AIRES,369,357,648,648,1296
06,06490,064901405,Lomas de Zamora,BUENOS AIRES,286,253,486,496,982
06,06490,064901410,Lomas de Zamora,BUENOS AIRES,358,282,624,598,1222
06,06490,064901504,Lomas de Zamora,BUENOS AIRES,268,203,517,456,973
06,06490,064901510,Lomas de Zamora,BUENOS AIRES,289,266,524,516,1040
06,06490,064901511,Lomas de Zamora,BUENOS AIRES,335,258,672,600,1272
06,06490,064901603,Lomas de Zamora,BUENOS AIRES,327,339,609,591,1200
06,06490,064901604,Lomas de Zamora,BUENOS AIRES,174,161,314,271,585
06,06490,064901705,Lomas de Zamora,BUENOS AIRES,399,397,713,655,1368
06,06490,064901805,Lomas de Zamora,BUENOS AIRES,222,235,360,302,662
06,06490,064901810,Lomas de Zamora,BUENOS AIRES,300,280,523,506,1029
06,06490,064901909,Lomas de Zamora,BUENOS AIRES,168,196,256,213,469
06,06490,064901910,Lomas de Zamora,BUENOS AIRES,337,365,501,470,971
06,06490,064902009,Lomas de Zamora,BUENOS AIRES,210,242,328,323,651
06,06490,064902103,Lomas de Zamora,BUENOS AIRES,353,407,550,449,999
06,06490,064902108,Lomas de Zamora,BUENOS AIRES,155,232,198,165,363
06,06490,064902202,Lomas de Zamora,BUENOS AIRES,225,314,341,258,599
06,06490,064903605,Lomas de Zamora,BUENOS AIRES,304,267,549,517,1066
06,06490,064902411,Lomas de Zamora,BUENOS AIRES,199,297,209,147,356
06,06490,064902502,Lomas de Zamora,BUENOS AIRES,290,327,417,380,797
06,06490,064902505,Lomas de Zamora,BUENOS AIRES,250,305,363,309,672
06,06490,064902508,Lomas de Zamora,BUENOS AIRES,346,389,568,474,1042
06,06490,064902708,Lomas de Zamora,BUENOS AIRES,311,308,497,443,940
06,06490,064902711,Lomas de Zamora,BUENOS AIRES,478,452,783,742,1525
06,06490,064902808,Lomas de Zamora,BUENOS AIRES,209,219,322,276,598
06,06490,064902810,Lomas de Zamora,BUENOS AIRES,407,431,677,650,1327
06,06490,064903002,Lomas de Zamora,BUENOS AIRES,523,517,1012,987,1999
06,06490,064903005,Lomas de Zamora,BUENOS AIRES,478,486,808,732,1540
06,06490,064903008,Lomas de Zamora,BUENOS AIRES,316,350,522,498,1020
06,06490,064903009,Lomas de Zamora,BUENOS AIRES,338,332,519,475,994
06,06490,064903101,Lomas de Zamora,BUENOS AIRES,246,223,447,460,907
06,06490,064903105,Lomas de Zamora,BUENOS AIRES,336,317,663,628,1291
06,06490,064903205,Lomas de Zamora,BUENOS AIRES,253,191,499,515,1014
06,06490,064903401,Lomas de Zamora,BUENOS AIRES,665,426,1105,1149,2254
06,06490,064903405,Lomas de Zamora,BUENOS AIRES,442,321,812,816,1628
06,06490,064903414,Lomas de Zamora,BUENOS AIRES,361,335,728,697,1425
06,06490,064903415,Lomas de Zamora,BUENOS AIRES,252,201,447,467,914
06,06490,064903517,Lomas de Zamora,BUENOS AIRES,321,285,589,585,1174
06,06490,064903603,Lomas de Zamora,BUENOS AIRES,275,266,511,516,1027
06,06490,064903805,Lomas de Zamora,BUENOS AIRES,405,359,791,765,1556
06,06490,064903808,Lomas de Zamora,BUENOS AIRES,482,387,948,981,1929
06,06490,064903810,Lomas de Zamora,BUENOS AIRES,274,211,536,522,1058
06,06490,064903811,Lomas de Zamora,BUENOS AIRES,354,314,683,690,1373
06,06490,064903812,Lomas de Zamora,BUENOS AIRES,263,199,507,465,972
06,06490,064903909,Lomas de Zamora,BUENOS AIRES,328,296,690,684,1374
06,06490,064904003,Lomas de Zamora,BUENOS AIRES,308,273,647,633,1280
06,06490,064904309,Lomas de Zamora,BUENOS AIRES,445,464,742,707,1449
06,06490,064904402,Lomas de Zamora,BUENOS AIRES,386,438,556,477,1033
06,06490,064904403,Lomas de Zamora,BUENOS AIRES,281,271,471,419,890
06,06490,064904412,Lomas de Zamora,BUENOS AIRES,260,260,475,452,927
06,06490,064904507,Lomas de Zamora,BUENOS AIRES,196,206,281,229,510
06,06490,064904603,Lomas de Zamora,BUENOS AIRES,273,318,420,371,791
06,06490,064904604,Lomas de Zamora,BUENOS AIRES,281,320,418,383,801
06,06490,064904605,Lomas de Zamora,BUENOS AIRES,126,163,171,141,312
06,06490,064904612,Lomas de Zamora,BUENOS AIRES,265,306,403,374,777
06,06490,064904804,Lomas de Zamora,BUENOS AIRES,345,423,471,461,932
06,06490,064904811,Lomas de Zamora,BUENOS AIRES,244,262,374,337,711
06,06490,064905003,Lomas de Zamora,BUENOS AIRES,299,331,384,383,767
06,06490,064900203,Lomas de Zamora,BUENOS AIRES,356,252,697,696,1393
06,06490,064900107,Lomas de Zamora,BUENOS AIRES,229,256,386,402,788
06,06490,064900210,Lomas de Zamora,BUENOS AIRES,368,356,689,698,1387
06,06490,064900304,Lomas de Zamora,BUENOS AIRES,134,116,239,231,470
06,06490,064900406,Lomas de Zamora,BUENOS AIRES,348,298,666,677,1343
06,06490,064900410,Lomas de Zamora,BUENOS AIRES,301,256,545,580,1125
06,06490,064900411,Lomas de Zamora,BUENOS AIRES,441,347,763,776,1539
06,06490,064900414,Lomas de Zamora,BUENOS AIRES,494,476,888,846,1734
06,06490,064900503,Lomas de Zamora,BUENOS AIRES,286,251,448,407,855
06,06490,064900509,Lomas de Zamora,BUENOS AIRES,259,243,472,447,919
06,06490,064900510,Lomas de Zamora,BUENOS AIRES,458,339,834,762,1596
06,06490,064900615,Lomas de Zamora,BUENOS AIRES,308,331,538,468,1006
06,06490,064900713,Lomas de Zamora,BUENOS AIRES,247,230,366,410,776
06,06490,064901001,Lomas de Zamora,BUENOS AIRES,233,244,370,322,692
06,06490,064901005,Lomas de Zamora,BUENOS AIRES,354,436,662,550,1212
06,06490,064901009,Lomas de Zamora,BUENOS AIRES,263,251,441,384,825
06,06490,064901011,Lomas de Zamora,BUENOS AIRES,396,404,574,505,1079
06,06490,064901102,Lomas de Zamora,BUENOS AIRES,287,326,421,370,791
06,06490,064901107,Lomas de Zamora,BUENOS AIRES,185,242,213,153,366
06,06490,064901112,Lomas de Zamora,BUENOS AIRES,239,357,264,234,498
06,06490,064901206,Lomas de Zamora,BUENOS AIRES,354,431,531,425,956
06,06490,064901207,Lomas de Zamora,BUENOS AIRES,329,361,497,411,908
06,06490,064901401,Lomas de Zamora,BUENOS AIRES,312,279,521,500,1021
06,06490,064901404,Lomas de Zamora,BUENOS AIRES,242,254,400,396,796
06,06490,064901408,Lomas de Zamora,BUENOS AIRES,253,220,417,380,797
06,06490,064901502,Lomas de Zamora,BUENOS AIRES,296,294,530,525,1055
06,06490,064901703,Lomas de Zamora,BUENOS AIRES,254,202,515,515,1030
06,06490,064901704,Lomas de Zamora,BUENOS AIRES,385,341,656,664,1320
06,06490,064901709,Lomas de Zamora,BUENOS AIRES,297,297,516,482,998
06,06490,064902003,Lomas de Zamora,BUENOS AIRES,336,357,586,495,1081
06,06490,064902004,Lomas de Zamora,BUENOS AIRES,215,242,331,303,634
06,06490,064902105,Lomas de Zamora,BUENOS AIRES,337,389,468,411,879
06,06490,064902201,Lomas de Zamora,BUENOS AIRES,265,330,412,345,757
06,06490,064902210,Lomas de Zamora,BUENOS AIRES,378,575,432,308,740
06,06490,064902301,Lomas de Zamora,BUENOS AIRES,286,306,444,383,827
06,06490,064902302,Lomas de Zamora,BUENOS AIRES,240,288,340,292,632
06,06490,064902408,Lomas de Zamora,BUENOS AIRES,183,292,196,151,347
06,06490,064902602,Lomas de Zamora,BUENOS AIRES,265,293,384,361,745
06,06490,064902702,Lomas de Zamora,BUENOS AIRES,421,429,685,643,1328
06,06490,064902710,Lomas de Zamora,BUENOS AIRES,492,488,771,646,1417
06,06490,064902806,Lomas de Zamora,BUENOS AIRES,413,459,628,568,1196
06,06490,064902811,Lomas de Zamora,BUENOS AIRES,313,315,452,388,840
06,06490,064902903,Lomas de Zamora,BUENOS AIRES,304,261,578,560,1138
06,06490,064903004,Lomas de Zamora,BUENOS AIRES,276,288,508,471,979
06,06490,064903103,Lomas de Zamora,BUENOS AIRES,413,405,766,737,1503
06,06490,064903108,Lomas de Zamora,BUENOS AIRES,401,339,795,773,1568
06,06490,064903110,Lomas de Zamora,BUENOS AIRES,275,264,477,443,920
06,06490,064903204,Lomas de Zamora,BUENOS AIRES,301,280,602,610,1212
06,06490,064903207,Lomas de Zamora,BUENOS AIRES,338,281,632,621,1253
06,06490,064903301,Lomas de Zamora,BUENOS AIRES,239,211,404,421,825
06,06490,064903302,Lomas de Zamora,BUENOS AIRES,283,247,563,562,1125
06,06490,064903303,Lomas de Zamora,BUENOS AIRES,441,371,793,799,1592
06,06490,064903413,Lomas de Zamora,BUENOS AIRES,359,332,761,736,1497
06,06490,064903501,Lomas de Zamora,BUENOS AIRES,259,285,434,464,898
06,06490,064903502,Lomas de Zamora,BUENOS AIRES,270,252,445,471,916
06,06490,064903511,Lomas de Zamora,BUENOS AIRES,271,227,523,494,1017
06,06490,064903515,Lomas de Zamora,BUENOS AIRES,243,220,442,449,891
06,06490,064903707,Lomas de Zamora,BUENOS AIRES,251,161,485,506,991
06,06490,064903902,Lomas de Zamora,BUENOS AIRES,188,181,373,368,741
06,06490,064903910,Lomas de Zamora,BUENOS AIRES,240,228,561,489,1050
06,06490,064903913,Lomas de Zamora,BUENOS AIRES,203,155,429,454,883
06,06490,064904204,Lomas de Zamora,BUENOS AIRES,325,360,495,430,925
06,06490,064904206,Lomas de Zamora,BUENOS AIRES,331,315,505,460,965
06,06490,064904301,Lomas de Zamora,BUENOS AIRES,15,12,15,23,38
06,06490,064904302,Lomas de Zamora,BUENOS AIRES,245,276,333,313,646
06,06490,064904609,Lomas de Zamora,BUENOS AIRES,288,323,452,386,838
06,06490,064904702,Lomas de Zamora,BUENOS AIRES,309,341,447,403,850
06,06490,064904712,Lomas de Zamora,BUENOS AIRES,278,310,432,360,792
06,06490,064904802,Lomas de Zamora,BUENOS AIRES,271,343,415,392,807
06,06490,064904810,Lomas de Zamora,BUENOS AIRES,258,294,371,326,697
06,06490,064904908,Lomas de Zamora,BUENOS AIRES,191,200,275,245,520
06,06490,064905105,Lomas de Zamora,BUENOS AIRES,416,420,683,620,1303
06,06490,064905109,Lomas de Zamora,BUENOS AIRES,279,301,430,371,801
06,06490,064904906,Lomas de Zamora,BUENOS AIRES,360,382,562,476,1038
06,06490,064900101,Lomas de Zamora,BUENOS AIRES,196,194,407,416,823
06,06490,064900113,Lomas de Zamora,BUENOS AIRES,147,147,271,301,572
06,06490,064900205,Lomas de Zamora,BUENOS AIRES,372,363,690,641,1331
06,06490,064900206,Lomas de Zamora,BUENOS AIRES,376,325,695,677,1372
06,06490,064900308,Lomas de Zamora,BUENOS AIRES,236,203,433,392,825
06,06490,064900508,Lomas de Zamora,BUENOS AIRES,427,387,740,712,1452
06,06490,064900405,Lomas de Zamora,BUENOS AIRES,344,310,653,663,1316
06,06490,064900408,Lomas de Zamora,BUENOS AIRES,345,235,663,674,1337
06,06490,064900504,Lomas de Zamora,BUENOS AIRES,242,200,459,370,829
06,06490,064900601,Lomas de Zamora,BUENOS AIRES,252,283,399,380,779
06,06490,064900609,Lomas de Zamora,BUENOS AIRES,246,208,435,363,798
06,06490,064900710,Lomas de Zamora,BUENOS AIRES,308,299,506,487,993
06,06490,064900714,Lomas de Zamora,BUENOS AIRES,262,246,438,392,830
06,06490,064900803,Lomas de Zamora,BUENOS AIRES,408,429,616,568,1184
06,06490,064900903,Lomas de Zamora,BUENOS AIRES,205,218,322,302,624
06,06490,064901008,Lomas de Zamora,BUENOS AIRES,292,324,408,387,795
06,06490,064901014,Lomas de Zamora,BUENOS AIRES,243,278,388,346,734
06,06490,064901109,Lomas de Zamora,BUENOS AIRES,210,285,245,190,435
06,06490,064901118,Lomas de Zamora,BUENOS AIRES,252,304,389,306,695
06,06490,064901205,Lomas de Zamora,BUENOS AIRES,198,221,277,237,514
06,06490,064901302,Lomas de Zamora,BUENOS AIRES,350,353,530,511,1041
06,06490,064901411,Lomas de Zamora,BUENOS AIRES,319,278,587,541,1128
06,06490,064901506,Lomas de Zamora,BUENOS AIRES,169,76,362,298,660
06,06490,064901608,Lomas de Zamora,BUENOS AIRES,318,321,526,467,993
06,06490,064901609,Lomas de Zamora,BUENOS AIRES,355,364,597,514,1111
06,06490,064901702,Lomas de Zamora,BUENOS AIRES,353,299,652,694,1346
06,06490,064901809,Lomas de Zamora,BUENOS AIRES,354,364,594,520,1114
06,06490,064901814,Lomas de Zamora,BUENOS AIRES,432,426,747,686,1433
06,06490,064902402,Lomas de Zamora,BUENOS AIRES,345,435,470,377,847
06,06490,064902404,Lomas de Zamora,BUENOS AIRES,379,512,489,350,839
06,06490,064902405,Lomas de Zamora,BUENOS AIRES,281,355,376,343,719
06,06490,064902606,Lomas de Zamora,BUENOS AIRES,327,364,486,427,913
06,06490,064902610,Lomas de Zamora,BUENOS AIRES,378,421,552,538,1090
06,06490,064902704,Lomas de Zamora,BUENOS AIRES,262,303,372,344,716
06,06490,064902709,Lomas de Zamora,BUENOS AIRES,300,291,481,389,870
06,06490,064902712,Lomas de Zamora,BUENOS AIRES,419,432,697,650,1347
06,06490,064902803,Lomas de Zamora,BUENOS AIRES,407,393,617,519,1136
06,06490,064902809,Lomas de Zamora,BUENOS AIRES,189,193,297,298,595
06,06490,064902902,Lomas de Zamora,BUENOS AIRES,481,462,808,756,1564
06,06490,064902907,Lomas de Zamora,BUENOS AIRES,424,416,745,743,1488
06,06490,064903001,Lomas de Zamora,BUENOS AIRES,268,253,462,474,936
06,06490,064903102,Lomas de Zamora,BUENOS AIRES,280,257,519,514,1033
06,06490,064903104,Lomas de Zamora,BUENOS AIRES,392,361,759,774,1533
06,06490,064903404,Lomas de Zamora,BUENOS AIRES,364,321,729,689,1418
06,06490,064903705,Lomas de Zamora,BUENOS AIRES,291,259,519,546,1065
06,06490,064903709,Lomas de Zamora,BUENOS AIRES,544,558,1005,990,1995
06,06490,064903807,Lomas de Zamora,BUENOS AIRES,350,284,699,679,1378
06,06490,064903815,Lomas de Zamora,BUENOS AIRES,228,193,387,310,697
06,06490,064903817,Lomas de Zamora,BUENOS AIRES,520,419,1001,1002,2003
06,06490,064903901,Lomas de Zamora,BUENOS AIRES,388,326,578,614,1192
06,06490,064903903,Lomas de Zamora,BUENOS AIRES,898,789,1669,1688,3357
06,06490,064903904,Lomas de Zamora,BUENOS AIRES,408,385,947,913,1860
06,06490,064903905,Lomas de Zamora,BUENOS AIRES,473,426,904,955,1859
06,06490,064903907,Lomas de Zamora,BUENOS AIRES,212,156,395,373,768
06,06490,064904004,Lomas de Zamora,BUENOS AIRES,469,376,934,960,1894
06,06490,064904405,Lomas de Zamora,BUENOS AIRES,411,391,738,695,1433
06,06490,064904501,Lomas de Zamora,BUENOS AIRES,264,267,467,404,871
06,06490,064904503,Lomas de Zamora,BUENOS AIRES,325,342,563,583,1146
06,06490,064904508,Lomas de Zamora,BUENOS AIRES,231,256,352,326,678
06,06490,064904607,Lomas de Zamora,BUENOS AIRES,304,348,460,393,853
06,06490,064904610,Lomas de Zamora,BUENOS AIRES,25,27,930,35,965
06,06490,064904704,Lomas de Zamora,BUENOS AIRES,230,260,325,283,608
06,06490,064904707,Lomas de Zamora,BUENOS AIRES,346,385,522,452,974
06,06490,064904708,Lomas de Zamora,BUENOS AIRES,292,314,448,411,859
06,06490,064904711,Lomas de Zamora,BUENOS AIRES,306,371,465,409,874
06,06490,064904806,Lomas de Zamora,BUENOS AIRES,143,177,250,199,449
06,06497,064970102,Luján,BUENOS AIRES,202,240,277,240,517
06,06497,064970502,Luján,BUENOS AIRES,218,246,315,281,596
06,06497,064970602,Luján,BUENOS AIRES,332,367,567,501,1068
06,06497,064970614,Luján,BUENOS AIRES,133,209,237,237,474
06,06497,064970707,Luján,BUENOS AIRES,155,258,192,137,329
06,06497,064970814,Luján,BUENOS AIRES,218,230,323,301,624
06,06497,064971001,Luján,BUENOS AIRES,214,262,363,312,675
06,06497,064971008,Luján,BUENOS AIRES,336,346,607,644,1251
06,06497,064971408,Luján,BUENOS AIRES,243,273,373,303,676
06,06497,064970303,Luján,BUENOS AIRES,231,281,350,321,671
06,06497,064970311,Luján,BUENOS AIRES,283,319,461,416,877
06,06497,064970312,Luján,BUENOS AIRES,371,397,612,624,1236
06,06497,064970510,Luján,BUENOS AIRES,429,446,779,714,1493
06,06497,064970501,Luján,BUENOS AIRES,230,262,358,333,691
06,06497,064970506,Luján,BUENOS AIRES,374,408,726,675,1401
06,06497,064970509,Luján,BUENOS AIRES,409,448,631,547,1178
06,06497,064970611,Luján,BUENOS AIRES,189,342,269,285,554
06,06497,064970701,Luján,BUENOS AIRES,297,346,420,340,760
06,06497,064970809,Luján,BUENOS AIRES,297,320,525,492,1017
06,06497,064971101,Luján,BUENOS AIRES,359,410,547,470,1017
06,06497,064971105,Luján,BUENOS AIRES,356,397,489,446,935
06,06497,064970201,Luján,BUENOS AIRES,167,245,270,287,557
06,06497,064970704,Luján,BUENOS AIRES,142,192,191,153,344
06,06497,064970202,Luján,BUENOS AIRES,22,46,28,35,63
06,06497,064970304,Luján,BUENOS AIRES,24,38,30,41,71
06,06497,064970401,Luján,BUENOS AIRES,34,33,56,77,133
06,06497,064970612,Luján,BUENOS AIRES,64,87,113,121,234
06,06497,064971003,Luján,BUENOS AIRES,17,21,27,32,59
06,06497,064970803,Luján,BUENOS AIRES,232,275,401,403,804
06,06497,064971210,Luján,BUENOS AIRES,127,229,197,237,434
06,06497,064971305,Luján,BUENOS AIRES,77,112,115,130,245
06,06497,064970108,Luján,BUENOS AIRES,229,219,376,337,713
06,06497,064970309,Luján,BUENOS AIRES,165,181,330,319,649
06,06497,064970406,Luján,BUENOS AIRES,182,206,290,295,585
06,06497,064970409,Luján,BUENOS AIRES,218,245,391,434,825
06,06497,064970604,Luján,BUENOS AIRES,295,330,444,421,865
06,06497,064970613,Luján,BUENOS AIRES,199,224,321,331,652
06,06497,064970802,Luján,BUENOS AIRES,275,278,604,726,1330
06,06497,064971107,Luján,BUENOS AIRES,308,340,469,422,891
06,06497,064971108,Luján,BUENOS AIRES,265,292,416,373,789
06,06497,064971205,Luján,BUENOS AIRES,370,391,608,545,1153
06,06497,064971212,Luján,BUENOS AIRES,91,168,138,144,282
06,06497,064970112,Luján,BUENOS AIRES,252,259,515,482,997
06,06497,064971306,Luján,BUENOS AIRES,319,353,491,434,925
06,06497,064970608,Luján,BUENOS AIRES,26,34,41,49,90
06,06497,064970609,Luján,BUENOS AIRES,188,270,315,354,669
06,06497,064970308,Luján,BUENOS AIRES,350,366,722,651,1373
06,06497,064970504,Luján,BUENOS AIRES,334,352,630,648,1278
06,06497,064970702,Luján,BUENOS AIRES,127,179,165,145,310
06,06497,064970709,Luján,BUENOS AIRES,207,240,295,244,539
06,06497,064971103,Luján,BUENOS AIRES,328,362,454,394,848
06,06497,064971201,Luján,BUENOS AIRES,302,313,549,538,1087
06,06497,064971206,Luján,BUENOS AIRES,296,326,507,462,969
06,06497,064971307,Luján,BUENOS AIRES,261,290,411,376,787
06,06497,064971407,Luján,BUENOS AIRES,162,227,213,182,395
06,06497,064971409,Luján,BUENOS AIRES,311,337,542,517,1059
06,06497,064970207,Luján,BUENOS AIRES,47,94,76,92,168
06,06497,064971311,Luján,BUENOS AIRES,4,15,6,9,15
06,06497,064970403,Luján,BUENOS AIRES,110,131,148,169,317
06,06497,064970105,Luján,BUENOS AIRES,295,377,409,376,785
06,06497,064970109,Luján,BUENOS AIRES,196,212,284,254,538
06,06497,064970302,Luján,BUENOS AIRES,369,446,997,990,1987
06,06497,064970310,Luján,BUENOS AIRES,118,125,213,212,425
06,06497,064970407,Luján,BUENOS AIRES,195,220,320,340,660
06,06497,064970508,Luján,BUENOS AIRES,327,380,555,476,1031
06,06497,064970513,Luján,BUENOS AIRES,352,409,526,478,1004
06,06497,064970605,Luján,BUENOS AIRES,307,328,515,516,1031
06,06497,064970706,Luján,BUENOS AIRES,291,437,368,262,630
06,06497,064970710,Luján,BUENOS AIRES,238,263,370,340,710
06,06497,064970801,Luján,BUENOS AIRES,219,219,380,345,725
06,06497,064970807,Luján,BUENOS AIRES,234,244,363,361,724
06,06497,064970811,Luján,BUENOS AIRES,406,435,653,593,1246
06,06497,064971207,Luján,BUENOS AIRES,321,352,543,517,1060
06,06497,064971308,Luján,BUENOS AIRES,273,299,376,400,776
06,06497,064971309,Luján,BUENOS AIRES,159,156,241,264,505
06,06497,064971404,Luján,BUENOS AIRES,24,30,52,50,102
06,06497,064970204,Luján,BUENOS AIRES,20,32,28,28,56
06,06497,064970805,Luján,BUENOS AIRES,48,71,81,73,154
06,06497,064970901,Luján,BUENOS AIRES,29,54,39,64,103
06,06497,064971007,Luján,BUENOS AIRES,11,13,20,21,41
06,06497,064971310,Luján,BUENOS AIRES,29,34,78,74,152
06,06497,064970402,Luján,BUENOS AIRES,60,105,82,100,182
06,06497,064970815,Luján,BUENOS AIRES,318,321,513,584,1097
06,06497,064971211,Luján,BUENOS AIRES,130,208,259,243,502
06,06497,064970606,Luján,BUENOS AIRES,100,113,189,196,385
06,06497,064971002,Luján,BUENOS AIRES,49,63,51,77,128
06,06497,064971004,Luján,BUENOS AIRES,30,50,34,57,91
06,06497,064971006,Luján,BUENOS AIRES,22,68,38,37,75
06,06497,064970305,Luján,BUENOS AIRES,213,534,340,345,685
06,06497,064970410,Luján,BUENOS AIRES,234,280,436,469,905
06,06497,064970104,Luján,BUENOS AIRES,313,374,493,384,877
06,06497,064970306,Luján,BUENOS AIRES,205,209,368,375,743
06,06497,064970307,Luján,BUENOS AIRES,432,446,819,851,1670
06,06497,064970405,Luján,BUENOS AIRES,181,184,298,296,594
06,06497,064970505,Luján,BUENOS AIRES,413,436,776,819,1595
06,06497,064970507,Luján,BUENOS AIRES,345,376,605,587,1192
06,06497,064970512,Luján,BUENOS AIRES,322,340,527,504,1031
06,06497,064970708,Luján,BUENOS AIRES,295,434,435,407,842
06,06497,064970806,Luján,BUENOS AIRES,213,240,362,335,697
06,06497,064971106,Luján,BUENOS AIRES,382,425,619,476,1095
06,06497,064971203,Luján,BUENOS AIRES,293,305,508,452,960
06,06497,064971303,Luján,BUENOS AIRES,165,238,258,259,517
06,06497,064971304,Luján,BUENOS AIRES,137,226,215,253,468
06,06497,064971403,Luján,BUENOS AIRES,502,536,833,774,1607
06,06497,064971410,Luján,BUENOS AIRES,292,315,475,434,909
06,06497,064970205,Luján,BUENOS AIRES,8,17,15,15,30
06,06497,064971005,Luján,BUENOS AIRES,11,34,12,16,28
06,06497,064970301,Luján,BUENOS AIRES,9,25,9,13,22
06,06497,064970804,Luján,BUENOS AIRES,71,80,116,129,245
06,06497,064970808,Luján,BUENOS AIRES,79,111,204,148,352
06,06497,064971208,Luján,BUENOS AIRES,118,192,205,225,430
06,06497,064970101,Luján,BUENOS AIRES,381,445,556,450,1006
06,06497,064970103,Luján,BUENOS AIRES,204,231,291,233,524
06,06497,064970106,Luján,BUENOS AIRES,327,413,486,364,850
06,06497,064970107,Luján,BUENOS AIRES,214,243,327,290,617
06,06497,064970111,Luján,BUENOS AIRES,278,293,483,394,877
06,06497,064970503,Luján,BUENOS AIRES,325,340,563,517,1080
06,06497,064970511,Luján,BUENOS AIRES,370,383,686,727,1413
06,06497,064970601,Luján,BUENOS AIRES,338,335,612,560,1172
06,06497,064970603,Luján,BUENOS AIRES,164,182,314,284,598
06,06497,064970703,Luján,BUENOS AIRES,147,218,223,172,395
06,06497,064970705,Luján,BUENOS AIRES,306,405,443,357,800
06,06497,064971204,Luján,BUENOS AIRES,265,276,436,408,844
06,06497,064971102,Luján,BUENOS AIRES,374,409,575,497,1072
06,06497,064971104,Luján,BUENOS AIRES,402,460,559,459,1018
06,06497,064971301,Luján,BUENOS AIRES,460,466,860,779,1639
06,06497,064971302,Luján,BUENOS AIRES,360,371,665,674,1339
06,06497,064971405,Luján,BUENOS AIRES,331,346,631,646,1277
06,06497,064971406,Luján,BUENOS AIRES,392,415,646,566,1212
06,06497,064970203,Luján,BUENOS AIRES,41,73,55,68,123
06,06497,064971209,Luján,BUENOS AIRES,45,64,66,69,135
06,06497,064970110,Luján,BUENOS AIRES,253,285,399,386,785
06,06497,064970404,Luján,BUENOS AIRES,218,186,347,307,654
06,06497,064970408,Luján,BUENOS AIRES,103,157,220,1201,1421
06,06497,064970607,Luján,BUENOS AIRES,361,406,665,600,1265
06,06497,064970610,Luján,BUENOS AIRES,205,259,401,391,792
06,06497,064970810,Luján,BUENOS AIRES,298,317,501,480,981
06,06497,064970812,Luján,BUENOS AIRES,502,510,842,828,1670
06,06497,064970813,Luján,BUENOS AIRES,205,211,316,318,634
06,06497,064971202,Luján,BUENOS AIRES,419,436,683,738,1421
06,06497,064971401,Luján,BUENOS AIRES,419,445,742,655,1397
06,06497,064971402,Luján,BUENOS AIRES,394,388,647,611,1258
06,06497,064970206,Luján,BUENOS AIRES,17,31,27,34,61
06,06658,066584312,Quilmes,BUENOS AIRES,386,402,614,557,1171
06,06658,066583712,Quilmes,BUENOS AIRES,512,543,979,972,1951
06,06658,066580108,Quilmes,BUENOS AIRES,252,284,360,330,690
06,06658,066580101,Quilmes,BUENOS AIRES,2,2,2,3,5
06,06658,066580105,Quilmes,BUENOS AIRES,307,330,469,380,849
06,06658,066580106,Quilmes,BUENOS AIRES,319,344,509,421,930
06,06658,066580110,Quilmes,BUENOS AIRES,508,474,889,887,1776
06,06658,066580205,Quilmes,BUENOS AIRES,231,216,383,410,793
06,06658,066580311,Quilmes,BUENOS AIRES,259,284,396,350,746
06,06658,066580401,Quilmes,BUENOS AIRES,187,221,277,274,551
06,06658,066580409,Quilmes,BUENOS AIRES,345,349,511,406,917
06,06658,066580410,Quilmes,BUENOS AIRES,326,346,480,406,886
06,06658,066580505,Quilmes,BUENOS AIRES,229,246,396,353,749
06,06658,066580612,Quilmes,BUENOS AIRES,282,304,422,362,784
06,06658,066580510,Quilmes,BUENOS AIRES,180,184,274,233,507
06,06658,066580602,Quilmes,BUENOS AIRES,275,347,371,344,715
06,06658,066580611,Quilmes,BUENOS AIRES,346,365,556,464,1020
06,06658,066580701,Quilmes,BUENOS AIRES,263,312,391,327,718
06,06658,066580806,Quilmes,BUENOS AIRES,205,295,254,215,469
06,06658,066580807,Quilmes,BUENOS AIRES,208,276,288,232,520
06,06658,066580812,Quilmes,BUENOS AIRES,218,378,236,154,390
06,06658,066580904,Quilmes,BUENOS AIRES,53,85,69,67,136
06,06658,066581010,Quilmes,BUENOS AIRES,288,332,445,357,802
06,06658,066581109,Quilmes,BUENOS AIRES,301,339,430,363,793
06,06658,066581111,Quilmes,BUENOS AIRES,234,262,336,359,695
06,06658,066581112,Quilmes,BUENOS AIRES,286,336,399,363,762
06,06658,066581509,Quilmes,BUENOS AIRES,348,387,550,496,1046
06,06658,066581607,Quilmes,BUENOS AIRES,231,266,327,318,645
06,06658,066581802,Quilmes,BUENOS AIRES,150,167,263,227,490
06,06658,066581809,Quilmes,BUENOS AIRES,310,371,442,385,827
06,06658,066581810,Quilmes,BUENOS AIRES,211,263,408,340,748
06,06658,066581905,Quilmes,BUENOS AIRES,207,253,301,294,595
06,06658,066581909,Quilmes,BUENOS AIRES,241,265,350,304,654
06,06658,066582305,Quilmes,BUENOS AIRES,329,375,522,468,990
06,06658,066582306,Quilmes,BUENOS AIRES,213,232,345,320,665
06,06658,066582409,Quilmes,BUENOS AIRES,270,305,371,365,736
06,06658,066582510,Quilmes,BUENOS AIRES,354,364,552,455,1007
06,06658,066582716,Quilmes,BUENOS AIRES,217,197,403,379,782
06,06658,066582902,Quilmes,BUENOS AIRES,273,250,403,374,777
06,06658,066582912,Quilmes,BUENOS AIRES,452,459,845,768,1613
06,06658,066583010,Quilmes,BUENOS AIRES,351,302,650,630,1280
06,06658,066583011,Quilmes,BUENOS AIRES,397,379,729,679,1408
06,06658,066583209,Quilmes,BUENOS AIRES,148,148,243,241,484
06,06658,066583206,Quilmes,BUENOS AIRES,107,97,189,194,383
06,06658,066583211,Quilmes,BUENOS AIRES,195,182,394,328,722
06,06658,066583212,Quilmes,BUENOS AIRES,516,535,874,815,1689
06,06658,066583213,Quilmes,BUENOS AIRES,315,315,572,547,1119
06,06658,066583309,Quilmes,BUENOS AIRES,430,386,720,641,1361
06,06658,066583313,Quilmes,BUENOS AIRES,276,315,484,520,1004
06,06658,066583510,Quilmes,BUENOS AIRES,468,413,886,902,1788
06,06658,066583605,Quilmes,BUENOS AIRES,345,311,619,518,1137
06,06658,066583611,Quilmes,BUENOS AIRES,466,459,867,792,1659
06,06658,066583701,Quilmes,BUENOS AIRES,491,486,975,972,1947
06,06658,066583713,Quilmes,BUENOS AIRES,524,475,982,1013,1995
06,06658,066583804,Quilmes,BUENOS AIRES,367,319,710,708,1418
06,06658,066583809,Quilmes,BUENOS AIRES,221,206,427,429,856
06,06658,066583909,Quilmes,BUENOS AIRES,240,248,421,426,847
06,06658,066584104,Quilmes,BUENOS AIRES,466,420,864,815,1679
06,06658,066584114,Quilmes,BUENOS AIRES,320,286,575,577,1152
06,06658,066584211,Quilmes,BUENOS AIRES,276,260,455,397,852
06,06658,066584408,Quilmes,BUENOS AIRES,432,427,729,707,1436
06,06658,066583411,Quilmes,BUENOS AIRES,391,388,626,633,1259
06,06658,066581807,Quilmes,BUENOS AIRES,225,265,326,274,600
06,06658,066580111,Quilmes,BUENOS AIRES,3,3,5,4,9
06,06658,066580208,Quilmes,BUENOS AIRES,326,297,616,569,1185
06,06658,066580211,Quilmes,BUENOS AIRES,385,376,828,787,1615
06,06658,066580212,Quilmes,BUENOS AIRES,287,297,484,438,922
06,06658,066580303,Quilmes,BUENOS AIRES,362,370,603,574,1177
06,06658,066580504,Quilmes,BUENOS AIRES,203,201,312,318,630
06,06658,066580513,Quilmes,BUENOS AIRES,281,275,457,421,878
06,06658,066580710,Quilmes,BUENOS AIRES,464,431,962,949,1911
06,06658,066580801,Quilmes,BUENOS AIRES,163,204,232,196,428
06,06658,066580802,Quilmes,BUENOS AIRES,205,262,225,155,380
06,06658,066580811,Quilmes,BUENOS AIRES,292,392,337,238,575
06,06658,066580814,Quilmes,BUENOS AIRES,199,268,215,161,376
06,06658,066580906,Quilmes,BUENOS AIRES,263,396,335,247,582
06,06658,066581002,Quilmes,BUENOS AIRES,363,339,746,713,1459
06,06658,066581007,Quilmes,BUENOS AIRES,379,420,539,477,1016
06,06658,066581101,Quilmes,BUENOS AIRES,315,321,461,410,871
06,06658,066581103,Quilmes,BUENOS AIRES,232,260,324,284,608
06,06658,066581108,Quilmes,BUENOS AIRES,276,312,429,365,794
06,06658,066581113,Quilmes,BUENOS AIRES,215,243,314,281,595
06,06658,066581201,Quilmes,BUENOS AIRES,440,480,716,632,1348
06,06658,066581301,Quilmes,BUENOS AIRES,170,164,311,341,652
06,06658,066581508,Quilmes,BUENOS AIRES,277,309,384,383,767
06,06658,066581511,Quilmes,BUENOS AIRES,207,246,312,280,592
06,06658,066581609,Quilmes,BUENOS AIRES,292,325,409,381,790
06,06658,066581611,Quilmes,BUENOS AIRES,227,261,345,300,645
06,06658,066581706,Quilmes,BUENOS AIRES,345,390,594,544,1138
06,06658,066581804,Quilmes,BUENOS AIRES,279,290,420,337,757
06,06658,066581808,Quilmes,BUENOS AIRES,269,303,353,312,665
06,06658,066582104,Quilmes,BUENOS AIRES,353,340,682,669,1351
06,06658,066582301,Quilmes,BUENOS AIRES,262,261,415,372,787
06,06658,066582410,Quilmes,BUENOS AIRES,236,257,382,300,682
06,06658,066582307,Quilmes,BUENOS AIRES,198,201,283,253,536
06,06658,066582312,Quilmes,BUENOS AIRES,278,295,458,395,853
06,06658,066582403,Quilmes,BUENOS AIRES,439,468,706,614,1320
06,06658,066582801,Quilmes,BUENOS AIRES,218,260,323,321,644
06,06658,066582806,Quilmes,BUENOS AIRES,368,360,721,679,1400
06,06658,066582810,Quilmes,BUENOS AIRES,388,406,608,529,1137
06,06658,066583001,Quilmes,BUENOS AIRES,389,418,601,537,1138
06,06658,066583003,Quilmes,BUENOS AIRES,311,318,505,476,981
06,06658,066583105,Quilmes,BUENOS AIRES,323,330,535,497,1032
06,06658,066583107,Quilmes,BUENOS AIRES,314,317,476,386,862
06,06658,066583302,Quilmes,BUENOS AIRES,360,293,780,827,1607
06,06658,066583303,Quilmes,BUENOS AIRES,343,281,669,758,1427
06,06658,066583306,Quilmes,BUENOS AIRES,447,470,900,844,1744
06,06658,066583412,Quilmes,BUENOS AIRES,376,390,636,603,1239
06,06658,066583509,Quilmes,BUENOS AIRES,332,338,597,522,1119
06,06658,066583805,Quilmes,BUENOS AIRES,447,360,810,878,1688
06,06658,066583806,Quilmes,BUENOS AIRES,438,443,879,899,1778
06,06658,066583815,Quilmes,BUENOS AIRES,451,404,801,775,1576
06,06658,066583905,Quilmes,BUENOS AIRES,411,361,742,736,1478
06,06658,066583908,Quilmes,BUENOS AIRES,292,297,509,528,1037
06,06658,066584002,Quilmes,BUENOS AIRES,329,344,714,725,1439
06,06658,066584007,Quilmes,BUENOS AIRES,429,413,775,785,1560
06,06658,066584014,Quilmes,BUENOS AIRES,296,264,561,547,1108
06,06658,066584206,Quilmes,BUENOS AIRES,273,268,491,463,954
06,06658,066584301,Quilmes,BUENOS AIRES,290,301,503,478,981
06,06658,066584302,Quilmes,BUENOS AIRES,420,418,739,709,1448
06,06658,066584305,Quilmes,BUENOS AIRES,315,273,619,653,1272
06,06658,066584306,Quilmes,BUENOS AIRES,370,323,718,738,1456
06,06658,066584404,Quilmes,BUENOS AIRES,558,516,1056,1059,2115
06,06658,066584405,Quilmes,BUENOS AIRES,361,336,684,646,1330
06,06658,066580809,Quilmes,BUENOS AIRES,292,414,324,238,562
06,06658,066580103,Quilmes,BUENOS AIRES,350,388,505,454,959
06,06658,066580301,Quilmes,BUENOS AIRES,313,327,566,624,1190
06,06658,066580302,Quilmes,BUENOS AIRES,329,334,641,728,1369
06,06658,066580402,Quilmes,BUENOS AIRES,336,358,556,566,1122
06,06658,066580408,Quilmes,BUENOS AIRES,401,430,633,605,1238
06,06658,066580413,Quilmes,BUENOS AIRES,239,248,360,313,673
06,06658,066580506,Quilmes,BUENOS AIRES,307,281,502,482,984
06,06658,066580603,Quilmes,BUENOS AIRES,314,370,446,382,828
06,06658,066580605,Quilmes,BUENOS AIRES,314,360,458,415,873
06,06658,066580608,Quilmes,BUENOS AIRES,174,204,253,239,492
06,06658,066580708,Quilmes,BUENOS AIRES,376,369,724,676,1400
06,06658,066580804,Quilmes,BUENOS AIRES,328,449,449,337,786
06,06658,066580908,Quilmes,BUENOS AIRES,166,249,203,174,377
06,06658,066580911,Quilmes,BUENOS AIRES,188,239,237,186,423
06,06658,066581003,Quilmes,BUENOS AIRES,264,262,421,414,835
06,06658,066581006,Quilmes,BUENOS AIRES,229,292,334,297,631
06,06658,066581104,Quilmes,BUENOS AIRES,206,225,291,258,549
06,06658,066581106,Quilmes,BUENOS AIRES,272,288,407,360,767
06,06658,066581203,Quilmes,BUENOS AIRES,411,401,711,634,1345
06,06658,066581204,Quilmes,BUENOS AIRES,398,434,561,436,997
06,06658,066581206,Quilmes,BUENOS AIRES,307,381,517,425,942
06,06658,066581208,Quilmes,BUENOS AIRES,308,376,419,332,751
06,06658,066581212,Quilmes,BUENOS AIRES,337,356,493,447,940
06,06658,066581307,Quilmes,BUENOS AIRES,273,255,454,498,952
06,06658,066581407,Quilmes,BUENOS AIRES,261,286,540,519,1059
06,06658,066581603,Quilmes,BUENOS AIRES,241,260,354,289,643
06,06658,066581610,Quilmes,BUENOS AIRES,221,283,302,285,587
06,06658,066581704,Quilmes,BUENOS AIRES,291,336,432,367,799
06,06658,066581705,Quilmes,BUENOS AIRES,322,374,460,384,844
06,06658,066581801,Quilmes,BUENOS AIRES,132,168,180,168,348
06,06658,066581907,Quilmes,BUENOS AIRES,187,200,273,268,541
06,06658,066582003,Quilmes,BUENOS AIRES,421,422,742,715,1457
06,06658,066582004,Quilmes,BUENOS AIRES,349,340,639,634,1273
06,06658,066582005,Quilmes,BUENOS AIRES,361,341,699,639,1338
06,06658,066582116,Quilmes,BUENOS AIRES,283,274,614,576,1190
06,06658,066582202,Quilmes,BUENOS AIRES,329,364,479,407,886
06,06658,066582205,Quilmes,BUENOS AIRES,232,254,350,322,672
06,06658,066582311,Quilmes,BUENOS AIRES,325,317,538,515,1053
06,06658,066582405,Quilmes,BUENOS AIRES,309,333,481,416,897
06,06658,066582411,Quilmes,BUENOS AIRES,245,294,354,299,653
06,06658,066582504,Quilmes,BUENOS AIRES,234,241,332,289,621
06,06658,066582508,Quilmes,BUENOS AIRES,331,328,515,440,955
06,06658,066582606,Quilmes,BUENOS AIRES,341,387,479,461,940
06,06658,066582609,Quilmes,BUENOS AIRES,241,262,379,315,694
06,06658,066582713,Quilmes,BUENOS AIRES,307,290,559,544,1103
06,06658,066582903,Quilmes,BUENOS AIRES,219,253,336,299,635
06,06658,066582907,Quilmes,BUENOS AIRES,374,386,696,634,1330
06,06658,066583103,Quilmes,BUENOS AIRES,658,650,1058,962,2020
06,06658,066583106,Quilmes,BUENOS AIRES,1053,1064,1689,1595,3284
06,06658,066583108,Quilmes,BUENOS AIRES,230,238,367,306,673
06,06658,066583113,Quilmes,BUENOS AIRES,199,204,300,285,585
06,06658,066583305,Quilmes,BUENOS AIRES,637,582,1250,1312,2562
06,06658,066583307,Quilmes,BUENOS AIRES,408,394,747,672,1419
06,06658,066583308,Quilmes,BUENOS AIRES,204,198,361,351,712
06,06658,066583405,Quilmes,BUENOS AIRES,314,305,530,516,1046
06,06658,066583406,Quilmes,BUENOS AIRES,400,416,635,636,1271
06,06658,066583503,Quilmes,BUENOS AIRES,281,288,458,440,898
06,06658,066583702,Quilmes,BUENOS AIRES,633,622,1075,1173,2248
06,06658,066583813,Quilmes,BUENOS AIRES,329,340,578,501,1079
06,06658,066583902,Quilmes,BUENOS AIRES,418,373,755,743,1498
06,06658,066583910,Quilmes,BUENOS AIRES,521,485,1027,985,2012
06,06658,066584004,Quilmes,BUENOS AIRES,456,455,992,985,1977
06,06658,066584012,Quilmes,BUENOS AIRES,389,349,757,728,1485
06,06658,066584017,Quilmes,BUENOS AIRES,487,466,904,876,1780
06,06658,066584105,Quilmes,BUENOS AIRES,426,441,788,727,1515
06,06658,066584106,Quilmes,BUENOS AIRES,475,455,817,788,1605
06,06658,066584115,Quilmes,BUENOS AIRES,310,294,589,605,1194
06,06658,066584401,Quilmes,BUENOS AIRES,329,345,665,576,1241
06,06658,066584407,Quilmes,BUENOS AIRES,229,240,392,357,749
06,06658,066583202,Quilmes,BUENOS AIRES,384,401,623,560,1183
06,06658,066580202,Quilmes,BUENOS AIRES,255,237,432,429,861
06,06658,066580203,Quilmes,BUENOS AIRES,249,259,502,479,981
06,06658,066580207,Quilmes,BUENOS AIRES,298,243,591,593,1184
06,06658,066580306,Quilmes,BUENOS AIRES,307,266,520,438,958
06,06658,066580501,Quilmes,BUENOS AIRES,224,243,372,299,671
06,06658,066580508,Quilmes,BUENOS AIRES,312,314,530,449,979
06,06658,066580805,Quilmes,BUENOS AIRES,322,464,371,314,685
06,06658,066580902,Quilmes,BUENOS AIRES,323,415,490,471,961
06,06658,066581009,Quilmes,BUENOS AIRES,261,302,376,305,681
06,06658,066581209,Quilmes,BUENOS AIRES,287,350,455,400,855
06,06658,066581210,Quilmes,BUENOS AIRES,281,371,439,372,811
06,06658,066581405,Quilmes,BUENOS AIRES,131,128,266,272,538
06,06658,066581406,Quilmes,BUENOS AIRES,135,128,265,267,532
06,06658,066581409,Quilmes,BUENOS AIRES,434,427,824,864,1688
06,06658,066581602,Quilmes,BUENOS AIRES,260,328,377,308,685
06,06658,066581605,Quilmes,BUENOS AIRES,209,252,312,253,565
06,06658,066581710,Quilmes,BUENOS AIRES,278,303,401,353,754
06,06658,066581712,Quilmes,BUENOS AIRES,317,358,432,371,803
06,06658,066581806,Quilmes,BUENOS AIRES,286,351,418,325,743
06,06658,066581812,Quilmes,BUENOS AIRES,148,175,207,185,392
06,06658,066581903,Quilmes,BUENOS AIRES,201,236,281,258,539
06,06658,066582006,Quilmes,BUENOS AIRES,254,201,530,536,1066
06,06658,066582101,Quilmes,BUENOS AIRES,492,502,866,784,1650
06,06658,066582103,Quilmes,BUENOS AIRES,495,512,854,832,1686
06,06658,066582111,Quilmes,BUENOS AIRES,451,475,800,775,1575
06,06658,066582115,Quilmes,BUENOS AIRES,296,291,608,605,1213
06,06658,066582201,Quilmes,BUENOS AIRES,328,371,485,448,933
06,06658,066582203,Quilmes,BUENOS AIRES,314,364,479,427,906
06,06658,066582204,Quilmes,BUENOS AIRES,266,292,394,330,724
06,06658,066582209,Quilmes,BUENOS AIRES,456,480,835,754,1589
06,06658,066582402,Quilmes,BUENOS AIRES,345,366,502,467,969
06,06658,066582404,Quilmes,BUENOS AIRES,284,320,413,373,786
06,06658,066582406,Quilmes,BUENOS AIRES,358,388,547,519,1066
06,06658,066582412,Quilmes,BUENOS AIRES,237,265,339,321,660
06,06658,066582506,Quilmes,BUENOS AIRES,304,330,446,367,813
06,06658,066582603,Quilmes,BUENOS AIRES,341,358,537,488,1025
06,06658,066582607,Quilmes,BUENOS AIRES,278,301,429,345,774
06,06658,066582705,Quilmes,BUENOS AIRES,120,117,239,232,471
06,06658,066582710,Quilmes,BUENOS AIRES,288,232,563,513,1076
06,06658,066582808,Quilmes,BUENOS AIRES,431,372,743,724,1467
06,06658,066582910,Quilmes,BUENOS AIRES,378,343,733,722,1455
06,06658,066583008,Quilmes,BUENOS AIRES,389,395,722,767,1489
06,06658,066583012,Quilmes,BUENOS AIRES,275,259,508,465,973
06,06658,066583101,Quilmes,BUENOS AIRES,310,330,468,355,823
06,06658,066583201,Quilmes,BUENOS AIRES,241,242,397,352,749
06,06658,066583205,Quilmes,BUENOS AIRES,274,259,472,419,891
06,06658,066583402,Quilmes,BUENOS AIRES,319,282,574,560,1134
06,06658,066583407,Quilmes,BUENOS AIRES,309,322,479,429,908
06,06658,066583602,Quilmes,BUENOS AIRES,535,502,1042,1043,2085
06,06658,066583604,Quilmes,BUENOS AIRES,249,260,394,381,775
06,06658,066583705,Quilmes,BUENOS AIRES,206,301,377,388,765
06,06658,066583708,Quilmes,BUENOS AIRES,398,398,821,788,1609
06,06658,066583709,Quilmes,BUENOS AIRES,310,299,552,554,1106
06,06658,066583803,Quilmes,BUENOS AIRES,251,231,475,472,947
06,06658,066583812,Quilmes,BUENOS AIRES,355,297,610,538,1148
06,06658,066584006,Quilmes,BUENOS AIRES,143,134,268,271,539
06,06658,066584015,Quilmes,BUENOS AIRES,551,498,1069,1048,2117
06,06658,066584101,Quilmes,BUENOS AIRES,330,279,580,567,1147
06,06658,066584109,Quilmes,BUENOS AIRES,468,460,872,840,1712
06,06658,066584111,Quilmes,BUENOS AIRES,253,244,490,490,980
06,06658,066584112,Quilmes,BUENOS AIRES,313,321,566,615,1181
06,06658,066584203,Quilmes,BUENOS AIRES,401,357,687,700,1387
06,06658,066584212,Quilmes,BUENOS AIRES,404,481,758,664,1422
06,06658,066584307,Quilmes,BUENOS AIRES,247,200,525,517,1042
06,06658,066584308,Quilmes,BUENOS AIRES,470,465,880,833,1713
06,06658,066580102,Quilmes,BUENOS AIRES,378,405,579,535,1114
06,06658,066580112,Quilmes,BUENOS AIRES,50,45,46,70,116
06,06658,066580404,Quilmes,BUENOS AIRES,271,273,495,479,974
06,06658,066580405,Quilmes,BUENOS AIRES,284,321,479,459,938
06,06658,066580502,Quilmes,BUENOS AIRES,171,181,261,236,497
06,06658,066580503,Quilmes,BUENOS AIRES,299,290,468,423,891
06,06658,066580705,Quilmes,BUENOS AIRES,269,315,372,328,700
06,06658,066580707,Quilmes,BUENOS AIRES,272,269,475,438,913
06,06658,066580907,Quilmes,BUENOS AIRES,195,297,235,179,414
06,06658,066581012,Quilmes,BUENOS AIRES,427,428,845,864,1709
06,06658,066581110,Quilmes,BUENOS AIRES,306,345,429,368,797
06,06658,066581213,Quilmes,BUENOS AIRES,264,320,372,296,668
06,06658,066581303,Quilmes,BUENOS AIRES,109,99,204,188,392
06,06658,066581309,Quilmes,BUENOS AIRES,268,249,449,450,899
06,06658,066581401,Quilmes,BUENOS AIRES,152,155,324,299,623
06,06658,066581402,Quilmes,BUENOS AIRES,65,67,132,134,266
06,06658,066581403,Quilmes,BUENOS AIRES,81,85,172,167,339
06,06658,066581404,Quilmes,BUENOS AIRES,188,188,354,385,739
06,06658,066581408,Quilmes,BUENOS AIRES,217,221,460,422,882
06,06658,066581505,Quilmes,BUENOS AIRES,371,366,619,579,1198
06,06658,066581510,Quilmes,BUENOS AIRES,233,261,337,334,671
06,06658,066581612,Quilmes,BUENOS AIRES,253,254,365,335,700
06,06658,066581709,Quilmes,BUENOS AIRES,364,410,514,471,985
06,06658,066581811,Quilmes,BUENOS AIRES,247,280,332,288,620
06,06658,066581904,Quilmes,BUENOS AIRES,193,220,255,219,474
06,06658,066581908,Quilmes,BUENOS AIRES,276,319,407,373,780
06,06658,066581910,Quilmes,BUENOS AIRES,277,340,426,431,857
06,06658,066581911,Quilmes,BUENOS AIRES,305,295,516,529,1045
06,06658,066582001,Quilmes,BUENOS AIRES,301,327,474,483,957
06,06658,066582009,Quilmes,BUENOS AIRES,566,554,1040,910,1950
06,06658,066582105,Quilmes,BUENOS AIRES,392,381,727,722,1449
06,06658,066582106,Quilmes,BUENOS AIRES,469,453,900,837,1737
06,06658,066582114,Quilmes,BUENOS AIRES,366,374,659,630,1289
06,06658,066582207,Quilmes,BUENOS AIRES,298,331,426,385,811
06,06658,066582309,Quilmes,BUENOS AIRES,371,351,694,675,1369
06,06658,066582407,Quilmes,BUENOS AIRES,323,348,503,459,962
06,06658,066582704,Quilmes,BUENOS AIRES,125,121,230,239,469
06,06658,066582901,Quilmes,BUENOS AIRES,432,430,669,625,1294
06,06658,066582905,Quilmes,BUENOS AIRES,345,368,554,501,1055
06,06658,066583004,Quilmes,BUENOS AIRES,262,292,394,344,738
06,06658,066583009,Quilmes,BUENOS AIRES,457,417,823,832,1655
06,06658,066583204,Quilmes,BUENOS AIRES,193,199,322,309,631
06,06658,066583207,Quilmes,BUENOS AIRES,523,526,873,689,1562
06,06658,066583304,Quilmes,BUENOS AIRES,352,344,794,742,1536
06,06658,066583403,Quilmes,BUENOS AIRES,326,302,567,525,1092
06,06658,066583404,Quilmes,BUENOS AIRES,333,281,566,523,1089
06,06658,066583505,Quilmes,BUENOS AIRES,271,259,432,387,819
06,06658,066583507,Quilmes,BUENOS AIRES,335,314,543,511,1054
06,06658,066583603,Quilmes,BUENOS AIRES,367,376,573,544,1117
06,06658,066583608,Quilmes,BUENOS AIRES,293,300,527,495,1022
06,06658,066583614,Quilmes,BUENOS AIRES,310,264,603,560,1163
06,06658,066583704,Quilmes,BUENOS AIRES,233,241,470,446,916
06,06658,066583710,Quilmes,BUENOS AIRES,272,268,514,499,1013
06,06658,066583811,Quilmes,BUENOS AIRES,522,505,924,920,1844
06,06658,066584009,Quilmes,BUENOS AIRES,195,181,405,389,794
06,06658,066584016,Quilmes,BUENOS AIRES,339,350,600,622,1222
06,06658,066584303,Quilmes,BUENOS AIRES,498,468,943,839,1782
06,06658,066584304,Quilmes,BUENOS AIRES,480,460,1001,989,1990
06,06658,066584310,Quilmes,BUENOS AIRES,232,239,444,385,829
06,06658,066584311,Quilmes,BUENOS AIRES,363,363,659,635,1294
06,06658,066584406,Quilmes,BUENOS AIRES,349,333,620,595,1215
06,06658,066584411,Quilmes,BUENOS AIRES,503,477,952,1018,1970
06,06658,066584413,Quilmes,BUENOS AIRES,145,140,290,292,582
06,06658,066584414,Quilmes,BUENOS AIRES,187,190,398,368,766
06,06658,066580815,Quilmes,BUENOS AIRES,157,247,183,129,312
06,06658,066580104,Quilmes,BUENOS AIRES,249,278,352,328,680
06,06658,066580206,Quilmes,BUENOS AIRES,428,438,702,714,1416
06,06658,066580307,Quilmes,BUENOS AIRES,378,366,585,552,1137
06,06658,066580412,Quilmes,BUENOS AIRES,398,420,642,568,1210
06,06658,066580511,Quilmes,BUENOS AIRES,356,374,579,533,1112
06,06658,066580601,Quilmes,BUENOS AIRES,237,314,331,298,629
06,06658,066580702,Quilmes,BUENOS AIRES,259,314,453,408,861
06,06658,066580709,Quilmes,BUENOS AIRES,305,287,604,610,1214
06,06658,066580711,Quilmes,BUENOS AIRES,260,295,445,420,865
06,06658,066580813,Quilmes,BUENOS AIRES,138,235,161,105,266
06,06658,066580909,Quilmes,BUENOS AIRES,183,239,232,178,410
06,06658,066580910,Quilmes,BUENOS AIRES,302,439,366,299,665
06,06658,066580913,Quilmes,BUENOS AIRES,239,332,326,256,582
06,06658,066581001,Quilmes,BUENOS AIRES,307,320,594,624,1218
06,06658,066581102,Quilmes,BUENOS AIRES,260,301,367,310,677
06,06658,066581107,Quilmes,BUENOS AIRES,289,336,428,358,786
06,06658,066581302,Quilmes,BUENOS AIRES,137,130,270,259,529
06,06658,066581504,Quilmes,BUENOS AIRES,171,161,271,286,557
06,06658,066581604,Quilmes,BUENOS AIRES,186,212,267,219,486
06,06658,066581711,Quilmes,BUENOS AIRES,361,351,545,503,1048
06,06658,066581901,Quilmes,BUENOS AIRES,228,288,264,248,512
06,06658,066582110,Quilmes,BUENOS AIRES,307,313,556,524,1080
06,06658,066582112,Quilmes,BUENOS AIRES,553,496,1085,998,2083
06,06658,066582206,Quilmes,BUENOS AIRES,242,282,375,336,711
06,06658,066582310,Quilmes,BUENOS AIRES,378,373,700,691,1391
06,06658,066582401,Quilmes,BUENOS AIRES,316,344,489,495,984
06,06658,066582513,Quilmes,BUENOS AIRES,375,396,619,530,1149
06,06658,066582601,Quilmes,BUENOS AIRES,517,549,846,814,1660
06,06658,066582604,Quilmes,BUENOS AIRES,349,340,543,472,1015
06,06658,066582702,Quilmes,BUENOS AIRES,327,320,594,571,1165
06,06658,066582706,Quilmes,BUENOS AIRES,402,403,715,735,1450
06,06658,066582708,Quilmes,BUENOS AIRES,214,170,417,421,838
06,06658,066582709,Quilmes,BUENOS AIRES,457,450,860,814,1674
06,06658,066582712,Quilmes,BUENOS AIRES,370,284,708,691,1399
06,06658,066582908,Quilmes,BUENOS AIRES,391,378,785,784,1569
06,06658,066582911,Quilmes,BUENOS AIRES,360,372,595,577,1172
06,06658,066583102,Quilmes,BUENOS AIRES,387,415,594,523,1117
06,06658,066583104,Quilmes,BUENOS AIRES,456,436,752,634,1386
06,06658,066583109,Quilmes,BUENOS AIRES,270,287,413,372,785
06,06658,066583112,Quilmes,BUENOS AIRES,235,245,369,327,696
06,06658,066583203,Quilmes,BUENOS AIRES,365,396,605,502,1107
06,06658,066583311,Quilmes,BUENOS AIRES,374,404,617,525,1142
06,06658,066583413,Quilmes,BUENOS AIRES,409,409,681,616,1297
06,06658,066583501,Quilmes,BUENOS AIRES,324,277,564,499,1063
06,06658,066583502,Quilmes,BUENOS AIRES,394,404,681,645,1326
06,06658,066583601,Quilmes,BUENOS AIRES,524,472,1030,1033,2063
06,06658,066583703,Quilmes,BUENOS AIRES,275,265,553,516,1069
06,06658,066583706,Quilmes,BUENOS AIRES,307,240,654,650,1304
06,06658,066583802,Quilmes,BUENOS AIRES,490,368,966,1008,1974
06,06658,066583807,Quilmes,BUENOS AIRES,108,101,227,210,437
06,06658,066583810,Quilmes,BUENOS AIRES,222,213,396,434,830
06,06658,066583814,Quilmes,BUENOS AIRES,421,382,813,749,1562
06,06658,066583907,Quilmes,BUENOS AIRES,370,351,673,672,1345
06,06658,066584003,Quilmes,BUENOS AIRES,301,339,601,674,1275
06,06658,066584008,Quilmes,BUENOS AIRES,284,220,514,538,1052
06,06658,066584013,Quilmes,BUENOS AIRES,333,338,609,645,1254
06,06658,066584107,Quilmes,BUENOS AIRES,497,532,943,871,1814
06,06658,066584113,Quilmes,BUENOS AIRES,495,433,941,923,1864
06,06658,066584209,Quilmes,BUENOS AIRES,467,473,808,741,1549
06,06658,066584309,Quilmes,BUENOS AIRES,237,199,410,381,791
06,06658,066584403,Quilmes,BUENOS AIRES,404,404,792,774,1566
06,06658,066584409,Quilmes,BUENOS AIRES,530,486,1012,1002,2014
06,06658,066584410,Quilmes,BUENOS AIRES,402,374,755,752,1507
06,06658,066583711,Quilmes,BUENOS AIRES,539,412,975,928,1903
06,06658,066583410,Quilmes,BUENOS AIRES,245,257,404,329,733
06,06658,066583612,Quilmes,BUENOS AIRES,398,354,754,754,1508
06,06658,066584207,Quilmes,BUENOS AIRES,226,243,371,413,784
06,06658,066583208,Quilmes,BUENOS AIRES,548,557,865,815,1680
06,06658,066580107,Quilmes,BUENOS AIRES,243,288,388,301,689
06,06658,066580308,Quilmes,BUENOS AIRES,470,498,829,678,1507
06,06658,066580309,Quilmes,BUENOS AIRES,452,482,684,599,1283
06,06658,066580403,Quilmes,BUENOS AIRES,338,324,596,573,1169
06,06658,066580406,Quilmes,BUENOS AIRES,283,277,479,433,912
06,06658,066580415,Quilmes,BUENOS AIRES,288,293,465,444,909
06,06658,066580509,Quilmes,BUENOS AIRES,363,392,572,519,1091
06,06658,066580512,Quilmes,BUENOS AIRES,266,280,417,406,823
06,06658,066580514,Quilmes,BUENOS AIRES,286,311,453,419,872
06,06658,066580606,Quilmes,BUENOS AIRES,196,211,285,253,538
06,06658,066580607,Quilmes,BUENOS AIRES,269,289,381,357,738
06,06658,066580609,Quilmes,BUENOS AIRES,403,425,639,566,1205
06,06658,066580706,Quilmes,BUENOS AIRES,270,277,476,410,886
06,06658,066580803,Quilmes,BUENOS AIRES,169,231,209,140,349
06,06658,066580808,Quilmes,BUENOS AIRES,216,372,229,169,398
06,06658,066580901,Quilmes,BUENOS AIRES,334,363,513,508,1021
06,06658,066581008,Quilmes,BUENOS AIRES,304,396,439,342,781
06,06658,066581013,Quilmes,BUENOS AIRES,233,228,435,454,889
06,06658,066581202,Quilmes,BUENOS AIRES,353,402,561,469,1030
06,06658,066581205,Quilmes,BUENOS AIRES,325,373,482,422,904
06,06658,066581211,Quilmes,BUENOS AIRES,344,416,487,442,929
06,06658,066581306,Quilmes,BUENOS AIRES,214,206,406,409,815
06,06658,066581502,Quilmes,BUENOS AIRES,302,334,478,428,906
06,06658,066581503,Quilmes,BUENOS AIRES,325,317,595,595,1190
06,06658,066581506,Quilmes,BUENOS AIRES,183,209,274,270,544
06,06658,066581507,Quilmes,BUENOS AIRES,262,287,410,351,761
06,06658,066581513,Quilmes,BUENOS AIRES,241,254,350,312,662
06,06658,066581601,Quilmes,BUENOS AIRES,261,291,356,323,679
06,06658,066581606,Quilmes,BUENOS AIRES,265,321,400,330,730
06,06658,066581701,Quilmes,BUENOS AIRES,300,307,453,368,821
06,06658,066581703,Quilmes,BUENOS AIRES,254,288,359,308,667
06,06658,066581707,Quilmes,BUENOS AIRES,298,336,445,392,837
06,06658,066581902,Quilmes,BUENOS AIRES,265,302,374,317,691
06,06658,066581906,Quilmes,BUENOS AIRES,190,213,280,235,515
06,06658,066582007,Quilmes,BUENOS AIRES,259,260,457,454,911
06,06658,066582102,Quilmes,BUENOS AIRES,478,401,882,867,1749
06,06658,066582108,Quilmes,BUENOS AIRES,582,563,1123,1120,2243
06,06658,066582109,Quilmes,BUENOS AIRES,367,359,719,692,1411
06,06658,066582113,Quilmes,BUENOS AIRES,505,476,963,903,1866
06,06658,066582210,Quilmes,BUENOS AIRES,379,392,634,550,1184
06,06658,066582302,Quilmes,BUENOS AIRES,379,344,624,586,1210
06,06658,066582303,Quilmes,BUENOS AIRES,450,516,691,642,1333
06,06658,066582304,Quilmes,BUENOS AIRES,324,324,596,541,1137
06,06658,066582408,Quilmes,BUENOS AIRES,271,302,428,347,775
06,06658,066582501,Quilmes,BUENOS AIRES,224,265,313,303,616
06,06658,066582502,Quilmes,BUENOS AIRES,238,272,361,290,651
06,06658,066582511,Quilmes,BUENOS AIRES,391,470,647,667,1314
06,06658,066582610,Quilmes,BUENOS AIRES,368,412,545,470,1015
06,06658,066582701,Quilmes,BUENOS AIRES,389,324,734,695,1429
06,06658,066582711,Quilmes,BUENOS AIRES,422,352,800,736,1536
06,06658,066582803,Quilmes,BUENOS AIRES,293,307,448,374,822
06,06658,066582807,Quilmes,BUENOS AIRES,332,304,667,661,1328
06,06658,066582809,Quilmes,BUENOS AIRES,370,372,641,572,1213
06,06658,066582904,Quilmes,BUENOS AIRES,258,270,406,389,795
06,06658,066582909,Quilmes,BUENOS AIRES,295,277,667,609,1276
06,06658,066583002,Quilmes,BUENOS AIRES,374,370,594,560,1154
06,06658,066583005,Quilmes,BUENOS AIRES,373,375,603,544,1147
06,06658,066583110,Quilmes,BUENOS AIRES,420,402,675,629,1304
06,06658,066583111,Quilmes,BUENOS AIRES,392,328,668,637,1305
06,06658,066583301,Quilmes,BUENOS AIRES,553,528,1039,1020,2059
06,06658,066583310,Quilmes,BUENOS AIRES,276,277,439,370,809
06,06658,066583401,Quilmes,BUENOS AIRES,403,417,654,591,1245
06,06658,066583408,Quilmes,BUENOS AIRES,340,348,556,479,1035
06,06658,066583506,Quilmes,BUENOS AIRES,416,418,670,651,1321
06,06658,066583609,Quilmes,BUENOS AIRES,352,277,624,601,1225
06,06658,066583610,Quilmes,BUENOS AIRES,309,303,529,468,997
06,06658,066583613,Quilmes,BUENOS AIRES,336,276,647,613,1260
06,06658,066583816,Quilmes,BUENOS AIRES,604,513,1135,1059,2194
06,06658,066583906,Quilmes,BUENOS AIRES,318,305,620,609,1229
06,06658,066584005,Quilmes,BUENOS AIRES,348,345,743,735,1478
06,06658,066584011,Quilmes,BUENOS AIRES,212,187,418,405,823
06,06658,066584103,Quilmes,BUENOS AIRES,421,431,737,716,1453
06,06658,066584108,Quilmes,BUENOS AIRES,425,395,796,768,1564
06,06658,066584208,Quilmes,BUENOS AIRES,341,357,639,600,1239
06,06658,066584213,Quilmes,BUENOS AIRES,450,419,816,769,1585
06,06658,066584402,Quilmes,BUENOS AIRES,352,327,656,668,1324
06,06658,066584412,Quilmes,BUENOS AIRES,393,389,753,756,1509
06,06658,066580414,Quilmes,BUENOS AIRES,198,445,350,296,646
06,06658,066580704,Quilmes,BUENOS AIRES,302,373,448,379,827
06,06658,066582208,Quilmes,BUENOS AIRES,223,227,351,323,674
06,06658,066580109,Quilmes,BUENOS AIRES,315,334,482,445,927
06,06658,066580113,Quilmes,BUENOS AIRES,28,35,38,41,79
06,06658,066580201,Quilmes,BUENOS AIRES,103,109,174,197,371
06,06658,066580209,Quilmes,BUENOS AIRES,287,269,493,436,929
06,06658,066580210,Quilmes,BUENOS AIRES,280,291,464,457,921
06,06658,066580304,Quilmes,BUENOS AIRES,299,332,509,431,940
06,06658,066580305,Quilmes,BUENOS AIRES,386,361,688,587,1275
06,06658,066580310,Quilmes,BUENOS AIRES,311,353,453,424,877
06,06658,066580407,Quilmes,BUENOS AIRES,292,296,523,517,1040
06,06658,066580411,Quilmes,BUENOS AIRES,339,344,560,511,1071
06,06658,066580507,Quilmes,BUENOS AIRES,413,419,640,592,1232
06,06658,066580604,Quilmes,BUENOS AIRES,284,353,435,382,817
06,06658,066580610,Quilmes,BUENOS AIRES,358,385,552,519,1071
06,06658,066580703,Quilmes,BUENOS AIRES,275,312,403,364,767
06,06658,066580810,Quilmes,BUENOS AIRES,198,313,210,134,344
06,06658,066580903,Quilmes,BUENOS AIRES,278,422,383,333,716
06,06658,066580905,Quilmes,BUENOS AIRES,208,310,242,136,378
06,06658,066580912,Quilmes,BUENOS AIRES,222,293,286,207,493
06,06658,066581004,Quilmes,BUENOS AIRES,255,318,377,324,701
06,06658,066581005,Quilmes,BUENOS AIRES,417,470,513,496,1009
06,06658,066581105,Quilmes,BUENOS AIRES,162,178,232,188,420
06,06658,066581207,Quilmes,BUENOS AIRES,286,361,394,288,682
06,06658,066581304,Quilmes,BUENOS AIRES,241,231,442,394,836
06,06658,066581308,Quilmes,BUENOS AIRES,235,233,427,419,846
06,06658,066581310,Quilmes,BUENOS AIRES,226,191,408,412,820
06,06658,066581410,Quilmes,BUENOS AIRES,203,214,400,402,802
06,06658,066581501,Quilmes,BUENOS AIRES,254,300,384,365,749
06,06658,066581512,Quilmes,BUENOS AIRES,234,272,354,279,633
06,06658,066581608,Quilmes,BUENOS AIRES,251,267,343,321,664
06,06658,066581702,Quilmes,BUENOS AIRES,268,322,386,337,723
06,06658,066581708,Quilmes,BUENOS AIRES,380,429,545,485,1030
06,06658,066581803,Quilmes,BUENOS AIRES,192,219,332,292,624
06,06658,066581805,Quilmes,BUENOS AIRES,271,319,402,338,740
06,06658,066582002,Quilmes,BUENOS AIRES,319,387,419,321,740
06,06658,066582008,Quilmes,BUENOS AIRES,386,362,795,757,1552
06,06658,066582010,Quilmes,BUENOS AIRES,510,492,903,824,1727
06,06658,066582011,Quilmes,BUENOS AIRES,441,436,830,773,1603
06,06658,066582107,Quilmes,BUENOS AIRES,596,570,1122,1138,2260
06,06658,066582211,Quilmes,BUENOS AIRES,368,383,578,484,1062
06,06658,066582308,Quilmes,BUENOS AIRES,216,212,316,282,598
06,06658,066582503,Quilmes,BUENOS AIRES,304,344,454,413,867
06,06658,066582505,Quilmes,BUENOS AIRES,281,277,434,350,784
06,06658,066582507,Quilmes,BUENOS AIRES,265,294,400,350,750
06,06658,066582509,Quilmes,BUENOS AIRES,231,247,340,299,639
06,06658,066582512,Quilmes,BUENOS AIRES,329,365,628,614,1242
06,06658,066582602,Quilmes,BUENOS AIRES,463,461,794,759,1553
06,06658,066582608,Quilmes,BUENOS AIRES,266,281,398,357,755
06,06658,066582703,Quilmes,BUENOS AIRES,181,176,375,386,761
06,06658,066582707,Quilmes,BUENOS AIRES,288,222,547,550,1097
06,06658,066582714,Quilmes,BUENOS AIRES,233,217,455,466,921
06,06658,066582715,Quilmes,BUENOS AIRES,291,238,563,584,1147
06,06658,066582802,Quilmes,BUENOS AIRES,359,378,587,520,1107
06,06658,066582804,Quilmes,BUENOS AIRES,368,405,574,516,1090
06,06658,066582805,Quilmes,BUENOS AIRES,268,298,437,399,836
06,06658,066582906,Quilmes,BUENOS AIRES,370,363,638,616,1254
06,06658,066583006,Quilmes,BUENOS AIRES,336,368,569,522,1091
06,06658,066583007,Quilmes,BUENOS AIRES,406,401,730,726,1456
06,06658,066583210,Quilmes,BUENOS AIRES,445,425,790,729,1519
06,06658,066583312,Quilmes,BUENOS AIRES,312,324,517,479,996
06,06658,066583508,Quilmes,BUENOS AIRES,406,413,720,671,1391
06,06658,066583606,Quilmes,BUENOS AIRES,243,211,403,412,815
06,06658,066583607,Quilmes,BUENOS AIRES,522,550,932,815,1747
06,06658,066583707,Quilmes,BUENOS AIRES,447,341,895,821,1716
06,06658,066583801,Quilmes,BUENOS AIRES,525,370,1029,1076,2105
06,06658,066583808,Quilmes,BUENOS AIRES,255,254,516,534,1050
06,06658,066583901,Quilmes,BUENOS AIRES,449,400,814,780,1594
06,06658,066583903,Quilmes,BUENOS AIRES,403,346,723,757,1480
06,06658,066583904,Quilmes,BUENOS AIRES,242,243,421,398,819
06,06658,066584001,Quilmes,BUENOS AIRES,438,415,858,906,1764
06,06658,066584010,Quilmes,BUENOS AIRES,172,141,372,380,752
06,06658,066584102,Quilmes,BUENOS AIRES,631,570,1313,1289,2602
06,06658,066584110,Quilmes,BUENOS AIRES,482,436,918,904,1822
06,06658,066584201,Quilmes,BUENOS AIRES,250,246,462,430,892
06,06658,066584202,Quilmes,BUENOS AIRES,283,288,494,458,952
06,06658,066584204,Quilmes,BUENOS AIRES,338,228,574,525,1099
06,06658,066584205,Quilmes,BUENOS AIRES,288,288,540,564,1104
06,06658,066584210,Quilmes,BUENOS AIRES,386,407,631,616,1247
06,06658,066581305,Quilmes,BUENOS AIRES,136,130,250,227,477
06,06658,066583409,Quilmes,BUENOS AIRES,288,296,512,459,971
06,06658,066583504,Quilmes,BUENOS AIRES,378,387,691,633,1324
06,06658,066582605,Quilmes,BUENOS AIRES,273,292,403,371,774
06,06658,066580204,Quilmes,BUENOS AIRES,290,285,547,619,1166
06,06658,066581011,Quilmes,BUENOS AIRES,353,378,549,495,1044
06,06658,066582514,Quilmes,BUENOS AIRES,141,150,220,204,424
06,06665,066650201,Ramallo,BUENOS AIRES,22,23,38,29,67
06,06665,066650402,Ramallo,BUENOS AIRES,47,109,85,80,165
06,06665,066650311,Ramallo,BUENOS AIRES,33,33,57,63,120
06,06665,066651007,Ramallo,BUENOS AIRES,328,350,520,534,1054
06,06665,066650403,Ramallo,BUENOS AIRES,26,38,26,35,61
06,06665,066651005,Ramallo,BUENOS AIRES,7,21,9,13,22
06,06665,066650204,Ramallo,BUENOS AIRES,339,376,472,399,871
06,06665,066650501,Ramallo,BUENOS AIRES,11,18,13,18,31
06,06665,066651002,Ramallo,BUENOS AIRES,338,362,577,583,1160
06,06665,066651306,Ramallo,BUENOS AIRES,425,455,702,711,1413
06,06665,066650304,Ramallo,BUENOS AIRES,17,23,36,30,66
06,06665,066650502,Ramallo,BUENOS AIRES,27,47,40,40,80
06,06665,066650208,Ramallo,BUENOS AIRES,284,324,483,475,958
06,06665,066650302,Ramallo,BUENOS AIRES,285,307,550,504,1054
06,06665,066650309,Ramallo,BUENOS AIRES,286,308,532,545,1077
06,06665,066650310,Ramallo,BUENOS AIRES,457,487,655,627,1282
06,06665,066651303,Ramallo,BUENOS AIRES,308,352,559,536,1095
06,06665,066651305,Ramallo,BUENOS AIRES,419,441,668,655,1323
06,06665,066651308,Ramallo,BUENOS AIRES,255,270,460,471,931
06,06665,066651309,Ramallo,BUENOS AIRES,377,406,734,733,1467
06,06665,066651312,Ramallo,BUENOS AIRES,508,526,836,809,1645
06,06665,066650105,Ramallo,BUENOS AIRES,66,123,82,114,196
06,06665,066650301,Ramallo,BUENOS AIRES,18,22,20,27,47
06,06665,066651101,Ramallo,BUENOS AIRES,21,45,29,42,71
06,06665,066651301,Ramallo,BUENOS AIRES,9,11,6,17,23
06,06665,066650202,Ramallo,BUENOS AIRES,304,341,439,381,820
06,06665,066650305,Ramallo,BUENOS AIRES,153,152,242,232,474
06,06665,066651310,Ramallo,BUENOS AIRES,311,340,488,453,941
06,06665,066651004,Ramallo,BUENOS AIRES,23,34,21,33,54
06,06665,066650303,Ramallo,BUENOS AIRES,237,282,409,452,861
06,06665,066650101,Ramallo,BUENOS AIRES,239,270,399,387,786
06,06665,066650203,Ramallo,BUENOS AIRES,401,442,614,518,1132
06,06665,066650205,Ramallo,BUENOS AIRES,451,467,733,647,1380
06,06665,066650401,Ramallo,BUENOS AIRES,123,150,216,186,402
06,06665,066650209,Ramallo,BUENOS AIRES,27,37,36,46,82
06,06665,066651003,Ramallo,BUENOS AIRES,14,29,15,22,37
06,06665,066650503,Ramallo,BUENOS AIRES,33,53,41,46,87
06,06665,066650102,Ramallo,BUENOS AIRES,195,214,355,370,725
06,06665,066650207,Ramallo,BUENOS AIRES,351,379,505,440,945
06,06665,066650306,Ramallo,BUENOS AIRES,169,188,294,305,599
06,06665,066651001,Ramallo,BUENOS AIRES,311,345,520,467,987
06,06665,066651304,Ramallo,BUENOS AIRES,318,322,482,493,975
06,06665,066651307,Ramallo,BUENOS AIRES,268,288,413,403,816
06,06665,066650103,Ramallo,BUENOS AIRES,7,14,9,19,28
06,06665,066650104,Ramallo,BUENOS AIRES,13,105,15,22,37
06,06665,066650801,Ramallo,BUENOS AIRES,13,27,15,24,39
06,06665,066651006,Ramallo,BUENOS AIRES,8,13,14,14,28
06,06665,066651202,Ramallo,BUENOS AIRES,2,70,0,2,2
06,06665,066650206,Ramallo,BUENOS AIRES,227,238,415,400,815
06,06665,066650307,Ramallo,BUENOS AIRES,135,139,229,233,462
06,06665,066651201,Ramallo,BUENOS AIRES,0,4,0,0,0
06,06665,066650308,Ramallo,BUENOS AIRES,96,104,179,184,363
06,06665,066651008,Ramallo,BUENOS AIRES,385,404,685,684,1369
06,06665,066651302,Ramallo,BUENOS AIRES,0,1,0,0,0
06,06665,066651311,Ramallo,BUENOS AIRES,381,415,626,614,1240
06,06665,066650404,Ramallo,BUENOS AIRES,18,45,18,28,46
06,06665,066650601,Ramallo,BUENOS AIRES,13,31,19,24,43
06,06665,066650701,Ramallo,BUENOS AIRES,36,44,48,52,100
06,06665,066650901,Ramallo,BUENOS AIRES,26,51,39,49,88
06,06441,064414005,La Plata,BUENOS AIRES,182,186,295,258,553
06,06441,064414010,La Plata,BUENOS AIRES,371,357,686,656,1342
06,06441,064414101,La Plata,BUENOS AIRES,588,575,1110,1156,2266
06,06441,064414106,La Plata,BUENOS AIRES,272,294,481,475,956
06,06441,064414217,La Plata,BUENOS AIRES,408,444,737,691,1428
06,06441,064414219,La Plata,BUENOS AIRES,370,383,1084,1256,2340
06,06441,064414305,La Plata,BUENOS AIRES,238,241,375,352,727
06,06441,064414707,La Plata,BUENOS AIRES,496,567,761,774,1535
06,06441,064414809,La Plata,BUENOS AIRES,236,255,352,328,680
06,06441,064414908,La Plata,BUENOS AIRES,193,223,275,246,521
06,06441,064414909,La Plata,BUENOS AIRES,250,296,320,302,622
06,06441,064415003,La Plata,BUENOS AIRES,405,443,580,521,1101
06,06441,064415107,La Plata,BUENOS AIRES,246,238,398,385,783
06,06441,064415116,La Plata,BUENOS AIRES,160,172,247,254,501
06,06441,064415118,La Plata,BUENOS AIRES,333,381,522,494,1016
06,06441,064415204,La Plata,BUENOS AIRES,352,363,619,620,1239
06,06441,064415307,La Plata,BUENOS AIRES,214,237,309,300,609
06,06441,064415407,La Plata,BUENOS AIRES,252,271,363,344,707
06,06441,064415702,La Plata,BUENOS AIRES,255,279,421,393,814
06,06441,064415711,La Plata,BUENOS AIRES,340,391,587,558,1145
06,06441,064415803,La Plata,BUENOS AIRES,276,321,414,406,820
06,06441,064415804,La Plata,BUENOS AIRES,180,216,270,223,493
06,06441,064415807,La Plata,BUENOS AIRES,228,256,433,389,822
06,06441,064415903,La Plata,BUENOS AIRES,204,201,299,300,599
06,06441,064415905,La Plata,BUENOS AIRES,246,265,367,293,660
06,06441,064415907,La Plata,BUENOS AIRES,302,310,481,472,953
06,06441,064416201,La Plata,BUENOS AIRES,111,149,166,177,343
06,06441,064416206,La Plata,BUENOS AIRES,286,321,397,336,733
06,06441,064416305,La Plata,BUENOS AIRES,180,260,295,272,567
06,06441,064416405,La Plata,BUENOS AIRES,136,151,254,254,508
06,06441,064415703,La Plata,BUENOS AIRES,192,209,382,359,741
06,06441,064413103,La Plata,BUENOS AIRES,216,242,324,292,616
06,06441,064415203,La Plata,BUENOS AIRES,204,228,308,265,573
06,06441,064416512,La Plata,BUENOS AIRES,99,197,158,165,323
06,06441,064410113,La Plata,BUENOS AIRES,181,233,417,368,785
06,06441,064410201,La Plata,BUENOS AIRES,212,244,190,246,436
06,06441,064410203,La Plata,BUENOS AIRES,281,313,315,286,601
06,06441,064410205,La Plata,BUENOS AIRES,242,257,263,196,459
06,06441,064410208,La Plata,BUENOS AIRES,45,51,42,57,99
06,06441,064410304,La Plata,BUENOS AIRES,247,257,304,265,569
06,06441,064410405,La Plata,BUENOS AIRES,199,239,252,237,489
06,06441,064410406,La Plata,BUENOS AIRES,252,353,288,248,536
06,06441,064410501,La Plata,BUENOS AIRES,303,404,334,338,672
06,06441,064410913,La Plata,BUENOS AIRES,234,347,322,256,578
06,06441,064411010,La Plata,BUENOS AIRES,195,233,247,233,480
06,06441,064411014,La Plata,BUENOS AIRES,191,240,212,186,398
06,06441,064411110,La Plata,BUENOS AIRES,183,258,200,176,376
06,06441,064411208,La Plata,BUENOS AIRES,131,230,130,95,225
06,06441,064411403,La Plata,BUENOS AIRES,190,291,219,146,365
06,06441,064411408,La Plata,BUENOS AIRES,231,342,272,199,471
06,06441,064411506,La Plata,BUENOS AIRES,212,294,236,178,414
06,06441,064411509,La Plata,BUENOS AIRES,329,431,352,263,615
06,06441,064411510,La Plata,BUENOS AIRES,270,362,322,292,614
06,06441,064411605,La Plata,BUENOS AIRES,181,224,238,232,470
06,06441,064411611,La Plata,BUENOS AIRES,356,460,468,420,888
06,06441,064411612,La Plata,BUENOS AIRES,268,367,346,283,629
06,06441,064411709,La Plata,BUENOS AIRES,196,229,253,205,458
06,06441,064411713,La Plata,BUENOS AIRES,211,215,310,287,597
06,06441,064411803,La Plata,BUENOS AIRES,172,247,191,135,326
06,06441,064411901,La Plata,BUENOS AIRES,275,399,387,266,653
06,06441,064411902,La Plata,BUENOS AIRES,317,438,402,312,714
06,06441,064411904,La Plata,BUENOS AIRES,226,334,279,207,486
06,06441,064412005,La Plata,BUENOS AIRES,214,286,236,204,440
06,06441,064412104,La Plata,BUENOS AIRES,371,437,479,403,882
06,06441,064412110,La Plata,BUENOS AIRES,225,266,290,242,532
06,06441,064412114,La Plata,BUENOS AIRES,203,258,261,242,503
06,06441,064412204,La Plata,BUENOS AIRES,378,483,464,434,898
06,06441,064412301,La Plata,BUENOS AIRES,256,320,327,270,597
06,06441,064412309,La Plata,BUENOS AIRES,165,194,216,178,394
06,06441,064412404,La Plata,BUENOS AIRES,212,239,317,246,563
06,06441,064412408,La Plata,BUENOS AIRES,193,266,243,211,454
06,06441,064412507,La Plata,BUENOS AIRES,215,280,274,228,502
06,06441,064412608,La Plata,BUENOS AIRES,170,206,216,179,395
06,06441,064412611,La Plata,BUENOS AIRES,219,272,297,258,555
06,06441,064412612,La Plata,BUENOS AIRES,249,318,301,276,577
06,06441,064412701,La Plata,BUENOS AIRES,331,415,479,366,845
06,06441,064412804,La Plata,BUENOS AIRES,171,231,226,174,400
06,06441,064412807,La Plata,BUENOS AIRES,171,215,254,195,449
06,06441,064412808,La Plata,BUENOS AIRES,217,263,288,274,562
06,06441,064412810,La Plata,BUENOS AIRES,274,321,352,282,634
06,06441,064412812,La Plata,BUENOS AIRES,371,435,534,475,1009
06,06441,064412904,La Plata,BUENOS AIRES,189,247,280,250,530
06,06441,064412912,La Plata,BUENOS AIRES,180,214,262,228,490
06,06441,064413206,La Plata,BUENOS AIRES,309,336,451,440,891
06,06441,064413305,La Plata,BUENOS AIRES,268,291,443,382,825
06,06441,064413406,La Plata,BUENOS AIRES,247,266,401,376,777
06,06441,064413407,La Plata,BUENOS AIRES,248,274,399,351,750
06,06441,064413410,La Plata,BUENOS AIRES,239,262,387,361,748
06,06441,064413502,La Plata,BUENOS AIRES,388,421,663,526,1189
06,06441,064413602,La Plata,BUENOS AIRES,271,284,474,1674,2148
06,06441,064413706,La Plata,BUENOS AIRES,358,371,635,600,1235
06,06441,064413711,La Plata,BUENOS AIRES,388,393,736,730,1466
06,06441,064413714,La Plata,BUENOS AIRES,353,381,620,597,1217
06,06441,064413802,La Plata,BUENOS AIRES,250,237,468,452,920
06,06441,064413804,La Plata,BUENOS AIRES,224,223,393,408,801
06,06441,064413903,La Plata,BUENOS AIRES,232,229,368,338,706
06,06441,064413905,La Plata,BUENOS AIRES,280,297,430,381,811
06,06441,064414112,La Plata,BUENOS AIRES,184,201,325,399,724
06,06441,064414202,La Plata,BUENOS AIRES,206,223,414,404,818
06,06441,064414203,La Plata,BUENOS AIRES,357,380,668,691,1359
06,06441,064414205,La Plata,BUENOS AIRES,360,347,677,730,1407
06,06441,064414215,La Plata,BUENOS AIRES,447,446,977,1032,2009
06,06441,064414303,La Plata,BUENOS AIRES,241,267,373,356,729
06,06441,064414310,La Plata,BUENOS AIRES,423,427,757,728,1485
06,06441,064414312,La Plata,BUENOS AIRES,216,241,381,357,738
06,06441,064414403,La Plata,BUENOS AIRES,368,386,731,685,1416
06,06441,064414405,La Plata,BUENOS AIRES,300,339,538,494,1032
06,06441,064414407,La Plata,BUENOS AIRES,387,415,689,689,1378
06,06441,064414511,La Plata,BUENOS AIRES,382,389,732,750,1482
06,06441,064414605,La Plata,BUENOS AIRES,253,265,427,409,836
06,06441,064414609,La Plata,BUENOS AIRES,322,341,569,598,1167
06,06441,064414709,La Plata,BUENOS AIRES,590,555,1064,1062,2126
06,06441,064414907,La Plata,BUENOS AIRES,282,328,395,337,732
06,06441,064415002,La Plata,BUENOS AIRES,204,224,295,263,558
06,06441,064415101,La Plata,BUENOS AIRES,596,440,1174,1209,2383
06,06441,064415111,La Plata,BUENOS AIRES,247,317,350,299,649
06,06441,064415113,La Plata,BUENOS AIRES,213,251,320,296,616
06,06441,064415208,La Plata,BUENOS AIRES,283,305,449,381,830
06,06441,064415301,La Plata,BUENOS AIRES,214,234,311,291,602
06,06441,064415403,La Plata,BUENOS AIRES,288,305,480,422,902
06,06441,064415416,La Plata,BUENOS AIRES,240,237,388,384,772
06,06441,064415505,La Plata,BUENOS AIRES,321,348,565,539,1104
06,06441,064415507,La Plata,BUENOS AIRES,243,276,370,367,737
06,06441,064415511,La Plata,BUENOS AIRES,205,235,359,396,755
06,06441,064415710,La Plata,BUENOS AIRES,240,281,444,441,885
06,06441,064416002,La Plata,BUENOS AIRES,225,287,341,325,666
06,06441,064416004,La Plata,BUENOS AIRES,382,398,647,617,1264
06,06441,064416005,La Plata,BUENOS AIRES,401,377,764,776,1540
06,06441,064416010,La Plata,BUENOS AIRES,291,341,459,470,929
06,06441,064416309,La Plata,BUENOS AIRES,140,210,240,262,502
06,06441,064416411,La Plata,BUENOS AIRES,185,218,306,298,604
06,06441,064416507,La Plata,BUENOS AIRES,64,117,93,110,203
06,06441,064416611,La Plata,BUENOS AIRES,372,450,625,558,1183
06,06441,064416615,La Plata,BUENOS AIRES,399,416,732,786,1518
06,06441,064416616,La Plata,BUENOS AIRES,266,328,482,469,951
06,06441,064416617,La Plata,BUENOS AIRES,353,410,612,617,1229
06,06441,064416805,La Plata,BUENOS AIRES,356,405,582,543,1125
06,06441,064416806,La Plata,BUENOS AIRES,162,186,313,327,640
06,06441,064416808,La Plata,BUENOS AIRES,146,275,208,228,436
06,06441,064416810,La Plata,BUENOS AIRES,72,168,85,112,197
06,06441,064416904,La Plata,BUENOS AIRES,402,416,697,645,1342
06,06441,064410414,La Plata,BUENOS AIRES,245,321,280,214,494
06,06441,064411903,La Plata,BUENOS AIRES,230,314,305,229,534
06,06441,064416613,La Plata,BUENOS AIRES,204,241,416,423,839
06,06441,064411812,La Plata,BUENOS AIRES,210,286,251,210,461
06,06441,064410202,La Plata,BUENOS AIRES,233,249,234,189,423
06,06441,064410306,La Plata,BUENOS AIRES,297,329,332,327,659
06,06441,064410401,La Plata,BUENOS AIRES,377,484,471,438,909
06,06441,064410404,La Plata,BUENOS AIRES,191,252,246,210,456
06,06441,064410602,La Plata,BUENOS AIRES,172,233,168,146,314
06,06441,064410606,La Plata,BUENOS AIRES,204,254,213,164,377
06,06441,064410608,La Plata,BUENOS AIRES,190,302,194,161,355
06,06441,064410707,La Plata,BUENOS AIRES,269,403,286,178,464
06,06441,064410803,La Plata,BUENOS AIRES,119,176,138,72,210
06,06441,064410804,La Plata,BUENOS AIRES,141,215,177,109,286
06,06441,064410908,La Plata,BUENOS AIRES,212,278,267,221,488
06,06441,064410914,La Plata,BUENOS AIRES,195,257,210,190,400
06,06441,064411003,La Plata,BUENOS AIRES,222,241,354,283,637
06,06441,064411004,La Plata,BUENOS AIRES,209,265,248,230,478
06,06441,064411013,La Plata,BUENOS AIRES,242,296,300,268,568
06,06441,064411106,La Plata,BUENOS AIRES,180,247,237,195,432
06,06441,064411112,La Plata,BUENOS AIRES,373,492,490,404,894
06,06441,064411201,La Plata,BUENOS AIRES,215,338,210,177,387
06,06441,064411211,La Plata,BUENOS AIRES,265,394,301,192,493
06,06441,064411215,La Plata,BUENOS AIRES,157,401,188,116,304
06,06441,064411303,La Plata,BUENOS AIRES,100,172,115,61,176
06,06441,064411309,La Plata,BUENOS AIRES,257,400,286,231,517
06,06441,064411602,La Plata,BUENOS AIRES,206,260,263,237,500
06,06441,064411604,La Plata,BUENOS AIRES,216,268,243,236,479
06,06441,064411704,La Plata,BUENOS AIRES,203,247,298,240,538
06,06441,064411910,La Plata,BUENOS AIRES,184,267,222,185,407
06,06441,064412002,La Plata,BUENOS AIRES,226,322,266,243,509
06,06441,064412106,La Plata,BUENOS AIRES,197,277,249,218,467
06,06441,064412111,La Plata,BUENOS AIRES,189,243,240,209,449
06,06441,064412201,La Plata,BUENOS AIRES,263,360,328,283,611
06,06441,064412203,La Plata,BUENOS AIRES,362,451,452,415,867
06,06441,064412302,La Plata,BUENOS AIRES,186,222,247,202,449
06,06441,064412307,La Plata,BUENOS AIRES,254,306,382,328,710
06,06441,064412402,La Plata,BUENOS AIRES,208,307,302,251,553
06,06441,064412707,La Plata,BUENOS AIRES,238,268,316,279,595
06,06441,064412809,La Plata,BUENOS AIRES,243,280,357,278,635
06,06441,064412906,La Plata,BUENOS AIRES,197,257,260,252,512
06,06441,064413009,La Plata,BUENOS AIRES,312,348,478,443,921
06,06441,064413101,La Plata,BUENOS AIRES,377,404,626,573,1199
06,06441,064413109,La Plata,BUENOS AIRES,235,277,365,322,687
06,06441,064413202,La Plata,BUENOS AIRES,183,214,288,262,550
06,06441,064413203,La Plata,BUENOS AIRES,407,448,601,565,1166
06,06441,064413209,La Plata,BUENOS AIRES,248,287,365,356,721
06,06441,064413301,La Plata,BUENOS AIRES,345,390,480,399,879
06,06441,064413307,La Plata,BUENOS AIRES,243,268,375,326,701
06,06441,064413507,La Plata,BUENOS AIRES,285,289,453,454,907
06,06441,064413514,La Plata,BUENOS AIRES,300,301,496,445,941
06,06441,064413515,La Plata,BUENOS AIRES,434,423,799,784,1583
06,06441,064413709,La Plata,BUENOS AIRES,376,386,578,521,1099
06,06441,064413712,La Plata,BUENOS AIRES,413,415,673,653,1326
06,06441,064413803,La Plata,BUENOS AIRES,270,268,461,444,905
06,06441,064413910,La Plata,BUENOS AIRES,435,422,782,741,1523
06,06441,064414003,La Plata,BUENOS AIRES,238,262,349,311,660
06,06441,064414012,La Plata,BUENOS AIRES,332,327,656,619,1275
06,06441,064414206,La Plata,BUENOS AIRES,449,471,791,889,1680
06,06441,064414207,La Plata,BUENOS AIRES,381,429,723,749,1472
06,06441,064414211,La Plata,BUENOS AIRES,298,304,495,526,1021
06,06441,064414218,La Plata,BUENOS AIRES,395,431,715,630,1345
06,06441,064414307,La Plata,BUENOS AIRES,229,240,402,387,789
06,06441,064414313,La Plata,BUENOS AIRES,244,283,397,438,835
06,06441,064414314,La Plata,BUENOS AIRES,328,364,588,576,1164
06,06441,064414408,La Plata,BUENOS AIRES,229,228,445,467,912
06,06441,064414503,La Plata,BUENOS AIRES,298,318,508,449,957
06,06441,064414507,La Plata,BUENOS AIRES,310,313,546,583,1129
06,06441,064414703,La Plata,BUENOS AIRES,315,275,546,525,1071
06,06441,064414706,La Plata,BUENOS AIRES,288,313,475,454,929
06,06441,064414710,La Plata,BUENOS AIRES,257,290,519,548,1067
06,06441,064414801,La Plata,BUENOS AIRES,329,367,523,465,988
06,06441,064414905,La Plata,BUENOS AIRES,190,217,258,210,468
06,06441,064415006,La Plata,BUENOS AIRES,235,281,337,279,616
06,06441,064415102,La Plata,BUENOS AIRES,260,275,487,498,985
06,06441,064415103,La Plata,BUENOS AIRES,211,228,317,289,606
06,06441,064415115,La Plata,BUENOS AIRES,213,223,298,311,609
06,06441,064415117,La Plata,BUENOS AIRES,421,491,626,595,1221
06,06441,064415404,La Plata,BUENOS AIRES,250,284,373,317,690
06,06441,064415405,La Plata,BUENOS AIRES,387,447,593,569,1162
06,06441,064415502,La Plata,BUENOS AIRES,496,533,936,953,1889
06,06441,064415601,La Plata,BUENOS AIRES,269,328,457,421,878
06,06441,064415603,La Plata,BUENOS AIRES,192,224,307,269,576
06,06441,064415808,La Plata,BUENOS AIRES,193,230,284,245,529
06,06441,064415908,La Plata,BUENOS AIRES,337,363,576,508,1084
06,06441,064416106,La Plata,BUENOS AIRES,370,426,620,618,1238
06,06441,064416111,La Plata,BUENOS AIRES,264,332,420,424,844
06,06441,064416202,La Plata,BUENOS AIRES,259,270,447,424,871
06,06441,064416204,La Plata,BUENOS AIRES,281,314,445,398,843
06,06441,064416212,La Plata,BUENOS AIRES,177,221,294,285,579
06,06441,064416310,La Plata,BUENOS AIRES,222,280,394,359,753
06,06441,064416404,La Plata,BUENOS AIRES,158,190,303,296,599
06,06441,064416410,La Plata,BUENOS AIRES,37,42,62,65,127
06,06441,064416419,La Plata,BUENOS AIRES,329,262,573,598,1171
06,06441,064416803,La Plata,BUENOS AIRES,238,248,425,406,831
06,06441,064416804,La Plata,BUENOS AIRES,233,276,382,380,762
06,06441,064416612,La Plata,BUENOS AIRES,337,369,605,617,1222
06,06441,064416807,La Plata,BUENOS AIRES,166,255,294,315,609
06,06441,064416809,La Plata,BUENOS AIRES,141,254,215,197,412
06,06441,064416903,La Plata,BUENOS AIRES,326,376,524,552,1076
06,06441,064416909,La Plata,BUENOS AIRES,350,394,565,620,1185
06,06441,064417002,La Plata,BUENOS AIRES,260,285,492,488,980
06,06441,064416503,La Plata,BUENOS AIRES,178,222,316,340,656
06,06441,064416510,La Plata,BUENOS AIRES,442,460,792,849,1641
06,06441,064416701,La Plata,BUENOS AIRES,122,166,195,223,418
06,06441,064416702,La Plata,BUENOS AIRES,42,54,65,74,139
06,06441,064416817,La Plata,BUENOS AIRES,39,39,56,65,121
06,06441,064416815,La Plata,BUENOS AIRES,147,193,262,272,534
06,06441,064416520,La Plata,BUENOS AIRES,209,249,334,328,662
06,06441,064416812,La Plata,BUENOS AIRES,96,173,145,142,287
06,06441,064410411,La Plata,BUENOS AIRES,353,474,411,302,713
06,06441,064415408,La Plata,BUENOS AIRES,168,200,254,226,480
06,06441,064415607,La Plata,BUENOS AIRES,296,345,465,455,920
06,06441,064415707,La Plata,BUENOS AIRES,454,463,781,810,1591
06,06441,064410103,La Plata,BUENOS AIRES,233,265,365,347,712
06,06441,064410709,La Plata,BUENOS AIRES,246,317,284,207,491
06,06441,064410108,La Plata,BUENOS AIRES,189,237,292,214,506
06,06441,064410109,La Plata,BUENOS AIRES,305,354,418,379,797
06,06441,064410403,La Plata,BUENOS AIRES,372,457,485,468,953
06,06441,064410407,La Plata,BUENOS AIRES,313,409,331,328,659
06,06441,064410408,La Plata,BUENOS AIRES,294,392,332,262,594
06,06441,064410702,La Plata,BUENOS AIRES,191,302,222,198,420
06,06441,064410706,La Plata,BUENOS AIRES,181,247,218,150,368
06,06441,064410903,La Plata,BUENOS AIRES,201,230,239,211,450
06,06441,064410904,La Plata,BUENOS AIRES,308,343,341,283,624
06,06441,064410912,La Plata,BUENOS AIRES,284,427,254,254,508
06,06441,064411002,La Plata,BUENOS AIRES,210,220,308,260,568
06,06441,064411008,La Plata,BUENOS AIRES,234,255,339,259,598
06,06441,064411012,La Plata,BUENOS AIRES,248,313,288,222,510
06,06441,064411101,La Plata,BUENOS AIRES,195,280,334,223,557
06,06441,064411103,La Plata,BUENOS AIRES,193,242,270,207,477
06,06441,064411104,La Plata,BUENOS AIRES,173,261,218,207,425
06,06441,064411107,La Plata,BUENOS AIRES,173,231,258,230,488
06,06441,064411108,La Plata,BUENOS AIRES,192,251,216,198,414
06,06441,064411809,La Plata,BUENOS AIRES,204,316,329,265,594
06,06441,064411409,La Plata,BUENOS AIRES,191,299,218,185,403
06,06441,064411501,La Plata,BUENOS AIRES,290,414,287,237,524
06,06441,064411503,La Plata,BUENOS AIRES,228,304,255,203,458
06,06441,064411601,La Plata,BUENOS AIRES,329,419,410,323,733
06,06441,064411614,La Plata,BUENOS AIRES,332,370,412,324,736
06,06441,064411703,La Plata,BUENOS AIRES,264,343,366,322,688
06,06441,064411801,La Plata,BUENOS AIRES,160,242,178,116,294
06,06441,064411806,La Plata,BUENOS AIRES,168,216,251,177,428
06,06441,064411906,La Plata,BUENOS AIRES,251,307,319,275,594
06,06441,064412003,La Plata,BUENOS AIRES,268,354,303,263,566
06,06441,064412010,La Plata,BUENOS AIRES,178,264,206,171,377
06,06441,064412011,La Plata,BUENOS AIRES,140,191,140,121,261
06,06441,064412101,La Plata,BUENOS AIRES,193,241,263,207,470
06,06441,064412112,La Plata,BUENOS AIRES,204,271,258,236,494
06,06441,064412113,La Plata,BUENOS AIRES,352,472,445,385,830
06,06441,064412209,La Plata,BUENOS AIRES,254,325,363,325,688
06,06441,064412305,La Plata,BUENOS AIRES,231,290,310,283,593
06,06441,064412407,La Plata,BUENOS AIRES,190,251,253,206,459
06,06441,064412409,La Plata,BUENOS AIRES,276,356,333,306,639
06,06441,064412510,La Plata,BUENOS AIRES,274,358,377,296,673
06,06441,064412706,La Plata,BUENOS AIRES,214,252,295,266,561
06,06441,064412811,La Plata,BUENOS AIRES,313,420,453,380,833
06,06441,064412813,La Plata,BUENOS AIRES,356,427,502,434,936
06,06441,064412905,La Plata,BUENOS AIRES,234,262,320,322,642
06,06441,064412911,La Plata,BUENOS AIRES,189,236,278,202,480
06,06441,064412913,La Plata,BUENOS AIRES,330,385,467,404,871
06,06441,064413005,La Plata,BUENOS AIRES,239,284,388,372,760
06,06441,064413007,La Plata,BUENOS AIRES,194,228,264,245,509
06,06441,064413112,La Plata,BUENOS AIRES,292,330,447,384,831
06,06441,064413116,La Plata,BUENOS AIRES,229,236,360,317,677
06,06441,064413201,La Plata,BUENOS AIRES,206,232,292,274,566
06,06441,064413210,La Plata,BUENOS AIRES,292,310,455,437,892
06,06441,064413302,La Plata,BUENOS AIRES,173,201,253,214,467
06,06441,064413405,La Plata,BUENOS AIRES,317,350,531,456,987
06,06441,064413415,La Plata,BUENOS AIRES,460,433,951,869,1820
06,06441,064413506,La Plata,BUENOS AIRES,241,259,383,342,725
06,06441,064413508,La Plata,BUENOS AIRES,366,384,613,621,1234
06,06441,064413607,La Plata,BUENOS AIRES,271,278,478,422,900
06,06441,064413610,La Plata,BUENOS AIRES,372,392,600,563,1163
06,06441,064413702,La Plata,BUENOS AIRES,369,383,700,688,1388
06,06441,064413710,La Plata,BUENOS AIRES,420,451,740,696,1436
06,06441,064413808,La Plata,BUENOS AIRES,208,245,373,387,760
06,06441,064413901,La Plata,BUENOS AIRES,308,337,439,386,825
06,06441,064413909,La Plata,BUENOS AIRES,271,275,462,430,892
06,06441,064414001,La Plata,BUENOS AIRES,276,305,454,450,904
06,06441,064414103,La Plata,BUENOS AIRES,357,357,664,677,1341
06,06441,064414104,La Plata,BUENOS AIRES,418,440,709,697,1406
06,06441,064414210,La Plata,BUENOS AIRES,469,498,888,883,1771
06,06441,064414216,La Plata,BUENOS AIRES,364,366,768,1479,2247
06,06441,064414311,La Plata,BUENOS AIRES,228,237,418,413,831
06,06441,064414402,La Plata,BUENOS AIRES,251,276,431,400,831
06,06441,064414501,La Plata,BUENOS AIRES,230,257,379,385,764
06,06441,064414505,La Plata,BUENOS AIRES,250,261,467,465,932
06,06441,064414506,La Plata,BUENOS AIRES,313,354,528,553,1081
06,06441,064414508,La Plata,BUENOS AIRES,305,333,547,550,1097
06,06441,064414509,La Plata,BUENOS AIRES,356,381,667,688,1355
06,06441,064414608,La Plata,BUENOS AIRES,326,340,547,517,1064
06,06441,064414802,La Plata,BUENOS AIRES,174,181,323,277,600
06,06441,064414902,La Plata,BUENOS AIRES,274,303,399,333,732
06,06441,064414904,La Plata,BUENOS AIRES,216,246,287,272,559
06,06441,064415005,La Plata,BUENOS AIRES,199,227,291,253,544
06,06441,064415109,La Plata,BUENOS AIRES,215,240,317,256,573
06,06441,064415112,La Plata,BUENOS AIRES,177,210,294,230,524
06,06441,064415205,La Plata,BUENOS AIRES,274,260,504,474,978
06,06441,064415207,La Plata,BUENOS AIRES,321,328,502,480,982
06,06441,064415303,La Plata,BUENOS AIRES,191,205,297,252,549
06,06441,064415309,La Plata,BUENOS AIRES,369,399,570,569,1139
06,06441,064415310,La Plata,BUENOS AIRES,391,388,798,832,1630
06,06441,064415402,La Plata,BUENOS AIRES,264,286,492,473,965
06,06441,064415406,La Plata,BUENOS AIRES,154,174,230,205,435
06,06441,064415413,La Plata,BUENOS AIRES,126,171,206,201,407
06,06441,064415606,La Plata,BUENOS AIRES,389,454,627,567,1194
06,06441,064415701,La Plata,BUENOS AIRES,41,48,51,55,106
06,06441,064415805,La Plata,BUENOS AIRES,168,201,254,219,473
06,06441,064415901,La Plata,BUENOS AIRES,228,242,363,314,677
06,06441,064415910,La Plata,BUENOS AIRES,385,411,621,570,1191
06,06441,064416101,La Plata,BUENOS AIRES,252,314,342,276,618
06,06441,064416103,La Plata,BUENOS AIRES,227,248,385,344,729
06,06441,064416209,La Plata,BUENOS AIRES,197,222,321,305,626
06,06441,064416307,La Plata,BUENOS AIRES,225,306,375,343,718
06,06441,064416514,La Plata,BUENOS AIRES,206,332,336,372,708
06,06441,064416502,La Plata,BUENOS AIRES,179,209,312,321,633
06,06441,064416506,La Plata,BUENOS AIRES,98,80,185,201,386
06,06441,064416601,La Plata,BUENOS AIRES,238,278,423,419,842
06,06441,064416607,La Plata,BUENOS AIRES,390,434,662,650,1312
06,06441,064416901,La Plata,BUENOS AIRES,344,349,631,652,1283
06,06441,064416907,La Plata,BUENOS AIRES,227,261,416,424,840
06,06441,064417004,La Plata,BUENOS AIRES,457,441,877,870,1747
06,06441,064417101,La Plata,BUENOS AIRES,47,65,55,76,131
06,06441,064412603,La Plata,BUENOS AIRES,234,291,292,238,530
06,06441,064416703,La Plata,BUENOS AIRES,87,221,152,163,315
06,06441,064416814,La Plata,BUENOS AIRES,186,226,356,353,709
06,06441,064411810,La Plata,BUENOS AIRES,256,359,317,259,576
06,06441,064411811,La Plata,BUENOS AIRES,392,543,476,368,844
06,06441,064410105,La Plata,BUENOS AIRES,228,295,302,257,559
06,06441,064410303,La Plata,BUENOS AIRES,189,210,232,200,432
06,06441,064410409,La Plata,BUENOS AIRES,290,377,342,265,607
06,06441,064410502,La Plata,BUENOS AIRES,276,338,321,321,642
06,06441,064410503,La Plata,BUENOS AIRES,224,272,271,259,530
06,06441,064410506,La Plata,BUENOS AIRES,219,270,305,301,606
06,06441,064410604,La Plata,BUENOS AIRES,190,292,201,153,354
06,06441,064410605,La Plata,BUENOS AIRES,271,379,330,297,627
06,06441,064410609,La Plata,BUENOS AIRES,298,396,330,271,601
06,06441,064411009,La Plata,BUENOS AIRES,371,472,467,414,881
06,06441,064411105,La Plata,BUENOS AIRES,228,276,307,232,539
06,06441,064411114,La Plata,BUENOS AIRES,293,341,333,322,655
06,06441,064411203,La Plata,BUENOS AIRES,149,225,175,126,301
06,06441,064411206,La Plata,BUENOS AIRES,189,287,203,181,384
06,06441,064411210,La Plata,BUENOS AIRES,106,182,134,77,211
06,06441,064411301,La Plata,BUENOS AIRES,192,274,205,156,361
06,06441,064411306,La Plata,BUENOS AIRES,149,232,178,156,334
06,06441,064411607,La Plata,BUENOS AIRES,356,489,523,421,944
06,06441,064411405,La Plata,BUENOS AIRES,301,423,326,229,555
06,06441,064411407,La Plata,BUENOS AIRES,215,314,224,188,412
06,06441,064411505,La Plata,BUENOS AIRES,276,391,320,230,550
06,06441,064411608,La Plata,BUENOS AIRES,200,246,273,251,524
06,06441,064411610,La Plata,BUENOS AIRES,398,483,533,459,992
06,06441,064411615,La Plata,BUENOS AIRES,89,120,102,88,190
06,06441,064411701,La Plata,BUENOS AIRES,192,232,241,212,453
06,06441,064411911,La Plata,BUENOS AIRES,241,306,290,247,537
06,06441,064412503,La Plata,BUENOS AIRES,198,274,263,218,481
06,06441,064412403,La Plata,BUENOS AIRES,186,220,284,238,522
06,06441,064412502,La Plata,BUENOS AIRES,265,335,337,273,610
06,06441,064412708,La Plata,BUENOS AIRES,384,455,554,405,959
06,06441,064412709,La Plata,BUENOS AIRES,347,404,500,459,959
06,06441,064412806,La Plata,BUENOS AIRES,197,241,274,244,518
06,06441,064413003,La Plata,BUENOS AIRES,285,318,459,406,865
06,06441,064413108,La Plata,BUENOS AIRES,211,240,302,242,544
06,06441,064413111,La Plata,BUENOS AIRES,400,453,613,557,1170
06,06441,064413207,La Plata,BUENOS AIRES,334,352,524,467,991
06,06441,064413309,La Plata,BUENOS AIRES,402,414,623,526,1149
06,06441,064413503,La Plata,BUENOS AIRES,207,217,278,262,540
06,06441,064413604,La Plata,BUENOS AIRES,220,215,353,323,676
06,06441,064413609,La Plata,BUENOS AIRES,309,315,510,498,1008
06,06441,064413611,La Plata,BUENOS AIRES,314,334,514,516,1030
06,06441,064413703,La Plata,BUENOS AIRES,197,195,430,418,848
06,06441,064413806,La Plata,BUENOS AIRES,307,333,719,519,1238
06,06441,064413810,La Plata,BUENOS AIRES,305,293,502,444,946
06,06441,064413906,La Plata,BUENOS AIRES,303,310,489,471,960
06,06441,064414105,La Plata,BUENOS AIRES,403,419,676,694,1370
06,06441,064414111,La Plata,BUENOS AIRES,123,128,181,237,418
06,06441,064414201,La Plata,BUENOS AIRES,508,527,989,1068,2057
06,06441,064414302,La Plata,BUENOS AIRES,297,315,473,403,876
06,06441,064414309,La Plata,BUENOS AIRES,367,445,569,597,1166
06,06441,064414410,La Plata,BUENOS AIRES,602,593,1247,1324,2571
06,06441,064414601,La Plata,BUENOS AIRES,295,303,504,484,988
06,06441,064414603,La Plata,BUENOS AIRES,283,300,482,480,962
06,06441,064414702,La Plata,BUENOS AIRES,368,349,633,637,1270
06,06441,064414705,La Plata,BUENOS AIRES,360,339,586,568,1154
06,06441,064414803,La Plata,BUENOS AIRES,244,263,377,302,679
06,06441,064414807,La Plata,BUENOS AIRES,332,349,511,438,949
06,06441,064414808,La Plata,BUENOS AIRES,197,203,316,302,618
06,06441,064415001,La Plata,BUENOS AIRES,198,216,297,256,553
06,06441,064415010,La Plata,BUENOS AIRES,263,294,387,308,695
06,06441,064415104,La Plata,BUENOS AIRES,292,306,476,434,910
06,06441,064415108,La Plata,BUENOS AIRES,282,319,435,350,785
06,06441,064415209,La Plata,BUENOS AIRES,186,212,268,264,532
06,06441,064415302,La Plata,BUENOS AIRES,377,413,593,521,1114
06,06441,064415304,La Plata,BUENOS AIRES,297,330,468,427,895
06,06441,064415306,La Plata,BUENOS AIRES,234,258,343,322,665
06,06441,064415401,La Plata,BUENOS AIRES,299,319,509,507,1016
06,06441,064415409,La Plata,BUENOS AIRES,214,238,310,283,593
06,06441,064415417,La Plata,BUENOS AIRES,354,397,590,573,1163
06,06441,064415504,La Plata,BUENOS AIRES,230,229,399,375,774
06,06441,064415510,La Plata,BUENOS AIRES,130,126,222,226,448
06,06441,064415605,La Plata,BUENOS AIRES,403,471,636,574,1210
06,06441,064415704,La Plata,BUENOS AIRES,241,263,388,352,740
06,06441,064415705,La Plata,BUENOS AIRES,364,410,649,584,1233
06,06441,064415906,La Plata,BUENOS AIRES,224,242,329,333,662
06,06441,064415909,La Plata,BUENOS AIRES,267,279,420,440,860
06,06441,064416008,La Plata,BUENOS AIRES,223,271,380,348,728
06,06441,064416210,La Plata,BUENOS AIRES,183,206,344,306,650
06,06441,064416516,La Plata,BUENOS AIRES,263,272,468,396,864
06,06441,064416213,La Plata,BUENOS AIRES,351,392,678,672,1350
06,06441,064416301,La Plata,BUENOS AIRES,216,271,335,327,662
06,06441,064416308,La Plata,BUENOS AIRES,184,222,289,276,565
06,06441,064416311,La Plata,BUENOS AIRES,140,234,217,234,451
06,06441,064416406,La Plata,BUENOS AIRES,155,187,290,272,562
06,06441,064416407,La Plata,BUENOS AIRES,157,144,254,228,482
06,06441,064416413,La Plata,BUENOS AIRES,91,124,163,166,329
06,06441,064416515,La Plata,BUENOS AIRES,312,347,558,542,1100
06,06441,064416505,La Plata,BUENOS AIRES,72,40,187,173,360
06,06441,064416518,La Plata,BUENOS AIRES,186,175,351,350,701
06,06441,064416608,La Plata,BUENOS AIRES,295,316,489,460,949
06,06441,064416902,La Plata,BUENOS AIRES,339,378,552,566,1118
06,06441,064416908,La Plata,BUENOS AIRES,349,361,655,684,1339
06,06441,064416816,La Plata,BUENOS AIRES,167,201,233,281,514
06,06441,064416521,La Plata,BUENOS AIRES,113,383,140,167,307
06,06441,064416811,La Plata,BUENOS AIRES,111,204,170,173,343
06,06441,064416813,La Plata,BUENOS AIRES,36,94,51,63,114
06,06441,064413603,La Plata,BUENOS AIRES,235,243,364,316,680
06,06441,064414011,La Plata,BUENOS AIRES,386,372,650,685,1335
06,06441,064415202,La Plata,BUENOS AIRES,254,260,376,355,731
06,06441,064411813,La Plata,BUENOS AIRES,203,282,234,200,434
06,06441,064410112,La Plata,BUENOS AIRES,309,413,350,352,702
06,06441,064410204,La Plata,BUENOS AIRES,208,246,225,214,439
06,06441,064410211,La Plata,BUENOS AIRES,223,246,295,292,587
06,06441,064410302,La Plata,BUENOS AIRES,415,426,563,525,1088
06,06441,064410504,La Plata,BUENOS AIRES,251,393,291,229,520
06,06441,064410507,La Plata,BUENOS AIRES,145,199,163,153,316
06,06441,064410607,La Plata,BUENOS AIRES,219,297,247,199,446
06,06441,064410704,La Plata,BUENOS AIRES,225,273,297,186,483
06,06441,064410809,La Plata,BUENOS AIRES,245,416,269,162,431
06,06441,064410905,La Plata,BUENOS AIRES,231,313,272,199,471
06,06441,064410910,La Plata,BUENOS AIRES,71,98,87,56,143
06,06441,064411001,La Plata,BUENOS AIRES,400,412,584,579,1163
06,06441,064411015,La Plata,BUENOS AIRES,177,283,230,150,380
06,06441,064411115,La Plata,BUENOS AIRES,202,297,251,175,426
06,06441,064411213,La Plata,BUENOS AIRES,200,358,210,158,368
06,06441,064411214,La Plata,BUENOS AIRES,169,322,193,142,335
06,06441,064411302,La Plata,BUENOS AIRES,268,369,287,224,511
06,06441,064411304,La Plata,BUENOS AIRES,281,460,312,238,550
06,06441,064411305,La Plata,BUENOS AIRES,142,222,158,107,265
06,06441,064411307,La Plata,BUENOS AIRES,215,292,252,202,454
06,06441,064411606,La Plata,BUENOS AIRES,351,418,467,415,882
06,06441,064411406,La Plata,BUENOS AIRES,159,200,184,140,324
06,06441,064411504,La Plata,BUENOS AIRES,241,365,302,263,565
06,06441,064411508,La Plata,BUENOS AIRES,202,269,188,163,351
06,06441,064411712,La Plata,BUENOS AIRES,298,360,423,356,779
06,06441,064411909,La Plata,BUENOS AIRES,204,265,231,191,422
06,06441,064412014,La Plata,BUENOS AIRES,57,241,55,36,91
06,06441,064412108,La Plata,BUENOS AIRES,196,265,238,197,435
06,06441,064412202,La Plata,BUENOS AIRES,288,353,424,365,789
06,06441,064412205,La Plata,BUENOS AIRES,300,365,425,376,801
06,06441,064412207,La Plata,BUENOS AIRES,216,264,316,281,597
06,06441,064412208,La Plata,BUENOS AIRES,253,317,379,341,720
06,06441,064412405,La Plata,BUENOS AIRES,411,496,573,498,1071
06,06441,064412411,La Plata,BUENOS AIRES,377,469,555,506,1061
06,06441,064412506,La Plata,BUENOS AIRES,231,318,302,254,556
06,06441,064412508,La Plata,BUENOS AIRES,224,264,308,274,582
06,06441,064412602,La Plata,BUENOS AIRES,214,269,285,252,537
06,06441,064412607,La Plata,BUENOS AIRES,266,321,379,316,695
06,06441,064412703,La Plata,BUENOS AIRES,313,359,477,430,907
06,06441,064412704,La Plata,BUENOS AIRES,331,397,470,397,867
06,06441,064412907,La Plata,BUENOS AIRES,242,288,332,256,588
06,06441,064412914,La Plata,BUENOS AIRES,337,401,546,501,1047
06,06441,064413006,La Plata,BUENOS AIRES,362,388,550,491,1041
06,06441,064413107,La Plata,BUENOS AIRES,233,270,374,301,675
06,06441,064413308,La Plata,BUENOS AIRES,230,258,311,307,618
06,06441,064413311,La Plata,BUENOS AIRES,423,448,681,569,1250
06,06441,064413409,La Plata,BUENOS AIRES,223,233,355,323,678
06,06441,064413411,La Plata,BUENOS AIRES,231,229,402,370,772
06,06441,064413509,La Plata,BUENOS AIRES,361,388,602,528,1130
06,06441,064413512,La Plata,BUENOS AIRES,349,373,509,489,998
06,06441,064413516,La Plata,BUENOS AIRES,752,660,1280,1366,2646
06,06441,064413801,La Plata,BUENOS AIRES,501,505,860,777,1637
06,06441,064413809,La Plata,BUENOS AIRES,311,282,584,583,1167
06,06441,064413908,La Plata,BUENOS AIRES,295,288,478,470,948
06,06441,064414002,La Plata,BUENOS AIRES,272,272,440,433,873
06,06441,064416409,La Plata,BUENOS AIRES,395,311,681,731,1412
06,06441,064416415,La Plata,BUENOS AIRES,329,397,612,549,1161
06,06441,064416416,La Plata,BUENOS AIRES,150,176,253,238,491
06,06441,064416417,La Plata,BUENOS AIRES,218,203,447,915,1362
06,06441,064416418,La Plata,BUENOS AIRES,177,251,328,335,663
06,06441,064416513,La Plata,BUENOS AIRES,150,220,292,282,574
06,06441,064416517,La Plata,BUENOS AIRES,324,332,578,570,1148
06,06441,064416602,La Plata,BUENOS AIRES,241,272,483,453,936
06,06441,064416603,La Plata,BUENOS AIRES,472,430,874,890,1764
06,06441,064416605,La Plata,BUENOS AIRES,19,13,30,43,73
06,06441,064416609,La Plata,BUENOS AIRES,311,334,578,604,1182
06,06441,064416906,La Plata,BUENOS AIRES,458,465,848,821,1669
06,06441,064416911,La Plata,BUENOS AIRES,319,357,575,610,1185
06,06441,064417001,La Plata,BUENOS AIRES,424,468,720,722,1442
06,06441,064412206,La Plata,BUENOS AIRES,233,308,303,277,580
06,06441,064412303,La Plata,BUENOS AIRES,234,291,335,230,565
06,06441,064412401,La Plata,BUENOS AIRES,204,269,248,211,459
06,06441,064412410,La Plata,BUENOS AIRES,187,264,220,206,426
06,06441,064412505,La Plata,BUENOS AIRES,331,430,430,350,780
06,06441,064412604,La Plata,BUENOS AIRES,165,209,215,200,415
06,06441,064412605,La Plata,BUENOS AIRES,196,226,251,219,470
06,06441,064412609,La Plata,BUENOS AIRES,203,260,266,249,515
06,06441,064412610,La Plata,BUENOS AIRES,400,448,541,491,1032
06,06441,064412705,La Plata,BUENOS AIRES,384,448,551,484,1035
06,06441,064412802,La Plata,BUENOS AIRES,307,370,416,390,806
06,06441,064412901,La Plata,BUENOS AIRES,212,257,262,251,513
06,06441,064412902,La Plata,BUENOS AIRES,210,238,303,239,542
06,06441,064412903,La Plata,BUENOS AIRES,241,285,337,286,623
06,06441,064412910,La Plata,BUENOS AIRES,202,232,271,257,528
06,06441,064413002,La Plata,BUENOS AIRES,360,401,595,571,1166
06,06441,064413008,La Plata,BUENOS AIRES,225,240,354,322,676
06,06441,064413104,La Plata,BUENOS AIRES,177,177,262,227,489
06,06441,064413110,La Plata,BUENOS AIRES,218,243,344,264,608
06,06441,064413115,La Plata,BUENOS AIRES,238,254,381,301,682
06,06441,064413205,La Plata,BUENOS AIRES,390,439,626,535,1161
06,06441,064413208,La Plata,BUENOS AIRES,319,328,534,455,989
06,06441,064413303,La Plata,BUENOS AIRES,277,312,421,364,785
06,06441,064413402,La Plata,BUENOS AIRES,252,283,420,355,775
06,06441,064413404,La Plata,BUENOS AIRES,258,270,417,377,794
06,06441,064413413,La Plata,BUENOS AIRES,301,312,532,553,1085
06,06441,064413504,La Plata,BUENOS AIRES,201,213,307,249,556
06,06441,064413511,La Plata,BUENOS AIRES,430,431,701,614,1315
06,06441,064413601,La Plata,BUENOS AIRES,289,299,405,410,815
06,06441,064413605,La Plata,BUENOS AIRES,358,381,567,509,1076
06,06441,064413606,La Plata,BUENOS AIRES,340,364,691,717,1408
06,06441,064413612,La Plata,BUENOS AIRES,325,342,601,580,1181
06,06441,064416704,La Plata,BUENOS AIRES,108,134,180,209,389
06,06441,064416519,La Plata,BUENOS AIRES,352,423,586,768,1354
06,06441,064416501,La Plata,BUENOS AIRES,169,274,302,323,625
06,06441,064416509,La Plata,BUENOS AIRES,278,317,406,464,870
06,06441,064412504,La Plata,BUENOS AIRES,187,226,229,164,393
06,06441,064413105,La Plata,BUENOS AIRES,205,246,293,234,527
06,06441,064414604,La Plata,BUENOS AIRES,293,286,460,417,877
06,06441,064416110,La Plata,BUENOS AIRES,220,277,369,303,672
06,06441,064416412,La Plata,BUENOS AIRES,122,146,177,195,372
06,06441,064410101,La Plata,BUENOS AIRES,299,368,448,404,852
06,06441,064410402,La Plata,BUENOS AIRES,354,433,622,580,1202
06,06441,064410412,La Plata,BUENOS AIRES,286,392,373,293,666
06,06441,064410601,La Plata,BUENOS AIRES,248,346,272,249,521
06,06441,064410701,La Plata,BUENOS AIRES,147,218,173,112,285
06,06441,064410703,La Plata,BUENOS AIRES,287,387,329,250,579
06,06441,064410705,La Plata,BUENOS AIRES,321,467,314,261,575
06,06441,064410708,La Plata,BUENOS AIRES,172,229,176,144,320
06,06441,064410806,La Plata,BUENOS AIRES,42,68,58,35,93
06,06441,064410807,La Plata,BUENOS AIRES,180,296,198,135,333
06,06441,064411007,La Plata,BUENOS AIRES,207,242,253,227,480
06,06441,064411109,La Plata,BUENOS AIRES,200,279,233,193,426
06,06441,064411202,La Plata,BUENOS AIRES,248,368,232,190,422
06,06441,064411207,La Plata,BUENOS AIRES,234,361,264,194,458
06,06441,064411216,La Plata,BUENOS AIRES,177,334,155,138,293
06,06441,064411502,La Plata,BUENOS AIRES,283,388,298,248,546
06,06441,064411507,La Plata,BUENOS AIRES,234,334,265,214,479
06,06441,064411702,La Plata,BUENOS AIRES,213,259,303,234,537
06,06441,064411802,La Plata,BUENOS AIRES,223,284,214,178,392
06,06441,064411805,La Plata,BUENOS AIRES,244,343,325,250,575
06,06441,064411905,La Plata,BUENOS AIRES,157,201,167,147,314
06,06441,064411907,La Plata,BUENOS AIRES,222,294,265,219,484
06,06441,064411908,La Plata,BUENOS AIRES,170,225,214,173,387
06,06441,064412001,La Plata,BUENOS AIRES,322,456,410,320,730
06,06441,064412006,La Plata,BUENOS AIRES,209,276,291,237,528
06,06441,064412007,La Plata,BUENOS AIRES,185,257,223,178,401
06,06441,064412009,La Plata,BUENOS AIRES,262,349,291,248,539
06,06441,064412013,La Plata,BUENOS AIRES,148,340,154,117,271
06,06441,064412102,La Plata,BUENOS AIRES,218,330,278,221,499
06,06441,064412103,La Plata,BUENOS AIRES,383,494,489,426,915
06,06441,064412105,La Plata,BUENOS AIRES,318,372,440,387,827
06,06441,064412109,La Plata,BUENOS AIRES,204,271,243,227,470
06,06441,064412304,La Plata,BUENOS AIRES,191,236,234,233,467
06,06441,064412308,La Plata,BUENOS AIRES,238,283,301,275,576
06,06441,064412406,La Plata,BUENOS AIRES,325,466,416,305,721
06,06441,064412501,La Plata,BUENOS AIRES,232,301,250,208,458
06,06441,064412509,La Plata,BUENOS AIRES,198,240,257,212,469
06,06441,064412601,La Plata,BUENOS AIRES,220,261,283,261,544
06,06441,064412606,La Plata,BUENOS AIRES,314,364,432,384,816
06,06441,064412614,La Plata,BUENOS AIRES,273,344,349,304,653
06,06441,064412702,La Plata,BUENOS AIRES,358,452,509,480,989
06,06441,064412803,La Plata,BUENOS AIRES,240,293,310,249,559
06,06441,064413106,La Plata,BUENOS AIRES,272,297,423,381,804
06,06441,064413113,La Plata,BUENOS AIRES,216,242,314,292,606
06,06441,064413114,La Plata,BUENOS AIRES,261,296,416,344,760
06,06441,064413204,La Plata,BUENOS AIRES,410,443,659,621,1280
06,06441,064413401,La Plata,BUENOS AIRES,215,255,334,287,621
06,06441,064413414,La Plata,BUENOS AIRES,291,294,555,505,1060
06,06441,064413501,La Plata,BUENOS AIRES,381,396,611,587,1198
06,06441,064413510,La Plata,BUENOS AIRES,334,353,576,635,1211
06,06441,064413707,La Plata,BUENOS AIRES,251,263,389,361,750
06,06441,064414004,La Plata,BUENOS AIRES,228,271,332,317,649
06,06441,064414009,La Plata,BUENOS AIRES,280,284,468,523,991
06,06441,064414109,La Plata,BUENOS AIRES,340,337,652,625,1277
06,06441,064414208,La Plata,BUENOS AIRES,231,258,408,409,817
06,06441,064414212,La Plata,BUENOS AIRES,283,315,483,439,922
06,06441,064414304,La Plata,BUENOS AIRES,344,373,505,494,999
06,06441,064414306,La Plata,BUENOS AIRES,322,342,533,526,1059
06,06441,064414308,La Plata,BUENOS AIRES,245,268,439,443,882
06,06441,064414404,La Plata,BUENOS AIRES,258,283,465,414,879
06,06441,064414409,La Plata,BUENOS AIRES,252,243,486,514,1000
06,06441,064414510,La Plata,BUENOS AIRES,339,329,687,654,1341
06,06441,064414607,La Plata,BUENOS AIRES,302,352,450,434,884
06,06441,064414805,La Plata,BUENOS AIRES,202,218,332,261,593
06,06441,064414903,La Plata,BUENOS AIRES,300,356,415,392,807
06,06441,064415004,La Plata,BUENOS AIRES,204,219,296,259,555
06,06441,064415009,La Plata,BUENOS AIRES,252,282,372,316,688
06,06441,064415114,La Plata,BUENOS AIRES,227,272,362,279,641
06,06441,064415305,La Plata,BUENOS AIRES,388,399,725,674,1399
06,06441,064415308,La Plata,BUENOS AIRES,275,297,442,430,872
06,06441,064415411,La Plata,BUENOS AIRES,194,221,332,309,641
06,06441,064415415,La Plata,BUENOS AIRES,204,200,348,352,700
06,06441,064415503,La Plata,BUENOS AIRES,212,257,376,387,763
06,06441,064415508,La Plata,BUENOS AIRES,334,417,555,524,1079
06,06441,064415608,La Plata,BUENOS AIRES,426,488,668,670,1338
06,06441,064415712,La Plata,BUENOS AIRES,344,397,547,508,1055
06,06441,064415801,La Plata,BUENOS AIRES,247,290,366,326,692
06,06441,064415902,La Plata,BUENOS AIRES,238,261,404,344,748
06,06441,064416001,La Plata,BUENOS AIRES,364,410,595,561,1156
06,06441,064416003,La Plata,BUENOS AIRES,257,282,442,385,827
06,06441,064416009,La Plata,BUENOS AIRES,345,386,593,600,1193
06,06441,064416102,La Plata,BUENOS AIRES,213,231,361,323,684
06,06441,064416104,La Plata,BUENOS AIRES,227,250,359,333,692
06,06441,064416109,La Plata,BUENOS AIRES,228,283,375,362,737
06,06441,064416112,La Plata,BUENOS AIRES,245,302,463,395,858
06,06441,064416205,La Plata,BUENOS AIRES,65,72,91,84,175
06,06441,064416207,La Plata,BUENOS AIRES,202,236,323,282,605
06,06441,064416208,La Plata,BUENOS AIRES,331,383,541,500,1041
06,06441,064416211,La Plata,BUENOS AIRES,437,461,776,793,1569
06,06441,064416302,La Plata,BUENOS AIRES,219,288,341,327,668
06,06441,064416306,La Plata,BUENOS AIRES,252,329,500,502,1002
06,06441,064416604,La Plata,BUENOS AIRES,306,321,521,479,1000
06,06441,064416614,La Plata,BUENOS AIRES,235,245,391,401,792
06,06441,064410106,La Plata,BUENOS AIRES,208,247,265,227,492
06,06441,064411807,La Plata,BUENOS AIRES,240,313,306,212,518
06,06441,064416610,La Plata,BUENOS AIRES,219,252,371,356,727
06,06441,064410102,La Plata,BUENOS AIRES,303,357,437,369,806
06,06441,064410104,La Plata,BUENOS AIRES,258,284,373,339,712
06,06441,064410209,La Plata,BUENOS AIRES,392,409,475,364,839
06,06441,064410107,La Plata,BUENOS AIRES,244,268,299,307,606
06,06441,064410305,La Plata,BUENOS AIRES,258,304,330,277,607
06,06441,064410308,La Plata,BUENOS AIRES,239,218,304,277,581
06,06441,064410509,La Plata,BUENOS AIRES,157,215,217,147,364
06,06441,064410603,La Plata,BUENOS AIRES,227,307,231,165,396
06,06441,064410805,La Plata,BUENOS AIRES,157,271,167,117,284
06,06441,064410808,La Plata,BUENOS AIRES,231,325,251,179,430
06,06441,064410901,La Plata,BUENOS AIRES,153,172,176,149,325
06,06441,064410902,La Plata,BUENOS AIRES,293,390,346,253,599
06,06441,064410909,La Plata,BUENOS AIRES,243,373,236,201,437
06,06441,064410911,La Plata,BUENOS AIRES,210,329,218,187,405
06,06441,064411011,La Plata,BUENOS AIRES,193,254,270,225,495
06,06441,064411113,La Plata,BUENOS AIRES,323,440,435,287,722
06,06441,064411116,La Plata,BUENOS AIRES,203,314,235,185,420
06,06441,064411209,La Plata,BUENOS AIRES,163,261,172,128,300
06,06441,064411212,La Plata,BUENOS AIRES,161,234,216,118,334
06,06441,064411308,La Plata,BUENOS AIRES,200,307,226,177,403
06,06441,064411401,La Plata,BUENOS AIRES,173,266,171,133,304
06,06441,064411402,La Plata,BUENOS AIRES,155,213,183,108,291
06,06441,064411512,La Plata,BUENOS AIRES,195,287,217,174,391
06,06441,064411603,La Plata,BUENOS AIRES,214,264,242,232,474
06,06441,064411613,La Plata,BUENOS AIRES,166,215,195,194,389
06,06441,064411705,La Plata,BUENOS AIRES,314,388,441,374,815
06,06441,064411706,La Plata,BUENOS AIRES,190,228,555,401,956
06,06441,064411708,La Plata,BUENOS AIRES,245,316,290,254,544
06,06441,064411710,La Plata,BUENOS AIRES,179,207,270,215,485
06,06441,064412004,La Plata,BUENOS AIRES,166,232,216,154,370
06,06441,064412008,La Plata,BUENOS AIRES,228,326,257,217,474
06,06441,064412012,La Plata,BUENOS AIRES,131,209,180,121,301
06,06441,064412015,La Plata,BUENOS AIRES,163,382,193,130,323
06,06441,064412016,La Plata,BUENOS AIRES,151,442,158,125,283
06,06441,064412017,La Plata,BUENOS AIRES,147,214,188,165,353
06,06441,064412107,La Plata,BUENOS AIRES,199,262,255,214,469
06,06441,064413705,La Plata,BUENOS AIRES,337,356,669,691,1360
06,06441,064413708,La Plata,BUENOS AIRES,297,308,492,486,978
06,06441,064413713,La Plata,BUENOS AIRES,255,301,476,449,925
06,06441,064413805,La Plata,BUENOS AIRES,288,301,492,448,940
06,06441,064413807,La Plata,BUENOS AIRES,349,343,584,546,1130
06,06441,064413902,La Plata,BUENOS AIRES,232,262,329,294,623
06,06441,064414006,La Plata,BUENOS AIRES,348,379,542,516,1058
06,06441,064414007,La Plata,BUENOS AIRES,293,287,504,483,987
06,06441,064414008,La Plata,BUENOS AIRES,265,273,469,471,940
06,06441,064414209,La Plata,BUENOS AIRES,283,313,530,511,1041
06,06441,064414213,La Plata,BUENOS AIRES,137,131,264,243,507
06,06441,064414214,La Plata,BUENOS AIRES,131,135,256,265,521
06,06441,064414301,La Plata,BUENOS AIRES,265,298,433,404,837
06,06441,064414315,La Plata,BUENOS AIRES,461,525,816,858,1674
06,06441,064414401,La Plata,BUENOS AIRES,283,300,475,416,891
06,06441,064414606,La Plata,BUENOS AIRES,232,261,353,324,677
06,06441,064414701,La Plata,BUENOS AIRES,520,342,938,849,1787
06,06441,064414704,La Plata,BUENOS AIRES,456,499,732,698,1430
06,06441,064414901,La Plata,BUENOS AIRES,314,342,483,424,907
06,06441,064415008,La Plata,BUENOS AIRES,235,260,336,282,618
06,06441,064415106,La Plata,BUENOS AIRES,178,169,317,335,652
06,06441,064415110,La Plata,BUENOS AIRES,171,186,260,203,463
06,06441,064415201,La Plata,BUENOS AIRES,296,312,595,616,1211
06,06441,064415210,La Plata,BUENOS AIRES,252,301,364,299,663
06,06441,064415806,La Plata,BUENOS AIRES,197,221,274,268,542
06,06441,064415410,La Plata,BUENOS AIRES,293,336,501,435,936
06,06441,064415412,La Plata,BUENOS AIRES,308,340,512,498,1010
06,06441,064415501,La Plata,BUENOS AIRES,487,483,940,866,1806
06,06441,064415509,La Plata,BUENOS AIRES,246,275,404,435,839
06,06441,064415602,La Plata,BUENOS AIRES,369,432,601,574,1175
06,06441,064415604,La Plata,BUENOS AIRES,265,312,407,364,771
06,06441,064415708,La Plata,BUENOS AIRES,289,284,437,407,844
06,06441,064415709,La Plata,BUENOS AIRES,245,270,451,437,888
06,06441,064415713,La Plata,BUENOS AIRES,244,269,437,361,798
06,06441,064415904,La Plata,BUENOS AIRES,282,304,446,389,835
06,06441,064416105,La Plata,BUENOS AIRES,288,321,450,416,866
06,06441,064416108,La Plata,BUENOS AIRES,95,108,180,175,355
06,06441,064416303,La Plata,BUENOS AIRES,274,366,442,425,867
06,06441,064416304,La Plata,BUENOS AIRES,293,358,505,513,1018
06,06441,064416403,La Plata,BUENOS AIRES,137,159,272,332,604
06,06441,064416504,La Plata,BUENOS AIRES,40,62,70,70,140
06,06441,064416508,La Plata,BUENOS AIRES,45,86,86,70,156
06,06441,064416802,La Plata,BUENOS AIRES,446,502,808,748,1556
06,06441,064416910,La Plata,BUENOS AIRES,232,272,363,343,706
06,06441,064417006,La Plata,BUENOS AIRES,298,325,549,585,1134
06,06441,064416408,La Plata,BUENOS AIRES,48,36,63,86,149
06,06441,064416511,La Plata,BUENOS AIRES,326,354,558,634,1192
06,06441,064416801,La Plata,BUENOS AIRES,232,239,407,441,848
06,06441,064417007,La Plata,BUENOS AIRES,224,372,328,376,704
06,06441,064410410,La Plata,BUENOS AIRES,272,346,284,234,518
06,06441,064411808,La Plata,BUENOS AIRES,290,376,359,290,649
06,06441,064411707,La Plata,BUENOS AIRES,193,210,260,233,493
06,06441,064414708,La Plata,BUENOS AIRES,340,298,595,554,1149
06,06441,064414906,La Plata,BUENOS AIRES,264,293,345,301,646
06,06441,064410110,La Plata,BUENOS AIRES,340,444,500,433,933
06,06441,064410111,La Plata,BUENOS AIRES,195,232,300,261,561
06,06441,064410206,La Plata,BUENOS AIRES,305,338,590,300,890
06,06441,064410207,La Plata,BUENOS AIRES,412,445,366,341,707
06,06441,064410210,La Plata,BUENOS AIRES,382,422,451,424,875
06,06441,064410301,La Plata,BUENOS AIRES,214,225,301,275,576
06,06441,064410307,La Plata,BUENOS AIRES,365,401,454,384,838
06,06441,064410413,La Plata,BUENOS AIRES,208,282,277,218,495
06,06441,064410505,La Plata,BUENOS AIRES,176,246,176,170,346
06,06441,064410508,La Plata,BUENOS AIRES,210,279,240,205,445
06,06441,064410801,La Plata,BUENOS AIRES,316,459,339,289,628
06,06441,064410802,La Plata,BUENOS AIRES,256,319,268,181,449
06,06441,064410906,La Plata,BUENOS AIRES,266,369,357,296,653
06,06441,064410907,La Plata,BUENOS AIRES,247,335,303,274,577
06,06441,064411005,La Plata,BUENOS AIRES,179,222,250,185,435
06,06441,064411006,La Plata,BUENOS AIRES,312,401,485,423,908
06,06441,064411102,La Plata,BUENOS AIRES,275,361,346,264,610
06,06441,064411111,La Plata,BUENOS AIRES,298,369,378,281,659
06,06441,064411204,La Plata,BUENOS AIRES,217,363,252,169,421
06,06441,064411205,La Plata,BUENOS AIRES,308,443,392,268,660
06,06441,064411404,La Plata,BUENOS AIRES,262,413,306,198,504
06,06441,064411511,La Plata,BUENOS AIRES,247,294,250,226,476
06,06441,064411609,La Plata,BUENOS AIRES,220,284,353,293,646
06,06441,064411711,La Plata,BUENOS AIRES,205,228,286,242,528
06,06441,064411804,La Plata,BUENOS AIRES,179,241,220,174,394
06,06441,064412115,La Plata,BUENOS AIRES,350,448,442,411,853
06,06441,064412306,La Plata,BUENOS AIRES,227,273,285,256,541
06,06441,064412613,La Plata,BUENOS AIRES,216,255,287,241,528
06,06441,064412801,La Plata,BUENOS AIRES,232,277,303,283,586
06,06441,064412805,La Plata,BUENOS AIRES,213,268,304,249,553
06,06441,064412908,La Plata,BUENOS AIRES,191,223,286,258,544
06,06441,064412909,La Plata,BUENOS AIRES,303,373,408,331,739
06,06441,064413001,La Plata,BUENOS AIRES,316,296,550,489,1039
06,06441,064413004,La Plata,BUENOS AIRES,367,418,576,502,1078
06,06441,064413102,La Plata,BUENOS AIRES,231,243,350,351,701
06,06441,064413211,La Plata,BUENOS AIRES,379,411,612,604,1216
06,06441,064413304,La Plata,BUENOS AIRES,223,252,324,314,638
06,06441,064413306,La Plata,BUENOS AIRES,433,462,663,635,1298
06,06441,064413310,La Plata,BUENOS AIRES,314,380,470,426,896
06,06441,064413403,La Plata,BUENOS AIRES,379,401,635,649,1284
06,06441,064413408,La Plata,BUENOS AIRES,358,377,518,453,971
06,06441,064413412,La Plata,BUENOS AIRES,165,190,270,265,535
06,06441,064413505,La Plata,BUENOS AIRES,377,396,605,567,1172
06,06441,064413513,La Plata,BUENOS AIRES,369,398,541,480,1021
06,06441,064413608,La Plata,BUENOS AIRES,264,300,382,371,753
06,06441,064413701,La Plata,BUENOS AIRES,338,348,605,601,1206
06,06441,064413704,La Plata,BUENOS AIRES,209,215,419,418,837
06,06441,064413904,La Plata,BUENOS AIRES,268,281,432,391,823
06,06441,064413907,La Plata,BUENOS AIRES,238,227,476,422,898
06,06441,064414013,La Plata,BUENOS AIRES,431,424,803,814,1617
06,06441,064414102,La Plata,BUENOS AIRES,336,361,653,661,1314
06,06441,064414107,La Plata,BUENOS AIRES,293,300,519,504,1023
06,06441,064414108,La Plata,BUENOS AIRES,446,454,795,774,1569
06,06441,064414110,La Plata,BUENOS AIRES,288,292,589,552,1141
06,06441,064414204,La Plata,BUENOS AIRES,341,321,614,633,1247
06,06441,064414406,La Plata,BUENOS AIRES,294,306,500,495,995
06,06441,064414502,La Plata,BUENOS AIRES,264,294,454,415,869
06,06441,064414504,La Plata,BUENOS AIRES,347,339,651,662,1313
06,06441,064414602,La Plata,BUENOS AIRES,355,352,620,578,1198
06,06441,064414804,La Plata,BUENOS AIRES,417,430,669,589,1258
06,06441,064414806,La Plata,BUENOS AIRES,283,314,457,449,906
06,06441,064414910,La Plata,BUENOS AIRES,201,236,262,217,479
06,06441,064415007,La Plata,BUENOS AIRES,179,213,251,218,469
06,06441,064415105,La Plata,BUENOS AIRES,402,441,609,579,1188
06,06441,064415206,La Plata,BUENOS AIRES,171,214,294,269,563
06,06441,064415414,La Plata,BUENOS AIRES,245,277,439,404,843
06,06441,064415418,La Plata,BUENOS AIRES,318,340,512,443,955
06,06441,064415506,La Plata,BUENOS AIRES,335,384,551,532,1083
06,06441,064415706,La Plata,BUENOS AIRES,410,421,681,679,1360
06,06441,064415802,La Plata,BUENOS AIRES,243,284,384,326,710
06,06441,064416006,La Plata,BUENOS AIRES,247,279,379,366,745
06,06441,064416007,La Plata,BUENOS AIRES,290,313,513,520,1033
06,06441,064416107,La Plata,BUENOS AIRES,264,336,421,426,847
06,06441,064416203,La Plata,BUENOS AIRES,228,271,357,351,708
06,06441,064416401,La Plata,BUENOS AIRES,402,468,669,645,1314
06,06441,064416402,La Plata,BUENOS AIRES,140,166,249,211,460
06,06441,064416414,La Plata,BUENOS AIRES,164,220,283,269,552
06,06441,064416606,La Plata,BUENOS AIRES,261,272,454,485,939
06,06441,064416618,La Plata,BUENOS AIRES,293,356,544,513,1057
06,06441,064416905,La Plata,BUENOS AIRES,310,309,512,533,1045
06,06441,064416912,La Plata,BUENOS AIRES,115,142,191,209,400
06,06441,064417003,La Plata,BUENOS AIRES,224,224,408,402,810
06,06441,064417005,La Plata,BUENOS AIRES,346,367,661,608,1269
06,06476,064760104,Lobería,BUENOS AIRES,190,215,264,186,450
06,06476,064760705,Lobería,BUENOS AIRES,51,65,73,72,145
06,06476,064761105,Lobería,BUENOS AIRES,19,40,25,27,52
06,06476,064760501,Lobería,BUENOS AIRES,21,34,34,42,76
06,06476,064760106,Lobería,BUENOS AIRES,260,286,453,441,894
06,06476,064761003,Lobería,BUENOS AIRES,10,17,11,17,28
06,06476,064760202,Lobería,BUENOS AIRES,55,76,70,79,149
06,06476,064760203,Lobería,BUENOS AIRES,42,69,48,63,111
06,06476,064760602,Lobería,BUENOS AIRES,12,36,16,20,36
06,06476,064760603,Lobería,BUENOS AIRES,37,81,47,56,103
06,06476,064760804,Lobería,BUENOS AIRES,17,32,15,27,42
06,06476,064761204,Lobería,BUENOS AIRES,21,43,43,55,98
06,06476,064760103,Lobería,BUENOS AIRES,194,225,252,201,453
06,06476,064761401,Lobería,BUENOS AIRES,242,248,420,437,857
06,06476,064761408,Lobería,BUENOS AIRES,312,330,490,476,966
06,06476,064760803,Lobería,BUENOS AIRES,14,28,14,20,34
06,06476,064760205,Lobería,BUENOS AIRES,36,45,65,62,127
06,06476,064760206,Lobería,BUENOS AIRES,23,36,34,39,73
06,06476,064760403,Lobería,BUENOS AIRES,7,16,6,10,16
06,06476,064761206,Lobería,BUENOS AIRES,27,45,25,48,73
06,06476,064761407,Lobería,BUENOS AIRES,148,189,215,193,408
06,06476,064760902,Lobería,BUENOS AIRES,16,45,19,29,48
06,06476,064761002,Lobería,BUENOS AIRES,10,19,13,16,29
06,06476,064761104,Lobería,BUENOS AIRES,8,23,11,11,22
06,06476,064760105,Lobería,BUENOS AIRES,209,238,273,258,531
06,06476,064760101,Lobería,BUENOS AIRES,233,235,424,403,827
06,06476,064761402,Lobería,BUENOS AIRES,283,289,464,446,910
06,06476,064761404,Lobería,BUENOS AIRES,257,291,370,385,755
06,06476,064760504,Lobería,BUENOS AIRES,15,26,18,30,48
06,06476,064760702,Lobería,BUENOS AIRES,48,64,66,86,152
06,06476,064760901,Lobería,BUENOS AIRES,19,28,21,33,54
06,06476,064761001,Lobería,BUENOS AIRES,30,47,40,60,100
06,06476,064760708,Lobería,BUENOS AIRES,182,206,285,319,604
06,06476,064761405,Lobería,BUENOS AIRES,220,254,301,271,572
06,06476,064760204,Lobería,BUENOS AIRES,25,43,22,38,60
06,06476,064760208,Lobería,BUENOS AIRES,20,36,28,40,68
06,06476,064760302,Lobería,BUENOS AIRES,18,34,17,22,39
06,06476,064760303,Lobería,BUENOS AIRES,10,19,11,21,32
06,06476,064760404,Lobería,BUENOS AIRES,15,28,20,19,39
06,06476,064760505,Lobería,BUENOS AIRES,11,25,15,18,33
06,06476,064760601,Lobería,BUENOS AIRES,9,15,6,13,19
06,06476,064760801,Lobería,BUENOS AIRES,19,33,25,27,52
06,06476,064761203,Lobería,BUENOS AIRES,26,32,27,36,63
06,06476,064761102,Lobería,BUENOS AIRES,24,41,13,72,85
06,06476,064760704,Lobería,BUENOS AIRES,46,68,55,68,123
06,06476,064760703,Lobería,BUENOS AIRES,82,106,125,151,276
06,06476,064760108,Lobería,BUENOS AIRES,296,313,474,465,939
06,06476,064760701,Lobería,BUENOS AIRES,96,107,166,151,317
06,06476,064760207,Lobería,BUENOS AIRES,25,36,40,28,68
06,06476,064760401,Lobería,BUENOS AIRES,7,9,11,10,21
06,06476,064760604,Lobería,BUENOS AIRES,7,28,11,7,18
06,06476,064761103,Lobería,BUENOS AIRES,20,35,23,27,50
06,06476,064761205,Lobería,BUENOS AIRES,26,44,27,43,70
06,06476,064760102,Lobería,BUENOS AIRES,292,300,453,402,855
06,06476,064760201,Lobería,BUENOS AIRES,407,485,574,552,1126
06,06476,064760707,Lobería,BUENOS AIRES,133,166,228,246,474
06,06476,064761101,Lobería,BUENOS AIRES,10,14,14,18,32
06,06476,064761201,Lobería,BUENOS AIRES,3,17,7,5,12
06,06476,064761403,Lobería,BUENOS AIRES,322,345,496,436,932
06,06476,064760301,Lobería,BUENOS AIRES,29,51,37,48,85
06,06476,064760402,Lobería,BUENOS AIRES,8,20,1,8,9
06,06476,064760802,Lobería,BUENOS AIRES,17,25,16,22,38
06,06476,064760107,Lobería,BUENOS AIRES,265,298,419,360,779
06,06476,064761406,Lobería,BUENOS AIRES,208,241,295,257,552
06,06476,064760502,Lobería,BUENOS AIRES,26,38,21,44,65
06,06476,064760503,Lobería,BUENOS AIRES,16,32,16,20,36
06,06476,064760706,Lobería,BUENOS AIRES,6,12,5,8,13
06,06476,064760709,Lobería,BUENOS AIRES,15,25,16,31,47
06,06476,064760903,Lobería,BUENOS AIRES,16,23,12,23,35
06,06476,064760904,Lobería,BUENOS AIRES,8,28,10,12,22
06,06476,064760905,Lobería,BUENOS AIRES,7,9,10,11,21
06,06476,064761202,Lobería,BUENOS AIRES,26,43,22,45,67
06,06476,064761301,Lobería,BUENOS AIRES,38,44,40,68,108
02,02009,020090102,Comuna 9,CIUDAD DE BUENOS AIRES,184,180,240,204,444
02,02009,020090101,Comuna 9,CIUDAD DE BUENOS AIRES,206,204,296,234,530
02,02009,020090107,Comuna 9,CIUDAD DE BUENOS AIRES,257,249,379,304,683
02,02009,020090108,Comuna 9,CIUDAD DE BUENOS AIRES,278,260,345,338,683
02,02009,020090106,Comuna 9,CIUDAD DE BUENOS AIRES,291,238,400,409,809
02,02009,020090109,Comuna 9,CIUDAD DE BUENOS AIRES,344,341,392,359,751
02,02009,020090105,Comuna 9,CIUDAD DE BUENOS AIRES,294,278,385,352,737
02,02009,020091104,Comuna 9,CIUDAD DE BUENOS AIRES,370,344,571,484,1055
02,02009,020090103,Comuna 9,CIUDAD DE BUENOS AIRES,261,247,345,268,613
02,02009,020091102,Comuna 9,CIUDAD DE BUENOS AIRES,355,344,556,526,1082
02,02009,020090104,Comuna 9,CIUDAD DE BUENOS AIRES,269,253,399,350,749
02,02009,020091101,Comuna 9,CIUDAD DE BUENOS AIRES,430,402,617,534,1151
02,02009,020091105,Comuna 9,CIUDAD DE BUENOS AIRES,397,369,640,584,1224
02,02009,020090305,Comuna 9,CIUDAD DE BUENOS AIRES,271,255,323,223,546
02,02009,020090306,Comuna 9,CIUDAD DE BUENOS AIRES,298,292,415,334,749
02,02009,020090304,Comuna 9,CIUDAD DE BUENOS AIRES,242,232,335,306,641
02,02009,020090201,Comuna 9,CIUDAD DE BUENOS AIRES,349,346,447,377,824
02,02009,020090303,Comuna 9,CIUDAD DE BUENOS AIRES,239,224,325,276,601
02,02009,020091103,Comuna 9,CIUDAD DE BUENOS AIRES,292,271,448,398,846
02,02009,020090302,Comuna 9,CIUDAD DE BUENOS AIRES,255,243,370,306,676
02,02009,020090202,Comuna 9,CIUDAD DE BUENOS AIRES,301,294,414,353,767
02,02009,020090301,Comuna 9,CIUDAD DE BUENOS AIRES,263,245,328,318,646
02,02009,020090203,Comuna 9,CIUDAD DE BUENOS AIRES,330,321,431,388,819
02,02009,020090204,Comuna 9,CIUDAD DE BUENOS AIRES,414,413,546,436,982
02,02009,020091009,Comuna 9,CIUDAD DE BUENOS AIRES,170,167,245,214,459
02,02009,020091107,Comuna 9,CIUDAD DE BUENOS AIRES,385,357,587,537,1124
02,02009,020091008,Comuna 9,CIUDAD DE BUENOS AIRES,322,313,497,434,931
02,02009,020090205,Comuna 9,CIUDAD DE BUENOS AIRES,428,402,617,526,1143
02,02009,020091106,Comuna 9,CIUDAD DE BUENOS AIRES,327,297,510,449,959
02,02009,020091108,Comuna 9,CIUDAD DE BUENOS AIRES,311,275,493,415,908
02,02009,020090206,Comuna 9,CIUDAD DE BUENOS AIRES,255,244,389,327,716
02,02009,020091010,Comuna 9,CIUDAD DE BUENOS AIRES,304,302,417,343,760
02,02009,020091007,Comuna 9,CIUDAD DE BUENOS AIRES,249,232,356,313,669
02,02009,020090209,Comuna 9,CIUDAD DE BUENOS AIRES,358,353,473,388,861
02,02009,020090307,Comuna 9,CIUDAD DE BUENOS AIRES,316,305,458,361,819
02,02009,020090210,Comuna 9,CIUDAD DE BUENOS AIRES,305,293,398,356,754
02,02009,020090509,Comuna 9,CIUDAD DE BUENOS AIRES,330,324,431,361,792
02,02009,020091202,Comuna 9,CIUDAD DE BUENOS AIRES,191,168,270,276,546
02,02009,020091111,Comuna 9,CIUDAD DE BUENOS AIRES,329,304,520,449,969
02,02009,020091006,Comuna 9,CIUDAD DE BUENOS AIRES,282,230,407,403,810
02,02009,020091109,Comuna 9,CIUDAD DE BUENOS AIRES,314,274,625,457,1082
02,02009,020090510,Comuna 9,CIUDAD DE BUENOS AIRES,319,310,439,408,847
02,02009,020090207,Comuna 9,CIUDAD DE BUENOS AIRES,300,294,418,382,800
02,02009,020090211,Comuna 9,CIUDAD DE BUENOS AIRES,341,337,609,449,1058
02,02009,020091011,Comuna 9,CIUDAD DE BUENOS AIRES,245,240,324,262,586
02,02009,020090310,Comuna 9,CIUDAD DE BUENOS AIRES,283,272,419,390,809
02,02009,020091004,Comuna 9,CIUDAD DE BUENOS AIRES,237,229,339,287,626
02,02009,020090313,Comuna 9,CIUDAD DE BUENOS AIRES,313,255,511,435,946
02,02009,020091012,Comuna 9,CIUDAD DE BUENOS AIRES,224,222,287,233,520
02,02009,020091005,Comuna 9,CIUDAD DE BUENOS AIRES,342,333,475,408,883
02,02009,020090208,Comuna 9,CIUDAD DE BUENOS AIRES,245,239,357,329,686
02,02009,020091110,Comuna 9,CIUDAD DE BUENOS AIRES,306,285,491,432,923
02,02009,020090308,Comuna 9,CIUDAD DE BUENOS AIRES,279,267,432,346,778
02,02009,020091003,Comuna 9,CIUDAD DE BUENOS AIRES,328,312,645,486,1131
02,02009,020090311,Comuna 9,CIUDAD DE BUENOS AIRES,294,275,439,394,833
02,02009,020090212,Comuna 9,CIUDAD DE BUENOS AIRES,223,217,333,292,625
02,02009,020090608,Comuna 9,CIUDAD DE BUENOS AIRES,281,273,403,382,785
02,02009,020090508,Comuna 9,CIUDAD DE BUENOS AIRES,292,270,436,398,834
02,02009,020091302,Comuna 9,CIUDAD DE BUENOS AIRES,404,375,582,530,1112
02,02009,020090609,Comuna 9,CIUDAD DE BUENOS AIRES,373,359,445,445,890
02,02009,020090511,Comuna 9,CIUDAD DE BUENOS AIRES,317,292,465,435,900
02,02009,020091112,Comuna 9,CIUDAD DE BUENOS AIRES,414,365,651,609,1260
02,02009,020090501,Comuna 9,CIUDAD DE BUENOS AIRES,310,291,465,414,879
02,02009,020090503,Comuna 9,CIUDAD DE BUENOS AIRES,261,254,593,468,1061
02,02009,020090606,Comuna 9,CIUDAD DE BUENOS AIRES,259,250,384,325,709
02,02009,020090610,Comuna 9,CIUDAD DE BUENOS AIRES,345,316,495,404,899
02,02009,020091001,Comuna 9,CIUDAD DE BUENOS AIRES,298,288,440,385,825
02,02009,020091002,Comuna 9,CIUDAD DE BUENOS AIRES,336,318,580,488,1068
02,02009,020091301,Comuna 9,CIUDAD DE BUENOS AIRES,315,264,491,481,972
02,02009,020090309,Comuna 9,CIUDAD DE BUENOS AIRES,257,246,391,306,697
02,02009,020091201,Comuna 9,CIUDAD DE BUENOS AIRES,338,324,561,481,1042
02,02009,020090312,Comuna 9,CIUDAD DE BUENOS AIRES,213,188,297,288,585
02,02009,020090607,Comuna 9,CIUDAD DE BUENOS AIRES,374,364,543,456,999
02,02009,020090506,Comuna 9,CIUDAD DE BUENOS AIRES,315,304,450,391,841
02,02009,020090507,Comuna 9,CIUDAD DE BUENOS AIRES,314,302,405,393,798
02,02009,020091303,Comuna 9,CIUDAD DE BUENOS AIRES,402,360,587,606,1193
02,02009,020090605,Comuna 9,CIUDAD DE BUENOS AIRES,412,372,586,523,1109
02,02009,020090502,Comuna 9,CIUDAD DE BUENOS AIRES,322,298,446,386,832
02,02009,020091203,Comuna 9,CIUDAD DE BUENOS AIRES,283,263,457,401,858
02,02009,020090611,Comuna 9,CIUDAD DE BUENOS AIRES,309,274,440,383,823
02,02009,020090907,Comuna 9,CIUDAD DE BUENOS AIRES,359,294,519,445,964
02,02009,020091304,Comuna 9,CIUDAD DE BUENOS AIRES,250,227,421,401,822
02,02009,020090404,Comuna 9,CIUDAD DE BUENOS AIRES,329,316,502,429,931
02,02009,020090403,Comuna 9,CIUDAD DE BUENOS AIRES,342,335,499,411,910
02,02009,020090604,Comuna 9,CIUDAD DE BUENOS AIRES,341,337,467,438,905
02,02009,020090402,Comuna 9,CIUDAD DE BUENOS AIRES,325,304,492,431,923
02,02009,020090401,Comuna 9,CIUDAD DE BUENOS AIRES,361,336,516,410,926
02,02009,020090411,Comuna 9,CIUDAD DE BUENOS AIRES,341,330,481,452,933
02,02009,020091208,Comuna 9,CIUDAD DE BUENOS AIRES,320,312,526,491,1017
02,02009,020091204,Comuna 9,CIUDAD DE BUENOS AIRES,296,271,426,384,810
02,02009,020090601,Comuna 9,CIUDAD DE BUENOS AIRES,408,397,605,506,1111
02,02009,020090505,Comuna 9,CIUDAD DE BUENOS AIRES,384,374,561,445,1006
02,02009,020090612,Comuna 9,CIUDAD DE BUENOS AIRES,286,266,426,404,830
02,02009,020091207,Comuna 9,CIUDAD DE BUENOS AIRES,250,242,364,355,719
02,02009,020090908,Comuna 9,CIUDAD DE BUENOS AIRES,205,179,297,292,589
02,02009,020091212,Comuna 9,CIUDAD DE BUENOS AIRES,232,205,373,353,726
02,02009,020090602,Comuna 9,CIUDAD DE BUENOS AIRES,259,250,468,366,834
02,02009,020090909,Comuna 9,CIUDAD DE BUENOS AIRES,256,240,433,376,809
02,02009,020090901,Comuna 9,CIUDAD DE BUENOS AIRES,282,261,442,350,792
02,02009,020090410,Comuna 9,CIUDAD DE BUENOS AIRES,290,235,419,352,771
02,02009,020090504,Comuna 9,CIUDAD DE BUENOS AIRES,303,290,471,377,848
02,02009,020091205,Comuna 9,CIUDAD DE BUENOS AIRES,290,255,417,386,803
02,02009,020090603,Comuna 9,CIUDAD DE BUENOS AIRES,373,364,510,419,929
02,02009,020090708,Comuna 9,CIUDAD DE BUENOS AIRES,275,269,389,348,737
02,02009,020091306,Comuna 9,CIUDAD DE BUENOS AIRES,300,184,488,489,977
02,02009,020090906,Comuna 9,CIUDAD DE BUENOS AIRES,304,296,469,412,881
02,02009,020090405,Comuna 9,CIUDAD DE BUENOS AIRES,355,302,523,469,992
02,02009,020091206,Comuna 9,CIUDAD DE BUENOS AIRES,338,316,538,478,1016
02,02009,020091305,Comuna 9,CIUDAD DE BUENOS AIRES,303,288,524,452,976
02,02009,020091209,Comuna 9,CIUDAD DE BUENOS AIRES,292,280,470,401,871
02,02009,020090910,Comuna 9,CIUDAD DE BUENOS AIRES,285,270,431,408,839
02,02009,020090914,Comuna 9,CIUDAD DE BUENOS AIRES,310,306,519,452,971
02,02009,020090902,Comuna 9,CIUDAD DE BUENOS AIRES,268,242,386,334,720
02,02009,020090408,Comuna 9,CIUDAD DE BUENOS AIRES,270,254,416,319,735
02,02009,020091211,Comuna 9,CIUDAD DE BUENOS AIRES,310,293,432,427,859
02,02009,020091210,Comuna 9,CIUDAD DE BUENOS AIRES,343,333,537,526,1063
02,02009,020090707,Comuna 9,CIUDAD DE BUENOS AIRES,232,219,336,264,600
02,02009,020090409,Comuna 9,CIUDAD DE BUENOS AIRES,256,243,365,342,707
02,02009,020090709,Comuna 9,CIUDAD DE BUENOS AIRES,313,295,449,389,838
02,02009,020090903,Comuna 9,CIUDAD DE BUENOS AIRES,396,373,546,487,1033
02,02009,020090911,Comuna 9,CIUDAD DE BUENOS AIRES,275,247,412,341,753
02,02009,020091307,Comuna 9,CIUDAD DE BUENOS AIRES,358,347,571,575,1146
02,02009,020090706,Comuna 9,CIUDAD DE BUENOS AIRES,308,270,451,402,853
02,02009,020090407,Comuna 9,CIUDAD DE BUENOS AIRES,271,255,372,308,680
02,02009,020090714,Comuna 9,CIUDAD DE BUENOS AIRES,297,283,486,375,861
02,02009,020091504,Comuna 9,CIUDAD DE BUENOS AIRES,272,240,452,413,865
02,02009,020090710,Comuna 9,CIUDAD DE BUENOS AIRES,245,234,362,307,669
02,02009,020090913,Comuna 9,CIUDAD DE BUENOS AIRES,209,195,341,299,640
02,02009,020090705,Comuna 9,CIUDAD DE BUENOS AIRES,257,252,377,332,709
02,02009,020090406,Comuna 9,CIUDAD DE BUENOS AIRES,251,241,334,292,626
02,02009,020090912,Comuna 9,CIUDAD DE BUENOS AIRES,227,218,371,318,689
02,02009,020091401,Comuna 9,CIUDAD DE BUENOS AIRES,388,341,572,537,1109
02,02009,020090905,Comuna 9,CIUDAD DE BUENOS AIRES,261,244,381,332,713
02,02009,020090713,Comuna 9,CIUDAD DE BUENOS AIRES,324,314,450,379,829
02,02009,020090704,Comuna 9,CIUDAD DE BUENOS AIRES,242,237,371,298,669
02,02009,020090808,Comuna 9,CIUDAD DE BUENOS AIRES,335,321,576,506,1082
02,02009,020090711,Comuna 9,CIUDAD DE BUENOS AIRES,278,271,405,362,767
02,02009,020090904,Comuna 9,CIUDAD DE BUENOS AIRES,211,186,326,302,628
02,02009,020090703,Comuna 9,CIUDAD DE BUENOS AIRES,220,213,309,259,568
02,02009,020091505,Comuna 9,CIUDAD DE BUENOS AIRES,319,312,481,468,949
02,02009,020091503,Comuna 9,CIUDAD DE BUENOS AIRES,290,267,456,407,863
02,02009,020090712,Comuna 9,CIUDAD DE BUENOS AIRES,315,299,527,487,1014
02,02009,020091402,Comuna 9,CIUDAD DE BUENOS AIRES,307,270,465,452,917
02,02009,020090701,Comuna 9,CIUDAD DE BUENOS AIRES,269,261,413,352,765
02,02009,020091404,Comuna 9,CIUDAD DE BUENOS AIRES,249,184,438,408,846
02,02009,020091502,Comuna 9,CIUDAD DE BUENOS AIRES,290,226,442,433,875
02,02009,020091403,Comuna 9,CIUDAD DE BUENOS AIRES,263,231,410,363,773
02,02009,020090801,Comuna 9,CIUDAD DE BUENOS AIRES,287,264,401,369,770
02,02009,020090702,Comuna 9,CIUDAD DE BUENOS AIRES,300,296,440,402,842
02,02009,020091506,Comuna 9,CIUDAD DE BUENOS AIRES,336,304,523,526,1049
02,02009,020090807,Comuna 9,CIUDAD DE BUENOS AIRES,330,300,556,510,1066
02,02009,020091501,Comuna 9,CIUDAD DE BUENOS AIRES,217,198,300,279,579
02,02009,020091508,Comuna 9,CIUDAD DE BUENOS AIRES,283,256,430,413,843
02,02009,020091405,Comuna 9,CIUDAD DE BUENOS AIRES,457,324,973,907,1880
02,02009,020090809,Comuna 9,CIUDAD DE BUENOS AIRES,250,232,396,368,764
02,02009,020091507,Comuna 9,CIUDAD DE BUENOS AIRES,348,319,539,520,1059
02,02009,020090802,Comuna 9,CIUDAD DE BUENOS AIRES,294,277,380,353,733
02,02009,020091406,Comuna 9,CIUDAD DE BUENOS AIRES,659,543,1297,1261,2558
02,02009,020091408,Comuna 9,CIUDAD DE BUENOS AIRES,426,333,855,829,1684
02,02009,020091509,Comuna 9,CIUDAD DE BUENOS AIRES,293,257,435,366,801
02,02009,020090806,Comuna 9,CIUDAD DE BUENOS AIRES,353,343,492,502,994
02,02009,020090803,Comuna 9,CIUDAD DE BUENOS AIRES,293,282,463,369,832
02,02009,020091604,Comuna 9,CIUDAD DE BUENOS AIRES,247,225,356,373,729
02,02009,020091409,Comuna 9,CIUDAD DE BUENOS AIRES,252,180,470,435,905
02,02009,020091410,Comuna 9,CIUDAD DE BUENOS AIRES,489,400,907,897,1804
02,02009,020091407,Comuna 9,CIUDAD DE BUENOS AIRES,351,253,698,676,1374
02,02009,020090805,Comuna 9,CIUDAD DE BUENOS AIRES,329,323,476,433,909
02,02009,020090810,Comuna 9,CIUDAD DE BUENOS AIRES,326,298,457,448,905
02,02009,020091511,Comuna 9,CIUDAD DE BUENOS AIRES,311,283,476,452,928
02,02009,020091510,Comuna 9,CIUDAD DE BUENOS AIRES,229,208,337,345,682
02,02009,020090811,Comuna 9,CIUDAD DE BUENOS AIRES,323,289,468,437,905
02,02009,020090804,Comuna 9,CIUDAD DE BUENOS AIRES,286,280,379,324,703
02,02009,020091603,Comuna 9,CIUDAD DE BUENOS AIRES,228,181,345,268,613
02,02009,020091602,Comuna 9,CIUDAD DE BUENOS AIRES,314,294,459,404,863
02,02009,020090812,Comuna 9,CIUDAD DE BUENOS AIRES,331,315,491,463,954
02,02009,020091605,Comuna 9,CIUDAD DE BUENOS AIRES,283,225,462,425,887
02,02009,020090813,Comuna 9,CIUDAD DE BUENOS AIRES,207,198,335,315,650
02,02009,020091601,Comuna 9,CIUDAD DE BUENOS AIRES,309,282,483,442,925
02,02009,020091611,Comuna 9,CIUDAD DE BUENOS AIRES,247,238,379,369,748
02,02009,020091606,Comuna 9,CIUDAD DE BUENOS AIRES,326,306,527,459,986
02,02009,020091610,Comuna 9,CIUDAD DE BUENOS AIRES,297,285,477,385,862
02,02009,020091612,Comuna 9,CIUDAD DE BUENOS AIRES,259,254,417,376,793
02,02009,020091607,Comuna 9,CIUDAD DE BUENOS AIRES,336,309,490,478,968
02,02009,020091609,Comuna 9,CIUDAD DE BUENOS AIRES,340,320,561,462,1023
02,02009,020091613,Comuna 9,CIUDAD DE BUENOS AIRES,296,284,392,392,784
02,02009,020091608,Comuna 9,CIUDAD DE BUENOS AIRES,301,273,513,417,930
02,02008,020081404,Comuna 8,CIUDAD DE BUENOS AIRES,793,610,1395,1310,2705
02,02008,020081405,Comuna 8,CIUDAD DE BUENOS AIRES,385,318,578,595,1173
02,02008,020081409,Comuna 8,CIUDAD DE BUENOS AIRES,336,229,512,499,1011
02,02008,020081403,Comuna 8,CIUDAD DE BUENOS AIRES,518,300,1052,981,2033
02,02008,020081410,Comuna 8,CIUDAD DE BUENOS AIRES,313,233,502,477,979
02,02008,020081307,Comuna 8,CIUDAD DE BUENOS AIRES,253,226,396,332,728
02,02008,020081402,Comuna 8,CIUDAD DE BUENOS AIRES,382,250,765,708,1473
02,02008,020081407,Comuna 8,CIUDAD DE BUENOS AIRES,297,271,515,434,949
02,02008,020081401,Comuna 8,CIUDAD DE BUENOS AIRES,464,318,929,876,1805
02,02008,020081505,Comuna 8,CIUDAD DE BUENOS AIRES,877,613,1712,1673,3385
02,02008,020081501,Comuna 8,CIUDAD DE BUENOS AIRES,852,463,1396,1401,2797
02,02008,020081408,Comuna 8,CIUDAD DE BUENOS AIRES,259,241,421,377,798
02,02008,020081705,Comuna 8,CIUDAD DE BUENOS AIRES,173,170,242,206,448
02,02008,020081507,Comuna 8,CIUDAD DE BUENOS AIRES,259,217,474,455,929
02,02008,020080502,Comuna 8,CIUDAD DE BUENOS AIRES,263,251,398,378,776
02,02008,020081506,Comuna 8,CIUDAD DE BUENOS AIRES,233,182,404,477,881
02,02008,020081701,Comuna 8,CIUDAD DE BUENOS AIRES,223,196,309,267,576
02,02008,020081504,Comuna 8,CIUDAD DE BUENOS AIRES,231,97,455,476,931
02,02008,020081306,Comuna 8,CIUDAD DE BUENOS AIRES,221,194,355,302,657
02,02008,020080501,Comuna 8,CIUDAD DE BUENOS AIRES,277,267,420,387,807
02,02008,020080503,Comuna 8,CIUDAD DE BUENOS AIRES,270,245,432,389,821
02,02008,020081308,Comuna 8,CIUDAD DE BUENOS AIRES,297,270,468,425,893
02,02008,020081503,Comuna 8,CIUDAD DE BUENOS AIRES,667,123,1247,1184,2431
02,02008,020081508,Comuna 8,CIUDAD DE BUENOS AIRES,358,274,709,648,1357
02,02008,020081704,Comuna 8,CIUDAD DE BUENOS AIRES,290,288,418,362,780
02,02008,020081304,Comuna 8,CIUDAD DE BUENOS AIRES,333,266,562,502,1064
02,02008,020081509,Comuna 8,CIUDAD DE BUENOS AIRES,519,260,922,800,1722
02,02008,020081305,Comuna 8,CIUDAD DE BUENOS AIRES,315,278,506,457,963
02,02008,020081510,Comuna 8,CIUDAD DE BUENOS AIRES,389,341,668,596,1264
02,02008,020081406,Comuna 8,CIUDAD DE BUENOS AIRES,250,199,402,391,793
02,02008,020080404,Comuna 8,CIUDAD DE BUENOS AIRES,224,214,330,333,663
02,02008,020080507,Comuna 8,CIUDAD DE BUENOS AIRES,336,319,532,492,1024
02,02008,020081502,Comuna 8,CIUDAD DE BUENOS AIRES,655,485,1227,1201,2428
02,02008,020081703,Comuna 8,CIUDAD DE BUENOS AIRES,327,313,376,290,666
02,02008,020080504,Comuna 8,CIUDAD DE BUENOS AIRES,291,282,474,398,872
02,02008,020080508,Comuna 8,CIUDAD DE BUENOS AIRES,254,204,332,292,624
02,02008,020081302,Comuna 8,CIUDAD DE BUENOS AIRES,118,96,191,174,365
02,02008,020081303,Comuna 8,CIUDAD DE BUENOS AIRES,311,248,509,489,998
02,02008,020080402,Comuna 8,CIUDAD DE BUENOS AIRES,214,173,333,289,622
02,02008,020081702,Comuna 8,CIUDAD DE BUENOS AIRES,221,221,325,295,620
02,02008,020080506,Comuna 8,CIUDAD DE BUENOS AIRES,282,262,442,389,831
02,02008,020080403,Comuna 8,CIUDAD DE BUENOS AIRES,220,202,351,312,663
02,02008,020080601,Comuna 8,CIUDAD DE BUENOS AIRES,302,298,509,417,926
02,02008,020080405,Comuna 8,CIUDAD DE BUENOS AIRES,332,309,509,451,960
02,02008,020080401,Comuna 8,CIUDAD DE BUENOS AIRES,287,246,473,426,899
02,02008,020080505,Comuna 8,CIUDAD DE BUENOS AIRES,201,170,325,292,617
02,02008,020080406,Comuna 8,CIUDAD DE BUENOS AIRES,350,338,575,509,1084
02,02008,020080509,Comuna 8,CIUDAD DE BUENOS AIRES,298,268,482,428,910
02,02008,020080602,Comuna 8,CIUDAD DE BUENOS AIRES,397,389,666,531,1197
02,02008,020081603,Comuna 8,CIUDAD DE BUENOS AIRES,289,280,599,519,1118
02,02008,020080603,Comuna 8,CIUDAD DE BUENOS AIRES,402,397,651,568,1219
02,02008,020081602,Comuna 8,CIUDAD DE BUENOS AIRES,183,165,336,281,617
02,02008,020080606,Comuna 8,CIUDAD DE BUENOS AIRES,320,214,512,491,1003
02,02008,020080510,Comuna 8,CIUDAD DE BUENOS AIRES,411,408,642,495,1137
02,02008,020080108,Comuna 8,CIUDAD DE BUENOS AIRES,374,338,602,581,1183
02,02008,020080410,Comuna 8,CIUDAD DE BUENOS AIRES,306,296,474,409,883
02,02008,020081610,Comuna 8,CIUDAD DE BUENOS AIRES,279,248,494,440,934
02,02008,020081301,Comuna 8,CIUDAD DE BUENOS AIRES,20,11,16,29,45
02,02008,020081601,Comuna 8,CIUDAD DE BUENOS AIRES,299,285,544,501,1045
02,02008,020081604,Comuna 8,CIUDAD DE BUENOS AIRES,266,256,504,438,942
02,02008,020080407,Comuna 8,CIUDAD DE BUENOS AIRES,278,253,442,394,836
02,02008,020080107,Comuna 8,CIUDAD DE BUENOS AIRES,460,360,806,645,1451
02,02008,020080511,Comuna 8,CIUDAD DE BUENOS AIRES,319,315,515,412,927
02,02008,020080607,Comuna 8,CIUDAD DE BUENOS AIRES,208,196,315,297,612
02,02008,020080605,Comuna 8,CIUDAD DE BUENOS AIRES,320,308,515,484,999
02,02008,020081605,Comuna 8,CIUDAD DE BUENOS AIRES,294,268,515,461,976
02,02008,020080411,Comuna 8,CIUDAD DE BUENOS AIRES,252,226,381,362,743
02,02008,020080106,Comuna 8,CIUDAD DE BUENOS AIRES,627,408,1158,1097,2255
02,02008,020081609,Comuna 8,CIUDAD DE BUENOS AIRES,280,268,475,440,915
02,02008,020080409,Comuna 8,CIUDAD DE BUENOS AIRES,258,244,417,353,770
02,02008,020081606,Comuna 8,CIUDAD DE BUENOS AIRES,267,255,452,378,830
02,02008,020080104,Comuna 8,CIUDAD DE BUENOS AIRES,482,399,928,966,1894
02,02008,020081608,Comuna 8,CIUDAD DE BUENOS AIRES,236,204,445,359,804
02,02008,020080301,Comuna 8,CIUDAD DE BUENOS AIRES,334,261,499,452,951
02,02008,020080105,Comuna 8,CIUDAD DE BUENOS AIRES,449,379,924,838,1762
02,02008,020081607,Comuna 8,CIUDAD DE BUENOS AIRES,276,256,560,481,1041
02,02008,020080109,Comuna 8,CIUDAD DE BUENOS AIRES,810,572,1346,1325,2671
02,02008,020080604,Comuna 8,CIUDAD DE BUENOS AIRES,233,183,406,336,742
02,02008,020080110,Comuna 8,CIUDAD DE BUENOS AIRES,440,392,756,758,1514
02,02008,020080408,Comuna 8,CIUDAD DE BUENOS AIRES,278,265,443,416,859
02,02008,020080305,Comuna 8,CIUDAD DE BUENOS AIRES,238,215,404,324,728
02,02008,020080111,Comuna 8,CIUDAD DE BUENOS AIRES,182,67,327,338,665
02,02008,020080102,Comuna 8,CIUDAD DE BUENOS AIRES,517,428,817,808,1625
02,02008,020080608,Comuna 8,CIUDAD DE BUENOS AIRES,241,231,390,374,764
02,02008,020080302,Comuna 8,CIUDAD DE BUENOS AIRES,256,248,405,386,791
02,02008,020080103,Comuna 8,CIUDAD DE BUENOS AIRES,351,257,619,702,1321
02,02008,020080714,Comuna 8,CIUDAD DE BUENOS AIRES,574,235,1025,1037,2062
02,02008,020080112,Comuna 8,CIUDAD DE BUENOS AIRES,1019,874,1701,1703,3404
02,02008,020080705,Comuna 8,CIUDAD DE BUENOS AIRES,543,453,833,874,1707
02,02008,020080703,Comuna 8,CIUDAD DE BUENOS AIRES,493,348,865,798,1663
02,02008,020080704,Comuna 8,CIUDAD DE BUENOS AIRES,446,302,789,732,1521
02,02008,020080609,Comuna 8,CIUDAD DE BUENOS AIRES,284,264,468,401,869
02,02008,020080303,Comuna 8,CIUDAD DE BUENOS AIRES,187,172,294,286,580
02,02008,020080706,Comuna 8,CIUDAD DE BUENOS AIRES,395,238,675,717,1392
02,02008,020080610,Comuna 8,CIUDAD DE BUENOS AIRES,219,189,347,293,640
02,02008,020080702,Comuna 8,CIUDAD DE BUENOS AIRES,478,368,814,815,1629
02,02008,020080805,Comuna 8,CIUDAD DE BUENOS AIRES,240,234,326,287,613
02,02008,020080707,Comuna 8,CIUDAD DE BUENOS AIRES,661,475,1073,1086,2159
02,02008,020080708,Comuna 8,CIUDAD DE BUENOS AIRES,457,374,969,916,1885
02,02008,020080611,Comuna 8,CIUDAD DE BUENOS AIRES,203,161,313,338,651
02,02008,020081008,Comuna 8,CIUDAD DE BUENOS AIRES,320,309,617,579,1196
02,02008,020080205,Comuna 8,CIUDAD DE BUENOS AIRES,174,173,293,268,561
02,02008,020080806,Comuna 8,CIUDAD DE BUENOS AIRES,321,299,552,393,945
02,02008,020080709,Comuna 8,CIUDAD DE BUENOS AIRES,814,479,1530,1558,3088
02,02008,020080710,Comuna 8,CIUDAD DE BUENOS AIRES,285,160,517,518,1035
02,02008,020080304,Comuna 8,CIUDAD DE BUENOS AIRES,250,229,411,380,791
02,02008,020080701,Comuna 8,CIUDAD DE BUENOS AIRES,359,291,687,652,1339
02,02008,020080202,Comuna 8,CIUDAD DE BUENOS AIRES,168,161,276,259,535
02,02008,020080711,Comuna 8,CIUDAD DE BUENOS AIRES,411,321,811,759,1570
02,02008,020080306,Comuna 8,CIUDAD DE BUENOS AIRES,144,120,199,198,397
02,02008,020080206,Comuna 8,CIUDAD DE BUENOS AIRES,249,240,385,313,698
02,02008,020080101,Comuna 8,CIUDAD DE BUENOS AIRES,331,260,569,578,1147
02,02008,020080207,Comuna 8,CIUDAD DE BUENOS AIRES,404,396,659,567,1226
02,02008,020080201,Comuna 8,CIUDAD DE BUENOS AIRES,387,367,709,573,1282
02,02008,020080807,Comuna 8,CIUDAD DE BUENOS AIRES,308,280,462,394,856
02,02008,020080712,Comuna 8,CIUDAD DE BUENOS AIRES,395,317,886,819,1705
02,02008,020080204,Comuna 8,CIUDAD DE BUENOS AIRES,249,243,415,385,800
02,02008,020080208,Comuna 8,CIUDAD DE BUENOS AIRES,307,282,498,412,910
02,02008,020080307,Comuna 8,CIUDAD DE BUENOS AIRES,245,205,394,370,764
02,02008,020080203,Comuna 8,CIUDAD DE BUENOS AIRES,161,154,277,238,515
02,02008,020080804,Comuna 8,CIUDAD DE BUENOS AIRES,300,299,431,378,809
02,02008,020080713,Comuna 8,CIUDAD DE BUENOS AIRES,391,253,771,742,1513
02,02008,020080810,Comuna 8,CIUDAD DE BUENOS AIRES,289,250,468,431,899
02,02008,020080210,Comuna 8,CIUDAD DE BUENOS AIRES,188,175,289,251,540
02,02008,020080209,Comuna 8,CIUDAD DE BUENOS AIRES,271,260,419,410,829
02,02008,020080308,Comuna 8,CIUDAD DE BUENOS AIRES,547,422,915,986,1901
02,02008,020080803,Comuna 8,CIUDAD DE BUENOS AIRES,235,217,369,313,682
02,02008,020080808,Comuna 8,CIUDAD DE BUENOS AIRES,206,182,341,299,640
02,02008,020081003,Comuna 8,CIUDAD DE BUENOS AIRES,380,375,561,448,1009
02,02008,020080809,Comuna 8,CIUDAD DE BUENOS AIRES,232,195,377,358,735
02,02008,020081006,Comuna 8,CIUDAD DE BUENOS AIRES,579,531,869,732,1601
02,02008,020081207,Comuna 8,CIUDAD DE BUENOS AIRES,278,241,418,408,826
02,02008,020080802,Comuna 8,CIUDAD DE BUENOS AIRES,309,270,487,437,924
02,02008,020080811,Comuna 8,CIUDAD DE BUENOS AIRES,338,331,494,433,927
02,02008,020080309,Comuna 8,CIUDAD DE BUENOS AIRES,569,365,1019,988,2007
02,02008,020080903,Comuna 8,CIUDAD DE BUENOS AIRES,352,346,538,490,1028
02,02008,020081004,Comuna 8,CIUDAD DE BUENOS AIRES,719,699,1182,1020,2202
02,02008,020081007,Comuna 8,CIUDAD DE BUENOS AIRES,543,533,888,739,1627
02,02008,020080310,Comuna 8,CIUDAD DE BUENOS AIRES,478,303,868,828,1696
02,02008,020081002,Comuna 8,CIUDAD DE BUENOS AIRES,237,221,387,372,759
02,02008,020080801,Comuna 8,CIUDAD DE BUENOS AIRES,281,262,457,407,864
02,02008,020080902,Comuna 8,CIUDAD DE BUENOS AIRES,298,272,465,418,883
02,02008,020081005,Comuna 8,CIUDAD DE BUENOS AIRES,842,805,1296,1105,2401
02,02008,020080904,Comuna 8,CIUDAD DE BUENOS AIRES,186,161,273,240,513
02,02008,020081103,Comuna 8,CIUDAD DE BUENOS AIRES,1057,998,1639,1330,2969
02,02008,020080909,Comuna 8,CIUDAD DE BUENOS AIRES,315,291,504,418,922
02,02008,020081101,Comuna 8,CIUDAD DE BUENOS AIRES,910,815,1559,1326,2885
02,02008,020081105,Comuna 8,CIUDAD DE BUENOS AIRES,449,444,724,566,1290
02,02008,020081104,Comuna 8,CIUDAD DE BUENOS AIRES,643,614,1019,896,1915
02,02008,020081001,Comuna 8,CIUDAD DE BUENOS AIRES,278,242,452,424,876
02,02008,020080905,Comuna 8,CIUDAD DE BUENOS AIRES,385,319,512,428,940
02,02008,020081102,Comuna 8,CIUDAD DE BUENOS AIRES,718,671,1136,912,2048
02,02008,020081203,Comuna 8,CIUDAD DE BUENOS AIRES,331,316,515,488,1003
02,02008,020080901,Comuna 8,CIUDAD DE BUENOS AIRES,271,259,447,354,801
02,02008,020080908,Comuna 8,CIUDAD DE BUENOS AIRES,258,216,392,364,756
02,02008,020081204,Comuna 8,CIUDAD DE BUENOS AIRES,302,226,491,488,979
02,02008,020080906,Comuna 8,CIUDAD DE BUENOS AIRES,294,276,551,469,1020
02,02008,020081202,Comuna 8,CIUDAD DE BUENOS AIRES,356,330,543,461,1004
02,02008,020080907,Comuna 8,CIUDAD DE BUENOS AIRES,260,243,442,330,772
02,02008,020081205,Comuna 8,CIUDAD DE BUENOS AIRES,341,314,503,475,978
02,02008,020081201,Comuna 8,CIUDAD DE BUENOS AIRES,306,293,488,427,915
02,02008,020081206,Comuna 8,CIUDAD DE BUENOS AIRES,249,240,395,349,744
06,06882,068821704,Zárate,BUENOS AIRES,485,483,1006,997,2003
06,06882,068820702,Zárate,BUENOS AIRES,148,173,226,257,483
06,06882,068820701,Zárate,BUENOS AIRES,59,60,92,111,203
06,06882,068821401,Zárate,BUENOS AIRES,160,195,252,365,617
06,06882,068820103,Zárate,BUENOS AIRES,403,415,590,612,1202
06,06882,068820108,Zárate,BUENOS AIRES,333,355,503,450,953
06,06882,068820209,Zárate,BUENOS AIRES,308,371,495,419,914
06,06882,068820507,Zárate,BUENOS AIRES,166,193,274,264,538
06,06882,068820508,Zárate,BUENOS AIRES,352,364,672,666,1338
06,06882,068820901,Zárate,BUENOS AIRES,465,451,901,897,1798
06,06882,068821001,Zárate,BUENOS AIRES,277,313,475,431,906
06,06882,068821008,Zárate,BUENOS AIRES,272,271,481,458,939
06,06882,068820402,Zárate,BUENOS AIRES,28,152,45,44,89
06,06882,068820101,Zárate,BUENOS AIRES,360,362,557,507,1064
06,06882,068820202,Zárate,BUENOS AIRES,275,304,423,408,831
06,06882,068820211,Zárate,BUENOS AIRES,391,425,613,547,1160
06,06882,068820503,Zárate,BUENOS AIRES,456,435,745,815,1560
06,06882,068820806,Zárate,BUENOS AIRES,336,382,494,460,954
06,06882,068820907,Zárate,BUENOS AIRES,487,441,906,875,1781
06,06882,068820914,Zárate,BUENOS AIRES,305,297,558,569,1127
06,06882,068821010,Zárate,BUENOS AIRES,555,491,1097,1110,2207
06,06882,068821602,Zárate,BUENOS AIRES,398,376,641,584,1225
06,06882,068820813,Zárate,BUENOS AIRES,433,407,991,1644,2635
06,06882,068820601,Zárate,BUENOS AIRES,54,169,67,77,144
06,06882,068820214,Zárate,BUENOS AIRES,215,211,396,398,794
06,06882,068820308,Zárate,BUENOS AIRES,388,386,622,507,1129
06,06882,068820502,Zárate,BUENOS AIRES,460,484,770,840,1610
06,06882,068820509,Zárate,BUENOS AIRES,436,494,721,761,1482
06,06882,068820803,Zárate,BUENOS AIRES,397,370,632,624,1256
06,06882,068820807,Zárate,BUENOS AIRES,305,327,446,382,828
06,06882,068821009,Zárate,BUENOS AIRES,429,420,754,719,1473
06,06882,068821607,Zárate,BUENOS AIRES,311,302,578,593,1171
06,06882,068821711,Zárate,BUENOS AIRES,300,322,557,580,1137
06,06882,068820212,Zárate,BUENOS AIRES,251,226,506,540,1046
06,06882,068821606,Zárate,BUENOS AIRES,254,258,428,448,876
06,06882,068821201,Zárate,BUENOS AIRES,134,216,201,235,436
06,06882,068821803,Zárate,BUENOS AIRES,27,86,24,47,71
06,06882,068820102,Zárate,BUENOS AIRES,396,371,638,574,1212
06,06882,068820106,Zárate,BUENOS AIRES,333,350,537,529,1066
06,06882,068820110,Zárate,BUENOS AIRES,339,348,542,459,1001
06,06882,068820208,Zárate,BUENOS AIRES,353,375,498,441,939
06,06882,068820302,Zárate,BUENOS AIRES,322,337,506,448,954
06,06882,068820703,Zárate,BUENOS AIRES,213,188,415,406,821
06,06882,068820808,Zárate,BUENOS AIRES,307,398,455,398,853
06,06882,068820810,Zárate,BUENOS AIRES,279,360,425,360,785
06,06882,068820912,Zárate,BUENOS AIRES,371,346,765,784,1549
06,06882,068821004,Zárate,BUENOS AIRES,250,240,424,377,801
06,06882,068821011,Zárate,BUENOS AIRES,446,406,868,931,1799
06,06882,068821604,Zárate,BUENOS AIRES,362,347,654,621,1275
06,06882,068821705,Zárate,BUENOS AIRES,518,495,1057,1074,2131
06,06882,068821708,Zárate,BUENOS AIRES,193,287,262,313,575
06,06882,068821101,Zárate,BUENOS AIRES,232,302,318,384,702
06,06882,068820206,Zárate,BUENOS AIRES,258,345,340,319,659
06,06882,068820207,Zárate,BUENOS AIRES,312,365,464,398,862
06,06882,068820210,Zárate,BUENOS AIRES,279,286,450,420,870
06,06882,068820304,Zárate,BUENOS AIRES,385,400,602,555,1157
06,06882,068820305,Zárate,BUENOS AIRES,294,330,431,380,811
06,06882,068820401,Zárate,BUENOS AIRES,368,372,589,644,1233
06,06882,068820911,Zárate,BUENOS AIRES,251,290,437,453,890
06,06882,068820506,Zárate,BUENOS AIRES,46,53,86,92,178
06,06882,068820802,Zárate,BUENOS AIRES,397,336,725,716,1441
06,06882,068820902,Zárate,BUENOS AIRES,332,335,636,654,1290
06,06882,068820905,Zárate,BUENOS AIRES,246,244,439,456,895
06,06882,068820910,Zárate,BUENOS AIRES,395,423,668,654,1322
06,06882,068821006,Zárate,BUENOS AIRES,432,433,670,678,1348
06,06882,068821608,Zárate,BUENOS AIRES,391,366,747,756,1503
06,06882,068821702,Zárate,BUENOS AIRES,302,285,578,567,1145
06,06882,068821301,Zárate,BUENOS AIRES,178,193,219,302,521
06,06882,068820104,Zárate,BUENOS AIRES,423,416,700,650,1350
06,06882,068820203,Zárate,BUENOS AIRES,226,308,276,249,525
06,06882,068820205,Zárate,BUENOS AIRES,314,413,430,363,793
06,06882,068820501,Zárate,BUENOS AIRES,117,111,201,197,398
06,06882,068820505,Zárate,BUENOS AIRES,48,43,69,77,146
06,06882,068820801,Zárate,BUENOS AIRES,440,440,796,830,1626
06,06882,068821002,Zárate,BUENOS AIRES,230,273,352,325,677
06,06882,068821007,Zárate,BUENOS AIRES,241,232,375,348,723
06,06882,068821605,Zárate,BUENOS AIRES,465,444,914,941,1855
06,06882,068821801,Zárate,BUENOS AIRES,56,171,64,88,152
06,06882,068821703,Zárate,BUENOS AIRES,421,429,738,746,1484
06,06882,068821709,Zárate,BUENOS AIRES,92,77,156,150,306
06,06882,068821707,Zárate,BUENOS AIRES,173,267,264,268,532
06,06882,068821710,Zárate,BUENOS AIRES,359,380,679,698,1377
06,06882,068820107,Zárate,BUENOS AIRES,350,348,517,499,1016
06,06882,068821003,Zárate,BUENOS AIRES,303,317,511,482,993
06,06882,068820109,Zárate,BUENOS AIRES,287,319,407,370,777
06,06882,068820201,Zárate,BUENOS AIRES,410,484,588,551,1139
06,06882,068820204,Zárate,BUENOS AIRES,254,360,336,275,611
06,06882,068820307,Zárate,BUENOS AIRES,283,261,443,423,866
06,06882,068820504,Zárate,BUENOS AIRES,459,457,841,895,1736
06,06882,068820804,Zárate,BUENOS AIRES,347,359,678,580,1258
06,06882,068820805,Zárate,BUENOS AIRES,322,340,529,476,1005
06,06882,068820809,Zárate,BUENOS AIRES,293,370,390,331,721
06,06882,068820811,Zárate,BUENOS AIRES,234,287,325,275,600
06,06882,068820904,Zárate,BUENOS AIRES,378,367,748,761,1509
06,06882,068820906,Zárate,BUENOS AIRES,462,466,884,997,1881
06,06882,068820908,Zárate,BUENOS AIRES,320,316,541,531,1072
06,06882,068820913,Zárate,BUENOS AIRES,299,302,609,628,1237
06,06882,068821603,Zárate,BUENOS AIRES,441,480,655,602,1257
06,06882,068821706,Zárate,BUENOS AIRES,146,139,235,275,510
06,06882,068821802,Zárate,BUENOS AIRES,18,26,13,34,47
06,06882,068821701,Zárate,BUENOS AIRES,353,351,635,644,1279
06,06882,068821501,Zárate,BUENOS AIRES,39,76,43,64,107
06,06882,068820105,Zárate,BUENOS AIRES,496,403,880,878,1758
06,06882,068820213,Zárate,BUENOS AIRES,321,345,494,455,949
06,06882,068820301,Zárate,BUENOS AIRES,59,70,100,104,204
06,06882,068820303,Zárate,BUENOS AIRES,376,413,614,589,1203
06,06882,068820306,Zárate,BUENOS AIRES,342,348,520,488,1008
06,06882,068820812,Zárate,BUENOS AIRES,315,465,394,315,709
06,06882,068820903,Zárate,BUENOS AIRES,368,376,671,627,1298
06,06882,068820909,Zárate,BUENOS AIRES,275,274,457,446,903
06,06882,068821005,Zárate,BUENOS AIRES,254,245,399,356,755
06,06882,068821601,Zárate,BUENOS AIRES,346,350,549,490,1039
06,06882,068820403,Zárate,BUENOS AIRES,65,96,95,215,310
06,06014,060141201,Adolfo Gonzales Chaves,BUENOS AIRES,17,32,25,31,56
06,06014,060140502,Adolfo Gonzales Chaves,BUENOS AIRES,37,51,65,69,134
06,06014,060141401,Adolfo Gonzales Chaves,BUENOS AIRES,7,23,5,11,16
06,06014,060140601,Adolfo Gonzales Chaves,BUENOS AIRES,19,50,17,28,45
06,06014,060141010,Adolfo Gonzales Chaves,BUENOS AIRES,354,413,492,427,919
06,06014,060140302,Adolfo Gonzales Chaves,BUENOS AIRES,34,55,35,65,100
06,06014,060140801,Adolfo Gonzales Chaves,BUENOS AIRES,30,56,34,42,76
06,06014,060141002,Adolfo Gonzales Chaves,BUENOS AIRES,29,91,45,42,87
06,06014,060141005,Adolfo Gonzales Chaves,BUENOS AIRES,221,237,362,315,677
06,06014,060140501,Adolfo Gonzales Chaves,BUENOS AIRES,153,179,204,164,368
06,06014,060141014,Adolfo Gonzales Chaves,BUENOS AIRES,212,240,302,293,595
06,06014,060141001,Adolfo Gonzales Chaves,BUENOS AIRES,127,144,189,205,394
06,06014,060141008,Adolfo Gonzales Chaves,BUENOS AIRES,213,241,379,320,699
06,06014,060141009,Adolfo Gonzales Chaves,BUENOS AIRES,277,330,381,337,718
06,06014,060141012,Adolfo Gonzales Chaves,BUENOS AIRES,193,214,298,281,579
06,06014,060141501,Adolfo Gonzales Chaves,BUENOS AIRES,3,16,3,4,7
06,06014,060140505,Adolfo Gonzales Chaves,BUENOS AIRES,154,196,216,209,425
06,06014,060141003,Adolfo Gonzales Chaves,BUENOS AIRES,150,179,232,221,453
06,06014,060141006,Adolfo Gonzales Chaves,BUENOS AIRES,204,237,307,270,577
06,06014,060140701,Adolfo Gonzales Chaves,BUENOS AIRES,12,32,13,25,38
06,06014,060141202,Adolfo Gonzales Chaves,BUENOS AIRES,18,43,11,22,33
06,06014,060141301,Adolfo Gonzales Chaves,BUENOS AIRES,21,86,32,32,64
06,06014,060140504,Adolfo Gonzales Chaves,BUENOS AIRES,301,352,421,411,832
06,06014,060141013,Adolfo Gonzales Chaves,BUENOS AIRES,306,352,417,377,794
06,06014,060140101,Adolfo Gonzales Chaves,BUENOS AIRES,27,39,23,43,66
06,06014,060140401,Adolfo Gonzales Chaves,BUENOS AIRES,35,66,42,58,100
06,06014,060140503,Adolfo Gonzales Chaves,BUENOS AIRES,36,85,36,64,100
06,06014,060141101,Adolfo Gonzales Chaves,BUENOS AIRES,18,32,21,32,53
06,06014,060141007,Adolfo Gonzales Chaves,BUENOS AIRES,137,146,218,270,488
06,06014,060141015,Adolfo Gonzales Chaves,BUENOS AIRES,282,286,487,478,965
06,06014,060140301,Adolfo Gonzales Chaves,BUENOS AIRES,56,77,102,110,212
06,06014,060141004,Adolfo Gonzales Chaves,BUENOS AIRES,183,208,274,272,546
06,06014,060141011,Adolfo Gonzales Chaves,BUENOS AIRES,307,368,417,338,755
06,06014,060140201,Adolfo Gonzales Chaves,BUENOS AIRES,11,19,13,23,36
06,06014,060140901,Adolfo Gonzales Chaves,BUENOS AIRES,15,36,20,20,40
06,06021,060210206,Alberti,BUENOS AIRES,58,76,79,98,177
06,06021,060210609,Alberti,BUENOS AIRES,26,49,41,39,80
06,06021,060210601,Alberti,BUENOS AIRES,123,155,170,185,355
06,06021,060210603,Alberti,BUENOS AIRES,296,352,407,322,729
06,06021,060210602,Alberti,BUENOS AIRES,422,481,653,590,1243
06,06021,060210701,Alberti,BUENOS AIRES,6,27,9,9,18
06,06021,060211002,Alberti,BUENOS AIRES,49,107,46,66,112
06,06021,060210205,Alberti,BUENOS AIRES,3,24,6,6,12
06,06021,060210702,Alberti,BUENOS AIRES,5,33,5,6,11
06,06021,060210902,Alberti,BUENOS AIRES,10,24,4,16,20
06,06021,060210903,Alberti,BUENOS AIRES,13,23,15,17,32
06,06021,060210503,Alberti,BUENOS AIRES,5,15,4,8,12
06,06021,060210501,Alberti,BUENOS AIRES,138,195,220,192,412
06,06021,060210605,Alberti,BUENOS AIRES,261,302,351,253,604
06,06021,060210607,Alberti,BUENOS AIRES,395,466,594,598,1192
06,06021,060210802,Alberti,BUENOS AIRES,6,15,6,5,11
06,06021,060210803,Alberti,BUENOS AIRES,16,30,19,22,41
06,06021,060210904,Alberti,BUENOS AIRES,17,26,16,19,35
06,06021,060211003,Alberti,BUENOS AIRES,8,17,14,11,25
06,06021,060210207,Alberti,BUENOS AIRES,11,20,14,20,34
06,06021,060210611,Alberti,BUENOS AIRES,331,398,484,493,977
06,06021,060210612,Alberti,BUENOS AIRES,227,264,326,342,668
06,06021,060210203,Alberti,BUENOS AIRES,14,31,16,26,42
06,06021,060210301,Alberti,BUENOS AIRES,7,19,6,10,16
06,06021,060210502,Alberti,BUENOS AIRES,11,19,13,18,31
06,06021,060210201,Alberti,BUENOS AIRES,154,175,205,213,418
06,06021,060210608,Alberti,BUENOS AIRES,143,171,194,181,375
06,06021,060210801,Alberti,BUENOS AIRES,70,121,96,96,192
06,06021,060210101,Alberti,BUENOS AIRES,9,17,8,10,18
06,06021,060210204,Alberti,BUENOS AIRES,6,34,8,11,19
06,06021,060210804,Alberti,BUENOS AIRES,16,25,16,23,39
06,06021,060210901,Alberti,BUENOS AIRES,12,31,14,18,32
06,06021,060210610,Alberti,BUENOS AIRES,93,135,160,143,303
06,06021,060210302,Alberti,BUENOS AIRES,7,19,5,14,19
06,06021,060210604,Alberti,BUENOS AIRES,384,400,569,543,1112
06,06021,060210202,Alberti,BUENOS AIRES,147,206,214,183,397
06,06021,060210401,Alberti,BUENOS AIRES,12,35,16,17,33
06,06021,060210606,Alberti,BUENOS AIRES,294,345,422,331,753
06,06021,060210102,Alberti,BUENOS AIRES,6,22,6,7,13
06,06021,060210402,Alberti,BUENOS AIRES,6,19,9,5,14
06,06021,060211001,Alberti,BUENOS AIRES,11,16,13,15,28
06,06042,060420501,Ayacucho,BUENOS AIRES,99,163,134,163,297
06,06042,060421102,Ayacucho,BUENOS AIRES,158,232,205,259,464
06,06042,060421001,Ayacucho,BUENOS AIRES,52,75,71,83,154
06,06042,060420301,Ayacucho,BUENOS AIRES,68,86,66,107,173
06,06042,060420701,Ayacucho,BUENOS AIRES,64,109,73,97,170
06,06042,060421901,Ayacucho,BUENOS AIRES,329,387,541,512,1053
06,06042,060420801,Ayacucho,BUENOS AIRES,42,72,43,71,114
06,06042,060421201,Ayacucho,BUENOS AIRES,52,70,63,84,147
06,06042,060421301,Ayacucho,BUENOS AIRES,44,49,32,62,94
06,06042,060420901,Ayacucho,BUENOS AIRES,93,151,94,153,247
06,06042,060420101,Ayacucho,BUENOS AIRES,381,433,702,681,1383
06,06042,060420104,Ayacucho,BUENOS AIRES,247,293,326,279,605
06,06042,060420105,Ayacucho,BUENOS AIRES,235,259,378,338,716
06,06042,060420109,Ayacucho,BUENOS AIRES,424,491,627,572,1199
06,06042,060421906,Ayacucho,BUENOS AIRES,310,372,477,354,831
06,06042,060421401,Ayacucho,BUENOS AIRES,69,109,74,93,167
06,06042,060421103,Ayacucho,BUENOS AIRES,299,378,477,500,977
06,06042,060421905,Ayacucho,BUENOS AIRES,309,354,472,363,835
06,06042,060420107,Ayacucho,BUENOS AIRES,232,273,341,342,683
06,06042,060420601,Ayacucho,BUENOS AIRES,58,73,67,97,164
06,06042,060421601,Ayacucho,BUENOS AIRES,34,77,31,49,80
06,06042,060421907,Ayacucho,BUENOS AIRES,231,254,384,373,757
06,06042,060421101,Ayacucho,BUENOS AIRES,24,51,26,31,57
06,06042,060420102,Ayacucho,BUENOS AIRES,276,318,369,323,692
06,06042,060420103,Ayacucho,BUENOS AIRES,296,357,399,307,706
06,06042,060420106,Ayacucho,BUENOS AIRES,251,286,347,340,687
06,06042,060420108,Ayacucho,BUENOS AIRES,399,475,528,415,943
06,06042,060421908,Ayacucho,BUENOS AIRES,224,252,399,408,807
06,06042,060421909,Ayacucho,BUENOS AIRES,502,531,836,845,1681
06,06042,060420201,Ayacucho,BUENOS AIRES,55,88,63,90,153
06,06042,060421701,Ayacucho,BUENOS AIRES,36,39,49,62,111
06,06042,060421902,Ayacucho,BUENOS AIRES,300,330,455,420,875
06,06042,060421903,Ayacucho,BUENOS AIRES,367,393,634,583,1217
06,06042,060421904,Ayacucho,BUENOS AIRES,311,368,441,366,807
06,06042,060420401,Ayacucho,BUENOS AIRES,41,68,57,65,122
06,06042,060421501,Ayacucho,BUENOS AIRES,37,74,49,59,108
06,06042,060421801,Ayacucho,BUENOS AIRES,18,18,22,39,61
06,06056,060562708,Bahía Blanca,BUENOS AIRES,155,179,267,257,524
06,06056,060560711,Bahía Blanca,BUENOS AIRES,374,414,590,595,1185
06,06056,060562001,Bahía Blanca,BUENOS AIRES,414,444,536,486,1022
06,06056,060563006,Bahía Blanca,BUENOS AIRES,73,86,107,88,195
06,06056,060560103,Bahía Blanca,BUENOS AIRES,391,556,387,360,747
06,06056,060560108,Bahía Blanca,BUENOS AIRES,479,551,530,487,1017
06,06056,060560117,Bahía Blanca,BUENOS AIRES,220,298,258,209,467
06,06056,060560201,Bahía Blanca,BUENOS AIRES,302,307,539,543,1082
06,06056,060560307,Bahía Blanca,BUENOS AIRES,221,268,340,279,619
06,06056,060560308,Bahía Blanca,BUENOS AIRES,184,196,262,228,490
06,06056,060560408,Bahía Blanca,BUENOS AIRES,258,306,364,296,660
06,06056,060560503,Bahía Blanca,BUENOS AIRES,407,415,695,719,1414
06,06056,060560605,Bahía Blanca,BUENOS AIRES,412,433,680,657,1337
06,06056,060560809,Bahía Blanca,BUENOS AIRES,509,526,953,979,1932
06,06056,060560810,Bahía Blanca,BUENOS AIRES,218,253,366,363,729
06,06056,060560907,Bahía Blanca,BUENOS AIRES,226,269,320,298,618
06,06056,060561003,Bahía Blanca,BUENOS AIRES,288,428,315,197,512
06,06056,060561208,Bahía Blanca,BUENOS AIRES,233,293,293,196,489
06,06056,060561303,Bahía Blanca,BUENOS AIRES,313,392,328,284,612
06,06056,060561306,Bahía Blanca,BUENOS AIRES,260,344,315,284,599
06,06056,060561310,Bahía Blanca,BUENOS AIRES,242,299,279,229,508
06,06056,060561411,Bahía Blanca,BUENOS AIRES,206,267,312,244,556
06,06056,060561506,Bahía Blanca,BUENOS AIRES,319,366,562,507,1069
06,06056,060561510,Bahía Blanca,BUENOS AIRES,212,237,334,302,636
06,06056,060561804,Bahía Blanca,BUENOS AIRES,233,258,437,392,829
06,06056,060561809,Bahía Blanca,BUENOS AIRES,309,363,471,395,866
06,06056,060561903,Bahía Blanca,BUENOS AIRES,440,477,651,631,1282
06,06056,060561909,Bahía Blanca,BUENOS AIRES,248,261,426,399,825
06,06056,060562306,Bahía Blanca,BUENOS AIRES,309,320,543,496,1039
06,06056,060562307,Bahía Blanca,BUENOS AIRES,272,282,464,445,909
06,06056,060562503,Bahía Blanca,BUENOS AIRES,278,425,472,531,1003
06,06056,060562504,Bahía Blanca,BUENOS AIRES,405,459,695,690,1385
06,06056,060562511,Bahía Blanca,BUENOS AIRES,343,395,495,466,961
06,06056,060562615,Bahía Blanca,BUENOS AIRES,257,310,487,482,969
06,06056,060562704,Bahía Blanca,BUENOS AIRES,290,445,499,504,1003
06,06056,060562705,Bahía Blanca,BUENOS AIRES,126,346,213,194,407
06,06056,060563005,Bahía Blanca,BUENOS AIRES,106,122,163,156,319
06,06056,060563205,Bahía Blanca,BUENOS AIRES,342,371,520,516,1036
06,06056,060563209,Bahía Blanca,BUENOS AIRES,375,412,625,572,1197
06,06056,060563211,Bahía Blanca,BUENOS AIRES,320,349,509,458,967
06,06056,060562313,Bahía Blanca,BUENOS AIRES,250,289,359,326,685
06,06056,060562609,Bahía Blanca,BUENOS AIRES,196,238,334,306,640
06,06056,060560210,Bahía Blanca,BUENOS AIRES,294,329,403,373,776
06,06056,060560304,Bahía Blanca,BUENOS AIRES,273,308,361,330,691
06,06056,060560407,Bahía Blanca,BUENOS AIRES,315,387,448,380,828
06,06056,060560508,Bahía Blanca,BUENOS AIRES,216,226,319,309,628
06,06056,060560701,Bahía Blanca,BUENOS AIRES,394,435,583,562,1145
06,06056,060560806,Bahía Blanca,BUENOS AIRES,252,269,443,407,850
06,06056,060561102,Bahía Blanca,BUENOS AIRES,146,223,200,145,345
06,06056,060561109,Bahía Blanca,BUENOS AIRES,187,270,212,136,348
06,06056,060561111,Bahía Blanca,BUENOS AIRES,236,353,269,191,460
06,06056,060561112,Bahía Blanca,BUENOS AIRES,279,374,335,262,597
06,06056,060561402,Bahía Blanca,BUENOS AIRES,221,254,300,269,569
06,06056,060561405,Bahía Blanca,BUENOS AIRES,217,251,236,212,448
06,06056,060561406,Bahía Blanca,BUENOS AIRES,409,525,517,439,956
06,06056,060561602,Bahía Blanca,BUENOS AIRES,202,256,286,283,569
06,06056,060561607,Bahía Blanca,BUENOS AIRES,190,214,253,207,460
06,06056,060561608,Bahía Blanca,BUENOS AIRES,315,383,474,388,862
06,06056,060561614,Bahía Blanca,BUENOS AIRES,251,351,346,247,593
06,06056,060561704,Bahía Blanca,BUENOS AIRES,214,259,313,257,570
06,06056,060561805,Bahía Blanca,BUENOS AIRES,311,332,424,412,836
06,06056,060561905,Bahía Blanca,BUENOS AIRES,383,389,734,709,1443
06,06056,060561908,Bahía Blanca,BUENOS AIRES,240,249,439,505,944
06,06056,060561912,Bahía Blanca,BUENOS AIRES,397,415,648,604,1252
06,06056,060562002,Bahía Blanca,BUENOS AIRES,387,462,519,440,959
06,06056,060562103,Bahía Blanca,BUENOS AIRES,209,234,317,286,603
06,06056,060562105,Bahía Blanca,BUENOS AIRES,351,397,507,438,945
06,06056,060562107,Bahía Blanca,BUENOS AIRES,352,298,594,571,1165
06,06056,060562111,Bahía Blanca,BUENOS AIRES,341,383,523,550,1073
06,06056,060562214,Bahía Blanca,BUENOS AIRES,309,351,519,503,1022
06,06056,060562309,Bahía Blanca,BUENOS AIRES,378,407,654,624,1278
06,06056,060562310,Bahía Blanca,BUENOS AIRES,284,319,405,379,784
06,06056,060562412,Bahía Blanca,BUENOS AIRES,413,426,793,773,1566
06,06056,060562416,Bahía Blanca,BUENOS AIRES,356,352,604,656,1260
06,06056,060562501,Bahía Blanca,BUENOS AIRES,389,521,619,609,1228
06,06056,060562502,Bahía Blanca,BUENOS AIRES,487,537,808,1276,2084
06,06056,060562616,Bahía Blanca,BUENOS AIRES,256,253,511,514,1025
06,06056,060562512,Bahía Blanca,BUENOS AIRES,348,416,563,505,1068
06,06056,060562603,Bahía Blanca,BUENOS AIRES,313,394,524,528,1052
06,06056,060562604,Bahía Blanca,BUENOS AIRES,128,180,192,214,406
06,06056,060562617,Bahía Blanca,BUENOS AIRES,468,615,832,855,1687
06,06056,060563003,Bahía Blanca,BUENOS AIRES,207,239,288,268,556
06,06056,060560309,Bahía Blanca,BUENOS AIRES,218,248,313,264,577
06,06056,060560801,Bahía Blanca,BUENOS AIRES,476,487,845,857,1702
06,06056,060560302,Bahía Blanca,BUENOS AIRES,238,327,267,202,469
06,06056,060560112,Bahía Blanca,BUENOS AIRES,277,357,309,241,550
06,06056,060560203,Bahía Blanca,BUENOS AIRES,182,207,285,271,556
06,06056,060560506,Bahía Blanca,BUENOS AIRES,327,369,482,432,914
06,06056,060560601,Bahía Blanca,BUENOS AIRES,272,291,470,445,915
06,06056,060560706,Bahía Blanca,BUENOS AIRES,242,271,371,359,730
06,06056,060560707,Bahía Blanca,BUENOS AIRES,347,378,610,505,1115
06,06056,060560709,Bahía Blanca,BUENOS AIRES,357,389,603,578,1181
06,06056,060561007,Bahía Blanca,BUENOS AIRES,245,337,284,250,534
06,06056,060560904,Bahía Blanca,BUENOS AIRES,255,348,343,309,652
06,06056,060560908,Bahía Blanca,BUENOS AIRES,264,277,355,322,677
06,06056,060560909,Bahía Blanca,BUENOS AIRES,153,152,249,236,485
06,06056,060561011,Bahía Blanca,BUENOS AIRES,195,246,266,236,502
06,06056,060561201,Bahía Blanca,BUENOS AIRES,310,353,313,284,597
06,06056,060561305,Bahía Blanca,BUENOS AIRES,178,229,207,191,398
06,06056,060561401,Bahía Blanca,BUENOS AIRES,208,256,251,242,493
06,06056,060561409,Bahía Blanca,BUENOS AIRES,170,222,212,166,378
06,06056,060561415,Bahía Blanca,BUENOS AIRES,191,291,195,127,322
06,06056,060561417,Bahía Blanca,BUENOS AIRES,280,351,351,238,589
06,06056,060561418,Bahía Blanca,BUENOS AIRES,217,332,286,164,450
06,06056,060561419,Bahía Blanca,BUENOS AIRES,256,356,329,225,554
06,06056,060561504,Bahía Blanca,BUENOS AIRES,246,274,360,340,700
06,06056,060561512,Bahía Blanca,BUENOS AIRES,400,418,617,601,1218
06,06056,060561515,Bahía Blanca,BUENOS AIRES,447,487,740,709,1449
06,06056,060561601,Bahía Blanca,BUENOS AIRES,214,238,311,264,575
06,06056,060561610,Bahía Blanca,BUENOS AIRES,270,350,396,316,712
06,06056,060561611,Bahía Blanca,BUENOS AIRES,335,447,442,336,778
06,06056,060561613,Bahía Blanca,BUENOS AIRES,341,454,439,322,761
06,06056,060561709,Bahía Blanca,BUENOS AIRES,253,346,379,281,660
06,06056,060561801,Bahía Blanca,BUENOS AIRES,384,427,560,531,1091
06,06056,060561911,Bahía Blanca,BUENOS AIRES,340,376,548,466,1014
06,06056,060561913,Bahía Blanca,BUENOS AIRES,413,429,656,630,1286
06,06056,060561914,Bahía Blanca,BUENOS AIRES,228,235,350,328,678
06,06056,060562210,Bahía Blanca,BUENOS AIRES,283,318,444,358,802
06,06056,060562215,Bahía Blanca,BUENOS AIRES,297,309,504,462,966
06,06056,060562216,Bahía Blanca,BUENOS AIRES,343,356,507,425,932
06,06056,060562415,Bahía Blanca,BUENOS AIRES,238,254,404,434,838
06,06056,060562508,Bahía Blanca,BUENOS AIRES,395,452,593,555,1148
06,06056,060562707,Bahía Blanca,BUENOS AIRES,325,385,584,587,1171
06,06056,060563004,Bahía Blanca,BUENOS AIRES,205,236,288,263,551
06,06056,060562701,Bahía Blanca,BUENOS AIRES,46,74,63,136,199
06,06056,060563001,Bahía Blanca,BUENOS AIRES,43,73,63,69,132
06,06056,060563212,Bahía Blanca,BUENOS AIRES,22,5,1,21,22
06,06056,060563202,Bahía Blanca,BUENOS AIRES,226,410,289,351,640
06,06056,060562003,Bahía Blanca,BUENOS AIRES,311,390,439,354,793
06,06056,060562109,Bahía Blanca,BUENOS AIRES,269,308,398,284,682
06,06056,060561008,Bahía Blanca,BUENOS AIRES,325,429,408,329,737
06,06056,060561009,Bahía Blanca,BUENOS AIRES,230,298,317,224,541
06,06056,060560104,Bahía Blanca,BUENOS AIRES,166,238,179,160,339
06,06056,060560105,Bahía Blanca,BUENOS AIRES,194,279,188,202,390
06,06056,060560106,Bahía Blanca,BUENOS AIRES,177,237,181,175,356
06,06056,060560109,Bahía Blanca,BUENOS AIRES,185,224,208,152,360
06,06056,060560113,Bahía Blanca,BUENOS AIRES,241,306,297,229,526
06,06056,060560303,Bahía Blanca,BUENOS AIRES,285,392,402,271,673
06,06056,060560207,Bahía Blanca,BUENOS AIRES,301,350,390,308,698
06,06056,060560213,Bahía Blanca,BUENOS AIRES,177,212,256,215,471
06,06056,060560310,Bahía Blanca,BUENOS AIRES,279,346,379,355,734
06,06056,060560312,Bahía Blanca,BUENOS AIRES,233,249,326,295,621
06,06056,060560501,Bahía Blanca,BUENOS AIRES,228,225,381,340,721
06,06056,060560502,Bahía Blanca,BUENOS AIRES,301,321,578,443,1021
06,06056,060560705,Bahía Blanca,BUENOS AIRES,223,234,348,338,686
06,06056,060560708,Bahía Blanca,BUENOS AIRES,277,305,426,384,810
06,06056,060560803,Bahía Blanca,BUENOS AIRES,367,362,643,636,1279
06,06056,060561006,Bahía Blanca,BUENOS AIRES,171,270,221,145,366
06,06056,060560812,Bahía Blanca,BUENOS AIRES,275,255,484,504,988
06,06056,060560902,Bahía Blanca,BUENOS AIRES,270,381,353,286,639
06,06056,060560905,Bahía Blanca,BUENOS AIRES,224,308,331,238,569
06,06056,060561105,Bahía Blanca,BUENOS AIRES,215,305,225,153,378
06,06056,060561113,Bahía Blanca,BUENOS AIRES,253,314,301,209,510
06,06056,060561207,Bahía Blanca,BUENOS AIRES,203,278,240,132,372
06,06056,060561209,Bahía Blanca,BUENOS AIRES,242,348,268,232,500
06,06056,060561210,Bahía Blanca,BUENOS AIRES,145,199,156,100,256
06,06056,060561308,Bahía Blanca,BUENOS AIRES,311,393,331,291,622
06,06056,060561412,Bahía Blanca,BUENOS AIRES,176,234,217,151,368
06,06056,060561413,Bahía Blanca,BUENOS AIRES,282,413,418,278,696
06,06056,060561416,Bahía Blanca,BUENOS AIRES,328,448,368,316,684
06,06056,060561605,Bahía Blanca,BUENOS AIRES,313,359,427,362,789
06,06056,060561612,Bahía Blanca,BUENOS AIRES,258,369,313,263,576
06,06056,060561806,Bahía Blanca,BUENOS AIRES,295,336,427,367,794
06,06056,060561810,Bahía Blanca,BUENOS AIRES,252,305,372,354,726
06,06056,060562206,Bahía Blanca,BUENOS AIRES,351,331,560,561,1121
06,06056,060562212,Bahía Blanca,BUENOS AIRES,101,313,226,246,472
06,06056,060562316,Bahía Blanca,BUENOS AIRES,296,305,517,532,1049
06,06056,060562404,Bahía Blanca,BUENOS AIRES,365,408,636,615,1251
06,06056,060562409,Bahía Blanca,BUENOS AIRES,361,382,648,646,1294
06,06056,060562413,Bahía Blanca,BUENOS AIRES,405,419,689,699,1388
06,06056,060562505,Bahía Blanca,BUENOS AIRES,354,367,671,644,1315
06,06056,060562514,Bahía Blanca,BUENOS AIRES,314,414,374,398,772
06,06056,060562607,Bahía Blanca,BUENOS AIRES,316,402,486,484,970
06,06056,060562702,Bahía Blanca,BUENOS AIRES,244,353,430,416,846
06,06056,060562706,Bahía Blanca,BUENOS AIRES,100,195,168,169,337
06,06056,060563203,Bahía Blanca,BUENOS AIRES,339,425,536,602,1138
06,06056,060563206,Bahía Blanca,BUENOS AIRES,340,365,586,533,1119
06,06056,060562901,Bahía Blanca,BUENOS AIRES,17,36,15,28,43
06,06056,060563204,Bahía Blanca,BUENOS AIRES,113,122,146,180,326
06,06056,060562507,Bahía Blanca,BUENOS AIRES,401,439,689,673,1362
06,06056,060563210,Bahía Blanca,BUENOS AIRES,315,339,492,417,909
06,06056,060561309,Bahía Blanca,BUENOS AIRES,172,244,183,149,332
06,06056,060561004,Bahía Blanca,BUENOS AIRES,308,426,371,281,652
06,06056,060560110,Bahía Blanca,BUENOS AIRES,240,312,276,216,492
06,06056,060560114,Bahía Blanca,BUENOS AIRES,223,293,218,185,403
06,06056,060560202,Bahía Blanca,BUENOS AIRES,377,384,619,655,1274
06,06056,060560211,Bahía Blanca,BUENOS AIRES,318,355,488,486,974
06,06056,060560604,Bahía Blanca,BUENOS AIRES,213,254,337,296,633
06,06056,060560606,Bahía Blanca,BUENOS AIRES,201,254,297,246,543
06,06056,060560702,Bahía Blanca,BUENOS AIRES,309,369,388,378,766
06,06056,060560710,Bahía Blanca,BUENOS AIRES,330,377,499,468,967
06,06056,060561005,Bahía Blanca,BUENOS AIRES,197,299,228,182,410
06,06056,060560805,Bahía Blanca,BUENOS AIRES,472,486,793,746,1539
06,06056,060560808,Bahía Blanca,BUENOS AIRES,73,73,156,158,314
06,06056,060560811,Bahía Blanca,BUENOS AIRES,23,29,39,38,77
06,06056,060560813,Bahía Blanca,BUENOS AIRES,325,339,606,623,1229
06,06056,060560814,Bahía Blanca,BUENOS AIRES,400,415,777,763,1540
06,06056,060561101,Bahía Blanca,BUENOS AIRES,210,293,263,216,479
06,06056,060561107,Bahía Blanca,BUENOS AIRES,258,366,287,191,478
06,06056,060561114,Bahía Blanca,BUENOS AIRES,209,240,247,191,438
06,06056,060561204,Bahía Blanca,BUENOS AIRES,271,367,340,240,580
06,06056,060561301,Bahía Blanca,BUENOS AIRES,496,611,532,507,1039
06,06056,060561404,Bahía Blanca,BUENOS AIRES,227,272,272,239,511
06,06056,060561407,Bahía Blanca,BUENOS AIRES,240,295,264,246,510
06,06056,060561421,Bahía Blanca,BUENOS AIRES,188,290,220,148,368
06,06056,060561505,Bahía Blanca,BUENOS AIRES,282,298,441,439,880
06,06056,060561507,Bahía Blanca,BUENOS AIRES,307,317,455,434,889
06,06056,060561508,Bahía Blanca,BUENOS AIRES,381,388,656,635,1291
06,06056,060561509,Bahía Blanca,BUENOS AIRES,177,186,322,280,602
06,06056,060561604,Bahía Blanca,BUENOS AIRES,182,234,239,224,463
06,06056,060561708,Bahía Blanca,BUENOS AIRES,259,330,336,299,635
06,06056,060561710,Bahía Blanca,BUENOS AIRES,261,324,346,277,623
06,06056,060561803,Bahía Blanca,BUENOS AIRES,222,242,319,255,574
06,06056,060561904,Bahía Blanca,BUENOS AIRES,341,351,598,551,1149
06,06056,060561906,Bahía Blanca,BUENOS AIRES,451,504,660,648,1308
06,06056,060562004,Bahía Blanca,BUENOS AIRES,320,392,399,354,753
06,06056,060562007,Bahía Blanca,BUENOS AIRES,240,299,301,232,533
06,06056,060562104,Bahía Blanca,BUENOS AIRES,225,248,340,334,674
06,06056,060562110,Bahía Blanca,BUENOS AIRES,252,262,401,344,745
06,06056,060562201,Bahía Blanca,BUENOS AIRES,343,393,502,437,939
06,06056,060562205,Bahía Blanca,BUENOS AIRES,253,244,448,409,857
06,06056,060562217,Bahía Blanca,BUENOS AIRES,355,360,542,484,1026
06,06056,060562312,Bahía Blanca,BUENOS AIRES,207,236,314,298,612
06,06056,060562401,Bahía Blanca,BUENOS AIRES,392,455,666,620,1286
06,06056,060562411,Bahía Blanca,BUENOS AIRES,194,203,283,302,585
06,06056,060562610,Bahía Blanca,BUENOS AIRES,572,689,974,948,1922
06,06056,060563002,Bahía Blanca,BUENOS AIRES,140,173,220,205,425
06,06056,060560209,Bahía Blanca,BUENOS AIRES,252,277,370,334,704
06,06056,060561202,Bahía Blanca,BUENOS AIRES,294,342,316,229,545
06,06056,060560405,Bahía Blanca,BUENOS AIRES,440,504,633,505,1138
06,06056,060560101,Bahía Blanca,BUENOS AIRES,326,433,358,340,698
06,06056,060560118,Bahía Blanca,BUENOS AIRES,176,284,199,168,367
06,06056,060560119,Bahía Blanca,BUENOS AIRES,295,411,339,297,636
06,06056,060560204,Bahía Blanca,BUENOS AIRES,193,232,320,287,607
06,06056,060560205,Bahía Blanca,BUENOS AIRES,189,215,293,280,573
06,06056,060560212,Bahía Blanca,BUENOS AIRES,329,383,489,438,927
06,06056,060560214,Bahía Blanca,BUENOS AIRES,247,288,347,320,667
06,06056,060560401,Bahía Blanca,BUENOS AIRES,387,421,571,489,1060
06,06056,060560507,Bahía Blanca,BUENOS AIRES,329,357,503,450,953
06,06056,060560704,Bahía Blanca,BUENOS AIRES,390,418,577,510,1087
06,06056,060560802,Bahía Blanca,BUENOS AIRES,475,508,868,893,1761
06,06056,060560903,Bahía Blanca,BUENOS AIRES,263,371,334,258,592
06,06056,060561001,Bahía Blanca,BUENOS AIRES,129,209,172,117,289
06,06056,060561002,Bahía Blanca,BUENOS AIRES,183,254,208,154,362
06,06056,060561108,Bahía Blanca,BUENOS AIRES,234,328,250,174,424
06,06056,060561211,Bahía Blanca,BUENOS AIRES,169,235,186,135,321
06,06056,060561302,Bahía Blanca,BUENOS AIRES,311,478,354,337,691
06,06056,060561307,Bahía Blanca,BUENOS AIRES,321,405,350,297,647
06,06056,060561414,Bahía Blanca,BUENOS AIRES,340,484,455,273,728
06,06056,060561502,Bahía Blanca,BUENOS AIRES,383,426,703,601,1304
06,06056,060561503,Bahía Blanca,BUENOS AIRES,336,374,496,476,972
06,06056,060561513,Bahía Blanca,BUENOS AIRES,234,248,387,367,754
06,06056,060561516,Bahía Blanca,BUENOS AIRES,175,193,296,305,601
06,06056,060561808,Bahía Blanca,BUENOS AIRES,327,375,513,438,951
06,06056,060561910,Bahía Blanca,BUENOS AIRES,479,480,913,906,1819
06,06056,060562005,Bahía Blanca,BUENOS AIRES,357,433,481,425,906
06,06056,060562106,Bahía Blanca,BUENOS AIRES,158,183,288,260,548
06,06056,060562208,Bahía Blanca,BUENOS AIRES,391,410,611,559,1170
06,06056,060562211,Bahía Blanca,BUENOS AIRES,264,310,374,309,683
06,06056,060562408,Bahía Blanca,BUENOS AIRES,732,830,1300,1387,2687
06,06056,060562417,Bahía Blanca,BUENOS AIRES,186,178,289,303,592
06,06056,060562510,Bahía Blanca,BUENOS AIRES,328,366,505,453,958
06,06056,060562516,Bahía Blanca,BUENOS AIRES,343,409,412,409,821
06,06056,060562602,Bahía Blanca,BUENOS AIRES,289,401,510,508,1018
06,06056,060562605,Bahía Blanca,BUENOS AIRES,301,339,461,459,920
06,06056,060562606,Bahía Blanca,BUENOS AIRES,189,215,278,294,572
06,06056,060562613,Bahía Blanca,BUENOS AIRES,438,531,743,782,1525
06,06056,060562618,Bahía Blanca,BUENOS AIRES,201,207,382,371,753
06,06056,060563101,Bahía Blanca,BUENOS AIRES,59,145,61,81,142
06,06056,060562301,Bahía Blanca,BUENOS AIRES,195,223,361,378,739
06,06056,060560404,Bahía Blanca,BUENOS AIRES,470,513,659,578,1237
06,06056,060560102,Bahía Blanca,BUENOS AIRES,361,496,411,330,741
06,06056,060560111,Bahía Blanca,BUENOS AIRES,297,404,324,283,607
06,06056,060560116,Bahía Blanca,BUENOS AIRES,214,292,244,229,473
06,06056,060560206,Bahía Blanca,BUENOS AIRES,192,253,216,226,442
06,06056,060560403,Bahía Blanca,BUENOS AIRES,317,331,508,477,985
06,06056,060560409,Bahía Blanca,BUENOS AIRES,211,273,298,264,562
06,06056,060560504,Bahía Blanca,BUENOS AIRES,395,439,578,582,1160
06,06056,060560505,Bahía Blanca,BUENOS AIRES,169,207,275,242,517
06,06056,060560602,Bahía Blanca,BUENOS AIRES,318,339,496,466,962
06,06056,060560603,Bahía Blanca,BUENOS AIRES,278,298,615,536,1151
06,06056,060560607,Bahía Blanca,BUENOS AIRES,401,422,646,599,1245
06,06056,060560608,Bahía Blanca,BUENOS AIRES,344,529,562,575,1137
06,06056,060560703,Bahía Blanca,BUENOS AIRES,370,381,578,498,1076
06,06056,060560804,Bahía Blanca,BUENOS AIRES,422,461,750,772,1522
06,06056,060560910,Bahía Blanca,BUENOS AIRES,185,219,275,237,512
06,06056,060561104,Bahía Blanca,BUENOS AIRES,244,411,220,188,408
06,06056,060561106,Bahía Blanca,BUENOS AIRES,214,299,230,156,386
06,06056,060561110,Bahía Blanca,BUENOS AIRES,271,353,393,267,660
06,06056,060561203,Bahía Blanca,BUENOS AIRES,193,245,231,155,386
06,06056,060561410,Bahía Blanca,BUENOS AIRES,310,389,340,257,597
06,06056,060561603,Bahía Blanca,BUENOS AIRES,244,268,334,285,619
06,06056,060561609,Bahía Blanca,BUENOS AIRES,315,382,423,379,802
06,06056,060561703,Bahía Blanca,BUENOS AIRES,340,398,471,389,860
06,06056,060561705,Bahía Blanca,BUENOS AIRES,184,237,218,200,418
06,06056,060561707,Bahía Blanca,BUENOS AIRES,319,411,452,390,842
06,06056,060561802,Bahía Blanca,BUENOS AIRES,371,403,535,486,1021
06,06056,060561807,Bahía Blanca,BUENOS AIRES,355,393,522,427,949
06,06056,060561901,Bahía Blanca,BUENOS AIRES,349,391,521,507,1028
06,06056,060561902,Bahía Blanca,BUENOS AIRES,342,365,503,473,976
06,06056,060561907,Bahía Blanca,BUENOS AIRES,393,410,660,697,1357
06,06056,060562006,Bahía Blanca,BUENOS AIRES,254,373,334,273,607
06,06056,060562101,Bahía Blanca,BUENOS AIRES,319,373,466,439,905
06,06056,060562102,Bahía Blanca,BUENOS AIRES,300,309,423,377,800
06,06056,060562108,Bahía Blanca,BUENOS AIRES,214,288,270,267,537
06,06056,060562203,Bahía Blanca,BUENOS AIRES,370,411,586,525,1111
06,06056,060562207,Bahía Blanca,BUENOS AIRES,216,219,348,328,676
06,06056,060562209,Bahía Blanca,BUENOS AIRES,206,219,305,283,588
06,06056,060562303,Bahía Blanca,BUENOS AIRES,334,344,560,613,1173
06,06056,060562304,Bahía Blanca,BUENOS AIRES,481,514,844,842,1686
06,06056,060562305,Bahía Blanca,BUENOS AIRES,257,272,389,358,747
06,06056,060562314,Bahía Blanca,BUENOS AIRES,318,324,514,450,964
06,06056,060562315,Bahía Blanca,BUENOS AIRES,263,281,416,473,889
06,06056,060562403,Bahía Blanca,BUENOS AIRES,305,415,519,529,1048
06,06056,060562407,Bahía Blanca,BUENOS AIRES,390,455,670,650,1320
06,06056,060562414,Bahía Blanca,BUENOS AIRES,234,245,398,383,781
06,06056,060562506,Bahía Blanca,BUENOS AIRES,421,470,710,743,1453
06,06056,060562509,Bahía Blanca,BUENOS AIRES,362,415,597,603,1200
06,06056,060562601,Bahía Blanca,BUENOS AIRES,281,351,489,499,988
06,06056,060562611,Bahía Blanca,BUENOS AIRES,426,527,702,712,1414
06,06056,060562612,Bahía Blanca,BUENOS AIRES,166,221,271,264,535
06,06056,060562619,Bahía Blanca,BUENOS AIRES,176,181,351,379,730
06,06056,060562703,Bahía Blanca,BUENOS AIRES,312,326,567,545,1112
06,06056,060563207,Bahía Blanca,BUENOS AIRES,169,224,300,309,609
06,06056,060563208,Bahía Blanca,BUENOS AIRES,247,265,449,459,908
06,06056,060563201,Bahía Blanca,BUENOS AIRES,23,65,17,28,45
06,06056,060563007,Bahía Blanca,BUENOS AIRES,27,55,37,43,80
06,06056,060560901,Bahía Blanca,BUENOS AIRES,309,426,365,266,631
06,06056,060561408,Bahía Blanca,BUENOS AIRES,305,399,339,254,593
06,06056,060562406,Bahía Blanca,BUENOS AIRES,434,456,732,713,1445
06,06056,060561010,Bahía Blanca,BUENOS AIRES,230,304,284,225,509
06,06056,060560406,Bahía Blanca,BUENOS AIRES,439,520,611,504,1115
06,06056,060560107,Bahía Blanca,BUENOS AIRES,239,324,204,190,394
06,06056,060560115,Bahía Blanca,BUENOS AIRES,229,293,273,247,520
06,06056,060560208,Bahía Blanca,BUENOS AIRES,364,441,469,423,892
06,06056,060560301,Bahía Blanca,BUENOS AIRES,181,228,201,170,371
06,06056,060560305,Bahía Blanca,BUENOS AIRES,123,153,168,138,306
06,06056,060560306,Bahía Blanca,BUENOS AIRES,335,449,363,313,676
06,06056,060560311,Bahía Blanca,BUENOS AIRES,363,398,506,434,940
06,06056,060560402,Bahía Blanca,BUENOS AIRES,233,253,390,353,743
06,06056,060560410,Bahía Blanca,BUENOS AIRES,150,172,227,207,434
06,06056,060560509,Bahía Blanca,BUENOS AIRES,373,411,622,545,1167
06,06056,060560609,Bahía Blanca,BUENOS AIRES,361,393,582,614,1196
06,06056,060560807,Bahía Blanca,BUENOS AIRES,248,258,441,415,856
06,06056,060560815,Bahía Blanca,BUENOS AIRES,202,230,394,412,806
06,06056,060560906,Bahía Blanca,BUENOS AIRES,326,381,485,343,828
06,06056,060560911,Bahía Blanca,BUENOS AIRES,208,227,304,290,594
06,06056,060561103,Bahía Blanca,BUENOS AIRES,148,228,187,137,324
06,06056,060561205,Bahía Blanca,BUENOS AIRES,284,400,286,205,491
06,06056,060561206,Bahía Blanca,BUENOS AIRES,265,368,277,174,451
06,06056,060561304,Bahía Blanca,BUENOS AIRES,172,240,170,155,325
06,06056,060561403,Bahía Blanca,BUENOS AIRES,261,336,298,256,554
06,06056,060561420,Bahía Blanca,BUENOS AIRES,114,167,115,75,190
06,06056,060561501,Bahía Blanca,BUENOS AIRES,302,348,506,513,1019
06,06056,060561511,Bahía Blanca,BUENOS AIRES,236,245,381,335,716
06,06056,060561514,Bahía Blanca,BUENOS AIRES,341,369,620,568,1188
06,06056,060561517,Bahía Blanca,BUENOS AIRES,173,179,286,287,573
06,06056,060561606,Bahía Blanca,BUENOS AIRES,171,201,219,206,425
06,06056,060561701,Bahía Blanca,BUENOS AIRES,344,388,479,401,880
06,06056,060561702,Bahía Blanca,BUENOS AIRES,331,380,440,406,846
06,06056,060561706,Bahía Blanca,BUENOS AIRES,311,377,421,359,780
06,06056,060562008,Bahía Blanca,BUENOS AIRES,189,219,269,244,513
06,06056,060562009,Bahía Blanca,BUENOS AIRES,193,227,282,262,544
06,06056,060562010,Bahía Blanca,BUENOS AIRES,204,227,307,281,588
06,06056,060562202,Bahía Blanca,BUENOS AIRES,345,386,503,445,948
06,06056,060562204,Bahía Blanca,BUENOS AIRES,410,415,634,610,1244
06,06056,060562213,Bahía Blanca,BUENOS AIRES,295,315,567,510,1077
06,06056,060562302,Bahía Blanca,BUENOS AIRES,280,294,473,471,944
06,06056,060562308,Bahía Blanca,BUENOS AIRES,292,308,457,422,879
06,06056,060562311,Bahía Blanca,BUENOS AIRES,179,197,281,282,563
06,06056,060562402,Bahía Blanca,BUENOS AIRES,473,491,838,871,1709
06,06056,060562405,Bahía Blanca,BUENOS AIRES,325,338,592,609,1201
06,06056,060562410,Bahía Blanca,BUENOS AIRES,267,270,455,444,899
06,06056,060562513,Bahía Blanca,BUENOS AIRES,289,316,370,367,737
06,06056,060562515,Bahía Blanca,BUENOS AIRES,259,297,372,308,680
06,06056,060562614,Bahía Blanca,BUENOS AIRES,375,461,634,645,1279
06,06056,060562608,Bahía Blanca,BUENOS AIRES,309,374,475,470,945
06,06056,060562801,Bahía Blanca,BUENOS AIRES,22,59,23,28,51
06,06063,060630706,Balcarce,BUENOS AIRES,366,449,660,635,1295
06,06063,060630802,Balcarce,BUENOS AIRES,60,85,73,89,162
06,06063,060630116,Balcarce,BUENOS AIRES,241,251,424,372,796
06,06063,060630113,Balcarce,BUENOS AIRES,272,312,347,315,662
06,06063,060630205,Balcarce,BUENOS AIRES,361,416,541,480,1021
06,06063,060630401,Balcarce,BUENOS AIRES,7,15,17,10,27
06,06063,060630709,Balcarce,BUENOS AIRES,265,332,441,463,904
06,06063,060631305,Balcarce,BUENOS AIRES,333,395,449,377,826
06,06063,060630301,Balcarce,BUENOS AIRES,14,18,13,19,32
06,06063,060630306,Balcarce,BUENOS AIRES,22,34,26,39,65
06,06063,060630707,Balcarce,BUENOS AIRES,240,330,351,364,715
06,06063,060631001,Balcarce,BUENOS AIRES,20,28,24,34,58
06,06063,060630208,Balcarce,BUENOS AIRES,330,356,482,461,943
06,06063,060631301,Balcarce,BUENOS AIRES,282,388,356,304,660
06,06063,060631201,Balcarce,BUENOS AIRES,15,16,23,25,48
06,06063,060630604,Balcarce,BUENOS AIRES,24,51,34,42,76
06,06063,060630606,Balcarce,BUENOS AIRES,18,57,16,23,39
06,06063,060630905,Balcarce,BUENOS AIRES,9,29,10,14,24
06,06063,060631004,Balcarce,BUENOS AIRES,23,53,23,32,55
06,06063,060631102,Balcarce,BUENOS AIRES,46,110,57,87,144
06,06063,060631105,Balcarce,BUENOS AIRES,40,65,61,66,127
06,06063,060630106,Balcarce,BUENOS AIRES,287,318,432,363,795
06,06063,060630108,Balcarce,BUENOS AIRES,382,422,558,538,1096
06,06063,060630111,Balcarce,BUENOS AIRES,297,322,414,349,763
06,06063,060630206,Balcarce,BUENOS AIRES,159,171,270,242,512
06,06063,060630806,Balcarce,BUENOS AIRES,66,85,91,92,183
06,06063,060631101,Balcarce,BUENOS AIRES,23,37,34,35,69
06,06063,060630304,Balcarce,BUENOS AIRES,17,35,19,32,51
06,06063,060630404,Balcarce,BUENOS AIRES,40,77,34,65,99
06,06063,060630501,Balcarce,BUENOS AIRES,8,10,19,13,32
06,06063,060630603,Balcarce,BUENOS AIRES,25,46,30,42,72
06,06063,060630904,Balcarce,BUENOS AIRES,7,24,6,8,14
06,06063,060631202,Balcarce,BUENOS AIRES,17,37,22,22,44
06,06063,060630302,Balcarce,BUENOS AIRES,162,215,233,237,470
06,06063,060630112,Balcarce,BUENOS AIRES,217,274,327,268,595
06,06063,060630207,Balcarce,BUENOS AIRES,325,371,505,454,959
06,06063,060630801,Balcarce,BUENOS AIRES,6,10,5,7,12
06,06063,060631303,Balcarce,BUENOS AIRES,439,489,622,560,1182
06,06063,060631308,Balcarce,BUENOS AIRES,372,402,548,540,1088
06,06063,060630502,Balcarce,BUENOS AIRES,16,21,16,25,41
06,06063,060630403,Balcarce,BUENOS AIRES,23,61,19,36,55
06,06063,060630102,Balcarce,BUENOS AIRES,324,339,461,430,891
06,06063,060630103,Balcarce,BUENOS AIRES,334,350,518,503,1021
06,06063,060630105,Balcarce,BUENOS AIRES,417,426,646,639,1285
06,06063,060630109,Balcarce,BUENOS AIRES,381,417,635,598,1233
06,06063,060630114,Balcarce,BUENOS AIRES,269,323,389,347,736
06,06063,060630202,Balcarce,BUENOS AIRES,299,377,426,370,796
06,06063,060630402,Balcarce,BUENOS AIRES,28,34,40,28,68
06,06063,060630803,Balcarce,BUENOS AIRES,8,19,8,12,20
06,06063,060630902,Balcarce,BUENOS AIRES,17,26,16,17,33
06,06063,060631203,Balcarce,BUENOS AIRES,8,19,9,11,20
06,06063,060630104,Balcarce,BUENOS AIRES,344,293,617,622,1239
06,06063,060630107,Balcarce,BUENOS AIRES,307,369,431,371,802
06,06063,060630201,Balcarce,BUENOS AIRES,446,509,718,683,1401
06,06063,060630203,Balcarce,BUENOS AIRES,303,365,404,365,769
06,06063,060630708,Balcarce,BUENOS AIRES,406,480,726,699,1425
06,06063,060630906,Balcarce,BUENOS AIRES,100,124,131,133,264
06,06063,060631302,Balcarce,BUENOS AIRES,336,399,531,394,925
06,06063,060631103,Balcarce,BUENOS AIRES,44,79,47,63,110
06,06063,060630406,Balcarce,BUENOS AIRES,29,42,32,47,79
06,06063,060630607,Balcarce,BUENOS AIRES,18,30,12,31,43
06,06063,060630805,Balcarce,BUENOS AIRES,56,106,66,78,144
06,06063,060631104,Balcarce,BUENOS AIRES,45,67,47,96,143
06,06063,060631106,Balcarce,BUENOS AIRES,42,92,36,76,112
06,06063,060630117,Balcarce,BUENOS AIRES,236,257,381,340,721
06,06063,060630110,Balcarce,BUENOS AIRES,240,268,355,312,667
06,06063,060630204,Balcarce,BUENOS AIRES,311,365,497,503,1000
06,06063,060630702,Balcarce,BUENOS AIRES,189,211,343,345,688
06,06063,060630901,Balcarce,BUENOS AIRES,82,108,121,113,234
06,06063,060631107,Balcarce,BUENOS AIRES,18,54,22,24,46
06,06063,060631304,Balcarce,BUENOS AIRES,340,357,458,360,818
06,06063,060630305,Balcarce,BUENOS AIRES,32,41,31,57,88
06,06063,060630602,Balcarce,BUENOS AIRES,22,39,20,40,60
06,06063,060630804,Balcarce,BUENOS AIRES,27,59,38,40,78
06,06063,060630903,Balcarce,BUENOS AIRES,17,41,15,24,39
06,06063,060631002,Balcarce,BUENOS AIRES,122,149,180,173,353
06,06063,060631003,Balcarce,BUENOS AIRES,43,104,29,62,91
06,06063,060630115,Balcarce,BUENOS AIRES,351,386,547,590,1137
06,06063,060630101,Balcarce,BUENOS AIRES,286,279,501,495,996
06,06063,060630701,Balcarce,BUENOS AIRES,430,459,787,832,1619
06,06063,060630703,Balcarce,BUENOS AIRES,314,332,545,531,1076
06,06063,060630704,Balcarce,BUENOS AIRES,258,252,429,412,841
06,06063,060630705,Balcarce,BUENOS AIRES,178,194,270,312,582
06,06063,060631306,Balcarce,BUENOS AIRES,282,340,437,408,845
06,06063,060631307,Balcarce,BUENOS AIRES,372,408,559,530,1089
06,06063,060630303,Balcarce,BUENOS AIRES,48,71,59,86,145
06,06063,060630405,Balcarce,BUENOS AIRES,12,21,23,25,48
06,06063,060630601,Balcarce,BUENOS AIRES,43,91,39,71,110
06,06063,060630605,Balcarce,BUENOS AIRES,30,56,39,43,82
06,06070,060700302,Baradero,BUENOS AIRES,81,145,121,126,247
06,06070,060700105,Baradero,BUENOS AIRES,217,244,346,256,602
06,06070,060700109,Baradero,BUENOS AIRES,301,365,479,379,858
06,06070,060700112,Baradero,BUENOS AIRES,125,161,181,153,334
06,06070,060700218,Baradero,BUENOS AIRES,143,221,233,253,486
06,06070,060700602,Baradero,BUENOS AIRES,43,65,53,65,118
06,06070,060700803,Baradero,BUENOS AIRES,9,13,10,15,25
06,06070,060701004,Baradero,BUENOS AIRES,9,16,9,13,22
06,06070,060701202,Baradero,BUENOS AIRES,21,53,21,39,60
06,06070,060700404,Baradero,BUENOS AIRES,111,162,183,194,377
06,06070,060700104,Baradero,BUENOS AIRES,145,175,208,175,383
06,06070,060700202,Baradero,BUENOS AIRES,314,327,502,501,1003
06,06070,060700204,Baradero,BUENOS AIRES,355,410,595,494,1089
06,06070,060700205,Baradero,BUENOS AIRES,357,382,598,576,1174
06,06070,060700208,Baradero,BUENOS AIRES,286,282,515,541,1056
06,06070,060700215,Baradero,BUENOS AIRES,296,331,456,489,945
06,06070,060701001,Baradero,BUENOS AIRES,58,89,99,104,203
06,06070,060700804,Baradero,BUENOS AIRES,15,32,21,24,45
06,06070,060700806,Baradero,BUENOS AIRES,4,11,7,9,16
06,06070,060700904,Baradero,BUENOS AIRES,5,14,2,12,14
06,06070,060701102,Baradero,BUENOS AIRES,5,11,6,5,11
06,06070,060700301,Baradero,BUENOS AIRES,53,92,91,153,244
06,06070,060700101,Baradero,BUENOS AIRES,166,202,240,193,433
06,06070,060700211,Baradero,BUENOS AIRES,246,303,426,420,846
06,06070,060700212,Baradero,BUENOS AIRES,373,401,641,641,1282
06,06070,060700802,Baradero,BUENOS AIRES,8,16,10,10,20
06,06070,060700902,Baradero,BUENOS AIRES,5,15,6,4,10
06,06070,060700305,Baradero,BUENOS AIRES,456,484,758,813,1571
06,06070,060700203,Baradero,BUENOS AIRES,202,207,308,273,581
06,06070,060700306,Baradero,BUENOS AIRES,454,470,875,883,1758
06,06070,060700501,Baradero,BUENOS AIRES,42,85,48,59,107
06,06070,060700702,Baradero,BUENOS AIRES,19,30,32,27,59
06,06070,060700901,Baradero,BUENOS AIRES,7,13,6,6,12
06,06070,060701003,Baradero,BUENOS AIRES,19,33,17,30,47
06,06070,060700102,Baradero,BUENOS AIRES,168,208,211,154,365
06,06070,060700106,Baradero,BUENOS AIRES,291,325,441,408,849
06,06070,060700110,Baradero,BUENOS AIRES,284,341,403,368,771
06,06070,060700210,Baradero,BUENOS AIRES,467,494,850,865,1715
06,06070,060700213,Baradero,BUENOS AIRES,286,331,462,457,919
06,06070,060700214,Baradero,BUENOS AIRES,354,375,574,523,1097
06,06070,060700401,Baradero,BUENOS AIRES,385,436,625,582,1207
06,06070,060700805,Baradero,BUENOS AIRES,13,28,19,19,38
06,06070,060701002,Baradero,BUENOS AIRES,19,31,32,41,73
06,06070,060700103,Baradero,BUENOS AIRES,229,285,321,295,616
06,06070,060700107,Baradero,BUENOS AIRES,292,351,414,387,801
06,06070,060700201,Baradero,BUENOS AIRES,459,529,739,739,1478
06,06070,060700206,Baradero,BUENOS AIRES,387,435,667,670,1337
06,06070,060700207,Baradero,BUENOS AIRES,185,212,249,244,493
06,06070,060700209,Baradero,BUENOS AIRES,296,337,482,454,936
06,06070,060700502,Baradero,BUENOS AIRES,26,57,30,42,72
06,06070,060700403,Baradero,BUENOS AIRES,19,42,28,30,58
06,06070,060700701,Baradero,BUENOS AIRES,22,27,26,31,57
06,06070,060701201,Baradero,BUENOS AIRES,21,40,27,35,62
06,06070,060700108,Baradero,BUENOS AIRES,275,303,373,350,723
06,06070,060700113,Baradero,BUENOS AIRES,161,190,228,212,440
06,06070,060700216,Baradero,BUENOS AIRES,201,215,356,345,701
06,06070,060700217,Baradero,BUENOS AIRES,134,149,212,217,429
06,06070,060700402,Baradero,BUENOS AIRES,19,43,18,29,47
06,06070,060700903,Baradero,BUENOS AIRES,13,30,16,18,34
06,06070,060700111,Baradero,BUENOS AIRES,151,180,221,190,411
06,06070,060700801,Baradero,BUENOS AIRES,135,185,173,206,379
06,06070,060700304,Baradero,BUENOS AIRES,78,114,105,123,228
06,06070,060700303,Baradero,BUENOS AIRES,75,103,133,189,322
06,06070,060700601,Baradero,BUENOS AIRES,16,36,23,24,47
06,06070,060701101,Baradero,BUENOS AIRES,5,9,7,11,18
06,06098,060980403,Berisso,BUENOS AIRES,179,274,286,288,574
06,06098,060980612,Berisso,BUENOS AIRES,192,207,351,344,695
06,06098,060980406,Berisso,BUENOS AIRES,169,253,241,295,536
06,06098,060980109,Berisso,BUENOS AIRES,254,285,387,329,716
06,06098,060980102,Berisso,BUENOS AIRES,293,324,500,449,949
06,06098,060980213,Berisso,BUENOS AIRES,214,240,296,305,601
06,06098,060980302,Berisso,BUENOS AIRES,128,98,218,163,381
06,06098,060980310,Berisso,BUENOS AIRES,492,435,933,853,1786
06,06098,060980311,Berisso,BUENOS AIRES,234,251,348,340,688
06,06098,060980814,Berisso,BUENOS AIRES,306,284,487,461,948
06,06098,060980509,Berisso,BUENOS AIRES,279,310,512,491,1003
06,06098,060980614,Berisso,BUENOS AIRES,261,281,442,431,873
06,06098,060980705,Berisso,BUENOS AIRES,309,354,471,460,931
06,06098,060980407,Berisso,BUENOS AIRES,76,200,118,107,225
06,06098,060980212,Berisso,BUENOS AIRES,449,466,877,907,1784
06,06098,060980306,Berisso,BUENOS AIRES,364,369,604,607,1211
06,06098,060980603,Berisso,BUENOS AIRES,491,511,831,743,1574
06,06098,060980607,Berisso,BUENOS AIRES,300,338,427,389,816
06,06098,060980503,Berisso,BUENOS AIRES,311,319,547,501,1048
06,06098,060980703,Berisso,BUENOS AIRES,165,183,281,233,514
06,06098,060980811,Berisso,BUENOS AIRES,260,268,440,394,834
06,06098,060980405,Berisso,BUENOS AIRES,10,13,9,16,25
06,06098,060980313,Berisso,BUENOS AIRES,140,145,228,202,430
06,06098,060980706,Berisso,BUENOS AIRES,368,393,529,541,1070
06,06098,060980110,Berisso,BUENOS AIRES,312,338,516,440,956
06,06098,060980103,Berisso,BUENOS AIRES,316,312,491,418,909
06,06098,060980105,Berisso,BUENOS AIRES,267,287,386,372,758
06,06098,060980209,Berisso,BUENOS AIRES,220,239,372,342,714
06,06098,060980210,Berisso,BUENOS AIRES,310,319,552,518,1070
06,06098,060980301,Berisso,BUENOS AIRES,137,151,209,168,377
06,06098,060980813,Berisso,BUENOS AIRES,239,235,418,379,797
06,06098,060980507,Berisso,BUENOS AIRES,240,248,392,391,783
06,06098,060980606,Berisso,BUENOS AIRES,298,325,478,401,879
06,06098,060980611,Berisso,BUENOS AIRES,316,330,550,530,1080
06,06098,060980804,Berisso,BUENOS AIRES,273,293,476,508,984
06,06098,060980816,Berisso,BUENOS AIRES,311,321,519,474,993
06,06098,060980402,Berisso,BUENOS AIRES,144,171,285,304,589
06,06098,060980610,Berisso,BUENOS AIRES,226,232,411,384,795
06,06098,060980106,Berisso,BUENOS AIRES,299,329,503,420,923
06,06098,060980204,Berisso,BUENOS AIRES,406,416,690,634,1324
06,06098,060980208,Berisso,BUENOS AIRES,360,397,619,599,1218
06,06098,060980604,Berisso,BUENOS AIRES,231,220,394,382,776
06,06098,060980608,Berisso,BUENOS AIRES,345,370,530,474,1004
06,06098,060980613,Berisso,BUENOS AIRES,240,243,442,471,913
06,06098,060980617,Berisso,BUENOS AIRES,232,243,412,371,783
06,06098,060980812,Berisso,BUENOS AIRES,231,254,355,310,665
06,06098,060980803,Berisso,BUENOS AIRES,240,251,404,391,795
06,06098,060980815,Berisso,BUENOS AIRES,326,337,543,511,1054
06,06098,060980401,Berisso,BUENOS AIRES,55,74,95,95,190
06,06098,060980304,Berisso,BUENOS AIRES,285,311,472,476,948
06,06098,060980108,Berisso,BUENOS AIRES,258,280,358,316,674
06,06098,060980112,Berisso,BUENOS AIRES,254,302,387,308,695
06,06098,060980202,Berisso,BUENOS AIRES,347,375,523,503,1026
06,06098,060980207,Berisso,BUENOS AIRES,377,424,628,588,1216
06,06098,060980309,Berisso,BUENOS AIRES,477,437,987,913,1900
06,06098,060980602,Berisso,BUENOS AIRES,387,429,584,520,1104
06,06098,060980605,Berisso,BUENOS AIRES,387,411,599,615,1214
06,06098,060980802,Berisso,BUENOS AIRES,367,287,685,762,1447
06,06098,060980805,Berisso,BUENOS AIRES,164,229,231,206,437
06,06098,060980807,Berisso,BUENOS AIRES,187,266,241,207,448
06,06098,060980817,Berisso,BUENOS AIRES,378,376,671,704,1375
06,06098,060980408,Berisso,BUENOS AIRES,45,150,58,70,128
06,06098,060980107,Berisso,BUENOS AIRES,235,286,352,283,635
06,06098,060980111,Berisso,BUENOS AIRES,367,404,613,528,1141
06,06098,060980206,Berisso,BUENOS AIRES,304,349,471,391,862
06,06098,060980211,Berisso,BUENOS AIRES,226,257,434,424,858
06,06098,060980305,Berisso,BUENOS AIRES,260,267,406,394,800
06,06098,060980504,Berisso,BUENOS AIRES,290,304,500,440,940
06,06098,060980505,Berisso,BUENOS AIRES,328,348,630,630,1260
06,06098,060980510,Berisso,BUENOS AIRES,319,338,612,575,1187
06,06098,060980702,Berisso,BUENOS AIRES,596,624,1090,1040,2130
06,06098,060980810,Berisso,BUENOS AIRES,458,438,854,832,1686
06,06098,060980404,Berisso,BUENOS AIRES,101,131,153,152,305
06,06098,060980501,Berisso,BUENOS AIRES,290,306,565,570,1135
06,06098,060980609,Berisso,BUENOS AIRES,420,441,710,684,1394
06,06098,060980101,Berisso,BUENOS AIRES,296,315,441,411,852
06,06098,060980104,Berisso,BUENOS AIRES,295,343,419,373,792
06,06098,060980203,Berisso,BUENOS AIRES,268,299,413,373,786
06,06098,060980214,Berisso,BUENOS AIRES,236,230,407,418,825
06,06098,060980215,Berisso,BUENOS AIRES,246,254,415,418,833
06,06098,060980303,Berisso,BUENOS AIRES,363,375,565,523,1088
06,06098,060980308,Berisso,BUENOS AIRES,424,447,706,662,1368
06,06098,060980312,Berisso,BUENOS AIRES,168,173,250,213,463
06,06098,060980506,Berisso,BUENOS AIRES,263,278,477,468,945
06,06098,060980601,Berisso,BUENOS AIRES,264,307,385,355,740
06,06098,060980808,Berisso,BUENOS AIRES,243,271,295,289,584
06,06098,060980701,Berisso,BUENOS AIRES,251,262,407,433,840
06,06098,060980801,Berisso,BUENOS AIRES,336,348,568,574,1142
06,06098,060980806,Berisso,BUENOS AIRES,264,300,325,319,644
06,06098,060980704,Berisso,BUENOS AIRES,293,330,450,401,851
06,06098,060980201,Berisso,BUENOS AIRES,283,320,440,371,811
06,06098,060980205,Berisso,BUENOS AIRES,321,328,493,444,937
06,06098,060980307,Berisso,BUENOS AIRES,258,284,432,397,829
06,06098,060980508,Berisso,BUENOS AIRES,264,255,445,440,885
06,06098,060980502,Berisso,BUENOS AIRES,370,361,632,591,1223
06,06098,060980615,Berisso,BUENOS AIRES,254,261,437,396,833
06,06098,060980616,Berisso,BUENOS AIRES,309,340,552,560,1112
06,06098,060980809,Berisso,BUENOS AIRES,242,284,280,297,577
06,06098,060980707,Berisso,BUENOS AIRES,13,36,5,19,24
06,06105,061051002,Bolívar,BUENOS AIRES,52,126,67,75,142
06,06105,061051201,Bolívar,BUENOS AIRES,40,101,65,96,161
06,06105,061050107,Bolívar,BUENOS AIRES,302,347,412,340,752
06,06105,061050202,Bolívar,BUENOS AIRES,340,393,464,403,867
06,06105,061050403,Bolívar,BUENOS AIRES,79,126,101,110,211
06,06105,061050802,Bolívar,BUENOS AIRES,179,202,303,309,612
06,06105,061051106,Bolívar,BUENOS AIRES,100,136,137,128,265
06,06105,061051107,Bolívar,BUENOS AIRES,113,138,140,168,308
06,06105,061051411,Bolívar,BUENOS AIRES,165,197,304,290,594
06,06105,061050401,Bolívar,BUENOS AIRES,46,100,61,75,136
06,06105,061050806,Bolívar,BUENOS AIRES,31,58,56,65,121
06,06105,061051409,Bolívar,BUENOS AIRES,30,41,47,49,96
06,06105,061050205,Bolívar,BUENOS AIRES,304,371,417,304,721
06,06105,061050402,Bolívar,BUENOS AIRES,22,51,22,33,55
06,06105,061050805,Bolívar,BUENOS AIRES,70,135,107,102,209
06,06105,061050809,Bolívar,BUENOS AIRES,35,76,40,56,96
06,06105,061051101,Bolívar,BUENOS AIRES,59,120,64,578,642
06,06105,061050211,Bolívar,BUENOS AIRES,346,406,453,415,868
06,06105,061051102,Bolívar,BUENOS AIRES,163,218,214,197,411
06,06105,061051104,Bolívar,BUENOS AIRES,178,225,229,217,446
06,06105,061051303,Bolívar,BUENOS AIRES,233,289,384,358,742
06,06105,061050301,Bolívar,BUENOS AIRES,101,157,126,164,290
06,06105,061050602,Bolívar,BUENOS AIRES,37,78,36,57,93
06,06105,061050701,Bolívar,BUENOS AIRES,44,74,54,65,119
06,06105,061050804,Bolívar,BUENOS AIRES,4,7,10,6,16
06,06105,061051103,Bolívar,BUENOS AIRES,156,188,231,187,418
06,06105,061050209,Bolívar,BUENOS AIRES,207,253,295,222,517
06,06105,061050210,Bolívar,BUENOS AIRES,287,338,392,330,722
06,06105,061050105,Bolívar,BUENOS AIRES,241,327,299,275,574
06,06105,061050204,Bolívar,BUENOS AIRES,165,196,220,151,371
06,06105,061051407,Bolívar,BUENOS AIRES,283,290,468,441,909
06,06105,061050901,Bolívar,BUENOS AIRES,42,106,43,62,105
06,06105,061051304,Bolívar,BUENOS AIRES,79,135,108,118,226
06,06105,061050208,Bolívar,BUENOS AIRES,151,226,205,166,371
06,06105,061051408,Bolívar,BUENOS AIRES,79,119,133,138,271
06,06105,061050103,Bolívar,BUENOS AIRES,289,333,400,331,731
06,06105,061051301,Bolívar,BUENOS AIRES,176,226,229,217,446
06,06105,061051402,Bolívar,BUENOS AIRES,262,290,441,470,911
06,06105,061051412,Bolívar,BUENOS AIRES,198,221,278,263,541
06,06105,061050101,Bolívar,BUENOS AIRES,390,443,524,497,1021
06,06105,061050102,Bolívar,BUENOS AIRES,332,394,468,444,912
06,06105,061050109,Bolívar,BUENOS AIRES,250,310,369,270,639
06,06105,061050201,Bolívar,BUENOS AIRES,348,429,508,458,966
06,06105,061050203,Bolívar,BUENOS AIRES,325,386,471,392,863
06,06105,061050801,Bolívar,BUENOS AIRES,138,158,221,214,435
06,06105,061050803,Bolívar,BUENOS AIRES,273,310,463,468,931
06,06105,061051401,Bolívar,BUENOS AIRES,424,497,756,733,1489
06,06105,061051413,Bolívar,BUENOS AIRES,339,362,619,635,1254
06,06105,061051001,Bolívar,BUENOS AIRES,54,123,53,74,127
06,06105,061050108,Bolívar,BUENOS AIRES,331,401,453,419,872
06,06105,061050206,Bolívar,BUENOS AIRES,277,329,384,353,737
06,06105,061051105,Bolívar,BUENOS AIRES,322,396,411,384,795
06,06105,061051405,Bolívar,BUENOS AIRES,225,272,304,345,649
06,06105,061050501,Bolívar,BUENOS AIRES,40,86,45,54,99
06,06105,061051406,Bolívar,BUENOS AIRES,271,331,475,475,950
06,06105,061050104,Bolívar,BUENOS AIRES,378,485,509,415,924
06,06105,061050106,Bolívar,BUENOS AIRES,253,322,341,269,610
06,06105,061050207,Bolívar,BUENOS AIRES,365,418,507,428,935
06,06105,061051302,Bolívar,BUENOS AIRES,128,148,181,182,363
06,06105,061051403,Bolívar,BUENOS AIRES,182,218,300,286,586
06,06105,061051404,Bolívar,BUENOS AIRES,195,243,282,305,587
06,06105,061051410,Bolívar,BUENOS AIRES,314,366,476,467,943
06,06105,061050601,Bolívar,BUENOS AIRES,65,121,79,93,172
06,06105,061050807,Bolívar,BUENOS AIRES,38,68,52,53,105
06,06105,061050808,Bolívar,BUENOS AIRES,57,105,56,84,140
06,06119,061190206,Brandsen,BUENOS AIRES,17,41,23,18,41
06,06119,061190406,Brandsen,BUENOS AIRES,39,79,51,59,110
06,06119,061190307,Brandsen,BUENOS AIRES,284,306,464,428,892
06,06119,061190702,Brandsen,BUENOS AIRES,364,408,602,600,1202
06,06119,061191003,Brandsen,BUENOS AIRES,340,357,595,589,1184
06,06119,061191007,Brandsen,BUENOS AIRES,275,308,412,348,760
06,06119,061190310,Brandsen,BUENOS AIRES,64,95,79,100,179
06,06119,061190802,Brandsen,BUENOS AIRES,12,18,16,26,42
06,06119,061190303,Brandsen,BUENOS AIRES,368,406,549,486,1035
06,06119,061190304,Brandsen,BUENOS AIRES,447,483,749,718,1467
06,06119,061190707,Brandsen,BUENOS AIRES,238,272,336,317,653
06,06119,061191002,Brandsen,BUENOS AIRES,357,368,616,598,1214
06,06119,061191005,Brandsen,BUENOS AIRES,294,327,511,505,1016
06,06119,061191009,Brandsen,BUENOS AIRES,267,294,451,433,884
06,06119,061190202,Brandsen,BUENOS AIRES,18,21,20,30,50
06,06119,061190804,Brandsen,BUENOS AIRES,7,16,11,10,21
06,06119,061190501,Brandsen,BUENOS AIRES,73,335,116,121,237
06,06119,061190309,Brandsen,BUENOS AIRES,278,267,534,519,1053
06,06119,061190701,Brandsen,BUENOS AIRES,201,231,322,319,641
06,06119,061190801,Brandsen,BUENOS AIRES,82,120,108,107,215
06,06119,061190205,Brandsen,BUENOS AIRES,38,63,45,73,118
06,06119,061190705,Brandsen,BUENOS AIRES,17,70,33,27,60
06,06119,061190706,Brandsen,BUENOS AIRES,7,14,9,15,24
06,06119,061190103,Brandsen,BUENOS AIRES,12,25,16,19,35
06,06119,061190306,Brandsen,BUENOS AIRES,181,219,295,307,602
06,06119,061191004,Brandsen,BUENOS AIRES,224,250,393,433,826
06,06119,061191006,Brandsen,BUENOS AIRES,426,477,723,686,1409
06,06119,061190204,Brandsen,BUENOS AIRES,28,31,28,61,89
06,06119,061190405,Brandsen,BUENOS AIRES,26,42,28,40,68
06,06119,061190203,Brandsen,BUENOS AIRES,112,253,159,195,354
06,06119,061190502,Brandsen,BUENOS AIRES,30,77,42,63,105
06,06119,061190305,Brandsen,BUENOS AIRES,384,398,690,603,1293
06,06119,061190403,Brandsen,BUENOS AIRES,123,221,172,190,362
06,06119,061191001,Brandsen,BUENOS AIRES,80,125,119,131,250
06,06119,061191008,Brandsen,BUENOS AIRES,352,393,534,460,994
06,06119,061190201,Brandsen,BUENOS AIRES,10,17,11,19,30
06,06119,061190104,Brandsen,BUENOS AIRES,15,26,20,23,43
06,06119,061191010,Brandsen,BUENOS AIRES,34,57,42,59,101
06,06119,061190404,Brandsen,BUENOS AIRES,55,214,78,81,159
06,06119,061190904,Brandsen,BUENOS AIRES,98,134,130,142,272
06,06119,061190302,Brandsen,BUENOS AIRES,308,375,501,427,928
06,06119,061190901,Brandsen,BUENOS AIRES,67,94,88,95,183
06,06119,061190102,Brandsen,BUENOS AIRES,13,21,18,20,38
06,06119,061190602,Brandsen,BUENOS AIRES,19,33,23,32,55
06,06119,061190803,Brandsen,BUENOS AIRES,0,0,0,0,0
06,06119,061190902,Brandsen,BUENOS AIRES,21,48,33,37,70
06,06119,061190401,Brandsen,BUENOS AIRES,153,239,228,248,476
06,06119,061190308,Brandsen,BUENOS AIRES,321,389,546,581,1127
06,06119,061190408,Brandsen,BUENOS AIRES,111,159,196,202,398
06,06119,061190101,Brandsen,BUENOS AIRES,27,47,51,45,96
06,06119,061190402,Brandsen,BUENOS AIRES,12,25,18,17,35
06,06119,061190601,Brandsen,BUENOS AIRES,19,33,15,27,42
06,06119,061190703,Brandsen,BUENOS AIRES,23,42,24,35,59
06,06119,061190805,Brandsen,BUENOS AIRES,15,21,18,19,37
06,06119,061190806,Brandsen,BUENOS AIRES,20,28,32,36,68
06,06119,061190301,Brandsen,BUENOS AIRES,296,350,427,323,750
06,06119,061190407,Brandsen,BUENOS AIRES,321,387,481,472,953
06,06119,061190409,Brandsen,BUENOS AIRES,246,306,395,396,791
06,06119,061190603,Brandsen,BUENOS AIRES,26,38,40,45,85
06,06119,061190704,Brandsen,BUENOS AIRES,12,31,13,19,32
06,06119,061190903,Brandsen,BUENOS AIRES,17,26,24,30,54
06,06126,061260917,Campana,BUENOS AIRES,74,130,119,122,241
06,06126,061260919,Campana,BUENOS AIRES,81,122,126,138,264
06,06126,061260914,Campana,BUENOS AIRES,245,254,464,533,997
06,06126,061260103,Campana,BUENOS AIRES,299,295,469,446,915
06,06126,061260309,Campana,BUENOS AIRES,301,365,432,416,848
06,06126,061260513,Campana,BUENOS AIRES,257,274,444,461,905
06,06126,061260503,Campana,BUENOS AIRES,317,351,513,491,1004
06,06126,061260507,Campana,BUENOS AIRES,263,251,531,466,997
06,06126,061260509,Campana,BUENOS AIRES,502,486,1062,1043,2105
06,06126,061260515,Campana,BUENOS AIRES,321,350,625,603,1228
06,06126,061260704,Campana,BUENOS AIRES,298,305,582,622,1204
06,06126,061260910,Campana,BUENOS AIRES,420,428,795,790,1585
06,06126,061261005,Campana,BUENOS AIRES,42,88,27,72,99
06,06126,061261002,Campana,BUENOS AIRES,46,72,60,80,140
06,06126,061260602,Campana,BUENOS AIRES,17,32,14,23,37
06,06126,061260603,Campana,BUENOS AIRES,32,53,55,48,103
06,06126,061260606,Campana,BUENOS AIRES,116,237,181,205,386
06,06126,061260705,Campana,BUENOS AIRES,340,334,652,675,1327
06,06126,061260706,Campana,BUENOS AIRES,233,253,418,403,821
06,06126,061260111,Campana,BUENOS AIRES,253,320,369,336,705
06,06126,061260208,Campana,BUENOS AIRES,286,284,495,450,945
06,06126,061260307,Campana,BUENOS AIRES,319,379,455,428,883
06,06126,061260803,Campana,BUENOS AIRES,219,307,311,274,585
06,06126,061260807,Campana,BUENOS AIRES,269,328,458,401,859
06,06126,061260911,Campana,BUENOS AIRES,343,358,656,670,1326
06,06126,061260517,Campana,BUENOS AIRES,17,19,26,32,58
06,06126,061261003,Campana,BUENOS AIRES,203,364,285,335,620
06,06126,061260916,Campana,BUENOS AIRES,60,145,88,114,202
06,06126,061260601,Campana,BUENOS AIRES,117,238,163,182,345
06,06126,061260605,Campana,BUENOS AIRES,102,179,159,170,329
06,06126,061260108,Campana,BUENOS AIRES,265,267,407,378,785
06,06126,061260303,Campana,BUENOS AIRES,357,454,482,412,894
06,06126,061260104,Campana,BUENOS AIRES,231,230,352,337,689
06,06126,061260202,Campana,BUENOS AIRES,442,446,736,736,1472
06,06126,061260203,Campana,BUENOS AIRES,347,401,547,521,1068
06,06126,061260301,Campana,BUENOS AIRES,256,338,329,301,630
06,06126,061260308,Campana,BUENOS AIRES,223,272,316,286,602
06,06126,061260501,Campana,BUENOS AIRES,321,343,592,535,1127
06,06126,061260502,Campana,BUENOS AIRES,375,406,619,590,1209
06,06126,061260506,Campana,BUENOS AIRES,277,280,450,472,922
06,06126,061260710,Campana,BUENOS AIRES,295,314,535,508,1043
06,06126,061260903,Campana,BUENOS AIRES,278,234,495,523,1018
06,06126,061260405,Campana,BUENOS AIRES,28,33,41,41,82
06,06126,061260912,Campana,BUENOS AIRES,1,2,1,1,2
06,06126,061260906,Campana,BUENOS AIRES,86,147,155,1396,1551
06,06126,061260105,Campana,BUENOS AIRES,255,259,401,371,772
06,06126,061260106,Campana,BUENOS AIRES,261,268,427,353,780
06,06126,061260109,Campana,BUENOS AIRES,328,373,515,463,978
06,06126,061260110,Campana,BUENOS AIRES,286,344,443,406,849
06,06126,061260114,Campana,BUENOS AIRES,227,260,320,325,645
06,06126,061260306,Campana,BUENOS AIRES,245,319,381,332,713
06,06126,061260310,Campana,BUENOS AIRES,368,409,560,504,1064
06,06126,061260401,Campana,BUENOS AIRES,249,312,355,327,682
06,06126,061260510,Campana,BUENOS AIRES,237,247,440,439,879
06,06126,061260607,Campana,BUENOS AIRES,108,352,180,173,353
06,06126,061260806,Campana,BUENOS AIRES,260,327,371,340,711
06,06126,061260905,Campana,BUENOS AIRES,89,145,144,156,300
06,06126,061260516,Campana,BUENOS AIRES,349,405,645,720,1365
06,06126,061260907,Campana,BUENOS AIRES,492,549,895,889,1784
06,06126,061260107,Campana,BUENOS AIRES,250,274,363,367,730
06,06126,061260112,Campana,BUENOS AIRES,362,406,564,510,1074
06,06126,061260113,Campana,BUENOS AIRES,242,265,368,336,704
06,06126,061260305,Campana,BUENOS AIRES,191,216,257,237,494
06,06126,061260402,Campana,BUENOS AIRES,248,303,361,303,664
06,06126,061260407,Campana,BUENOS AIRES,492,497,930,966,1896
06,06126,061260604,Campana,BUENOS AIRES,108,204,181,178,359
06,06126,061260707,Campana,BUENOS AIRES,331,306,578,588,1166
06,06126,061260709,Campana,BUENOS AIRES,468,524,794,818,1612
06,06126,061261004,Campana,BUENOS AIRES,37,118,52,67,119
06,06126,061260403,Campana,BUENOS AIRES,17,20,26,30,56
06,06126,061260508,Campana,BUENOS AIRES,359,238,675,708,1383
06,06126,061260904,Campana,BUENOS AIRES,0,0,0,0,0
06,06126,061260102,Campana,BUENOS AIRES,465,442,647,594,1241
06,06126,061260205,Campana,BUENOS AIRES,374,420,553,536,1089
06,06126,061260206,Campana,BUENOS AIRES,238,219,404,386,790
06,06126,061260210,Campana,BUENOS AIRES,335,348,589,559,1148
06,06126,061260302,Campana,BUENOS AIRES,273,421,324,299,623
06,06126,061260304,Campana,BUENOS AIRES,167,239,218,198,416
06,06126,061260404,Campana,BUENOS AIRES,432,423,885,872,1757
06,06126,061260504,Campana,BUENOS AIRES,320,332,615,610,1225
06,06126,061260608,Campana,BUENOS AIRES,99,201,170,163,333
06,06126,061260701,Campana,BUENOS AIRES,357,331,683,686,1369
06,06126,061260703,Campana,BUENOS AIRES,454,434,808,773,1581
06,06126,061260805,Campana,BUENOS AIRES,319,372,454,422,876
06,06126,061260808,Campana,BUENOS AIRES,301,333,458,401,859
06,06126,061260809,Campana,BUENOS AIRES,246,293,357,284,641
06,06126,061260901,Campana,BUENOS AIRES,495,496,897,880,1777
06,06126,061260902,Campana,BUENOS AIRES,277,277,486,474,960
06,06126,061260908,Campana,BUENOS AIRES,308,328,468,459,927
06,06126,061260909,Campana,BUENOS AIRES,420,404,788,795,1583
06,06126,061260913,Campana,BUENOS AIRES,114,204,205,189,394
06,06126,061261001,Campana,BUENOS AIRES,93,148,133,181,314
06,06126,061260211,Campana,BUENOS AIRES,207,237,302,291,593
06,06126,061260101,Campana,BUENOS AIRES,282,293,408,346,754
06,06126,061260207,Campana,BUENOS AIRES,247,250,423,391,814
06,06126,061260209,Campana,BUENOS AIRES,382,402,611,599,1210
06,06126,061260505,Campana,BUENOS AIRES,377,346,679,658,1337
06,06126,061260511,Campana,BUENOS AIRES,243,255,453,462,915
06,06126,061260801,Campana,BUENOS AIRES,32,24,45,55,100
06,06126,061260918,Campana,BUENOS AIRES,189,198,399,404,803
06,06126,061260406,Campana,BUENOS AIRES,15,32,18,23,41
06,06126,061260512,Campana,BUENOS AIRES,394,391,785,781,1566
06,06126,061260915,Campana,BUENOS AIRES,165,170,340,340,680
06,06126,061260201,Campana,BUENOS AIRES,393,327,806,830,1636
06,06126,061260204,Campana,BUENOS AIRES,324,344,558,547,1105
06,06126,061260311,Campana,BUENOS AIRES,308,343,449,428,877
06,06126,061260514,Campana,BUENOS AIRES,246,268,456,484,940
06,06126,061260609,Campana,BUENOS AIRES,108,382,170,173,343
06,06126,061260702,Campana,BUENOS AIRES,296,287,545,495,1040
06,06126,061260708,Campana,BUENOS AIRES,328,312,588,612,1200
06,06126,061260802,Campana,BUENOS AIRES,182,239,264,278,542
06,06126,061260804,Campana,BUENOS AIRES,273,394,432,341,773
06,06134,061340109,Cañuelas,BUENOS AIRES,163,206,304,344,648
06,06134,061340104,Cañuelas,BUENOS AIRES,94,108,168,161,329
06,06134,061340106,Cañuelas,BUENOS AIRES,248,280,453,480,933
06,06134,061340204,Cañuelas,BUENOS AIRES,438,481,727,654,1381
06,06134,061340306,Cañuelas,BUENOS AIRES,308,370,456,376,832
06,06134,061340401,Cañuelas,BUENOS AIRES,43,46,66,89,155
06,06134,061340912,Cañuelas,BUENOS AIRES,44,53,46,92,138
06,06134,061340911,Cañuelas,BUENOS AIRES,272,295,497,512,1009
06,06134,061340103,Cañuelas,BUENOS AIRES,224,302,418,439,857
06,06134,061340304,Cañuelas,BUENOS AIRES,385,437,574,530,1104
06,06134,061340402,Cañuelas,BUENOS AIRES,185,261,322,347,669
06,06134,061340904,Cañuelas,BUENOS AIRES,141,146,247,255,502
06,06134,061341006,Cañuelas,BUENOS AIRES,297,343,471,395,866
06,06134,061341007,Cañuelas,BUENOS AIRES,193,205,321,308,629
06,06134,061341009,Cañuelas,BUENOS AIRES,502,529,885,862,1747
06,06134,061340205,Cañuelas,BUENOS AIRES,48,66,64,82,146
06,06134,061340701,Cañuelas,BUENOS AIRES,24,41,35,32,67
06,06134,061340602,Cañuelas,BUENOS AIRES,45,62,70,62,132
06,06134,061340203,Cañuelas,BUENOS AIRES,301,323,580,563,1143
06,06134,061340909,Cañuelas,BUENOS AIRES,409,393,721,695,1416
06,06134,061340309,Cañuelas,BUENOS AIRES,454,514,609,518,1127
06,06134,061341002,Cañuelas,BUENOS AIRES,381,533,714,698,1412
06,06134,061341008,Cañuelas,BUENOS AIRES,290,318,488,486,974
06,06134,061340702,Cañuelas,BUENOS AIRES,18,38,25,29,54
06,06134,061340405,Cañuelas,BUENOS AIRES,12,20,13,23,36
06,06134,061340804,Cañuelas,BUENOS AIRES,13,26,19,17,36
06,06134,061340206,Cañuelas,BUENOS AIRES,198,222,313,371,684
06,06134,061340901,Cañuelas,BUENOS AIRES,38,53,81,88,169
06,06134,061340201,Cañuelas,BUENOS AIRES,354,374,616,534,1150
06,06134,061340307,Cañuelas,BUENOS AIRES,474,486,755,727,1482
06,06134,061340906,Cañuelas,BUENOS AIRES,169,179,300,306,606
06,06134,061340802,Cañuelas,BUENOS AIRES,14,27,17,21,38
06,06134,061340803,Cañuelas,BUENOS AIRES,31,51,43,44,87
06,06134,061340902,Cañuelas,BUENOS AIRES,162,232,204,271,475
06,06134,061340305,Cañuelas,BUENOS AIRES,296,351,432,395,827
06,06134,061340914,Cañuelas,BUENOS AIRES,159,178,245,245,490
06,06134,061340801,Cañuelas,BUENOS AIRES,105,131,172,158,330
06,06134,061340207,Cañuelas,BUENOS AIRES,386,401,710,667,1377
06,06134,061340209,Cañuelas,BUENOS AIRES,306,327,592,594,1186
06,06134,061340302,Cañuelas,BUENOS AIRES,292,315,510,471,981
06,06134,061340903,Cañuelas,BUENOS AIRES,133,216,186,231,417
06,06134,061340404,Cañuelas,BUENOS AIRES,67,106,97,122,219
06,06134,061340501,Cañuelas,BUENOS AIRES,141,212,220,248,468
06,06134,061341001,Cañuelas,BUENOS AIRES,38,51,61,64,125
06,06134,061340105,Cañuelas,BUENOS AIRES,427,469,789,817,1606
06,06134,061340303,Cañuelas,BUENOS AIRES,257,268,411,390,801
06,06134,061340905,Cañuelas,BUENOS AIRES,130,155,257,254,511
06,06134,061340913,Cañuelas,BUENOS AIRES,270,304,406,381,787
06,06134,061341005,Cañuelas,BUENOS AIRES,299,318,558,526,1084
06,06134,061340502,Cañuelas,BUENOS AIRES,32,55,47,62,109
06,06134,061340112,Cañuelas,BUENOS AIRES,225,797,338,354,692
06,06134,061340202,Cañuelas,BUENOS AIRES,255,298,443,426,869
06,06134,061340908,Cañuelas,BUENOS AIRES,323,354,628,647,1275
06,06134,061340208,Cañuelas,BUENOS AIRES,321,340,570,573,1143
06,06134,061340907,Cañuelas,BUENOS AIRES,209,243,420,421,841
06,06134,061341004,Cañuelas,BUENOS AIRES,291,311,587,543,1130
06,06134,061340101,Cañuelas,BUENOS AIRES,288,322,500,557,1057
06,06134,061340108,Cañuelas,BUENOS AIRES,63,103,104,124,228
06,06134,061340102,Cañuelas,BUENOS AIRES,152,182,260,284,544
06,06134,061340107,Cañuelas,BUENOS AIRES,183,241,300,279,579
06,06134,061340110,Cañuelas,BUENOS AIRES,145,224,246,250,496
06,06134,061340111,Cañuelas,BUENOS AIRES,124,198,187,241,428
06,06134,061340114,Cañuelas,BUENOS AIRES,42,63,67,72,139
06,06134,061340301,Cañuelas,BUENOS AIRES,550,598,990,898,1888
06,06134,061340308,Cañuelas,BUENOS AIRES,463,495,745,738,1483
06,06134,061340406,Cañuelas,BUENOS AIRES,158,210,248,365,613
06,06134,061340910,Cañuelas,BUENOS AIRES,280,291,472,510,982
06,06134,061341003,Cañuelas,BUENOS AIRES,319,350,569,639,1208
06,06134,061341010,Cañuelas,BUENOS AIRES,405,433,689,628,1317
06,06134,061340113,Cañuelas,BUENOS AIRES,33,48,60,61,121
06,06134,061340403,Cañuelas,BUENOS AIRES,55,118,71,94,165
06,06134,061340601,Cañuelas,BUENOS AIRES,45,64,51,78,129
06,06134,061341011,Cañuelas,BUENOS AIRES,73,109,112,102,214
06,06203,062031601,Coronel Suárez,BUENOS AIRES,428,810,706,673,1379
06,06203,062030102,Coronel Suárez,BUENOS AIRES,256,320,333,265,598
06,06203,062030105,Coronel Suárez,BUENOS AIRES,269,297,369,301,670
06,06203,062030111,Coronel Suárez,BUENOS AIRES,293,318,434,456,890
06,06203,062030809,Coronel Suárez,BUENOS AIRES,333,367,471,415,886
06,06203,062030603,Coronel Suárez,BUENOS AIRES,5,13,6,8,14
06,06203,062030702,Coronel Suárez,BUENOS AIRES,5,14,5,5,10
06,06203,062030706,Coronel Suárez,BUENOS AIRES,3,7,3,4,7
06,06203,062031001,Coronel Suárez,BUENOS AIRES,1,9,1,1,2
06,06203,062031103,Coronel Suárez,BUENOS AIRES,0,12,0,0,0
06,06203,062031403,Coronel Suárez,BUENOS AIRES,7,11,6,11,17
06,06203,062031204,Coronel Suárez,BUENOS AIRES,12,14,10,18,28
06,06203,062031405,Coronel Suárez,BUENOS AIRES,22,31,22,38,60
06,06203,062031504,Coronel Suárez,BUENOS AIRES,8,19,8,9,17
06,06203,062030109,Coronel Suárez,BUENOS AIRES,220,256,293,259,552
06,06203,062030204,Coronel Suárez,BUENOS AIRES,181,217,270,274,544
06,06203,062030213,Coronel Suárez,BUENOS AIRES,127,144,166,159,325
06,06203,062030215,Coronel Suárez,BUENOS AIRES,195,231,275,250,525
06,06203,062030402,Coronel Suárez,BUENOS AIRES,5,21,4,7,11
06,06203,062030806,Coronel Suárez,BUENOS AIRES,392,440,524,487,1011
06,06203,062030801,Coronel Suárez,BUENOS AIRES,12,30,17,18,35
06,06203,062031406,Coronel Suárez,BUENOS AIRES,5,14,1,5,6
06,06203,062030301,Coronel Suárez,BUENOS AIRES,14,27,16,23,39
06,06203,062030303,Coronel Suárez,BUENOS AIRES,8,22,9,10,19
06,06203,062030902,Coronel Suárez,BUENOS AIRES,14,28,16,20,36
06,06203,062030906,Coronel Suárez,BUENOS AIRES,1,8,1,2,3
06,06203,062031104,Coronel Suárez,BUENOS AIRES,4,11,3,8,11
06,06203,062031302,Coronel Suárez,BUENOS AIRES,5,11,8,8,16
06,06203,062030501,Coronel Suárez,BUENOS AIRES,38,66,47,48,95
06,06203,062030104,Coronel Suárez,BUENOS AIRES,279,325,352,300,652
06,06203,062030113,Coronel Suárez,BUENOS AIRES,263,278,438,407,845
06,06203,062030212,Coronel Suárez,BUENOS AIRES,322,415,473,454,927
06,06203,062030401,Coronel Suárez,BUENOS AIRES,59,93,79,86,165
06,06203,062030803,Coronel Suárez,BUENOS AIRES,234,255,418,416,834
06,06203,062030810,Coronel Suárez,BUENOS AIRES,315,380,474,419,893
06,06203,062031605,Coronel Suárez,BUENOS AIRES,274,308,374,380,754
06,06203,062031606,Coronel Suárez,BUENOS AIRES,158,171,281,297,578
06,06203,062031613,Coronel Suárez,BUENOS AIRES,299,349,411,417,828
06,06203,062030903,Coronel Suárez,BUENOS AIRES,2,11,0,3,3
06,06203,062030207,Coronel Suárez,BUENOS AIRES,36,77,33,43,76
06,06203,062030209,Coronel Suárez,BUENOS AIRES,9,34,9,12,21
06,06203,062030506,Coronel Suárez,BUENOS AIRES,7,15,8,10,18
06,06203,062030701,Coronel Suárez,BUENOS AIRES,2,13,3,3,6
06,06203,062030704,Coronel Suárez,BUENOS AIRES,5,15,6,10,16
06,06203,062030708,Coronel Suárez,BUENOS AIRES,2,7,2,2,4
06,06203,062031004,Coronel Suárez,BUENOS AIRES,6,18,5,11,16
06,06203,062030107,Coronel Suárez,BUENOS AIRES,228,288,285,241,526
06,06203,062030108,Coronel Suárez,BUENOS AIRES,294,315,418,408,826
06,06203,062030103,Coronel Suárez,BUENOS AIRES,293,390,397,303,700
06,06203,062030201,Coronel Suárez,BUENOS AIRES,182,202,227,214,441
06,06203,062030210,Coronel Suárez,BUENOS AIRES,248,284,352,357,709
06,06203,062030211,Coronel Suárez,BUENOS AIRES,147,168,205,184,389
06,06203,062030805,Coronel Suárez,BUENOS AIRES,424,474,589,501,1090
06,06203,062030808,Coronel Suárez,BUENOS AIRES,483,553,759,724,1483
06,06203,062031604,Coronel Suárez,BUENOS AIRES,425,459,662,645,1307
06,06203,062031609,Coronel Suárez,BUENOS AIRES,405,465,610,590,1200
06,06203,062030601,Coronel Suárez,BUENOS AIRES,9,19,7,14,21
06,06203,062030208,Coronel Suárez,BUENOS AIRES,10,43,12,13,25
06,06203,062030306,Coronel Suárez,BUENOS AIRES,9,17,10,14,24
06,06203,062030405,Coronel Suárez,BUENOS AIRES,6,13,5,9,14
06,06203,062030407,Coronel Suárez,BUENOS AIRES,5,15,7,11,18
06,06203,062030505,Coronel Suárez,BUENOS AIRES,7,23,5,12,17
06,06203,062030507,Coronel Suárez,BUENOS AIRES,3,9,4,2,6
06,06203,062030907,Coronel Suárez,BUENOS AIRES,5,6,4,5,9
06,06203,062031202,Coronel Suárez,BUENOS AIRES,6,15,6,15,21
06,06203,062030110,Coronel Suárez,BUENOS AIRES,317,337,482,450,932
06,06203,062030112,Coronel Suárez,BUENOS AIRES,308,342,461,461,922
06,06203,062030807,Coronel Suárez,BUENOS AIRES,353,403,490,429,919
06,06203,062031301,Coronel Suárez,BUENOS AIRES,7,20,9,11,20
06,06203,062031603,Coronel Suárez,BUENOS AIRES,255,350,446,408,854
06,06203,062031610,Coronel Suárez,BUENOS AIRES,320,371,502,532,1034
06,06203,062031404,Coronel Suárez,BUENOS AIRES,5,12,7,7,14
06,06203,062030305,Coronel Suárez,BUENOS AIRES,9,26,17,13,30
06,06203,062030404,Coronel Suárez,BUENOS AIRES,5,18,6,6,12
06,06203,062030605,Coronel Suárez,BUENOS AIRES,5,11,1,10,11
06,06203,062031005,Coronel Suárez,BUENOS AIRES,6,20,6,12,18
06,06203,062031102,Coronel Suárez,BUENOS AIRES,12,20,16,28,44
06,06203,062031105,Coronel Suárez,BUENOS AIRES,3,11,2,6,8
06,06203,062031402,Coronel Suárez,BUENOS AIRES,11,22,17,18,35
06,06203,062031303,Coronel Suárez,BUENOS AIRES,7,11,9,11,20
06,06203,062030406,Coronel Suárez,BUENOS AIRES,6,13,6,9,15
06,06203,062031611,Coronel Suárez,BUENOS AIRES,105,129,178,171,349
06,06203,062030101,Coronel Suárez,BUENOS AIRES,339,387,547,451,998
06,06203,062030106,Coronel Suárez,BUENOS AIRES,280,321,408,364,772
06,06203,062031602,Coronel Suárez,BUENOS AIRES,292,310,485,508,993
06,06203,062030206,Coronel Suárez,BUENOS AIRES,11,28,14,21,35
06,06203,062030403,Coronel Suárez,BUENOS AIRES,10,29,9,13,22
06,06203,062030408,Coronel Suárez,BUENOS AIRES,12,18,10,17,27
06,06203,062030502,Coronel Suárez,BUENOS AIRES,3,17,4,5,9
06,06203,062030703,Coronel Suárez,BUENOS AIRES,5,6,4,8,12
06,06203,062030705,Coronel Suárez,BUENOS AIRES,4,9,4,5,9
06,06203,062030802,Coronel Suárez,BUENOS AIRES,28,45,37,42,79
06,06203,062030905,Coronel Suárez,BUENOS AIRES,3,10,0,4,4
06,06203,062031002,Coronel Suárez,BUENOS AIRES,11,31,16,21,37
06,06203,062031203,Coronel Suárez,BUENOS AIRES,12,24,13,14,27
06,06203,062031305,Coronel Suárez,BUENOS AIRES,13,29,12,18,30
06,06203,062031307,Coronel Suárez,BUENOS AIRES,11,23,8,17,25
06,06203,062031308,Coronel Suárez,BUENOS AIRES,10,14,2,11,13
06,06203,062031503,Coronel Suárez,BUENOS AIRES,11,7,13,19,32
06,06203,062030203,Coronel Suárez,BUENOS AIRES,201,234,263,253,516
06,06203,062030602,Coronel Suárez,BUENOS AIRES,8,14,4,9,13
06,06203,062030205,Coronel Suárez,BUENOS AIRES,18,29,16,24,40
06,06203,062030302,Coronel Suárez,BUENOS AIRES,13,22,17,16,33
06,06203,062030604,Coronel Suárez,BUENOS AIRES,12,16,17,22,39
06,06203,062030709,Coronel Suárez,BUENOS AIRES,2,9,2,2,4
06,06203,062030710,Coronel Suárez,BUENOS AIRES,9,14,8,14,22
06,06203,062030811,Coronel Suárez,BUENOS AIRES,94,190,110,135,245
06,06203,062030812,Coronel Suárez,BUENOS AIRES,167,205,254,261,515
06,06203,062031003,Coronel Suárez,BUENOS AIRES,12,23,8,15,23
06,06203,062031201,Coronel Suárez,BUENOS AIRES,7,27,8,9,17
06,06203,062031306,Coronel Suárez,BUENOS AIRES,9,18,10,16,26
06,06203,062031407,Coronel Suárez,BUENOS AIRES,3,4,3,3,6
06,06203,062031408,Coronel Suárez,BUENOS AIRES,0,55,0,0,0
06,06203,062030804,Coronel Suárez,BUENOS AIRES,356,368,583,520,1103
06,06203,062030202,Coronel Suárez,BUENOS AIRES,226,274,309,273,582
06,06203,062030214,Coronel Suárez,BUENOS AIRES,26,40,27,35,62
06,06203,062031401,Coronel Suárez,BUENOS AIRES,152,316,215,219,434
06,06203,062031607,Coronel Suárez,BUENOS AIRES,322,382,545,488,1033
06,06203,062031608,Coronel Suárez,BUENOS AIRES,306,348,466,444,910
06,06203,062031612,Coronel Suárez,BUENOS AIRES,274,336,359,371,730
06,06203,062031304,Coronel Suárez,BUENOS AIRES,12,25,22,19,41
06,06203,062030304,Coronel Suárez,BUENOS AIRES,14,28,13,20,33
06,06203,062030503,Coronel Suárez,BUENOS AIRES,10,16,13,14,27
06,06203,062030504,Coronel Suárez,BUENOS AIRES,14,26,18,22,40
06,06203,062030707,Coronel Suárez,BUENOS AIRES,4,20,2,8,10
06,06203,062030711,Coronel Suárez,BUENOS AIRES,5,15,5,8,13
06,06203,062030901,Coronel Suárez,BUENOS AIRES,9,22,9,10,19
06,06203,062030904,Coronel Suárez,BUENOS AIRES,4,10,8,10,18
06,06203,062031101,Coronel Suárez,BUENOS AIRES,12,14,11,14,25
06,06203,062031106,Coronel Suárez,BUENOS AIRES,3,2,4,12,16
06,06203,062031205,Coronel Suárez,BUENOS AIRES,13,21,10,17,27
06,06203,062031501,Coronel Suárez,BUENOS AIRES,4,7,4,5,9
06,06203,062031502,Coronel Suárez,BUENOS AIRES,17,34,30,30,60
06,06210,062100501,Chacabuco,BUENOS AIRES,123,165,159,190,349
06,06210,062100808,Chacabuco,BUENOS AIRES,818,730,1456,1460,2916
06,06210,062100810,Chacabuco,BUENOS AIRES,352,395,642,682,1324
06,06210,062100118,Chacabuco,BUENOS AIRES,274,311,404,383,787
06,06210,062100202,Chacabuco,BUENOS AIRES,392,436,626,579,1205
06,06210,062100604,Chacabuco,BUENOS AIRES,51,63,80,92,172
06,06210,062100607,Chacabuco,BUENOS AIRES,126,147,180,163,343
06,06210,062100602,Chacabuco,BUENOS AIRES,20,34,18,28,46
06,06210,062100807,Chacabuco,BUENOS AIRES,76,98,117,140,257
06,06210,062101001,Chacabuco,BUENOS AIRES,49,86,65,85,150
06,06210,062100108,Chacabuco,BUENOS AIRES,224,244,311,295,606
06,06210,062100105,Chacabuco,BUENOS AIRES,178,193,247,223,470
06,06210,062100109,Chacabuco,BUENOS AIRES,174,219,247,200,447
06,06210,062100112,Chacabuco,BUENOS AIRES,161,187,228,206,434
06,06210,062100114,Chacabuco,BUENOS AIRES,150,181,229,243,472
06,06210,062100613,Chacabuco,BUENOS AIRES,68,91,84,100,184
06,06210,062101301,Chacabuco,BUENOS AIRES,355,402,470,393,863
06,06210,062101309,Chacabuco,BUENOS AIRES,332,359,549,528,1077
06,06210,062100601,Chacabuco,BUENOS AIRES,25,48,41,50,91
06,06210,062100801,Chacabuco,BUENOS AIRES,119,151,177,213,390
06,06210,062100107,Chacabuco,BUENOS AIRES,279,295,455,412,867
06,06210,062100110,Chacabuco,BUENOS AIRES,168,224,246,177,423
06,06210,062100115,Chacabuco,BUENOS AIRES,280,305,474,411,885
06,06210,062100201,Chacabuco,BUENOS AIRES,279,356,448,459,907
06,06210,062100206,Chacabuco,BUENOS AIRES,198,215,299,271,570
06,06210,062100606,Chacabuco,BUENOS AIRES,197,263,291,242,533
06,06210,062101302,Chacabuco,BUENOS AIRES,309,340,454,441,895
06,06210,062100401,Chacabuco,BUENOS AIRES,52,94,59,102,161
06,06210,062100811,Chacabuco,BUENOS AIRES,87,122,136,154,290
06,06210,062100104,Chacabuco,BUENOS AIRES,168,204,241,203,444
06,06210,062100113,Chacabuco,BUENOS AIRES,203,242,293,296,589
06,06210,062100121,Chacabuco,BUENOS AIRES,271,293,420,393,813
06,06210,062100207,Chacabuco,BUENOS AIRES,440,471,677,624,1301
06,06210,062100603,Chacabuco,BUENOS AIRES,165,196,249,261,510
06,06210,062100608,Chacabuco,BUENOS AIRES,94,122,139,141,280
06,06210,062100901,Chacabuco,BUENOS AIRES,222,258,313,281,594
06,06210,062101303,Chacabuco,BUENOS AIRES,187,194,289,226,515
06,06210,062101306,Chacabuco,BUENOS AIRES,404,425,561,508,1069
06,06210,062100610,Chacabuco,BUENOS AIRES,21,39,21,28,49
06,06210,062100102,Chacabuco,BUENOS AIRES,187,211,267,269,536
06,06210,062100106,Chacabuco,BUENOS AIRES,271,308,374,345,719
06,06210,062100111,Chacabuco,BUENOS AIRES,272,352,376,313,689
06,06210,062100117,Chacabuco,BUENOS AIRES,315,350,438,361,799
06,06210,062100120,Chacabuco,BUENOS AIRES,306,329,476,429,905
06,06210,062100612,Chacabuco,BUENOS AIRES,134,202,171,167,338
06,06210,062101307,Chacabuco,BUENOS AIRES,282,305,454,401,855
06,06210,062100609,Chacabuco,BUENOS AIRES,14,23,18,18,36
06,06210,062100208,Chacabuco,BUENOS AIRES,289,345,406,333,739
06,06210,062100101,Chacabuco,BUENOS AIRES,197,209,293,288,581
06,06210,062100103,Chacabuco,BUENOS AIRES,164,188,239,217,456
06,06210,062100119,Chacabuco,BUENOS AIRES,298,317,513,468,981
06,06210,062100203,Chacabuco,BUENOS AIRES,417,417,636,589,1225
06,06210,062100804,Chacabuco,BUENOS AIRES,389,323,632,601,1233
06,06210,062100902,Chacabuco,BUENOS AIRES,241,282,315,297,612
06,06210,062101305,Chacabuco,BUENOS AIRES,239,261,439,373,812
06,06210,062100301,Chacabuco,BUENOS AIRES,70,157,84,118,202
06,06210,062101101,Chacabuco,BUENOS AIRES,17,42,18,29,47
06,06210,062100803,Chacabuco,BUENOS AIRES,314,394,531,545,1076
06,06210,062100204,Chacabuco,BUENOS AIRES,348,394,489,442,931
06,06210,062100209,Chacabuco,BUENOS AIRES,264,330,363,271,634
06,06210,062100210,Chacabuco,BUENOS AIRES,416,453,592,547,1139
06,06210,062100611,Chacabuco,BUENOS AIRES,64,98,80,87,167
06,06210,062101304,Chacabuco,BUENOS AIRES,344,380,480,394,874
06,06210,062100701,Chacabuco,BUENOS AIRES,64,106,93,105,198
06,06210,062100802,Chacabuco,BUENOS AIRES,265,291,406,409,815
06,06210,062100805,Chacabuco,BUENOS AIRES,534,633,930,977,1907
06,06210,062100116,Chacabuco,BUENOS AIRES,303,362,434,361,795
06,06210,062100205,Chacabuco,BUENOS AIRES,212,254,296,235,531
06,06210,062100605,Chacabuco,BUENOS AIRES,117,141,166,119,285
06,06210,062100809,Chacabuco,BUENOS AIRES,285,306,434,483,917
06,06210,062101308,Chacabuco,BUENOS AIRES,419,468,651,606,1257
06,06210,062100806,Chacabuco,BUENOS AIRES,208,244,331,390,721
06,06210,062100903,Chacabuco,BUENOS AIRES,65,120,89,99,188
06,06210,062101201,Chacabuco,BUENOS AIRES,81,136,104,121,225
06,06231,062310803,Daireaux,BUENOS AIRES,229,261,318,330,648
06,06231,062310302,Daireaux,BUENOS AIRES,25,33,43,37,80
06,06231,062310102,Daireaux,BUENOS AIRES,167,193,251,235,486
06,06231,062311212,Daireaux,BUENOS AIRES,176,196,289,308,597
06,06231,062310203,Daireaux,BUENOS AIRES,13,24,13,17,30
06,06231,062310702,Daireaux,BUENOS AIRES,10,17,12,15,27
06,06231,062311201,Daireaux,BUENOS AIRES,315,304,579,563,1142
06,06231,062310603,Daireaux,BUENOS AIRES,33,42,37,50,87
06,06231,062311203,Daireaux,BUENOS AIRES,223,248,320,316,636
06,06231,062311205,Daireaux,BUENOS AIRES,297,354,409,331,740
06,06231,062311211,Daireaux,BUENOS AIRES,356,393,623,648,1271
06,06231,062310103,Daireaux,BUENOS AIRES,16,30,17,25,42
06,06231,062310106,Daireaux,BUENOS AIRES,29,74,31,43,74
06,06231,062310304,Daireaux,BUENOS AIRES,8,14,12,10,22
06,06231,062310605,Daireaux,BUENOS AIRES,7,10,9,14,23
06,06231,062310801,Daireaux,BUENOS AIRES,14,44,15,19,34
06,06231,062310903,Daireaux,BUENOS AIRES,15,24,14,28,42
06,06231,062311002,Daireaux,BUENOS AIRES,3,14,1,3,4
06,06231,062310101,Daireaux,BUENOS AIRES,227,270,352,328,680
06,06231,062310107,Daireaux,BUENOS AIRES,190,233,264,279,543
06,06231,062311206,Daireaux,BUENOS AIRES,197,212,253,222,475
06,06231,062311208,Daireaux,BUENOS AIRES,398,435,643,647,1290
06,06231,062311213,Daireaux,BUENOS AIRES,180,184,322,356,678
06,06231,062310405,Daireaux,BUENOS AIRES,7,16,10,13,23
06,06231,062310105,Daireaux,BUENOS AIRES,22,36,34,39,73
06,06231,062310201,Daireaux,BUENOS AIRES,22,40,22,28,50
06,06231,062310403,Daireaux,BUENOS AIRES,9,17,7,12,19
06,06231,062310707,Daireaux,BUENOS AIRES,4,26,4,7,11
06,06231,062311004,Daireaux,BUENOS AIRES,1,9,0,2,2
06,06231,062311005,Daireaux,BUENOS AIRES,56,72,107,124,231
06,06231,062310602,Daireaux,BUENOS AIRES,8,11,16,14,30
06,06231,062310902,Daireaux,BUENOS AIRES,37,62,42,64,106
06,06231,062311214,Daireaux,BUENOS AIRES,39,51,60,60,120
06,06231,062311210,Daireaux,BUENOS AIRES,289,335,415,377,792
06,06231,062311207,Daireaux,BUENOS AIRES,332,362,492,458,950
06,06231,062310303,Daireaux,BUENOS AIRES,22,25,40,44,84
06,06231,062310704,Daireaux,BUENOS AIRES,16,23,32,31,63
06,06231,062310705,Daireaux,BUENOS AIRES,1,15,1,3,4
06,06231,062311202,Daireaux,BUENOS AIRES,297,314,529,502,1031
06,06231,062311209,Daireaux,BUENOS AIRES,241,273,326,296,622
06,06231,062310401,Daireaux,BUENOS AIRES,2,11,1,3,4
06,06231,062310301,Daireaux,BUENOS AIRES,11,14,13,17,30
06,06231,062310404,Daireaux,BUENOS AIRES,13,27,23,25,48
06,06231,062310501,Daireaux,BUENOS AIRES,12,20,15,22,37
06,06231,062310604,Daireaux,BUENOS AIRES,5,12,7,11,18
06,06231,062310703,Daireaux,BUENOS AIRES,10,10,11,20,31
06,06231,062310706,Daireaux,BUENOS AIRES,5,15,1,7,8
06,06231,062311003,Daireaux,BUENOS AIRES,11,11,11,18,29
06,06231,062310606,Daireaux,BUENOS AIRES,23,45,27,41,68
06,06231,062310701,Daireaux,BUENOS AIRES,14,20,23,17,40
06,06231,062310805,Daireaux,BUENOS AIRES,6,21,9,12,21
06,06231,062311101,Daireaux,BUENOS AIRES,2,6,5,1,6
06,06231,062311001,Daireaux,BUENOS AIRES,361,417,665,651,1316
06,06231,062310104,Daireaux,BUENOS AIRES,80,99,141,129,270
06,06231,062311204,Daireaux,BUENOS AIRES,324,369,482,421,903
06,06231,062310202,Daireaux,BUENOS AIRES,21,29,32,30,62
06,06231,062310204,Daireaux,BUENOS AIRES,8,28,10,16,26
06,06231,062310402,Daireaux,BUENOS AIRES,7,13,7,11,18
06,06231,062310502,Daireaux,BUENOS AIRES,10,26,19,17,36
06,06231,062310601,Daireaux,BUENOS AIRES,3,15,1,4,5
06,06231,062310802,Daireaux,BUENOS AIRES,2,15,1,2,3
06,06231,062310804,Daireaux,BUENOS AIRES,2,11,2,3,5
06,06231,062310901,Daireaux,BUENOS AIRES,16,41,17,26,43
06,06448,064480101,Laprida,BUENOS AIRES,112,159,146,163,309
06,06448,064480202,Laprida,BUENOS AIRES,6,14,3,7,10
06,06448,064480403,Laprida,BUENOS AIRES,0,18,0,0,0
06,06448,064480502,Laprida,BUENOS AIRES,8,11,12,18,30
06,06448,064480801,Laprida,BUENOS AIRES,5,15,5,9,14
06,06448,064481206,Laprida,BUENOS AIRES,4,13,2,7,9
06,06448,064480612,Laprida,BUENOS AIRES,32,38,43,29,72
06,06448,064480603,Laprida,BUENOS AIRES,250,261,356,366,722
06,06448,064480604,Laprida,BUENOS AIRES,255,299,336,262,598
06,06448,064480614,Laprida,BUENOS AIRES,246,274,424,398,822
06,06448,064480103,Laprida,BUENOS AIRES,14,24,11,17,28
06,06448,064480401,Laprida,BUENOS AIRES,9,7,10,15,25
06,06448,064480613,Laprida,BUENOS AIRES,2,10,5,4,9
06,06448,064481102,Laprida,BUENOS AIRES,10,13,12,22,34
06,06448,064481103,Laprida,BUENOS AIRES,6,13,3,8,11
06,06448,064481202,Laprida,BUENOS AIRES,5,16,6,6,12
06,06448,064481203,Laprida,BUENOS AIRES,8,20,7,12,19
06,06448,064481205,Laprida,BUENOS AIRES,16,28,19,25,44
06,06448,064480802,Laprida,BUENOS AIRES,8,12,12,13,25
06,06448,064480609,Laprida,BUENOS AIRES,230,278,402,360,762
06,06448,064480607,Laprida,BUENOS AIRES,285,340,443,358,801
06,06448,064480102,Laprida,BUENOS AIRES,8,14,8,13,21
06,06448,064480201,Laprida,BUENOS AIRES,10,16,16,19,35
06,06448,064480501,Laprida,BUENOS AIRES,11,14,24,25,49
06,06448,064480503,Laprida,BUENOS AIRES,4,14,5,7,12
06,06448,064480702,Laprida,BUENOS AIRES,1,13,3,2,5
06,06448,064480703,Laprida,BUENOS AIRES,5,13,7,8,15
06,06448,064480904,Laprida,BUENOS AIRES,6,9,7,13,20
06,06448,064481201,Laprida,BUENOS AIRES,7,13,6,9,15
06,06448,064480601,Laprida,BUENOS AIRES,464,554,704,636,1340
06,06448,064480602,Laprida,BUENOS AIRES,357,402,543,469,1012
06,06448,064480611,Laprida,BUENOS AIRES,6,20,11,12,23
06,06448,064480203,Laprida,BUENOS AIRES,16,19,10,28,38
06,06448,064480302,Laprida,BUENOS AIRES,5,10,4,11,15
06,06448,064480701,Laprida,BUENOS AIRES,10,15,15,19,34
06,06448,064480902,Laprida,BUENOS AIRES,8,9,3,10,13
06,06448,064480903,Laprida,BUENOS AIRES,3,5,4,7,11
06,06448,064481002,Laprida,BUENOS AIRES,7,10,8,13,21
06,06448,064481004,Laprida,BUENOS AIRES,3,10,3,3,6
06,06448,064480605,Laprida,BUENOS AIRES,201,239,278,270,548
06,06448,064481001,Laprida,BUENOS AIRES,6,9,13,10,23
06,06448,064480301,Laprida,BUENOS AIRES,7,13,9,9,18
06,06448,064480303,Laprida,BUENOS AIRES,5,12,5,8,13
06,06448,064480402,Laprida,BUENOS AIRES,4,5,6,8,14
06,06448,064480803,Laprida,BUENOS AIRES,8,24,13,15,28
06,06448,064481003,Laprida,BUENOS AIRES,3,13,4,4,8
06,06448,064480608,Laprida,BUENOS AIRES,385,441,635,578,1213
06,06448,064480901,Laprida,BUENOS AIRES,5,6,8,8,16
06,06448,064481204,Laprida,BUENOS AIRES,4,11,8,7,15
06,06448,064480610,Laprida,BUENOS AIRES,63,89,84,107,191
06,06448,064480606,Laprida,BUENOS AIRES,333,401,560,505,1065
06,06448,064481101,Laprida,BUENOS AIRES,6,20,9,8,17
06,06224,062240908,Chivilcoy,BUENOS AIRES,281,317,540,475,1015
06,06224,062241301,Chivilcoy,BUENOS AIRES,71,112,93,124,217
06,06224,062240105,Chivilcoy,BUENOS AIRES,335,368,502,473,975
06,06224,062240107,Chivilcoy,BUENOS AIRES,320,368,441,384,825
06,06224,062240115,Chivilcoy,BUENOS AIRES,178,201,318,335,653
06,06224,062240116,Chivilcoy,BUENOS AIRES,173,205,305,267,572
06,06224,062240302,Chivilcoy,BUENOS AIRES,304,337,479,478,957
06,06224,062241201,Chivilcoy,BUENOS AIRES,47,92,62,56,118
06,06224,062242206,Chivilcoy,BUENOS AIRES,354,416,514,395,909
06,06224,062242209,Chivilcoy,BUENOS AIRES,219,238,330,324,654
06,06224,062242210,Chivilcoy,BUENOS AIRES,227,261,452,409,861
06,06224,062241702,Chivilcoy,BUENOS AIRES,17,34,18,32,50
06,06224,062240909,Chivilcoy,BUENOS AIRES,83,108,130,149,279
06,06224,062241401,Chivilcoy,BUENOS AIRES,12,22,14,21,35
06,06224,062241402,Chivilcoy,BUENOS AIRES,24,41,29,37,66
06,06224,062241601,Chivilcoy,BUENOS AIRES,9,33,11,12,23
06,06224,062242007,Chivilcoy,BUENOS AIRES,11,27,13,23,36
06,06224,062240110,Chivilcoy,BUENOS AIRES,294,396,409,353,762
06,06224,062240201,Chivilcoy,BUENOS AIRES,222,263,349,334,683
06,06224,062240202,Chivilcoy,BUENOS AIRES,248,271,396,375,771
06,06224,062240204,Chivilcoy,BUENOS AIRES,408,448,652,672,1324
06,06224,062240214,Chivilcoy,BUENOS AIRES,238,263,388,371,759
06,06224,062240305,Chivilcoy,BUENOS AIRES,214,247,329,302,631
06,06224,062240306,Chivilcoy,BUENOS AIRES,237,266,369,347,716
06,06224,062240401,Chivilcoy,BUENOS AIRES,248,236,464,479,943
06,06224,062240403,Chivilcoy,BUENOS AIRES,383,438,553,528,1081
06,06224,062240412,Chivilcoy,BUENOS AIRES,150,197,246,246,492
06,06224,062240416,Chivilcoy,BUENOS AIRES,168,201,257,223,480
06,06224,062240505,Chivilcoy,BUENOS AIRES,16,23,25,29,54
06,06224,062240915,Chivilcoy,BUENOS AIRES,176,211,289,258,547
06,06224,062241901,Chivilcoy,BUENOS AIRES,48,93,86,80,166
06,06224,062242205,Chivilcoy,BUENOS AIRES,296,345,379,357,736
06,06224,062242208,Chivilcoy,BUENOS AIRES,278,336,397,320,717
06,06224,062240701,Chivilcoy,BUENOS AIRES,2,12,2,5,7
06,06224,062240702,Chivilcoy,BUENOS AIRES,14,23,19,18,37
06,06224,062240906,Chivilcoy,BUENOS AIRES,70,100,99,118,217
06,06224,062241303,Chivilcoy,BUENOS AIRES,13,26,18,22,40
06,06224,062241903,Chivilcoy,BUENOS AIRES,14,44,20,27,47
06,06224,062242006,Chivilcoy,BUENOS AIRES,6,24,10,11,21
06,06224,062240111,Chivilcoy,BUENOS AIRES,361,417,491,394,885
06,06224,062240101,Chivilcoy,BUENOS AIRES,166,200,305,287,592
06,06224,062240102,Chivilcoy,BUENOS AIRES,311,353,450,369,819
06,06224,062240109,Chivilcoy,BUENOS AIRES,326,397,454,378,832
06,06224,062240208,Chivilcoy,BUENOS AIRES,366,434,562,471,1033
06,06224,062240301,Chivilcoy,BUENOS AIRES,277,310,403,369,772
06,06224,062240303,Chivilcoy,BUENOS AIRES,310,345,422,400,822
06,06224,062240308,Chivilcoy,BUENOS AIRES,303,261,584,557,1141
06,06224,062240406,Chivilcoy,BUENOS AIRES,282,344,410,292,702
06,06224,062240409,Chivilcoy,BUENOS AIRES,369,436,575,489,1064
06,06224,062240410,Chivilcoy,BUENOS AIRES,235,264,331,345,676
06,06224,062240413,Chivilcoy,BUENOS AIRES,336,388,461,343,804
06,06224,062240415,Chivilcoy,BUENOS AIRES,134,146,233,213,446
06,06224,062240501,Chivilcoy,BUENOS AIRES,12,19,15,18,33
06,06224,062240901,Chivilcoy,BUENOS AIRES,140,217,216,216,432
06,06224,062240902,Chivilcoy,BUENOS AIRES,287,330,436,428,864
06,06224,062240911,Chivilcoy,BUENOS AIRES,165,192,270,278,548
06,06224,062242202,Chivilcoy,BUENOS AIRES,261,320,335,280,615
06,06224,062240905,Chivilcoy,BUENOS AIRES,10,15,12,16,28
06,06224,062241902,Chivilcoy,BUENOS AIRES,9,15,12,16,28
06,06224,062240602,Chivilcoy,BUENOS AIRES,29,33,36,53,89
06,06224,062240801,Chivilcoy,BUENOS AIRES,10,26,17,16,33
06,06224,062241203,Chivilcoy,BUENOS AIRES,22,48,28,32,60
06,06224,062241403,Chivilcoy,BUENOS AIRES,51,86,77,73,150
06,06224,062240113,Chivilcoy,BUENOS AIRES,282,295,472,439,911
06,06224,062240104,Chivilcoy,BUENOS AIRES,250,274,356,353,709
06,06224,062240309,Chivilcoy,BUENOS AIRES,167,191,273,263,536
06,06224,062240404,Chivilcoy,BUENOS AIRES,286,344,395,318,713
06,06224,062240407,Chivilcoy,BUENOS AIRES,321,370,467,365,832
06,06224,062240414,Chivilcoy,BUENOS AIRES,155,178,282,237,519
06,06224,062240903,Chivilcoy,BUENOS AIRES,85,206,136,126,262
06,06224,062240912,Chivilcoy,BUENOS AIRES,144,249,228,216,444
06,06224,062240703,Chivilcoy,BUENOS AIRES,15,28,16,21,37
06,06224,062241001,Chivilcoy,BUENOS AIRES,9,22,16,14,30
06,06224,062242005,Chivilcoy,BUENOS AIRES,18,37,24,38,62
06,06224,062242103,Chivilcoy,BUENOS AIRES,7,19,10,13,23
06,06224,062240207,Chivilcoy,BUENOS AIRES,300,367,442,388,830
06,06224,062240411,Chivilcoy,BUENOS AIRES,317,367,465,432,897
06,06224,062240913,Chivilcoy,BUENOS AIRES,69,177,92,104,196
06,06224,062240914,Chivilcoy,BUENOS AIRES,68,139,100,107,207
06,06224,062242003,Chivilcoy,BUENOS AIRES,294,344,441,418,859
06,06224,062240604,Chivilcoy,BUENOS AIRES,35,49,51,52,103
06,06224,062240802,Chivilcoy,BUENOS AIRES,12,32,20,19,39
06,06224,062240910,Chivilcoy,BUENOS AIRES,55,61,75,93,168
06,06224,062241703,Chivilcoy,BUENOS AIRES,24,35,28,41,69
06,06224,062241802,Chivilcoy,BUENOS AIRES,18,19,21,26,47
06,06224,062242101,Chivilcoy,BUENOS AIRES,9,31,12,22,34
06,06224,062242004,Chivilcoy,BUENOS AIRES,5,5,9,9,18
06,06224,062240114,Chivilcoy,BUENOS AIRES,321,367,532,494,1026
06,06224,062240211,Chivilcoy,BUENOS AIRES,261,341,364,283,647
06,06224,062240108,Chivilcoy,BUENOS AIRES,216,275,305,258,563
06,06224,062240203,Chivilcoy,BUENOS AIRES,152,160,281,289,570
06,06224,062240205,Chivilcoy,BUENOS AIRES,267,301,432,398,830
06,06224,062240210,Chivilcoy,BUENOS AIRES,316,421,430,346,776
06,06224,062240213,Chivilcoy,BUENOS AIRES,105,110,275,267,542
06,06224,062240304,Chivilcoy,BUENOS AIRES,288,378,434,350,784
06,06224,062240310,Chivilcoy,BUENOS AIRES,266,280,454,407,861
06,06224,062240417,Chivilcoy,BUENOS AIRES,248,253,464,448,912
06,06224,062241102,Chivilcoy,BUENOS AIRES,46,84,53,70,123
06,06224,062242201,Chivilcoy,BUENOS AIRES,233,305,289,251,540
06,06224,062242203,Chivilcoy,BUENOS AIRES,331,407,444,393,837
06,06224,062241302,Chivilcoy,BUENOS AIRES,14,44,20,19,39
06,06224,062240907,Chivilcoy,BUENOS AIRES,29,56,48,54,102
06,06224,062241502,Chivilcoy,BUENOS AIRES,18,32,21,23,44
06,06224,062242102,Chivilcoy,BUENOS AIRES,4,14,4,5,9
06,06224,062240603,Chivilcoy,BUENOS AIRES,36,78,43,65,108
06,06224,062240904,Chivilcoy,BUENOS AIRES,59,85,86,97,183
06,06224,062241701,Chivilcoy,BUENOS AIRES,72,147,87,92,179
06,06224,062240103,Chivilcoy,BUENOS AIRES,408,481,600,565,1165
06,06224,062240106,Chivilcoy,BUENOS AIRES,284,360,435,416,851
06,06224,062240206,Chivilcoy,BUENOS AIRES,273,320,414,388,802
06,06224,062240212,Chivilcoy,BUENOS AIRES,133,127,217,221,438
06,06224,062240307,Chivilcoy,BUENOS AIRES,294,301,542,535,1077
06,06224,062240405,Chivilcoy,BUENOS AIRES,363,421,492,390,882
06,06224,062242002,Chivilcoy,BUENOS AIRES,129,153,175,176,351
06,06224,062242204,Chivilcoy,BUENOS AIRES,316,403,415,325,740
06,06224,062242207,Chivilcoy,BUENOS AIRES,242,274,385,350,735
06,06224,062240502,Chivilcoy,BUENOS AIRES,8,15,15,15,30
06,06224,062240503,Chivilcoy,BUENOS AIRES,25,54,31,36,67
06,06224,062241002,Chivilcoy,BUENOS AIRES,21,72,23,28,51
06,06224,062241501,Chivilcoy,BUENOS AIRES,8,15,10,10,20
06,06224,062241801,Chivilcoy,BUENOS AIRES,10,19,17,15,32
06,06224,062241904,Chivilcoy,BUENOS AIRES,18,36,32,27,59
06,06224,062242008,Chivilcoy,BUENOS AIRES,11,22,9,12,21
06,06224,062241204,Chivilcoy,BUENOS AIRES,102,213,132,133,265
06,06224,062240112,Chivilcoy,BUENOS AIRES,339,442,429,343,772
06,06224,062240117,Chivilcoy,BUENOS AIRES,237,284,389,360,749
06,06224,062240209,Chivilcoy,BUENOS AIRES,273,277,402,398,800
06,06224,062240402,Chivilcoy,BUENOS AIRES,433,473,622,568,1190
06,06224,062240408,Chivilcoy,BUENOS AIRES,268,371,344,241,585
06,06224,062242009,Chivilcoy,BUENOS AIRES,79,101,114,121,235
06,06224,062241103,Chivilcoy,BUENOS AIRES,68,91,110,91,201
06,06224,062242010,Chivilcoy,BUENOS AIRES,134,163,188,185,373
06,06224,062242001,Chivilcoy,BUENOS AIRES,117,178,158,136,294
06,06224,062240504,Chivilcoy,BUENOS AIRES,4,14,3,6,9
06,06224,062240601,Chivilcoy,BUENOS AIRES,19,33,20,32,52
06,06224,062241101,Chivilcoy,BUENOS AIRES,33,55,43,54,97
06,06224,062241202,Chivilcoy,BUENOS AIRES,10,27,13,15,28
06,06224,062241503,Chivilcoy,BUENOS AIRES,10,27,17,17,34
06,06224,062241602,Chivilcoy,BUENOS AIRES,7,17,6,10,16
06,06238,062380702,Dolores,BUENOS AIRES,45,81,52,63,115
06,06238,062380105,Dolores,BUENOS AIRES,362,406,558,813,1371
06,06238,062380212,Dolores,BUENOS AIRES,336,387,563,573,1136
06,06238,062380301,Dolores,BUENOS AIRES,100,113,156,130,286
06,06238,062380206,Dolores,BUENOS AIRES,274,336,417,323,740
06,06238,062380106,Dolores,BUENOS AIRES,247,317,426,303,729
06,06238,062380108,Dolores,BUENOS AIRES,236,288,334,289,623
06,06238,062380205,Dolores,BUENOS AIRES,242,309,338,282,620
06,06238,062380208,Dolores,BUENOS AIRES,336,363,495,466,961
06,06238,062380210,Dolores,BUENOS AIRES,228,263,407,364,771
06,06238,062380608,Dolores,BUENOS AIRES,4,26,4,7,11
06,06238,062380606,Dolores,BUENOS AIRES,18,26,18,23,41
06,06238,062380109,Dolores,BUENOS AIRES,262,337,385,319,704
06,06238,062380602,Dolores,BUENOS AIRES,88,108,167,157,324
06,06238,062380607,Dolores,BUENOS AIRES,43,74,48,70,118
06,06238,062380101,Dolores,BUENOS AIRES,193,209,292,306,598
06,06238,062380107,Dolores,BUENOS AIRES,420,481,649,658,1307
06,06238,062380112,Dolores,BUENOS AIRES,252,271,422,380,802
06,06238,062380601,Dolores,BUENOS AIRES,131,146,202,232,434
06,06238,062380605,Dolores,BUENOS AIRES,9,13,15,13,28
06,06238,062380610,Dolores,BUENOS AIRES,16,22,15,21,36
06,06238,062380611,Dolores,BUENOS AIRES,183,189,293,274,567
06,06238,062381001,Dolores,BUENOS AIRES,8,41,5,10,15
06,06238,062380215,Dolores,BUENOS AIRES,20,25,38,28,66
06,06238,062380102,Dolores,BUENOS AIRES,194,219,288,273,561
06,06238,062380202,Dolores,BUENOS AIRES,398,450,591,506,1097
06,06238,062380203,Dolores,BUENOS AIRES,328,379,510,369,879
06,06238,062380204,Dolores,BUENOS AIRES,196,238,254,193,447
06,06238,062380207,Dolores,BUENOS AIRES,403,443,603,597,1200
06,06238,062380603,Dolores,BUENOS AIRES,207,238,373,325,698
06,06238,062380701,Dolores,BUENOS AIRES,51,69,71,68,139
06,06238,062380302,Dolores,BUENOS AIRES,25,48,21,40,61
06,06238,062380103,Dolores,BUENOS AIRES,356,421,553,472,1025
06,06238,062380113,Dolores,BUENOS AIRES,163,184,273,236,509
06,06238,062380201,Dolores,BUENOS AIRES,245,274,402,402,804
06,06238,062380213,Dolores,BUENOS AIRES,153,181,255,219,474
06,06238,062380401,Dolores,BUENOS AIRES,29,58,34,53,87
06,06238,062380104,Dolores,BUENOS AIRES,362,402,532,498,1030
06,06238,062380110,Dolores,BUENOS AIRES,335,384,514,440,954
06,06238,062380209,Dolores,BUENOS AIRES,314,336,473,375,848
06,06238,062380801,Dolores,BUENOS AIRES,22,45,31,29,60
06,06238,062380111,Dolores,BUENOS AIRES,227,244,339,316,655
06,06238,062380114,Dolores,BUENOS AIRES,156,181,231,211,442
06,06238,062380211,Dolores,BUENOS AIRES,90,92,168,163,331
06,06238,062380214,Dolores,BUENOS AIRES,176,193,311,292,603
06,06238,062380604,Dolores,BUENOS AIRES,260,300,431,457,888
06,06238,062380609,Dolores,BUENOS AIRES,140,155,280,247,527
06,06238,062380501,Dolores,BUENOS AIRES,51,83,73,72,145
06,06238,062380901,Dolores,BUENOS AIRES,43,57,47,62,109
06,06238,062381101,Dolores,BUENOS AIRES,27,48,24,42,66
06,06260,062600301,Esteban Echeverría,BUENOS AIRES,703,752,1172,1120,2292
06,06260,062600119,Esteban Echeverría,BUENOS AIRES,406,408,762,753,1515
06,06260,062600205,Esteban Echeverría,BUENOS AIRES,468,438,1007,1047,2054
06,06260,062600210,Esteban Echeverría,BUENOS AIRES,390,383,717,698,1415
06,06260,062600216,Esteban Echeverría,BUENOS AIRES,364,358,681,704,1385
06,06260,062600306,Esteban Echeverría,BUENOS AIRES,293,235,576,551,1127
06,06260,062600315,Esteban Echeverría,BUENOS AIRES,286,287,501,524,1025
06,06260,062600402,Esteban Echeverría,BUENOS AIRES,364,312,698,655,1353
06,06260,062600406,Esteban Echeverría,BUENOS AIRES,331,319,598,592,1190
06,06260,062600507,Esteban Echeverría,BUENOS AIRES,321,334,631,593,1224
06,06260,062600510,Esteban Echeverría,BUENOS AIRES,297,302,509,516,1025
06,06260,062600607,Esteban Echeverría,BUENOS AIRES,247,252,446,429,875
06,06260,062600609,Esteban Echeverría,BUENOS AIRES,247,282,396,356,752
06,06260,062600610,Esteban Echeverría,BUENOS AIRES,193,203,315,302,617
06,06260,062600613,Esteban Echeverría,BUENOS AIRES,341,339,549,484,1033
06,06260,062600701,Esteban Echeverría,BUENOS AIRES,488,464,769,681,1450
06,06260,062600703,Esteban Echeverría,BUENOS AIRES,417,506,665,566,1231
06,06260,062600704,Esteban Echeverría,BUENOS AIRES,319,350,500,471,971
06,06260,062600707,Esteban Echeverría,BUENOS AIRES,351,374,602,561,1163
06,06260,062600804,Esteban Echeverría,BUENOS AIRES,433,416,881,889,1770
06,06260,062600808,Esteban Echeverría,BUENOS AIRES,369,364,670,616,1286
06,06260,062600905,Esteban Echeverría,BUENOS AIRES,304,307,615,625,1240
06,06260,062601010,Esteban Echeverría,BUENOS AIRES,260,260,449,436,885
06,06260,062601012,Esteban Echeverría,BUENOS AIRES,291,273,544,536,1080
06,06260,062601103,Esteban Echeverría,BUENOS AIRES,366,469,514,438,952
06,06260,062601105,Esteban Echeverría,BUENOS AIRES,292,335,443,419,862
06,06260,062601108,Esteban Echeverría,BUENOS AIRES,365,407,562,505,1067
06,06260,062601212,Esteban Echeverría,BUENOS AIRES,341,374,628,633,1261
06,06260,062601309,Esteban Echeverría,BUENOS AIRES,329,368,561,517,1078
06,06260,062601313,Esteban Echeverría,BUENOS AIRES,228,289,312,276,588
06,06260,062601406,Esteban Echeverría,BUENOS AIRES,453,510,673,590,1263
06,06260,062601509,Esteban Echeverría,BUENOS AIRES,368,376,803,799,1602
06,06260,062601517,Esteban Echeverría,BUENOS AIRES,483,476,938,933,1871
06,06260,062601612,Esteban Echeverría,BUENOS AIRES,345,346,678,697,1375
06,06260,062601714,Esteban Echeverría,BUENOS AIRES,52,91,73,96,169
06,06260,062601705,Esteban Echeverría,BUENOS AIRES,62,175,95,124,219
06,06260,062600214,Esteban Echeverría,BUENOS AIRES,359,346,688,626,1314
06,06260,062600101,Esteban Echeverría,BUENOS AIRES,446,419,827,865,1692
06,06260,062600106,Esteban Echeverría,BUENOS AIRES,520,514,988,992,1980
06,06260,062600114,Esteban Echeverría,BUENOS AIRES,352,322,684,666,1350
06,06260,062600211,Esteban Echeverría,BUENOS AIRES,385,383,750,738,1488
06,06260,062600309,Esteban Echeverría,BUENOS AIRES,222,218,410,431,841
06,06260,062600409,Esteban Echeverría,BUENOS AIRES,311,308,545,527,1072
06,06260,062600505,Esteban Echeverría,BUENOS AIRES,372,373,709,725,1434
06,06260,062600806,Esteban Echeverría,BUENOS AIRES,320,303,641,639,1280
06,06260,062600809,Esteban Echeverría,BUENOS AIRES,352,374,587,581,1168
06,06260,062600908,Esteban Echeverría,BUENOS AIRES,438,436,803,799,1602
06,06260,062600909,Esteban Echeverría,BUENOS AIRES,249,254,443,417,860
06,06260,062600912,Esteban Echeverría,BUENOS AIRES,309,295,588,611,1199
06,06260,062601101,Esteban Echeverría,BUENOS AIRES,130,214,156,117,273
06,06260,062601104,Esteban Echeverría,BUENOS AIRES,336,397,517,423,940
06,06260,062601203,Esteban Echeverría,BUENOS AIRES,170,235,238,190,428
06,06260,062601402,Esteban Echeverría,BUENOS AIRES,297,333,478,439,917
06,06260,062601405,Esteban Echeverría,BUENOS AIRES,370,397,628,538,1166
06,06260,062601411,Esteban Echeverría,BUENOS AIRES,345,308,585,585,1170
06,06260,062601501,Esteban Echeverría,BUENOS AIRES,443,461,848,879,1727
06,06260,062601503,Esteban Echeverría,BUENOS AIRES,200,211,359,367,726
06,06260,062601505,Esteban Echeverría,BUENOS AIRES,348,307,629,643,1272
06,06260,062601507,Esteban Echeverría,BUENOS AIRES,292,275,566,560,1126
06,06260,062601508,Esteban Echeverría,BUENOS AIRES,264,269,539,580,1119
06,06260,062601601,Esteban Echeverría,BUENOS AIRES,412,452,738,718,1456
06,06260,062601607,Esteban Echeverría,BUENOS AIRES,377,396,835,764,1599
06,06260,062600310,Esteban Echeverría,BUENOS AIRES,471,507,912,874,1786
06,06260,062600202,Esteban Echeverría,BUENOS AIRES,501,461,933,923,1856
06,06260,062601615,Esteban Echeverría,BUENOS AIRES,455,436,808,863,1671
06,06260,062600110,Esteban Echeverría,BUENOS AIRES,469,445,818,855,1673
06,06260,062600111,Esteban Echeverría,BUENOS AIRES,295,314,494,531,1025
06,06260,062600108,Esteban Echeverría,BUENOS AIRES,446,441,761,780,1541
06,06260,062600115,Esteban Echeverría,BUENOS AIRES,312,270,564,577,1141
06,06260,062600201,Esteban Echeverría,BUENOS AIRES,587,573,1125,1101,2226
06,06260,062600212,Esteban Echeverría,BUENOS AIRES,348,304,724,722,1446
06,06260,062600305,Esteban Echeverría,BUENOS AIRES,393,398,796,761,1557
06,06260,062600307,Esteban Echeverría,BUENOS AIRES,375,325,680,702,1382
06,06260,062600312,Esteban Echeverría,BUENOS AIRES,519,534,1047,941,1988
06,06260,062600317,Esteban Echeverría,BUENOS AIRES,377,316,730,643,1373
06,06260,062600318,Esteban Echeverría,BUENOS AIRES,345,336,635,635,1270
06,06260,062600513,Esteban Echeverría,BUENOS AIRES,399,440,710,752,1462
06,06260,062600515,Esteban Echeverría,BUENOS AIRES,357,321,656,646,1302
06,06260,062600603,Esteban Echeverría,BUENOS AIRES,326,348,542,461,1003
06,06260,062600605,Esteban Echeverría,BUENOS AIRES,400,414,670,580,1250
06,06260,062600615,Esteban Echeverría,BUENOS AIRES,303,348,464,409,873
06,06260,062600706,Esteban Echeverría,BUENOS AIRES,337,370,583,536,1119
06,06260,062600708,Esteban Echeverría,BUENOS AIRES,255,276,434,389,823
06,06260,062600810,Esteban Echeverría,BUENOS AIRES,254,250,452,466,918
06,06260,062600813,Esteban Echeverría,BUENOS AIRES,446,431,801,787,1588
06,06260,062600903,Esteban Echeverría,BUENOS AIRES,502,485,942,909,1851
06,06260,062600904,Esteban Echeverría,BUENOS AIRES,455,449,882,853,1735
06,06260,062600906,Esteban Echeverría,BUENOS AIRES,100,96,176,163,339
06,06260,062600911,Esteban Echeverría,BUENOS AIRES,435,460,794,802,1596
06,06260,062601008,Esteban Echeverría,BUENOS AIRES,338,358,611,591,1202
06,06260,062601202,Esteban Echeverría,BUENOS AIRES,187,222,296,263,559
06,06260,062601205,Esteban Echeverría,BUENOS AIRES,407,452,646,581,1227
06,06260,062601208,Esteban Echeverría,BUENOS AIRES,314,351,467,445,912
06,06260,062601302,Esteban Echeverría,BUENOS AIRES,477,484,695,651,1346
06,06260,062601312,Esteban Echeverría,BUENOS AIRES,171,266,208,176,384
06,06260,062601502,Esteban Echeverría,BUENOS AIRES,338,335,605,629,1234
06,06260,062601510,Esteban Echeverría,BUENOS AIRES,469,453,928,943,1871
06,06260,062601611,Esteban Echeverría,BUENOS AIRES,303,324,645,677,1322
06,06260,062601702,Esteban Echeverría,BUENOS AIRES,21,30,36,33,69
06,06260,062601713,Esteban Echeverría,BUENOS AIRES,643,850,1160,1160,2320
06,06260,062601701,Esteban Echeverría,BUENOS AIRES,515,535,796,838,1634
06,06260,062600103,Esteban Echeverría,BUENOS AIRES,271,217,536,546,1082
06,06260,062600302,Esteban Echeverría,BUENOS AIRES,247,243,528,513,1041
06,06260,062601310,Esteban Echeverría,BUENOS AIRES,209,230,392,305,697
06,06260,062600213,Esteban Echeverría,BUENOS AIRES,334,334,608,661,1269
06,06260,062600112,Esteban Echeverría,BUENOS AIRES,418,398,798,814,1612
06,06260,062600206,Esteban Echeverría,BUENOS AIRES,328,276,655,701,1356
06,06260,062600208,Esteban Echeverría,BUENOS AIRES,82,139,117,122,239
06,06260,062600215,Esteban Echeverría,BUENOS AIRES,411,415,782,786,1568
06,06260,062600501,Esteban Echeverría,BUENOS AIRES,351,344,625,648,1273
06,06260,062600313,Esteban Echeverría,BUENOS AIRES,463,477,939,899,1838
06,06260,062600404,Esteban Echeverría,BUENOS AIRES,336,319,594,573,1167
06,06260,062600407,Esteban Echeverría,BUENOS AIRES,289,268,503,509,1012
06,06260,062600410,Esteban Echeverría,BUENOS AIRES,235,241,393,333,726
06,06260,062600502,Esteban Echeverría,BUENOS AIRES,325,337,627,589,1216
06,06260,062600506,Esteban Echeverría,BUENOS AIRES,424,357,841,836,1677
06,06260,062600512,Esteban Echeverría,BUENOS AIRES,313,264,633,614,1247
06,06260,062600604,Esteban Echeverría,BUENOS AIRES,432,441,706,590,1296
06,06260,062600606,Esteban Echeverría,BUENOS AIRES,221,234,374,318,692
06,06260,062600614,Esteban Echeverría,BUENOS AIRES,353,394,501,490,991
06,06260,062600711,Esteban Echeverría,BUENOS AIRES,323,360,525,452,977
06,06260,062600910,Esteban Echeverría,BUENOS AIRES,372,385,684,683,1367
06,06260,062601001,Esteban Echeverría,BUENOS AIRES,337,358,669,595,1264
06,06260,062601009,Esteban Echeverría,BUENOS AIRES,238,230,465,404,869
06,06260,062601207,Esteban Echeverría,BUENOS AIRES,213,196,362,313,675
06,06260,062601301,Esteban Echeverría,BUENOS AIRES,253,288,401,367,768
06,06260,062601311,Esteban Echeverría,BUENOS AIRES,269,380,388,296,684
06,06260,062601403,Esteban Echeverría,BUENOS AIRES,287,299,463,406,869
06,06260,062601413,Esteban Echeverría,BUENOS AIRES,291,287,487,495,982
06,06260,062601513,Esteban Echeverría,BUENOS AIRES,342,305,639,615,1254
06,06260,062601514,Esteban Echeverría,BUENOS AIRES,244,243,478,498,976
06,06260,062601515,Esteban Echeverría,BUENOS AIRES,285,297,605,593,1198
06,06260,062601516,Esteban Echeverría,BUENOS AIRES,307,326,683,585,1268
06,06260,062601519,Esteban Echeverría,BUENOS AIRES,329,324,586,573,1159
06,06260,062601608,Esteban Echeverría,BUENOS AIRES,125,129,256,244,500
06,06260,062601610,Esteban Echeverría,BUENOS AIRES,286,313,575,563,1138
06,06260,062601616,Esteban Echeverría,BUENOS AIRES,361,398,646,631,1277
06,06260,062601712,Esteban Echeverría,BUENOS AIRES,108,217,185,204,389
06,06260,062600104,Esteban Echeverría,BUENOS AIRES,235,211,396,425,821
06,06260,062600105,Esteban Echeverría,BUENOS AIRES,306,185,463,499,962
06,06260,062600117,Esteban Echeverría,BUENOS AIRES,464,397,844,820,1664
06,06260,062600311,Esteban Echeverría,BUENOS AIRES,432,422,972,931,1903
06,06260,062600319,Esteban Echeverría,BUENOS AIRES,325,284,547,576,1123
06,06260,062600403,Esteban Echeverría,BUENOS AIRES,339,335,612,614,1226
06,06260,062600405,Esteban Echeverría,BUENOS AIRES,313,324,526,524,1050
06,06260,062600412,Esteban Echeverría,BUENOS AIRES,331,314,579,537,1116
06,06260,062600503,Esteban Echeverría,BUENOS AIRES,240,231,425,425,850
06,06260,062600508,Esteban Echeverría,BUENOS AIRES,187,197,322,280,602
06,06260,062601314,Esteban Echeverría,BUENOS AIRES,218,313,242,184,426
06,06260,062600608,Esteban Echeverría,BUENOS AIRES,246,268,366,401,767
06,06260,062600616,Esteban Echeverría,BUENOS AIRES,390,428,600,556,1156
06,06260,062600801,Esteban Echeverría,BUENOS AIRES,332,328,678,659,1337
06,06260,062600805,Esteban Echeverría,BUENOS AIRES,290,287,593,595,1188
06,06260,062600901,Esteban Echeverría,BUENOS AIRES,344,344,629,592,1221
06,06260,062600902,Esteban Echeverría,BUENOS AIRES,325,315,601,591,1192
06,06260,062601004,Esteban Echeverría,BUENOS AIRES,303,323,484,494,978
06,06260,062601201,Esteban Echeverría,BUENOS AIRES,308,377,427,359,786
06,06260,062601204,Esteban Echeverría,BUENOS AIRES,303,373,446,406,852
06,06260,062601210,Esteban Echeverría,BUENOS AIRES,204,231,345,322,667
06,06260,062601211,Esteban Echeverría,BUENOS AIRES,283,269,482,466,948
06,06260,062601305,Esteban Echeverría,BUENOS AIRES,429,461,697,631,1328
06,06260,062601307,Esteban Echeverría,BUENOS AIRES,371,430,639,545,1184
06,06260,062601308,Esteban Echeverría,BUENOS AIRES,356,368,570,504,1074
06,06260,062601605,Esteban Echeverría,BUENOS AIRES,370,368,690,636,1326
06,06260,062601614,Esteban Echeverría,BUENOS AIRES,472,450,896,897,1793
06,06260,062601707,Esteban Echeverría,BUENOS AIRES,58,299,93,111,204
06,06260,062601709,Esteban Echeverría,BUENOS AIRES,77,291,160,132,292
06,06260,062601110,Esteban Echeverría,BUENOS AIRES,389,407,682,623,1305
06,06260,062601206,Esteban Echeverría,BUENOS AIRES,353,404,560,506,1066
06,06260,062601303,Esteban Echeverría,BUENOS AIRES,360,426,546,477,1023
06,06260,062601306,Esteban Echeverría,BUENOS AIRES,344,385,550,464,1014
06,06260,062601412,Esteban Echeverría,BUENOS AIRES,249,246,393,332,725
06,06260,062601604,Esteban Echeverría,BUENOS AIRES,306,261,545,567,1112
06,06260,062601703,Esteban Echeverría,BUENOS AIRES,1223,574,1624,1763,3387
06,06260,062601710,Esteban Echeverría,BUENOS AIRES,107,259,170,143,313
06,06260,062600314,Esteban Echeverría,BUENOS AIRES,259,269,485,523,1008
06,06260,062601617,Esteban Echeverría,BUENOS AIRES,416,463,753,738,1491
06,06260,062600113,Esteban Echeverría,BUENOS AIRES,278,236,501,532,1033
06,06260,062600107,Esteban Echeverría,BUENOS AIRES,368,283,655,650,1305
06,06260,062600116,Esteban Echeverría,BUENOS AIRES,324,275,602,589,1191
06,06260,062600207,Esteban Echeverría,BUENOS AIRES,424,408,785,842,1627
06,06260,062600303,Esteban Echeverría,BUENOS AIRES,338,273,700,702,1402
06,06260,062600411,Esteban Echeverría,BUENOS AIRES,247,240,403,370,773
06,06260,062600514,Esteban Echeverría,BUENOS AIRES,386,410,775,715,1490
06,06260,062600611,Esteban Echeverría,BUENOS AIRES,239,251,378,343,721
06,06260,062600803,Esteban Echeverría,BUENOS AIRES,317,328,624,660,1284
06,06260,062600812,Esteban Echeverría,BUENOS AIRES,402,379,806,760,1566
06,06260,062600814,Esteban Echeverría,BUENOS AIRES,295,314,533,509,1042
06,06260,062600907,Esteban Echeverría,BUENOS AIRES,420,391,742,728,1470
06,06260,062601007,Esteban Echeverría,BUENOS AIRES,376,324,685,675,1360
06,06260,062601013,Esteban Echeverría,BUENOS AIRES,412,393,829,810,1639
06,06260,062601102,Esteban Echeverría,BUENOS AIRES,195,303,240,204,444
06,06260,062601107,Esteban Echeverría,BUENOS AIRES,419,430,637,539,1176
06,06260,062601109,Esteban Echeverría,BUENOS AIRES,353,392,601,573,1174
06,06260,062601209,Esteban Echeverría,BUENOS AIRES,274,304,447,414,861
06,06260,062601409,Esteban Echeverría,BUENOS AIRES,380,401,665,614,1279
06,06260,062601410,Esteban Echeverría,BUENOS AIRES,401,405,696,620,1316
06,06260,062601511,Esteban Echeverría,BUENOS AIRES,448,448,872,909,1781
06,06260,062601606,Esteban Echeverría,BUENOS AIRES,386,410,692,680,1372
06,06260,062601609,Esteban Echeverría,BUENOS AIRES,336,345,665,654,1319
06,06260,062601613,Esteban Echeverría,BUENOS AIRES,318,339,586,603,1189
06,06260,062601706,Esteban Echeverría,BUENOS AIRES,457,486,862,888,1750
06,06260,062601711,Esteban Echeverría,BUENOS AIRES,85,297,146,155,301
06,06260,062600807,Esteban Echeverría,BUENOS AIRES,266,264,527,551,1078
06,06260,062601602,Esteban Echeverría,BUENOS AIRES,317,326,581,554,1135
06,06260,062600109,Esteban Echeverría,BUENOS AIRES,380,365,747,683,1430
06,06260,062600118,Esteban Echeverría,BUENOS AIRES,176,171,325,313,638
06,06260,062600203,Esteban Echeverría,BUENOS AIRES,481,458,960,920,1880
06,06260,062600304,Esteban Echeverría,BUENOS AIRES,534,545,1059,1120,2179
06,06260,062600308,Esteban Echeverría,BUENOS AIRES,320,323,631,587,1218
06,06260,062600504,Esteban Echeverría,BUENOS AIRES,371,330,668,644,1312
06,06260,062600509,Esteban Echeverría,BUENOS AIRES,378,382,680,679,1359
06,06260,062600511,Esteban Echeverría,BUENOS AIRES,405,367,834,794,1628
06,06260,062600516,Esteban Echeverría,BUENOS AIRES,246,239,440,419,859
06,06260,062600601,Esteban Echeverría,BUENOS AIRES,398,416,711,648,1359
06,06260,062600612,Esteban Echeverría,BUENOS AIRES,346,408,533,460,993
06,06260,062600702,Esteban Echeverría,BUENOS AIRES,369,415,571,512,1083
06,06260,062600705,Esteban Echeverría,BUENOS AIRES,254,270,418,423,841
06,06260,062600709,Esteban Echeverría,BUENOS AIRES,297,322,473,441,914
06,06260,062600710,Esteban Echeverría,BUENOS AIRES,434,477,694,612,1306
06,06260,062601002,Esteban Echeverría,BUENOS AIRES,275,278,502,489,991
06,06260,062601005,Esteban Echeverría,BUENOS AIRES,146,78,221,181,402
06,06260,062601011,Esteban Echeverría,BUENOS AIRES,337,322,594,608,1202
06,06260,062601015,Esteban Echeverría,BUENOS AIRES,137,172,252,250,502
06,06260,062601304,Esteban Echeverría,BUENOS AIRES,349,406,516,475,991
06,06260,062601401,Esteban Echeverría,BUENOS AIRES,391,414,635,578,1213
06,06260,062601404,Esteban Echeverría,BUENOS AIRES,214,243,360,318,678
06,06260,062601407,Esteban Echeverría,BUENOS AIRES,281,294,454,444,898
06,06260,062601408,Esteban Echeverría,BUENOS AIRES,382,444,680,652,1332
06,06260,062601504,Esteban Echeverría,BUENOS AIRES,255,262,466,438,904
06,06260,062601506,Esteban Echeverría,BUENOS AIRES,317,320,592,600,1192
06,06260,062601512,Esteban Echeverría,BUENOS AIRES,294,303,521,498,1019
06,06260,062601518,Esteban Echeverría,BUENOS AIRES,454,448,864,847,1711
06,06260,062601603,Esteban Echeverría,BUENOS AIRES,394,412,772,788,1560
06,06260,062601704,Esteban Echeverría,BUENOS AIRES,262,259,514,507,1021
06,06260,062601708,Esteban Echeverría,BUENOS AIRES,206,246,380,374,754
06,06260,062600517,Esteban Echeverría,BUENOS AIRES,283,287,464,452,916
06,06260,062600102,Esteban Echeverría,BUENOS AIRES,359,387,629,658,1287
06,06260,062600204,Esteban Echeverría,BUENOS AIRES,388,371,792,809,1601
06,06260,062600209,Esteban Echeverría,BUENOS AIRES,443,411,844,865,1709
06,06260,062600316,Esteban Echeverría,BUENOS AIRES,409,391,775,774,1549
06,06260,062600401,Esteban Echeverría,BUENOS AIRES,277,235,499,449,948
06,06260,062600408,Esteban Echeverría,BUENOS AIRES,364,373,595,592,1187
06,06260,062600602,Esteban Echeverría,BUENOS AIRES,295,266,466,464,930
06,06260,062600712,Esteban Echeverría,BUENOS AIRES,305,364,431,396,827
06,06260,062600713,Esteban Echeverría,BUENOS AIRES,332,371,473,380,853
06,06260,062600802,Esteban Echeverría,BUENOS AIRES,440,451,827,788,1615
06,06260,062600811,Esteban Echeverría,BUENOS AIRES,390,408,772,742,1514
06,06260,062600913,Esteban Echeverría,BUENOS AIRES,425,391,827,816,1643
06,06260,062600914,Esteban Echeverría,BUENOS AIRES,314,353,543,539,1082
06,06260,062601003,Esteban Echeverría,BUENOS AIRES,367,381,602,571,1173
06,06260,062601006,Esteban Echeverría,BUENOS AIRES,1270,1259,1918,1743,3661
06,06260,062601014,Esteban Echeverría,BUENOS AIRES,258,276,509,548,1057
06,06260,062601106,Esteban Echeverría,BUENOS AIRES,189,212,292,237,529
06,06266,062660506,Exaltación de la Cruz,BUENOS AIRES,76,184,117,154,271
06,06266,062660601,Exaltación de la Cruz,BUENOS AIRES,142,179,230,247,477
06,06266,062660502,Exaltación de la Cruz,BUENOS AIRES,177,191,318,306,624
06,06266,062660708,Exaltación de la Cruz,BUENOS AIRES,340,353,625,605,1230
06,06266,062660202,Exaltación de la Cruz,BUENOS AIRES,38,45,32,68,100
06,06266,062660403,Exaltación de la Cruz,BUENOS AIRES,90,187,137,171,308
06,06266,062660501,Exaltación de la Cruz,BUENOS AIRES,412,497,683,766,1449
06,06266,062660706,Exaltación de la Cruz,BUENOS AIRES,80,116,136,121,257
06,06266,062660611,Exaltación de la Cruz,BUENOS AIRES,114,281,176,185,361
06,06266,062660301,Exaltación de la Cruz,BUENOS AIRES,304,329,519,544,1063
06,06266,062660509,Exaltación de la Cruz,BUENOS AIRES,75,192,119,97,216
06,06266,062660606,Exaltación de la Cruz,BUENOS AIRES,61,172,64,74,138
06,06266,062660711,Exaltación de la Cruz,BUENOS AIRES,159,182,295,301,596
06,06266,062660304,Exaltación de la Cruz,BUENOS AIRES,202,214,341,304,645
06,06266,062660306,Exaltación de la Cruz,BUENOS AIRES,166,182,243,205,448
06,06266,062660308,Exaltación de la Cruz,BUENOS AIRES,159,185,253,183,436
06,06266,062660309,Exaltación de la Cruz,BUENOS AIRES,197,251,281,231,512
06,06266,062660505,Exaltación de la Cruz,BUENOS AIRES,54,165,66,69,135
06,06266,062660612,Exaltación de la Cruz,BUENOS AIRES,115,233,196,203,399
06,06266,062660603,Exaltación de la Cruz,BUENOS AIRES,113,173,160,174,334
06,06266,062660710,Exaltación de la Cruz,BUENOS AIRES,318,320,614,593,1207
06,06266,062660102,Exaltación de la Cruz,BUENOS AIRES,70,123,83,103,186
06,06266,062660103,Exaltación de la Cruz,BUENOS AIRES,31,60,59,45,104
06,06266,062660402,Exaltación de la Cruz,BUENOS AIRES,5,9,9,17,26
06,06266,062660707,Exaltación de la Cruz,BUENOS AIRES,257,322,373,364,737
06,06266,062660302,Exaltación de la Cruz,BUENOS AIRES,285,298,415,376,791
06,06266,062660307,Exaltación de la Cruz,BUENOS AIRES,186,209,316,232,548
06,06266,062660310,Exaltación de la Cruz,BUENOS AIRES,279,300,449,386,835
06,06266,062660604,Exaltación de la Cruz,BUENOS AIRES,77,236,103,104,207
06,06266,062660204,Exaltación de la Cruz,BUENOS AIRES,309,312,674,640,1314
06,06266,062660602,Exaltación de la Cruz,BUENOS AIRES,223,583,321,393,714
06,06266,062660610,Exaltación de la Cruz,BUENOS AIRES,151,307,255,243,498
06,06266,062660312,Exaltación de la Cruz,BUENOS AIRES,26,31,32,34,66
06,06266,062660201,Exaltación de la Cruz,BUENOS AIRES,15,25,18,25,43
06,06266,062660104,Exaltación de la Cruz,BUENOS AIRES,62,79,79,101,180
06,06266,062660305,Exaltación de la Cruz,BUENOS AIRES,114,128,201,202,403
06,06266,062660311,Exaltación de la Cruz,BUENOS AIRES,271,291,438,450,888
06,06266,062660401,Exaltación de la Cruz,BUENOS AIRES,53,74,104,113,217
06,06266,062660507,Exaltación de la Cruz,BUENOS AIRES,39,90,57,47,104
06,06266,062660607,Exaltación de la Cruz,BUENOS AIRES,65,241,87,92,179
06,06266,062660709,Exaltación de la Cruz,BUENOS AIRES,403,440,635,612,1247
06,06266,062660205,Exaltación de la Cruz,BUENOS AIRES,125,220,192,207,399
06,06266,062660101,Exaltación de la Cruz,BUENOS AIRES,8,20,10,9,19
06,06266,062660303,Exaltación de la Cruz,BUENOS AIRES,274,286,502,453,955
06,06266,062660503,Exaltación de la Cruz,BUENOS AIRES,139,208,226,237,463
06,06266,062660605,Exaltación de la Cruz,BUENOS AIRES,105,222,142,158,300
06,06266,062660608,Exaltación de la Cruz,BUENOS AIRES,102,300,132,125,257
06,06266,062660702,Exaltación de la Cruz,BUENOS AIRES,283,353,448,446,894
06,06266,062660504,Exaltación de la Cruz,BUENOS AIRES,68,169,103,110,213
06,06266,062660701,Exaltación de la Cruz,BUENOS AIRES,245,252,443,428,871
06,06266,062660609,Exaltación de la Cruz,BUENOS AIRES,196,248,329,382,711
06,06266,062660703,Exaltación de la Cruz,BUENOS AIRES,429,469,741,748,1489
06,06266,062660203,Exaltación de la Cruz,BUENOS AIRES,26,46,31,36,67
06,06266,062660508,Exaltación de la Cruz,BUENOS AIRES,223,380,330,384,714
06,06266,062660704,Exaltación de la Cruz,BUENOS AIRES,107,221,143,182,325
06,06266,062660705,Exaltación de la Cruz,BUENOS AIRES,458,502,797,838,1635
06,06270,062700103,Ezeiza,BUENOS AIRES,144,189,1007,2153,3160
06,06270,062701104,Ezeiza,BUENOS AIRES,111,219,175,185,360
06,06270,062700215,Ezeiza,BUENOS AIRES,277,284,504,553,1057
06,06270,062700201,Ezeiza,BUENOS AIRES,501,489,1026,955,1981
06,06270,062700202,Ezeiza,BUENOS AIRES,251,238,516,482,998
06,06270,062700206,Ezeiza,BUENOS AIRES,472,491,744,712,1456
06,06270,062700309,Ezeiza,BUENOS AIRES,412,427,754,754,1508
06,06270,062700314,Ezeiza,BUENOS AIRES,305,354,466,408,874
06,06270,062700316,Ezeiza,BUENOS AIRES,262,308,412,392,804
06,06270,062700406,Ezeiza,BUENOS AIRES,480,509,866,832,1698
06,06270,062700412,Ezeiza,BUENOS AIRES,370,400,651,577,1228
06,06270,062700414,Ezeiza,BUENOS AIRES,335,334,637,647,1284
06,06270,062700601,Ezeiza,BUENOS AIRES,291,298,496,527,1023
06,06270,062700604,Ezeiza,BUENOS AIRES,145,257,243,234,477
06,06270,062700605,Ezeiza,BUENOS AIRES,361,444,601,625,1226
06,06270,062700611,Ezeiza,BUENOS AIRES,420,483,769,785,1554
06,06270,062700612,Ezeiza,BUENOS AIRES,117,214,214,184,398
06,06270,062700615,Ezeiza,BUENOS AIRES,201,227,371,360,731
06,06270,062700712,Ezeiza,BUENOS AIRES,476,438,964,953,1917
06,06270,062700811,Ezeiza,BUENOS AIRES,334,753,580,548,1128
06,06270,062700904,Ezeiza,BUENOS AIRES,296,329,479,428,907
06,06270,062700908,Ezeiza,BUENOS AIRES,208,213,377,372,749
06,06270,062701102,Ezeiza,BUENOS AIRES,11,12,17,20,37
06,06270,062701101,Ezeiza,BUENOS AIRES,402,463,739,712,1451
06,06270,062700102,Ezeiza,BUENOS AIRES,185,216,339,290,629
06,06270,062700204,Ezeiza,BUENOS AIRES,288,298,506,532,1038
06,06270,062700303,Ezeiza,BUENOS AIRES,435,442,838,871,1709
06,06270,062700310,Ezeiza,BUENOS AIRES,383,411,704,691,1395
06,06270,062700408,Ezeiza,BUENOS AIRES,180,239,295,256,551
06,06270,062700411,Ezeiza,BUENOS AIRES,478,473,902,879,1781
06,06270,062700510,Ezeiza,BUENOS AIRES,418,429,792,764,1556
06,06270,062700512,Ezeiza,BUENOS AIRES,235,389,371,387,758
06,06270,062700602,Ezeiza,BUENOS AIRES,186,428,281,264,545
06,06270,062700606,Ezeiza,BUENOS AIRES,442,469,771,770,1541
06,06270,062700609,Ezeiza,BUENOS AIRES,363,458,646,635,1281
06,06270,062700718,Ezeiza,BUENOS AIRES,522,523,955,956,1911
06,06270,062700719,Ezeiza,BUENOS AIRES,445,466,820,818,1638
06,06270,062700802,Ezeiza,BUENOS AIRES,43,103,58,64,122
06,06270,062701006,Ezeiza,BUENOS AIRES,385,315,687,735,1422
06,06270,062700806,Ezeiza,BUENOS AIRES,32,219,55,41,96
06,06270,062700104,Ezeiza,BUENOS AIRES,338,340,692,726,1418
06,06270,062700216,Ezeiza,BUENOS AIRES,338,358,665,674,1339
06,06270,062700203,Ezeiza,BUENOS AIRES,281,292,479,499,978
06,06270,062700205,Ezeiza,BUENOS AIRES,309,322,487,430,917
06,06270,062700207,Ezeiza,BUENOS AIRES,402,420,745,669,1414
06,06270,062700308,Ezeiza,BUENOS AIRES,396,393,642,652,1294
06,06270,062700312,Ezeiza,BUENOS AIRES,456,523,713,668,1381
06,06270,062700315,Ezeiza,BUENOS AIRES,256,302,379,352,731
06,06270,062700401,Ezeiza,BUENOS AIRES,172,183,279,298,577
06,06270,062700405,Ezeiza,BUENOS AIRES,403,447,716,721,1437
06,06270,062700413,Ezeiza,BUENOS AIRES,366,396,639,625,1264
06,06270,062700617,Ezeiza,BUENOS AIRES,495,532,939,918,1857
06,06270,062700701,Ezeiza,BUENOS AIRES,266,268,508,503,1011
06,06270,062700703,Ezeiza,BUENOS AIRES,320,337,611,599,1210
06,06270,062700707,Ezeiza,BUENOS AIRES,431,481,746,720,1466
06,06270,062700709,Ezeiza,BUENOS AIRES,220,243,407,351,758
06,06270,062700714,Ezeiza,BUENOS AIRES,331,348,590,586,1176
06,06270,062700717,Ezeiza,BUENOS AIRES,389,414,787,730,1517
06,06270,062700910,Ezeiza,BUENOS AIRES,367,384,696,690,1386
06,06270,062700810,Ezeiza,BUENOS AIRES,238,236,498,508,1006
06,06270,062700813,Ezeiza,BUENOS AIRES,63,156,92,89,181
06,06270,062700903,Ezeiza,BUENOS AIRES,295,331,567,589,1156
06,06270,062701001,Ezeiza,BUENOS AIRES,370,430,647,581,1228
06,06270,062701003,Ezeiza,BUENOS AIRES,644,666,1224,1219,2443
06,06270,062701004,Ezeiza,BUENOS AIRES,470,462,912,848,1760
06,06270,062701008,Ezeiza,BUENOS AIRES,345,359,695,704,1399
06,06270,062700805,Ezeiza,BUENOS AIRES,46,108,76,80,156
06,06270,062700706,Ezeiza,BUENOS AIRES,237,250,498,528,1026
06,06270,062700311,Ezeiza,BUENOS AIRES,356,381,571,559,1130
06,06270,062700407,Ezeiza,BUENOS AIRES,339,374,551,495,1046
06,06270,062700409,Ezeiza,BUENOS AIRES,433,483,631,571,1202
06,06270,062700504,Ezeiza,BUENOS AIRES,465,449,940,940,1880
06,06270,062700505,Ezeiza,BUENOS AIRES,380,380,743,763,1506
06,06270,062700508,Ezeiza,BUENOS AIRES,434,462,787,834,1621
06,06270,062700909,Ezeiza,BUENOS AIRES,392,284,821,847,1668
06,06270,062701005,Ezeiza,BUENOS AIRES,368,388,709,676,1385
06,06270,062700106,Ezeiza,BUENOS AIRES,169,278,258,482,740
06,06270,062700503,Ezeiza,BUENOS AIRES,280,246,529,539,1068
06,06270,062700208,Ezeiza,BUENOS AIRES,478,494,956,996,1952
06,06270,062700214,Ezeiza,BUENOS AIRES,263,269,527,506,1033
06,06270,062700301,Ezeiza,BUENOS AIRES,232,282,427,413,840
06,06270,062700302,Ezeiza,BUENOS AIRES,266,278,472,493,965
06,06270,062700305,Ezeiza,BUENOS AIRES,455,465,849,804,1653
06,06270,062700502,Ezeiza,BUENOS AIRES,248,269,491,434,925
06,06270,062700402,Ezeiza,BUENOS AIRES,274,320,437,454,891
06,06270,062700607,Ezeiza,BUENOS AIRES,420,487,765,759,1524
06,06270,062700613,Ezeiza,BUENOS AIRES,108,175,177,169,346
06,06270,062700704,Ezeiza,BUENOS AIRES,191,219,314,310,624
06,06270,062700711,Ezeiza,BUENOS AIRES,367,399,728,724,1452
06,06270,062700716,Ezeiza,BUENOS AIRES,367,434,646,698,1344
06,06270,062700816,Ezeiza,BUENOS AIRES,188,205,337,373,710
06,06270,062700901,Ezeiza,BUENOS AIRES,674,649,1282,1331,2613
06,06270,062701002,Ezeiza,BUENOS AIRES,609,603,1193,1156,2349
06,06270,062700105,Ezeiza,BUENOS AIRES,169,204,256,210,466
06,06270,062700209,Ezeiza,BUENOS AIRES,464,462,914,924,1838
06,06270,062700212,Ezeiza,BUENOS AIRES,429,465,812,830,1642
06,06270,062700304,Ezeiza,BUENOS AIRES,506,526,953,984,1937
06,06270,062700501,Ezeiza,BUENOS AIRES,294,338,487,454,941
06,06270,062700507,Ezeiza,BUENOS AIRES,384,426,665,635,1300
06,06270,062700603,Ezeiza,BUENOS AIRES,111,260,159,145,304
06,06270,062700705,Ezeiza,BUENOS AIRES,337,335,638,632,1270
06,06270,062700713,Ezeiza,BUENOS AIRES,273,285,529,563,1092
06,06270,062700807,Ezeiza,BUENOS AIRES,72,129,110,110,220
06,06270,062700912,Ezeiza,BUENOS AIRES,280,300,478,494,972
06,06270,062700913,Ezeiza,BUENOS AIRES,297,332,523,550,1073
06,06270,062700902,Ezeiza,BUENOS AIRES,385,418,726,788,1514
06,06270,062700906,Ezeiza,BUENOS AIRES,369,303,723,685,1408
06,06270,062701010,Ezeiza,BUENOS AIRES,338,373,646,689,1335
06,06270,062700217,Ezeiza,BUENOS AIRES,388,411,727,706,1433
06,06270,062700210,Ezeiza,BUENOS AIRES,405,387,815,767,1582
06,06270,062700211,Ezeiza,BUENOS AIRES,439,446,836,845,1681
06,06270,062700306,Ezeiza,BUENOS AIRES,375,377,694,659,1353
06,06270,062700307,Ezeiza,BUENOS AIRES,287,311,478,453,931
06,06270,062700313,Ezeiza,BUENOS AIRES,258,271,457,399,856
06,06270,062700403,Ezeiza,BUENOS AIRES,372,461,555,462,1017
06,06270,062700404,Ezeiza,BUENOS AIRES,401,515,654,654,1308
06,06270,062700410,Ezeiza,BUENOS AIRES,364,380,647,587,1234
06,06270,062700511,Ezeiza,BUENOS AIRES,222,236,388,425,813
06,06270,062700608,Ezeiza,BUENOS AIRES,424,482,734,774,1508
06,06270,062700610,Ezeiza,BUENOS AIRES,559,594,1129,1101,2230
06,06270,062700702,Ezeiza,BUENOS AIRES,218,239,406,420,826
06,06270,062700803,Ezeiza,BUENOS AIRES,75,127,109,126,235
06,06270,062700808,Ezeiza,BUENOS AIRES,380,412,708,637,1345
06,06270,062700809,Ezeiza,BUENOS AIRES,263,280,528,516,1044
06,06270,062700911,Ezeiza,BUENOS AIRES,251,266,414,405,819
06,06270,062700907,Ezeiza,BUENOS AIRES,246,276,383,372,755
06,06270,062700804,Ezeiza,BUENOS AIRES,19,25,31,27,58
06,06270,062700817,Ezeiza,BUENOS AIRES,37,50,62,73,135
06,06270,062700708,Ezeiza,BUENOS AIRES,246,292,393,314,707
06,06270,062701009,Ezeiza,BUENOS AIRES,371,348,719,705,1424
06,06270,062700213,Ezeiza,BUENOS AIRES,256,285,570,533,1103
06,06270,062700506,Ezeiza,BUENOS AIRES,361,367,735,721,1456
06,06270,062700614,Ezeiza,BUENOS AIRES,235,262,436,414,850
06,06270,062700616,Ezeiza,BUENOS AIRES,346,397,709,669,1378
06,06270,062700710,Ezeiza,BUENOS AIRES,207,208,374,345,719
06,06270,062700715,Ezeiza,BUENOS AIRES,278,303,492,503,995
06,06270,062700801,Ezeiza,BUENOS AIRES,75,145,116,121,237
06,06270,062700814,Ezeiza,BUENOS AIRES,116,155,201,189,390
06,06270,062700815,Ezeiza,BUENOS AIRES,170,220,274,295,569
06,06270,062701007,Ezeiza,BUENOS AIRES,377,404,769,724,1493
06,06270,062701103,Ezeiza,BUENOS AIRES,21,24,24,44,68
06,06270,062700101,Ezeiza,BUENOS AIRES,181,204,315,330,645
06,06270,062700905,Ezeiza,BUENOS AIRES,302,317,560,571,1131
06,06270,062700509,Ezeiza,BUENOS AIRES,11,13,15,25,40
06,06270,062700812,Ezeiza,BUENOS AIRES,28,32,30,45,75
06,06270,062701105,Ezeiza,BUENOS AIRES,13,21,16,19,35
06,06329,063290402,General Las Heras,BUENOS AIRES,72,121,95,124,219
06,06329,063290403,General Las Heras,BUENOS AIRES,80,107,124,129,253
06,06329,063290503,General Las Heras,BUENOS AIRES,36,37,57,60,117
06,06329,063290201,General Las Heras,BUENOS AIRES,60,74,98,100,198
06,06329,063290304,General Las Heras,BUENOS AIRES,247,282,420,384,804
06,06329,063290103,General Las Heras,BUENOS AIRES,24,33,24,41,65
06,06329,063290505,General Las Heras,BUENOS AIRES,112,157,189,188,377
06,06329,063290506,General Las Heras,BUENOS AIRES,156,193,240,270,510
06,06329,063290104,General Las Heras,BUENOS AIRES,23,31,30,27,57
06,06329,063290101,General Las Heras,BUENOS AIRES,15,31,22,19,41
06,06329,063290305,General Las Heras,BUENOS AIRES,304,319,547,545,1092
06,06329,063290312,General Las Heras,BUENOS AIRES,332,396,473,392,865
06,06329,063290313,General Las Heras,BUENOS AIRES,190,211,282,239,521
06,06329,063290316,General Las Heras,BUENOS AIRES,264,291,473,445,918
06,06329,063290401,General Las Heras,BUENOS AIRES,32,41,59,71,130
06,06329,063290307,General Las Heras,BUENOS AIRES,153,167,273,275,548
06,06329,063290309,General Las Heras,BUENOS AIRES,251,268,415,367,782
06,06329,063290310,General Las Heras,BUENOS AIRES,307,342,491,462,953
06,06329,063290314,General Las Heras,BUENOS AIRES,192,217,338,272,610
06,06329,063290315,General Las Heras,BUENOS AIRES,294,334,505,463,968
06,06329,063290202,General Las Heras,BUENOS AIRES,18,33,34,35,69
06,06329,063290303,General Las Heras,BUENOS AIRES,64,82,122,126,248
06,06329,063290502,General Las Heras,BUENOS AIRES,101,111,107,165,272
06,06329,063290306,General Las Heras,BUENOS AIRES,217,268,408,378,786
06,06329,063290308,General Las Heras,BUENOS AIRES,318,353,551,491,1042
06,06329,063290311,General Las Heras,BUENOS AIRES,328,370,493,451,944
06,06329,063290102,General Las Heras,BUENOS AIRES,36,53,54,62,116
06,06329,063290301,General Las Heras,BUENOS AIRES,33,47,62,63,125
06,06329,063290601,General Las Heras,BUENOS AIRES,25,43,40,46,86
06,06329,063290317,General Las Heras,BUENOS AIRES,147,149,267,231,498
06,06329,063290501,General Las Heras,BUENOS AIRES,95,115,124,136,260
06,06329,063290203,General Las Heras,BUENOS AIRES,30,50,58,60,118
06,06329,063290302,General Las Heras,BUENOS AIRES,44,71,75,79,154
06,06329,063290504,General Las Heras,BUENOS AIRES,25,30,37,50,87
06,06329,063290602,General Las Heras,BUENOS AIRES,16,43,27,29,56
06,06336,063360701,General Lavalle,BUENOS AIRES,62,109,97,88,185
06,06336,063360203,General Lavalle,BUENOS AIRES,89,121,162,155,317
06,06336,063360204,General Lavalle,BUENOS AIRES,14,26,21,25,46
06,06336,063360201,General Lavalle,BUENOS AIRES,175,227,304,299,603
06,06336,063360101,General Lavalle,BUENOS AIRES,35,58,48,54,102
06,06336,063360501,General Lavalle,BUENOS AIRES,116,178,148,184,332
06,06336,063360901,General Lavalle,BUENOS AIRES,33,54,29,44,73
06,06336,063360202,General Lavalle,BUENOS AIRES,149,192,245,214,459
06,06336,063360205,General Lavalle,BUENOS AIRES,126,156,205,197,402
06,06336,063360401,General Lavalle,BUENOS AIRES,16,26,13,19,32
06,06336,063360601,General Lavalle,BUENOS AIRES,19,36,31,33,64
06,06336,063360801,General Lavalle,BUENOS AIRES,45,55,48,63,111
06,06336,063361002,General Lavalle,BUENOS AIRES,147,212,208,237,445
06,06336,063361001,General Lavalle,BUENOS AIRES,123,165,216,239,455
06,06336,063360301,General Lavalle,BUENOS AIRES,27,44,32,42,74
06,06364,063640205,General Rodríguez,BUENOS AIRES,318,433,506,525,1031
06,06364,063640504,General Rodríguez,BUENOS AIRES,103,108,183,164,347
06,06364,063640116,General Rodríguez,BUENOS AIRES,207,260,311,240,551
06,06364,063640304,General Rodríguez,BUENOS AIRES,202,221,377,434,811
06,06364,063640306,General Rodríguez,BUENOS AIRES,301,401,505,482,987
06,06364,063640308,General Rodríguez,BUENOS AIRES,305,328,571,577,1148
06,06364,063640309,General Rodríguez,BUENOS AIRES,156,153,273,287,560
06,06364,063640411,General Rodríguez,BUENOS AIRES,163,183,313,309,622
06,06364,063640405,General Rodríguez,BUENOS AIRES,337,357,617,631,1248
06,06364,063640412,General Rodríguez,BUENOS AIRES,217,256,407,429,836
06,06364,063640706,General Rodríguez,BUENOS AIRES,309,404,421,361,782
06,06364,063640712,General Rodríguez,BUENOS AIRES,420,473,677,592,1269
06,06364,063640714,General Rodríguez,BUENOS AIRES,274,295,482,440,922
06,06364,063640802,General Rodríguez,BUENOS AIRES,148,186,287,272,559
06,06364,063640803,General Rodríguez,BUENOS AIRES,190,201,328,354,682
06,06364,063640815,General Rodríguez,BUENOS AIRES,188,228,305,344,649
06,06364,063640604,General Rodríguez,BUENOS AIRES,19,35,41,33,74
06,06364,063640204,General Rodríguez,BUENOS AIRES,223,127,381,404,785
06,06364,063640305,General Rodríguez,BUENOS AIRES,187,203,355,330,685
06,06364,063640211,General Rodríguez,BUENOS AIRES,116,167,186,211,397
06,06364,063640214,General Rodríguez,BUENOS AIRES,116,203,180,186,366
06,06364,063640312,General Rodríguez,BUENOS AIRES,273,359,543,491,1034
06,06364,063640401,General Rodríguez,BUENOS AIRES,375,395,656,621,1277
06,06364,063640409,General Rodríguez,BUENOS AIRES,240,277,466,462,928
06,06364,063640702,General Rodríguez,BUENOS AIRES,264,312,447,421,868
06,06364,063640707,General Rodríguez,BUENOS AIRES,251,284,418,346,764
06,06364,063640713,General Rodríguez,BUENOS AIRES,277,324,438,387,825
06,06364,063640808,General Rodríguez,BUENOS AIRES,199,134,349,384,733
06,06364,063640816,General Rodríguez,BUENOS AIRES,221,330,368,369,737
06,06364,063640819,General Rodríguez,BUENOS AIRES,267,305,478,489,967
06,06364,063640601,General Rodríguez,BUENOS AIRES,12,15,13,19,32
06,06364,063640317,General Rodríguez,BUENOS AIRES,94,138,305,285,590
06,06364,063640413,General Rodríguez,BUENOS AIRES,200,240,361,507,868
06,06364,063640501,General Rodríguez,BUENOS AIRES,309,156,565,602,1167
06,06364,063640101,General Rodríguez,BUENOS AIRES,330,364,570,586,1156
06,06364,063640102,General Rodríguez,BUENOS AIRES,227,231,339,314,653
06,06364,063640105,General Rodríguez,BUENOS AIRES,302,343,495,442,937
06,06364,063640113,General Rodríguez,BUENOS AIRES,205,214,397,414,811
06,06364,063640202,General Rodríguez,BUENOS AIRES,300,239,478,518,996
06,06364,063640711,General Rodríguez,BUENOS AIRES,210,238,330,276,606
06,06364,063640318,General Rodríguez,BUENOS AIRES,293,310,498,478,976
06,06364,063640403,General Rodríguez,BUENOS AIRES,350,385,674,681,1355
06,06364,063640404,General Rodríguez,BUENOS AIRES,118,136,203,201,404
06,06364,063640407,General Rodríguez,BUENOS AIRES,190,221,338,308,646
06,06364,063640708,General Rodríguez,BUENOS AIRES,258,295,435,347,782
06,06364,063640804,General Rodríguez,BUENOS AIRES,157,182,260,283,543
06,06364,063640810,General Rodríguez,BUENOS AIRES,290,332,502,527,1029
06,06364,063640814,General Rodríguez,BUENOS AIRES,196,249,352,349,701
06,06364,063640817,General Rodríguez,BUENOS AIRES,237,283,454,457,911
06,06364,063640821,General Rodríguez,BUENOS AIRES,157,179,292,290,582
06,06364,063640502,General Rodríguez,BUENOS AIRES,24,29,265,338,603
06,06364,063640414,General Rodríguez,BUENOS AIRES,47,51,68,74,142
06,06364,063640801,General Rodríguez,BUENOS AIRES,141,240,227,240,467
06,06364,063640603,General Rodríguez,BUENOS AIRES,24,83,37,40,77
06,06364,063640109,General Rodríguez,BUENOS AIRES,245,271,483,498,981
06,06364,063640110,General Rodríguez,BUENOS AIRES,252,267,468,463,931
06,06364,063640112,General Rodríguez,BUENOS AIRES,187,209,342,294,636
06,06364,063640210,General Rodríguez,BUENOS AIRES,283,352,487,472,959
06,06364,063640313,General Rodríguez,BUENOS AIRES,106,296,194,146,340
06,06364,063640314,General Rodríguez,BUENOS AIRES,0,213,0,0,0
06,06364,063640704,General Rodríguez,BUENOS AIRES,332,391,661,630,1291
06,06364,063640705,General Rodríguez,BUENOS AIRES,270,285,510,410,920
06,06364,063640809,General Rodríguez,BUENOS AIRES,263,301,462,487,949
06,06364,063640818,General Rodríguez,BUENOS AIRES,262,292,452,452,904
06,06364,063640208,General Rodríguez,BUENOS AIRES,230,219,405,372,777
06,06364,063640103,General Rodríguez,BUENOS AIRES,368,373,575,503,1078
06,06364,063640206,General Rodríguez,BUENOS AIRES,234,237,395,419,814
06,06364,063640213,General Rodríguez,BUENOS AIRES,143,225,246,261,507
06,06364,063640303,General Rodríguez,BUENOS AIRES,230,274,406,429,835
06,06364,063640406,General Rodríguez,BUENOS AIRES,213,242,412,426,838
06,06364,063640408,General Rodríguez,BUENOS AIRES,237,218,442,468,910
06,06364,063640701,General Rodríguez,BUENOS AIRES,263,306,399,438,837
06,06364,063640811,General Rodríguez,BUENOS AIRES,161,178,323,331,654
06,06364,063640106,General Rodríguez,BUENOS AIRES,275,297,436,412,848
06,06364,063640104,General Rodríguez,BUENOS AIRES,262,295,494,502,996
06,06364,063640117,General Rodríguez,BUENOS AIRES,191,230,275,291,566
06,06364,063640119,General Rodríguez,BUENOS AIRES,379,434,574,531,1105
06,06364,063640203,General Rodríguez,BUENOS AIRES,362,643,559,595,1154
06,06364,063640207,General Rodríguez,BUENOS AIRES,335,348,606,614,1220
06,06364,063640310,General Rodríguez,BUENOS AIRES,161,187,296,308,604
06,06364,063640315,General Rodríguez,BUENOS AIRES,167,281,342,319,661
06,06364,063640410,General Rodríguez,BUENOS AIRES,256,284,458,468,926
06,06364,063640710,General Rodríguez,BUENOS AIRES,186,271,237,207,444
06,06364,063640703,General Rodríguez,BUENOS AIRES,234,293,395,345,740
06,06364,063640807,General Rodríguez,BUENOS AIRES,259,137,493,492,985
06,06364,063640820,General Rodríguez,BUENOS AIRES,195,224,421,403,824
06,06364,063640602,General Rodríguez,BUENOS AIRES,14,35,16,18,34
06,06364,063640301,General Rodríguez,BUENOS AIRES,209,276,336,373,709
06,06364,063640115,General Rodríguez,BUENOS AIRES,196,255,304,249,553
06,06364,063640118,General Rodríguez,BUENOS AIRES,202,257,307,278,585
06,06364,063640201,General Rodríguez,BUENOS AIRES,176,255,310,293,603
06,06364,063640209,General Rodríguez,BUENOS AIRES,233,190,413,427,840
06,06364,063640302,General Rodríguez,BUENOS AIRES,260,295,464,474,938
06,06364,063640307,General Rodríguez,BUENOS AIRES,448,483,877,795,1672
06,06364,063640316,General Rodríguez,BUENOS AIRES,0,317,0,0,0
06,06364,063640402,General Rodríguez,BUENOS AIRES,345,170,676,668,1344
06,06364,063640716,General Rodríguez,BUENOS AIRES,183,209,363,339,702
06,06364,063640717,General Rodríguez,BUENOS AIRES,159,199,321,327,648
06,06364,063640812,General Rodríguez,BUENOS AIRES,152,186,313,314,627
06,06364,063640813,General Rodríguez,BUENOS AIRES,259,326,457,481,938
06,06364,063640822,General Rodríguez,BUENOS AIRES,178,223,358,350,708
06,06364,063640823,General Rodríguez,BUENOS AIRES,305,384,521,536,1057
06,06364,063640503,General Rodríguez,BUENOS AIRES,15,23,15,18,33
06,06364,063640107,General Rodríguez,BUENOS AIRES,220,238,417,395,812
06,06364,063640108,General Rodríguez,BUENOS AIRES,257,261,488,458,946
06,06364,063640111,General Rodríguez,BUENOS AIRES,274,294,455,419,874
06,06364,063640114,General Rodríguez,BUENOS AIRES,411,423,678,683,1361
06,06364,063640212,General Rodríguez,BUENOS AIRES,100,165,160,150,310
06,06364,063640311,General Rodríguez,BUENOS AIRES,136,459,264,213,477
06,06364,063640709,General Rodríguez,BUENOS AIRES,397,439,623,549,1172
06,06364,063640715,General Rodríguez,BUENOS AIRES,227,244,396,389,785
06,06364,063640805,General Rodríguez,BUENOS AIRES,284,298,466,499,965
06,06364,063640806,General Rodríguez,BUENOS AIRES,208,237,391,389,780
06,06413,064131202,Junín,BUENOS AIRES,0,0,0,0,0
06,06413,064131506,Junín,BUENOS AIRES,7,45,32,26,58
06,06413,064132202,Junín,BUENOS AIRES,117,126,199,203,402
06,06413,064130101,Junín,BUENOS AIRES,279,281,484,479,963
06,06413,064130202,Junín,BUENOS AIRES,291,303,468,476,944
06,06413,064130306,Junín,BUENOS AIRES,274,329,392,293,685
06,06413,064130406,Junín,BUENOS AIRES,292,459,384,273,657
06,06413,064130509,Junín,BUENOS AIRES,327,374,473,361,834
06,06413,064130602,Junín,BUENOS AIRES,277,289,389,398,787
06,06413,064130605,Junín,BUENOS AIRES,340,424,482,393,875
06,06413,064131308,Junín,BUENOS AIRES,140,187,239,266,505
06,06413,064131403,Junín,BUENOS AIRES,85,95,195,196,391
06,06413,064131501,Junín,BUENOS AIRES,108,123,162,181,343
06,06413,064132108,Junín,BUENOS AIRES,438,477,686,660,1346
06,06413,064132206,Junín,BUENOS AIRES,108,160,164,169,333
06,06413,064132211,Junín,BUENOS AIRES,204,256,301,266,567
06,06413,064130902,Junín,BUENOS AIRES,9,10,12,14,26
06,06413,064131803,Junín,BUENOS AIRES,14,27,21,19,40
06,06413,064131407,Junín,BUENOS AIRES,371,366,746,714,1460
06,06413,064130107,Junín,BUENOS AIRES,331,361,525,464,989
06,06413,064130109,Junín,BUENOS AIRES,285,310,407,368,775
06,06413,064130201,Junín,BUENOS AIRES,408,422,732,722,1454
06,06413,064130310,Junín,BUENOS AIRES,292,288,447,464,911
06,06413,064130511,Junín,BUENOS AIRES,330,401,426,372,798
06,06413,064131305,Junín,BUENOS AIRES,158,181,284,294,578
06,06413,064131502,Junín,BUENOS AIRES,27,27,45,43,88
06,06413,064132205,Junín,BUENOS AIRES,178,197,366,332,698
06,06413,064131802,Junín,BUENOS AIRES,39,42,77,62,139
06,06413,064132109,Junín,BUENOS AIRES,473,517,715,722,1437
06,06413,064132110,Junín,BUENOS AIRES,392,419,563,464,1027
06,06413,064130702,Junín,BUENOS AIRES,0,0,0,0,0
06,06413,064130903,Junín,BUENOS AIRES,0,0,0,0,0
06,06413,064131404,Junín,BUENOS AIRES,24,34,42,699,741
06,06413,064131402,Junín,BUENOS AIRES,36,42,60,59,119
06,06413,064131201,Junín,BUENOS AIRES,0,0,0,0,0
06,06413,064130105,Junín,BUENOS AIRES,282,278,466,437,903
06,06413,064130209,Junín,BUENOS AIRES,311,355,457,389,846
06,06413,064130412,Junín,BUENOS AIRES,248,277,374,351,725
06,06413,064130601,Junín,BUENOS AIRES,197,206,299,274,573
06,06413,064130611,Junín,BUENOS AIRES,295,314,460,434,894
06,06413,064131406,Junín,BUENOS AIRES,147,154,298,248,546
06,06413,064131408,Junín,BUENOS AIRES,178,200,400,401,801
06,06413,064131505,Junín,BUENOS AIRES,40,168,48,58,106
06,06413,064131508,Junín,BUENOS AIRES,34,110,44,47,91
06,06413,064131509,Junín,BUENOS AIRES,34,121,42,44,86
06,06413,064132101,Junín,BUENOS AIRES,436,461,669,707,1376
06,06413,064132107,Junín,BUENOS AIRES,267,304,384,339,723
06,06413,064132210,Junín,BUENOS AIRES,157,186,254,235,489
06,06413,064132001,Junín,BUENOS AIRES,0,0,0,0,0
06,06413,064130701,Junín,BUENOS AIRES,0,0,0,0,0
06,06413,064131805,Junín,BUENOS AIRES,4,7,7,5,12
06,06413,064131901,Junín,BUENOS AIRES,15,39,29,23,52
06,06413,064132003,Junín,BUENOS AIRES,0,0,0,0,0
06,06413,064131301,Junín,BUENOS AIRES,118,147,175,203,378
06,06413,064130505,Junín,BUENOS AIRES,159,235,192,111,303
06,06413,064130603,Junín,BUENOS AIRES,338,375,490,432,922
06,06413,064130204,Junín,BUENOS AIRES,273,302,526,482,1008
06,06413,064130208,Junín,BUENOS AIRES,316,348,469,395,864
06,06413,064130210,Junín,BUENOS AIRES,322,379,445,346,791
06,06413,064130407,Junín,BUENOS AIRES,256,292,332,302,634
06,06413,064130609,Junín,BUENOS AIRES,332,358,534,506,1040
06,06413,064132209,Junín,BUENOS AIRES,128,147,187,191,378
06,06413,064131104,Junín,BUENOS AIRES,0,0,0,0,0
06,06413,064131902,Junín,BUENOS AIRES,165,187,330,316,646
06,06413,064130901,Junín,BUENOS AIRES,42,50,85,70,155
06,06413,064131507,Junín,BUENOS AIRES,68,383,91,94,185
06,06413,064131801,Junín,BUENOS AIRES,106,113,198,210,408
06,06413,064130108,Junín,BUENOS AIRES,299,327,495,412,907
06,06413,064130102,Junín,BUENOS AIRES,293,278,473,435,908
06,06413,064130104,Junín,BUENOS AIRES,372,377,607,568,1175
06,06413,064130203,Junín,BUENOS AIRES,322,354,542,488,1030
06,06413,064130211,Junín,BUENOS AIRES,298,375,368,349,717
06,06413,064130212,Junín,BUENOS AIRES,301,352,420,358,778
06,06413,064130213,Junín,BUENOS AIRES,258,274,479,427,906
06,06413,064130305,Junín,BUENOS AIRES,240,373,319,255,574
06,06413,064130311,Junín,BUENOS AIRES,267,292,394,390,784
06,06413,064130409,Junín,BUENOS AIRES,386,467,502,467,969
06,06413,064130502,Junín,BUENOS AIRES,298,345,416,334,750
06,06413,064130513,Junín,BUENOS AIRES,148,224,240,157,397
06,06413,064130606,Junín,BUENOS AIRES,307,367,394,352,746
06,06413,064131303,Junín,BUENOS AIRES,172,200,306,299,605
06,06413,064131903,Junín,BUENOS AIRES,40,62,70,74,144
06,06413,064132203,Junín,BUENOS AIRES,42,105,65,66,131
06,06413,064132207,Junín,BUENOS AIRES,68,99,110,103,213
06,06413,064130801,Junín,BUENOS AIRES,0,0,0,0,0
06,06413,064130802,Junín,BUENOS AIRES,0,0,0,0,0
06,06413,064131001,Junín,BUENOS AIRES,0,0,0,0,0
06,06413,064131105,Junín,BUENOS AIRES,0,0,0,0,0
06,06413,064131701,Junín,BUENOS AIRES,0,0,0,0,0
06,06413,064131906,Junín,BUENOS AIRES,35,63,38,53,91
06,06413,064130106,Junín,BUENOS AIRES,380,403,623,588,1211
06,06413,064130206,Junín,BUENOS AIRES,294,304,521,543,1064
06,06413,064130301,Junín,BUENOS AIRES,139,195,194,152,346
06,06413,064130304,Junín,BUENOS AIRES,215,313,324,264,588
06,06413,064130401,Junín,BUENOS AIRES,265,323,381,285,666
06,06413,064130402,Junín,BUENOS AIRES,225,397,317,223,540
06,06413,064130413,Junín,BUENOS AIRES,380,437,577,528,1105
06,06413,064130501,Junín,BUENOS AIRES,400,481,505,423,928
06,06413,064130506,Junín,BUENOS AIRES,266,384,345,257,602
06,06413,064130703,Junín,BUENOS AIRES,37,40,71,64,135
06,06413,064131106,Junín,BUENOS AIRES,40,49,71,68,139
06,06413,064131302,Junín,BUENOS AIRES,332,343,586,565,1151
06,06413,064131601,Junín,BUENOS AIRES,8,20,7,15,22
06,06413,064132102,Junín,BUENOS AIRES,305,323,508,476,984
06,06413,064132104,Junín,BUENOS AIRES,452,478,659,579,1238
06,06413,064132204,Junín,BUENOS AIRES,50,110,90,69,159
06,06413,064132212,Junín,BUENOS AIRES,97,140,139,147,286
06,06413,064131604,Junín,BUENOS AIRES,0,0,0,0,0
06,06413,064131410,Junín,BUENOS AIRES,0,0,0,0,0
06,06413,064130110,Junín,BUENOS AIRES,344,401,508,430,938
06,06413,064130205,Junín,BUENOS AIRES,329,274,579,597,1176
06,06413,064130302,Junín,BUENOS AIRES,256,374,358,278,636
06,06413,064130303,Junín,BUENOS AIRES,313,419,412,252,664
06,06413,064130307,Junín,BUENOS AIRES,363,401,564,501,1065
06,06413,064130309,Junín,BUENOS AIRES,314,311,529,511,1040
06,06413,064130405,Junín,BUENOS AIRES,288,362,403,350,753
06,06413,064130410,Junín,BUENOS AIRES,193,235,267,226,493
06,06413,064130411,Junín,BUENOS AIRES,351,353,513,451,964
06,06413,064130503,Junín,BUENOS AIRES,329,392,441,381,822
06,06413,064130610,Junín,BUENOS AIRES,239,246,418,375,793
06,06413,064131304,Junín,BUENOS AIRES,286,379,524,478,1002
06,06413,064131306,Junín,BUENOS AIRES,35,40,60,55,115
06,06413,064131307,Junín,BUENOS AIRES,358,365,612,596,1208
06,06413,064131409,Junín,BUENOS AIRES,129,142,252,214,466
06,06413,064131905,Junín,BUENOS AIRES,44,68,82,88,170
06,06413,064132103,Junín,BUENOS AIRES,228,261,317,275,592
06,06413,064132106,Junín,BUENOS AIRES,210,230,301,252,553
06,06413,064132208,Junín,BUENOS AIRES,110,109,199,168,367
06,06413,064131103,Junín,BUENOS AIRES,0,0,0,0,0
06,06413,064131102,Junín,BUENOS AIRES,0,0,0,0,0
06,06413,064131503,Junín,BUENOS AIRES,22,35,27,34,61
06,06413,064131504,Junín,BUENOS AIRES,2,10,2,4,6
06,06413,064131603,Junín,BUENOS AIRES,0,0,0,0,0
06,06413,064132002,Junín,BUENOS AIRES,0,0,0,0,0
06,06413,064131806,Junín,BUENOS AIRES,17,18,22,24,46
06,06413,064131101,Junín,BUENOS AIRES,47,56,89,103,192
06,06413,064130103,Junín,BUENOS AIRES,295,305,472,469,941
06,06413,064130207,Junín,BUENOS AIRES,368,438,706,577,1283
06,06413,064130308,Junín,BUENOS AIRES,217,223,398,394,792
06,06413,064130403,Junín,BUENOS AIRES,324,406,456,350,806
06,06413,064130404,Junín,BUENOS AIRES,403,438,555,473,1028
06,06413,064130408,Junín,BUENOS AIRES,439,471,631,548,1179
06,06413,064130504,Junín,BUENOS AIRES,318,370,432,342,774
06,06413,064130507,Junín,BUENOS AIRES,384,423,547,452,999
06,06413,064130508,Junín,BUENOS AIRES,271,355,357,288,645
06,06413,064130510,Junín,BUENOS AIRES,210,219,299,289,588
06,06413,064130512,Junín,BUENOS AIRES,339,370,478,395,873
06,06413,064130604,Junín,BUENOS AIRES,373,433,529,435,964
06,06413,064130607,Junín,BUENOS AIRES,378,441,556,479,1035
06,06413,064130608,Junín,BUENOS AIRES,250,276,385,376,761
06,06413,064130612,Junín,BUENOS AIRES,246,252,404,402,806
06,06413,064130704,Junín,BUENOS AIRES,32,32,60,62,122
06,06413,064131309,Junín,BUENOS AIRES,217,228,373,400,773
06,06413,064131405,Junín,BUENOS AIRES,1,1,2,359,361
06,06413,064131904,Junín,BUENOS AIRES,46,89,69,72,141
06,06413,064132105,Junín,BUENOS AIRES,287,313,419,366,785
06,06413,064132201,Junín,BUENOS AIRES,118,138,207,281,488
06,06413,064131602,Junín,BUENOS AIRES,0,0,0,0,0
06,06413,064130904,Junín,BUENOS AIRES,0,0,0,0,0
06,06413,064131401,Junín,BUENOS AIRES,36,44,64,73,137
06,06413,064131804,Junín,BUENOS AIRES,3,6,4,4,8
06,06525,065250303,Marcos Paz,BUENOS AIRES,449,423,966,988,1954
06,06525,065250501,Marcos Paz,BUENOS AIRES,516,598,934,1266,2200
06,06525,065250107,Marcos Paz,BUENOS AIRES,322,380,429,423,852
06,06525,065250410,Marcos Paz,BUENOS AIRES,14,27,31,24,55
06,06525,065250411,Marcos Paz,BUENOS AIRES,81,94,176,167,343
06,06525,065250610,Marcos Paz,BUENOS AIRES,360,410,644,622,1266
06,06525,065250203,Marcos Paz,BUENOS AIRES,305,409,539,566,1105
06,06525,065250302,Marcos Paz,BUENOS AIRES,35,39,59,101,160
06,06525,065250413,Marcos Paz,BUENOS AIRES,73,196,141,159,300
06,06525,065250202,Marcos Paz,BUENOS AIRES,40,51,62,65,127
06,06525,065250105,Marcos Paz,BUENOS AIRES,284,311,535,514,1049
06,06525,065250409,Marcos Paz,BUENOS AIRES,338,371,638,598,1236
06,06525,065250504,Marcos Paz,BUENOS AIRES,118,175,220,252,472
06,06525,065250301,Marcos Paz,BUENOS AIRES,35,43,44,71,115
06,06525,065250412,Marcos Paz,BUENOS AIRES,80,105,132,153,285
06,06525,065250503,Marcos Paz,BUENOS AIRES,19,28,26,36,62
06,06525,065250110,Marcos Paz,BUENOS AIRES,258,289,382,318,700
06,06525,065250103,Marcos Paz,BUENOS AIRES,130,138,233,236,469
06,06525,065250109,Marcos Paz,BUENOS AIRES,348,389,516,510,1026
06,06525,065250114,Marcos Paz,BUENOS AIRES,256,305,520,472,992
06,06525,065250304,Marcos Paz,BUENOS AIRES,254,283,502,519,1021
06,06525,065250407,Marcos Paz,BUENOS AIRES,281,291,522,526,1048
06,06525,065250609,Marcos Paz,BUENOS AIRES,271,285,548,549,1097
06,06525,065250607,Marcos Paz,BUENOS AIRES,549,606,901,869,1770
06,06525,065250612,Marcos Paz,BUENOS AIRES,305,330,581,533,1114
06,06525,065250108,Marcos Paz,BUENOS AIRES,332,381,484,423,907
06,06525,065250201,Marcos Paz,BUENOS AIRES,32,30,52,64,116
06,06525,065250106,Marcos Paz,BUENOS AIRES,317,351,579,528,1107
06,06525,065250608,Marcos Paz,BUENOS AIRES,236,262,403,411,814
06,06525,065250403,Marcos Paz,BUENOS AIRES,228,235,447,466,913
06,06525,065250404,Marcos Paz,BUENOS AIRES,352,349,698,717,1415
06,06525,065250605,Marcos Paz,BUENOS AIRES,196,207,336,291,627
06,06525,065250606,Marcos Paz,BUENOS AIRES,497,543,698,665,1363
06,06525,065250611,Marcos Paz,BUENOS AIRES,483,553,741,651,1392
06,06525,065250414,Marcos Paz,BUENOS AIRES,373,419,746,706,1452
06,06525,065250104,Marcos Paz,BUENOS AIRES,189,190,326,333,659
06,06525,065250402,Marcos Paz,BUENOS AIRES,433,446,835,824,1659
06,06525,065250408,Marcos Paz,BUENOS AIRES,414,443,766,699,1465
06,06525,065250113,Marcos Paz,BUENOS AIRES,160,199,253,229,482
06,06525,065250405,Marcos Paz,BUENOS AIRES,422,446,823,835,1658
06,06525,065250406,Marcos Paz,BUENOS AIRES,488,496,957,977,1934
06,06525,065250601,Marcos Paz,BUENOS AIRES,129,143,295,287,582
06,06525,065250204,Marcos Paz,BUENOS AIRES,146,502,225,224,449
06,06525,065250416,Marcos Paz,BUENOS AIRES,135,167,272,280,552
06,06525,065250418,Marcos Paz,BUENOS AIRES,400,422,744,694,1438
06,06525,065250614,Marcos Paz,BUENOS AIRES,171,187,245,230,475
06,06525,065250111,Marcos Paz,BUENOS AIRES,399,449,677,638,1315
06,06525,065250401,Marcos Paz,BUENOS AIRES,413,441,774,746,1520
06,06525,065250417,Marcos Paz,BUENOS AIRES,437,464,876,813,1689
06,06525,065250602,Marcos Paz,BUENOS AIRES,116,142,211,229,440
06,06525,065250603,Marcos Paz,BUENOS AIRES,147,164,274,275,549
06,06525,065250604,Marcos Paz,BUENOS AIRES,190,214,293,307,600
06,06525,065250613,Marcos Paz,BUENOS AIRES,303,343,515,483,998
06,06525,065250112,Marcos Paz,BUENOS AIRES,190,181,308,358,666
06,06525,065250415,Marcos Paz,BUENOS AIRES,263,290,573,525,1098
06,06525,065250502,Marcos Paz,BUENOS AIRES,33,39,86,1778,1864
06,06525,065250101,Marcos Paz,BUENOS AIRES,155,180,289,288,577
06,06525,065250102,Marcos Paz,BUENOS AIRES,156,167,297,291,588
06,06483,064830401,Lobos,BUENOS AIRES,512,257,920,862,1782
06,06483,064830602,Lobos,BUENOS AIRES,119,222,188,213,401
06,06483,064830906,Lobos,BUENOS AIRES,28,47,44,49,93
06,06483,064830104,Lobos,BUENOS AIRES,253,291,370,289,659
06,06483,064830101,Lobos,BUENOS AIRES,456,499,779,687,1466
06,06483,064830114,Lobos,BUENOS AIRES,300,320,559,482,1041
06,06483,064830118,Lobos,BUENOS AIRES,239,263,372,369,741
06,06483,064830405,Lobos,BUENOS AIRES,274,308,456,409,865
06,06483,064830417,Lobos,BUENOS AIRES,118,158,222,191,413
06,06483,064830501,Lobos,BUENOS AIRES,341,366,553,521,1074
06,06483,064830705,Lobos,BUENOS AIRES,17,27,25,33,58
06,06483,064830413,Lobos,BUENOS AIRES,397,431,690,732,1422
06,06483,064830706,Lobos,BUENOS AIRES,30,37,37,50,87
06,06483,064830103,Lobos,BUENOS AIRES,388,434,585,504,1089
06,06483,064830102,Lobos,BUENOS AIRES,368,419,610,587,1197
06,06483,064830108,Lobos,BUENOS AIRES,237,307,314,265,579
06,06483,064830109,Lobos,BUENOS AIRES,280,330,427,318,745
06,06483,064830407,Lobos,BUENOS AIRES,372,392,639,605,1244
06,06483,064830409,Lobos,BUENOS AIRES,292,322,466,433,899
06,06483,064830806,Lobos,BUENOS AIRES,137,170,221,215,436
06,06483,064830506,Lobos,BUENOS AIRES,9,16,12,15,27
06,06483,064830410,Lobos,BUENOS AIRES,183,203,283,294,577
06,06483,064830412,Lobos,BUENOS AIRES,271,308,462,405,867
06,06483,064830414,Lobos,BUENOS AIRES,269,296,445,408,853
06,06483,064830702,Lobos,BUENOS AIRES,50,77,66,62,128
06,06483,064830801,Lobos,BUENOS AIRES,106,121,165,136,301
06,06483,064830805,Lobos,BUENOS AIRES,16,35,23,29,52
06,06483,064830907,Lobos,BUENOS AIRES,27,56,44,42,86
06,06483,064830112,Lobos,BUENOS AIRES,205,220,406,310,716
06,06483,064830406,Lobos,BUENOS AIRES,109,118,167,177,344
06,06483,064830601,Lobos,BUENOS AIRES,32,35,52,54,106
06,06483,064830703,Lobos,BUENOS AIRES,30,56,46,49,95
06,06483,064830902,Lobos,BUENOS AIRES,41,58,48,70,118
06,06483,064831001,Lobos,BUENOS AIRES,29,54,34,43,77
06,06483,064830117,Lobos,BUENOS AIRES,278,312,441,402,843
06,06483,064830415,Lobos,BUENOS AIRES,326,341,581,538,1119
06,06483,064830201,Lobos,BUENOS AIRES,13,26,19,28,47
06,06483,064830503,Lobos,BUENOS AIRES,57,76,71,92,163
06,06483,064830303,Lobos,BUENOS AIRES,73,87,112,121,233
06,06483,064830904,Lobos,BUENOS AIRES,34,103,43,70,113
06,06483,064830106,Lobos,BUENOS AIRES,307,371,402,334,736
06,06483,064830115,Lobos,BUENOS AIRES,214,243,371,332,703
06,06483,064830301,Lobos,BUENOS AIRES,94,82,157,159,316
06,06483,064830403,Lobos,BUENOS AIRES,154,167,263,231,494
06,06483,064830404,Lobos,BUENOS AIRES,363,379,592,566,1158
06,06483,064830701,Lobos,BUENOS AIRES,112,124,152,143,295
06,06483,064830302,Lobos,BUENOS AIRES,87,124,145,161,306
06,06483,064830502,Lobos,BUENOS AIRES,42,64,54,74,128
06,06483,064830504,Lobos,BUENOS AIRES,71,95,109,115,224
06,06483,064830704,Lobos,BUENOS AIRES,8,11,14,15,29
06,06483,064830802,Lobos,BUENOS AIRES,43,62,53,65,118
06,06483,064830905,Lobos,BUENOS AIRES,39,55,53,53,106
06,06483,064830803,Lobos,BUENOS AIRES,30,33,48,49,97
06,06483,064830107,Lobos,BUENOS AIRES,215,333,317,222,539
06,06483,064830110,Lobos,BUENOS AIRES,306,341,441,399,840
06,06483,064830402,Lobos,BUENOS AIRES,180,204,267,247,514
06,06483,064830416,Lobos,BUENOS AIRES,228,251,401,370,771
06,06483,064830505,Lobos,BUENOS AIRES,42,68,52,78,130
06,06483,064830203,Lobos,BUENOS AIRES,22,29,29,48,77
06,06483,064830903,Lobos,BUENOS AIRES,74,120,88,142,230
06,06483,064830901,Lobos,BUENOS AIRES,87,244,117,125,242
06,06483,064830105,Lobos,BUENOS AIRES,277,331,412,329,741
06,06483,064830111,Lobos,BUENOS AIRES,257,285,365,355,720
06,06483,064830113,Lobos,BUENOS AIRES,243,267,371,350,721
06,06483,064830116,Lobos,BUENOS AIRES,224,247,366,338,704
06,06483,064830408,Lobos,BUENOS AIRES,259,278,379,344,723
06,06483,064830411,Lobos,BUENOS AIRES,201,213,292,245,537
06,06483,064830908,Lobos,BUENOS AIRES,85,242,127,142,269
06,06483,064830202,Lobos,BUENOS AIRES,33,39,47,63,110
06,06483,064830304,Lobos,BUENOS AIRES,53,76,90,100,190
06,06483,064830804,Lobos,BUENOS AIRES,36,66,42,59,101
06,06483,064831002,Lobos,BUENOS AIRES,47,58,62,85,147
06,06455,064551301,Las Flores,BUENOS AIRES,147,260,183,196,379
06,06455,064550101,Las Flores,BUENOS AIRES,314,348,461,439,900
06,06455,064551409,Las Flores,BUENOS AIRES,77,87,113,114,227
06,06455,064551411,Las Flores,BUENOS AIRES,216,240,342,306,648
06,06455,064550802,Las Flores,BUENOS AIRES,26,85,24,47,71
06,06455,064550201,Las Flores,BUENOS AIRES,32,52,32,48,80
06,06455,064550603,Las Flores,BUENOS AIRES,40,66,48,59,107
06,06455,064550605,Las Flores,BUENOS AIRES,22,27,23,30,53
06,06455,064550701,Las Flores,BUENOS AIRES,66,107,79,97,176
06,06455,064550113,Las Flores,BUENOS AIRES,211,236,318,298,616
06,06455,064551414,Las Flores,BUENOS AIRES,242,340,343,266,609
06,06455,064550606,Las Flores,BUENOS AIRES,15,22,21,34,55
06,06455,064550607,Las Flores,BUENOS AIRES,55,81,68,76,144
06,06455,064550901,Las Flores,BUENOS AIRES,36,72,38,58,96
06,06455,064550801,Las Flores,BUENOS AIRES,18,27,19,24,43
06,06455,064550106,Las Flores,BUENOS AIRES,288,296,465,415,880
06,06455,064550110,Las Flores,BUENOS AIRES,271,345,419,325,744
06,06455,064550114,Las Flores,BUENOS AIRES,257,290,368,367,735
06,06455,064551401,Las Flores,BUENOS AIRES,320,301,579,544,1123
06,06455,064551412,Las Flores,BUENOS AIRES,355,403,505,447,952
06,06455,064551413,Las Flores,BUENOS AIRES,321,370,430,372,802
06,06455,064551406,Las Flores,BUENOS AIRES,321,359,454,377,831
06,06455,064551410,Las Flores,BUENOS AIRES,284,326,463,446,909
06,06455,064550602,Las Flores,BUENOS AIRES,18,33,14,19,33
06,06455,064551101,Las Flores,BUENOS AIRES,59,124,73,94,167
06,06455,064550107,Las Flores,BUENOS AIRES,183,213,328,322,650
06,06455,064550108,Las Flores,BUENOS AIRES,264,290,405,426,831
06,06455,064551403,Las Flores,BUENOS AIRES,144,231,221,246,467
06,06455,064550109,Las Flores,BUENOS AIRES,263,314,381,348,729
06,06455,064550102,Las Flores,BUENOS AIRES,270,287,350,315,665
06,06455,064550104,Las Flores,BUENOS AIRES,226,288,321,274,595
06,06455,064550105,Las Flores,BUENOS AIRES,258,286,434,351,785
06,06455,064551404,Las Flores,BUENOS AIRES,160,177,221,215,436
06,06455,064551405,Las Flores,BUENOS AIRES,280,326,410,347,757
06,06455,064551407,Las Flores,BUENOS AIRES,306,344,460,396,856
06,06455,064551408,Las Flores,BUENOS AIRES,329,346,480,445,925
06,06455,064550301,Las Flores,BUENOS AIRES,47,103,55,79,134
06,06455,064550604,Las Flores,BUENOS AIRES,56,118,62,80,142
06,06455,064550111,Las Flores,BUENOS AIRES,143,170,224,223,447
06,06455,064550401,Las Flores,BUENOS AIRES,80,154,100,125,225
06,06455,064550501,Las Flores,BUENOS AIRES,27,42,28,39,67
06,06455,064550601,Las Flores,BUENOS AIRES,61,89,89,87,176
06,06455,064551201,Las Flores,BUENOS AIRES,62,123,92,92,184
06,06455,064550103,Las Flores,BUENOS AIRES,251,323,401,268,669
06,06455,064550112,Las Flores,BUENOS AIRES,186,218,285,272,557
06,06455,064550115,Las Flores,BUENOS AIRES,154,181,270,249,519
06,06455,064551402,Las Flores,BUENOS AIRES,427,472,819,772,1591
06,06455,064551001,Las Flores,BUENOS AIRES,25,37,35,49,84
06,06462,064620203,Leandro N. Alem,BUENOS AIRES,7,23,11,12,23
06,06462,064620705,Leandro N. Alem,BUENOS AIRES,312,358,418,328,746
06,06462,064621202,Leandro N. Alem,BUENOS AIRES,444,485,595,566,1161
06,06462,064620403,Leandro N. Alem,BUENOS AIRES,392,444,575,489,1064
06,06462,064620101,Leandro N. Alem,BUENOS AIRES,12,38,10,21,31
06,06462,064621101,Leandro N. Alem,BUENOS AIRES,16,31,24,29,53
06,06462,064621207,Leandro N. Alem,BUENOS AIRES,22,32,31,40,71
06,06462,064620404,Leandro N. Alem,BUENOS AIRES,38,57,50,60,110
06,06462,064620703,Leandro N. Alem,BUENOS AIRES,398,452,569,502,1071
06,06462,064620706,Leandro N. Alem,BUENOS AIRES,446,504,683,646,1329
06,06462,064620301,Leandro N. Alem,BUENOS AIRES,9,29,10,10,20
06,06462,064620901,Leandro N. Alem,BUENOS AIRES,13,23,15,22,37
06,06462,064620405,Leandro N. Alem,BUENOS AIRES,36,60,43,53,96
06,06462,064620710,Leandro N. Alem,BUENOS AIRES,40,51,63,57,120
06,06462,064620201,Leandro N. Alem,BUENOS AIRES,33,46,46,55,101
06,06462,064620402,Leandro N. Alem,BUENOS AIRES,276,313,401,333,734
06,06462,064620601,Leandro N. Alem,BUENOS AIRES,104,135,155,163,318
06,06462,064621201,Leandro N. Alem,BUENOS AIRES,112,136,166,195,361
06,06462,064620406,Leandro N. Alem,BUENOS AIRES,110,129,148,147,295
06,06462,064620501,Leandro N. Alem,BUENOS AIRES,6,32,12,11,23
06,06462,064620709,Leandro N. Alem,BUENOS AIRES,9,13,10,15,25
06,06462,064620602,Leandro N. Alem,BUENOS AIRES,8,33,11,14,25
06,06462,064620604,Leandro N. Alem,BUENOS AIRES,13,31,13,22,35
06,06462,064621001,Leandro N. Alem,BUENOS AIRES,20,32,19,19,38
06,06462,064621102,Leandro N. Alem,BUENOS AIRES,8,15,15,14,29
06,06462,064620401,Leandro N. Alem,BUENOS AIRES,111,131,166,152,318
06,06462,064620707,Leandro N. Alem,BUENOS AIRES,401,455,594,570,1164
06,06462,064621203,Leandro N. Alem,BUENOS AIRES,303,360,447,444,891
06,06462,064620605,Leandro N. Alem,BUENOS AIRES,15,32,23,21,44
06,06462,064620711,Leandro N. Alem,BUENOS AIRES,8,16,10,20,30
06,06462,064620801,Leandro N. Alem,BUENOS AIRES,29,52,59,54,113
06,06462,064621204,Leandro N. Alem,BUENOS AIRES,8,19,14,10,24
06,06462,064620708,Leandro N. Alem,BUENOS AIRES,282,309,370,338,708
06,06462,064621002,Leandro N. Alem,BUENOS AIRES,346,421,583,587,1170
06,06462,064620701,Leandro N. Alem,BUENOS AIRES,319,342,480,465,945
06,06462,064620502,Leandro N. Alem,BUENOS AIRES,12,24,11,24,35
06,06462,064620603,Leandro N. Alem,BUENOS AIRES,18,36,20,31,51
06,06462,064621206,Leandro N. Alem,BUENOS AIRES,13,22,13,25,38
06,06462,064620802,Leandro N. Alem,BUENOS AIRES,327,383,638,580,1218
06,06462,064621205,Leandro N. Alem,BUENOS AIRES,98,129,164,198,362
06,06462,064620702,Leandro N. Alem,BUENOS AIRES,292,356,412,352,764
06,06462,064620704,Leandro N. Alem,BUENOS AIRES,302,339,472,493,965
06,06462,064620202,Leandro N. Alem,BUENOS AIRES,12,16,11,22,33
06,06462,064620712,Leandro N. Alem,BUENOS AIRES,3,6,4,6,10
06,06638,066382102,Pilar,BUENOS AIRES,56,84,103,110,213
06,06638,066382106,Pilar,BUENOS AIRES,16,30,22,29,51
06,06638,066380214,Pilar,BUENOS AIRES,255,271,455,481,936
06,06638,066380211,Pilar,BUENOS AIRES,472,477,783,735,1518
06,06638,066380212,Pilar,BUENOS AIRES,254,301,401,426,827
06,06638,066380111,Pilar,BUENOS AIRES,645,735,1207,1221,2428
06,06638,066380508,Pilar,BUENOS AIRES,280,258,523,540,1063
06,06638,066380703,Pilar,BUENOS AIRES,314,304,589,635,1224
06,06638,066380713,Pilar,BUENOS AIRES,281,316,558,563,1121
06,06638,066380801,Pilar,BUENOS AIRES,227,349,368,344,712
06,06638,066381002,Pilar,BUENOS AIRES,331,321,613,559,1172
06,06638,066381005,Pilar,BUENOS AIRES,270,277,419,395,814
06,06638,066381006,Pilar,BUENOS AIRES,440,396,846,813,1659
06,06638,066381803,Pilar,BUENOS AIRES,395,366,778,779,1557
06,06638,066381110,Pilar,BUENOS AIRES,461,473,913,923,1836
06,06638,066381303,Pilar,BUENOS AIRES,264,294,511,504,1015
06,06638,066381403,Pilar,BUENOS AIRES,429,431,874,903,1777
06,06638,066381511,Pilar,BUENOS AIRES,275,418,586,549,1135
06,06638,066381611,Pilar,BUENOS AIRES,357,394,620,551,1171
06,06638,066381713,Pilar,BUENOS AIRES,413,522,575,490,1065
06,06638,066382304,Pilar,BUENOS AIRES,205,308,370,399,769
06,06638,066381109,Pilar,BUENOS AIRES,342,350,729,697,1426
06,06638,066380101,Pilar,BUENOS AIRES,49,71,70,91,161
06,06638,066380605,Pilar,BUENOS AIRES,423,400,848,802,1650
06,06638,066380112,Pilar,BUENOS AIRES,729,937,1332,1347,2679
06,06638,066380208,Pilar,BUENOS AIRES,253,269,464,460,924
06,06638,066381007,Pilar,BUENOS AIRES,441,443,841,846,1687
06,06638,066380401,Pilar,BUENOS AIRES,366,355,659,650,1309
06,06638,066380403,Pilar,BUENOS AIRES,318,270,664,717,1381
06,06638,066380407,Pilar,BUENOS AIRES,335,358,605,628,1233
06,06638,066380501,Pilar,BUENOS AIRES,90,122,165,147,312
06,06638,066380607,Pilar,BUENOS AIRES,384,388,720,766,1486
06,06638,066380610,Pilar,BUENOS AIRES,429,438,872,837,1709
06,06638,066380613,Pilar,BUENOS AIRES,387,312,712,736,1448
06,06638,066380706,Pilar,BUENOS AIRES,158,229,255,259,514
06,06638,066380712,Pilar,BUENOS AIRES,313,354,559,569,1128
06,06638,066380806,Pilar,BUENOS AIRES,197,215,324,324,648
06,06638,066380913,Pilar,BUENOS AIRES,436,378,902,924,1826
06,06638,066381101,Pilar,BUENOS AIRES,163,169,320,340,660
06,06638,066381202,Pilar,BUENOS AIRES,52,281,121,158,279
06,06638,066381205,Pilar,BUENOS AIRES,497,695,923,921,1844
06,06638,066381207,Pilar,BUENOS AIRES,11,283,12,11,23
06,06638,066381311,Pilar,BUENOS AIRES,309,328,644,683,1327
06,06638,066381501,Pilar,BUENOS AIRES,129,142,220,252,472
06,06638,066381608,Pilar,BUENOS AIRES,283,305,446,420,866
06,06638,066381704,Pilar,BUENOS AIRES,293,288,474,483,957
06,06638,066381801,Pilar,BUENOS AIRES,925,463,1664,1745,3409
06,06638,066381804,Pilar,BUENOS AIRES,413,548,664,672,1336
06,06638,066381904,Pilar,BUENOS AIRES,178,169,339,371,710
06,06638,066382105,Pilar,BUENOS AIRES,60,122,107,112,219
06,06638,066382214,Pilar,BUENOS AIRES,410,424,812,788,1600
06,06638,066380305,Pilar,BUENOS AIRES,221,293,386,374,760
06,06638,066382001,Pilar,BUENOS AIRES,24,25,25,41,66
06,06638,066380110,Pilar,BUENOS AIRES,449,445,874,810,1684
06,06638,066380213,Pilar,BUENOS AIRES,294,299,528,491,1019
06,06638,066380202,Pilar,BUENOS AIRES,386,570,627,599,1226
06,06638,066380402,Pilar,BUENOS AIRES,451,385,840,800,1640
06,06638,066380404,Pilar,BUENOS AIRES,235,303,398,360,758
06,06638,066380502,Pilar,BUENOS AIRES,65,108,123,85,208
06,06638,066380512,Pilar,BUENOS AIRES,296,286,568,568,1136
06,06638,066380603,Pilar,BUENOS AIRES,412,437,729,692,1421
06,06638,066380612,Pilar,BUENOS AIRES,306,331,633,566,1199
06,06638,066380614,Pilar,BUENOS AIRES,446,426,902,877,1779
06,06638,066380704,Pilar,BUENOS AIRES,339,336,632,598,1230
06,06638,066380711,Pilar,BUENOS AIRES,237,278,402,417,819
06,06638,066380803,Pilar,BUENOS AIRES,295,348,568,511,1079
06,06638,066380807,Pilar,BUENOS AIRES,167,220,232,230,462
06,06638,066380813,Pilar,BUENOS AIRES,125,188,212,208,420
06,06638,066380903,Pilar,BUENOS AIRES,287,273,516,502,1018
06,06638,066380907,Pilar,BUENOS AIRES,575,542,1142,1152,2294
06,06638,066381203,Pilar,BUENOS AIRES,388,402,710,691,1401
06,06638,066381210,Pilar,BUENOS AIRES,105,119,188,201,389
06,06638,066381306,Pilar,BUENOS AIRES,527,539,1029,1032,2061
06,06638,066381312,Pilar,BUENOS AIRES,239,318,446,400,846
06,06638,066381316,Pilar,BUENOS AIRES,190,192,364,387,751
06,06638,066381409,Pilar,BUENOS AIRES,356,363,684,732,1416
06,06638,066381508,Pilar,BUENOS AIRES,464,454,822,814,1636
06,06638,066381510,Pilar,BUENOS AIRES,405,463,835,829,1664
06,06638,066381602,Pilar,BUENOS AIRES,203,256,334,298,632
06,06638,066381604,Pilar,BUENOS AIRES,229,291,345,319,664
06,06638,066381605,Pilar,BUENOS AIRES,199,241,284,242,526
06,06638,066381701,Pilar,BUENOS AIRES,308,311,513,553,1066
06,06638,066381809,Pilar,BUENOS AIRES,313,308,496,466,962
06,06638,066381901,Pilar,BUENOS AIRES,301,522,510,529,1039
06,06638,066382201,Pilar,BUENOS AIRES,582,554,1054,1066,2120
06,06638,066382003,Pilar,BUENOS AIRES,304,418,473,526,999
06,06638,066382009,Pilar,BUENOS AIRES,230,310,432,400,832
06,06638,066382107,Pilar,BUENOS AIRES,260,457,546,510,1056
06,06638,066382207,Pilar,BUENOS AIRES,230,242,396,336,732
06,06638,066382212,Pilar,BUENOS AIRES,153,179,287,282,569
06,06638,066382301,Pilar,BUENOS AIRES,207,220,420,483,903
06,06638,066380909,Pilar,BUENOS AIRES,376,342,778,710,1488
06,06638,066381711,Pilar,BUENOS AIRES,189,348,260,210,470
06,06638,066381301,Pilar,BUENOS AIRES,350,461,597,568,1165
06,06638,066382307,Pilar,BUENOS AIRES,59,74,79,98,177
06,06638,066380210,Pilar,BUENOS AIRES,329,325,566,582,1148
06,06638,066380108,Pilar,BUENOS AIRES,489,474,997,984,1981
06,06638,066380204,Pilar,BUENOS AIRES,409,403,733,738,1471
06,06638,066380205,Pilar,BUENOS AIRES,352,363,625,611,1236
06,06638,066380309,Pilar,BUENOS AIRES,826,1165,1553,1499,3052
06,06638,066380310,Pilar,BUENOS AIRES,240,311,411,435,846
06,06638,066380312,Pilar,BUENOS AIRES,536,522,937,902,1839
06,06638,066380702,Pilar,BUENOS AIRES,285,284,523,543,1066
06,06638,066380812,Pilar,BUENOS AIRES,157,244,340,283,623
06,06638,066380816,Pilar,BUENOS AIRES,192,296,385,376,761
06,06638,066380902,Pilar,BUENOS AIRES,170,266,267,295,562
06,06638,066380904,Pilar,BUENOS AIRES,184,197,369,368,737
06,06638,066380908,Pilar,BUENOS AIRES,373,349,771,707,1478
06,06638,066381004,Pilar,BUENOS AIRES,289,268,537,525,1062
06,06638,066381104,Pilar,BUENOS AIRES,452,434,809,879,1688
06,06638,066381206,Pilar,BUENOS AIRES,328,419,531,539,1070
06,06638,066381305,Pilar,BUENOS AIRES,391,413,697,676,1373
06,06638,066381315,Pilar,BUENOS AIRES,115,148,187,199,386
06,06638,066381407,Pilar,BUENOS AIRES,397,401,774,768,1542
06,06638,066381705,Pilar,BUENOS AIRES,244,289,363,316,679
06,06638,066381707,Pilar,BUENOS AIRES,266,334,371,336,707
06,06638,066381808,Pilar,BUENOS AIRES,368,354,662,655,1317
06,06638,066381902,Pilar,BUENOS AIRES,464,564,768,807,1575
06,06638,066381906,Pilar,BUENOS AIRES,143,252,223,239,462
06,06638,066382007,Pilar,BUENOS AIRES,229,268,419,410,829
06,06638,066382208,Pilar,BUENOS AIRES,305,310,642,632,1274
06,06638,066382302,Pilar,BUENOS AIRES,289,237,477,522,999
06,06638,066380201,Pilar,BUENOS AIRES,341,435,691,654,1345
06,06638,066380105,Pilar,BUENOS AIRES,190,366,318,314,632
06,06638,066381102,Pilar,BUENOS AIRES,147,145,304,317,621
06,06638,066382004,Pilar,BUENOS AIRES,25,32,54,46,100
06,06638,066382305,Pilar,BUENOS AIRES,6,25,6,10,16
06,06638,066380104,Pilar,BUENOS AIRES,107,161,189,202,391
06,06638,066380203,Pilar,BUENOS AIRES,252,233,496,492,988
06,06638,066380301,Pilar,BUENOS AIRES,380,365,851,853,1704
06,06638,066380304,Pilar,BUENOS AIRES,533,503,1080,1085,2165
06,06638,066380308,Pilar,BUENOS AIRES,142,318,239,231,470
06,06638,066380503,Pilar,BUENOS AIRES,84,132,158,144,302
06,06638,066380504,Pilar,BUENOS AIRES,57,115,121,121,242
06,06638,066380409,Pilar,BUENOS AIRES,248,349,365,404,769
06,06638,066380410,Pilar,BUENOS AIRES,291,387,454,465,919
06,06638,066380601,Pilar,BUENOS AIRES,387,386,738,695,1433
06,06638,066380609,Pilar,BUENOS AIRES,154,216,241,244,485
06,06638,066380701,Pilar,BUENOS AIRES,528,426,1090,1067,2157
06,06638,066380708,Pilar,BUENOS AIRES,215,332,332,349,681
06,06638,066380810,Pilar,BUENOS AIRES,199,323,295,307,602
06,06638,066380906,Pilar,BUENOS AIRES,403,447,736,758,1494
06,06638,066380910,Pilar,BUENOS AIRES,362,328,633,621,1254
06,06638,066381107,Pilar,BUENOS AIRES,372,370,703,588,1291
06,06638,066381204,Pilar,BUENOS AIRES,94,127,336,292,628
06,06638,066381208,Pilar,BUENOS AIRES,15,352,22,21,43
06,06638,066381307,Pilar,BUENOS AIRES,484,446,868,831,1699
06,06638,066381313,Pilar,BUENOS AIRES,387,676,715,656,1371
06,06638,066381317,Pilar,BUENOS AIRES,112,174,218,187,405
06,06638,066381404,Pilar,BUENOS AIRES,280,279,530,514,1044
06,06638,066381408,Pilar,BUENOS AIRES,355,342,748,719,1467
06,06638,066381507,Pilar,BUENOS AIRES,474,470,852,805,1657
06,06638,066381606,Pilar,BUENOS AIRES,319,355,503,475,978
06,06638,066381703,Pilar,BUENOS AIRES,327,450,455,461,916
06,06638,066381706,Pilar,BUENOS AIRES,193,230,267,235,502
06,06638,066381708,Pilar,BUENOS AIRES,352,490,443,390,833
06,06638,066381709,Pilar,BUENOS AIRES,165,300,192,144,336
06,06638,066381714,Pilar,BUENOS AIRES,340,527,433,359,792
06,06638,066381805,Pilar,BUENOS AIRES,149,164,268,221,489
06,06638,066382005,Pilar,BUENOS AIRES,221,256,409,411,820
06,06638,066382204,Pilar,BUENOS AIRES,393,356,773,800,1573
06,06638,066382101,Pilar,BUENOS AIRES,114,142,168,252,420
06,06638,066382211,Pilar,BUENOS AIRES,170,169,305,398,703
06,06638,066380107,Pilar,BUENOS AIRES,353,385,655,665,1320
06,06638,066381405,Pilar,BUENOS AIRES,323,331,600,645,1245
06,06638,066382108,Pilar,BUENOS AIRES,3,3,5,6,11
06,06638,066382306,Pilar,BUENOS AIRES,32,34,41,53,94
06,06638,066381401,Pilar,BUENOS AIRES,171,190,277,252,529
06,06638,066380109,Pilar,BUENOS AIRES,433,432,798,789,1587
06,06638,066380114,Pilar,BUENOS AIRES,309,630,537,489,1026
06,06638,066380302,Pilar,BUENOS AIRES,422,398,834,861,1695
06,06638,066380306,Pilar,BUENOS AIRES,228,319,404,386,790
06,06638,066380307,Pilar,BUENOS AIRES,163,383,275,234,509
06,06638,066380311,Pilar,BUENOS AIRES,490,480,941,915,1856
06,06638,066380411,Pilar,BUENOS AIRES,244,352,393,377,770
06,06638,066380602,Pilar,BUENOS AIRES,301,323,515,481,996
06,06638,066380606,Pilar,BUENOS AIRES,390,346,778,798,1576
06,06638,066380705,Pilar,BUENOS AIRES,252,326,409,417,826
06,06638,066380709,Pilar,BUENOS AIRES,226,272,405,383,788
06,06638,066381008,Pilar,BUENOS AIRES,524,518,1065,1090,2155
06,06638,066380809,Pilar,BUENOS AIRES,143,200,243,233,476
06,06638,066380901,Pilar,BUENOS AIRES,181,288,283,253,536
06,06638,066380911,Pilar,BUENOS AIRES,374,360,757,735,1492
06,06638,066381011,Pilar,BUENOS AIRES,313,308,554,518,1072
06,06638,066381103,Pilar,BUENOS AIRES,573,553,1135,1208,2343
06,06638,066381106,Pilar,BUENOS AIRES,307,304,494,488,982
06,06638,066381108,Pilar,BUENOS AIRES,406,412,739,793,1532
06,06638,066381201,Pilar,BUENOS AIRES,113,143,171,159,330
06,06638,066381209,Pilar,BUENOS AIRES,150,300,317,296,613
06,06638,066381211,Pilar,BUENOS AIRES,167,160,296,339,635
06,06638,066381310,Pilar,BUENOS AIRES,327,354,623,649,1272
06,06638,066381503,Pilar,BUENOS AIRES,341,374,580,552,1132
06,06638,066381504,Pilar,BUENOS AIRES,356,375,665,625,1290
06,06638,066381506,Pilar,BUENOS AIRES,337,396,594,551,1145
06,06638,066381603,Pilar,BUENOS AIRES,377,479,495,434,929
06,06638,066381609,Pilar,BUENOS AIRES,285,316,500,478,978
06,06638,066381610,Pilar,BUENOS AIRES,330,343,638,555,1193
06,06638,066381702,Pilar,BUENOS AIRES,215,255,353,382,735
06,06638,066381810,Pilar,BUENOS AIRES,198,194,321,363,684
06,06638,066381905,Pilar,BUENOS AIRES,384,784,715,814,1529
06,06638,066382209,Pilar,BUENOS AIRES,263,265,446,473,919
06,06638,066380106,Pilar,BUENOS AIRES,331,338,668,737,1405
06,06638,066381710,Pilar,BUENOS AIRES,203,272,271,223,494
06,06638,066382202,Pilar,BUENOS AIRES,266,286,480,485,965
06,06638,066381319,Pilar,BUENOS AIRES,196,257,345,333,678
06,06638,066382210,Pilar,BUENOS AIRES,166,207,290,273,563
06,06638,066380814,Pilar,BUENOS AIRES,164,145,302,321,623
06,06638,066381111,Pilar,BUENOS AIRES,275,248,526,552,1078
06,06638,066382103,Pilar,BUENOS AIRES,71,82,108,111,219
06,06638,066382303,Pilar,BUENOS AIRES,70,103,117,130,247
06,06638,066380113,Pilar,BUENOS AIRES,792,821,1471,1469,2940
06,06638,066380206,Pilar,BUENOS AIRES,246,244,490,497,987
06,06638,066380406,Pilar,BUENOS AIRES,299,331,577,558,1135
06,06638,066380408,Pilar,BUENOS AIRES,347,324,621,556,1177
06,06638,066380509,Pilar,BUENOS AIRES,262,266,517,483,1000
06,06638,066380514,Pilar,BUENOS AIRES,369,361,753,705,1458
06,06638,066380615,Pilar,BUENOS AIRES,383,355,739,677,1416
06,06638,066380808,Pilar,BUENOS AIRES,509,491,978,970,1948
06,06638,066380811,Pilar,BUENOS AIRES,191,282,304,287,591
06,06638,066380905,Pilar,BUENOS AIRES,310,346,531,490,1021
06,06638,066381001,Pilar,BUENOS AIRES,362,354,725,710,1435
06,06638,066381009,Pilar,BUENOS AIRES,379,311,712,661,1373
06,06638,066381308,Pilar,BUENOS AIRES,275,274,571,546,1117
06,06638,066381309,Pilar,BUENOS AIRES,281,293,536,562,1098
06,06638,066381314,Pilar,BUENOS AIRES,101,164,178,151,329
06,06638,066381318,Pilar,BUENOS AIRES,412,447,760,712,1472
06,06638,066381406,Pilar,BUENOS AIRES,343,357,571,592,1163
06,06638,066381502,Pilar,BUENOS AIRES,145,161,262,259,521
06,06638,066381505,Pilar,BUENOS AIRES,180,211,348,355,703
06,06638,066381509,Pilar,BUENOS AIRES,361,375,649,681,1330
06,06638,066381512,Pilar,BUENOS AIRES,431,458,793,737,1530
06,06638,066381601,Pilar,BUENOS AIRES,363,384,505,460,965
06,06638,066381712,Pilar,BUENOS AIRES,376,426,570,524,1094
06,06638,066381903,Pilar,BUENOS AIRES,328,379,572,551,1123
06,06638,066382203,Pilar,BUENOS AIRES,252,243,506,450,956
06,06638,066382104,Pilar,BUENOS AIRES,291,552,448,464,912
06,06638,066382205,Pilar,BUENOS AIRES,312,301,589,620,1209
06,06638,066382206,Pilar,BUENOS AIRES,641,625,1172,1110,2282
06,06638,066382213,Pilar,BUENOS AIRES,233,257,475,459,934
06,06638,066380710,Pilar,BUENOS AIRES,341,346,605,629,1234
06,06638,066380804,Pilar,BUENOS AIRES,160,370,243,252,495
06,06638,066381302,Pilar,BUENOS AIRES,303,304,535,563,1098
06,06638,066381402,Pilar,BUENOS AIRES,234,248,489,487,976
06,06638,066380102,Pilar,BUENOS AIRES,473,509,907,892,1799
06,06638,066380103,Pilar,BUENOS AIRES,275,324,480,447,927
06,06638,066380207,Pilar,BUENOS AIRES,269,272,484,477,961
06,06638,066380209,Pilar,BUENOS AIRES,303,298,543,547,1090
06,06638,066380303,Pilar,BUENOS AIRES,400,363,712,710,1422
06,06638,066380313,Pilar,BUENOS AIRES,407,456,776,714,1490
06,06638,066380405,Pilar,BUENOS AIRES,556,560,1132,1129,2261
06,06638,066380505,Pilar,BUENOS AIRES,191,291,343,303,646
06,06638,066380412,Pilar,BUENOS AIRES,270,364,537,491,1028
06,06638,066380506,Pilar,BUENOS AIRES,148,229,272,278,550
06,06638,066380507,Pilar,BUENOS AIRES,216,282,390,388,778
06,06638,066380510,Pilar,BUENOS AIRES,364,405,671,642,1313
06,06638,066380511,Pilar,BUENOS AIRES,350,300,605,625,1230
06,06638,066380513,Pilar,BUENOS AIRES,307,316,662,685,1347
06,06638,066380604,Pilar,BUENOS AIRES,413,409,856,836,1692
06,06638,066380608,Pilar,BUENOS AIRES,228,315,376,345,721
06,06638,066380611,Pilar,BUENOS AIRES,325,277,708,655,1363
06,06638,066380707,Pilar,BUENOS AIRES,420,469,597,590,1187
06,06638,066380802,Pilar,BUENOS AIRES,220,399,404,331,735
06,06638,066380805,Pilar,BUENOS AIRES,152,358,243,243,486
06,06638,066381802,Pilar,BUENOS AIRES,435,449,830,879,1709
06,06638,066380815,Pilar,BUENOS AIRES,45,177,54,61,115
06,06638,066380912,Pilar,BUENOS AIRES,343,320,691,672,1363
06,06638,066381003,Pilar,BUENOS AIRES,361,408,658,600,1258
06,06638,066381010,Pilar,BUENOS AIRES,431,405,801,821,1622
06,06638,066381105,Pilar,BUENOS AIRES,333,375,553,512,1065
06,06638,066381112,Pilar,BUENOS AIRES,187,205,419,420,839
06,06638,066381304,Pilar,BUENOS AIRES,239,296,426,381,807
06,06638,066381513,Pilar,BUENOS AIRES,465,467,840,833,1673
06,06638,066381514,Pilar,BUENOS AIRES,341,357,655,646,1301
06,06638,066381607,Pilar,BUENOS AIRES,393,412,589,521,1110
06,06638,066381807,Pilar,BUENOS AIRES,336,370,641,657,1298
06,06638,066382002,Pilar,BUENOS AIRES,262,364,488,527,1015
06,06638,066382008,Pilar,BUENOS AIRES,162,186,250,255,505
06,06638,066381806,Pilar,BUENOS AIRES,341,353,604,644,1248
06,06638,066382006,Pilar,BUENOS AIRES,173,210,338,333,671
06,06742,067420409,San Cayetano,BUENOS AIRES,33,40,53,61,114
06,06742,067420701,San Cayetano,BUENOS AIRES,19,27,27,24,51
06,06742,067421002,San Cayetano,BUENOS AIRES,63,100,77,99,176
06,06742,067420401,San Cayetano,BUENOS AIRES,339,382,450,446,896
06,06742,067420405,San Cayetano,BUENOS AIRES,229,260,349,298,647
06,06742,067420408,San Cayetano,BUENOS AIRES,194,225,287,251,538
06,06742,067420411,San Cayetano,BUENOS AIRES,1,6,0,2,2
06,06742,067420201,San Cayetano,BUENOS AIRES,57,97,52,83,135
06,06742,067420412,San Cayetano,BUENOS AIRES,3,5,4,4,8
06,06742,067420414,San Cayetano,BUENOS AIRES,192,225,296,296,592
06,06742,067421001,San Cayetano,BUENOS AIRES,16,170,19,27,46
06,06742,067420404,San Cayetano,BUENOS AIRES,259,286,361,317,678
06,06742,067420406,San Cayetano,BUENOS AIRES,185,221,273,252,525
06,06742,067420901,San Cayetano,BUENOS AIRES,38,64,37,71,108
06,06742,067420402,San Cayetano,BUENOS AIRES,311,349,451,411,862
06,06742,067420403,San Cayetano,BUENOS AIRES,242,275,326,304,630
06,06742,067420407,San Cayetano,BUENOS AIRES,249,282,444,432,876
06,06742,067420413,San Cayetano,BUENOS AIRES,258,295,377,380,757
06,06742,067420101,San Cayetano,BUENOS AIRES,19,19,26,28,54
06,06742,067420301,San Cayetano,BUENOS AIRES,27,73,37,40,77
06,06742,067420410,San Cayetano,BUENOS AIRES,104,120,145,163,308
06,06742,067420801,San Cayetano,BUENOS AIRES,29,29,40,48,88
06,06742,067420501,San Cayetano,BUENOS AIRES,29,98,40,38,78
06,06742,067420601,San Cayetano,BUENOS AIRES,10,26,6,14,20
06,06742,067420702,San Cayetano,BUENOS AIRES,55,109,53,80,133
06,06532,065320901,Mercedes,BUENOS AIRES,490,557,886,848,1734
06,06532,065321510,Mercedes,BUENOS AIRES,244,271,376,345,721
06,06532,065320501,Mercedes,BUENOS AIRES,11,16,13,18,31
06,06532,065320401,Mercedes,BUENOS AIRES,81,122,118,120,238
06,06532,065320502,Mercedes,BUENOS AIRES,30,32,43,54,97
06,06532,065320603,Mercedes,BUENOS AIRES,13,28,18,20,38
06,06532,065321301,Mercedes,BUENOS AIRES,13,12,9,26,35
06,06532,065320304,Mercedes,BUENOS AIRES,225,257,368,381,749
06,06532,065320309,Mercedes,BUENOS AIRES,422,462,710,694,1404
06,06532,065320912,Mercedes,BUENOS AIRES,104,222,171,186,357
06,06532,065321101,Mercedes,BUENOS AIRES,62,101,97,94,191
06,06532,065320908,Mercedes,BUENOS AIRES,131,182,217,368,585
06,06532,065320305,Mercedes,BUENOS AIRES,307,322,613,640,1253
06,06532,065320805,Mercedes,BUENOS AIRES,43,77,60,77,137
06,06532,065321303,Mercedes,BUENOS AIRES,6,6,8,11,19
06,06532,065320204,Mercedes,BUENOS AIRES,282,318,449,343,792
06,06532,065320306,Mercedes,BUENOS AIRES,296,327,558,519,1077
06,06532,065321402,Mercedes,BUENOS AIRES,287,322,424,420,844
06,06532,065321501,Mercedes,BUENOS AIRES,262,272,396,405,801
06,06532,065320904,Mercedes,BUENOS AIRES,196,269,318,311,629
06,06532,065320910,Mercedes,BUENOS AIRES,828,853,1702,1658,3360
06,06532,065320504,Mercedes,BUENOS AIRES,49,61,54,64,118
06,06532,065321002,Mercedes,BUENOS AIRES,21,27,24,29,53
06,06532,065320106,Mercedes,BUENOS AIRES,321,348,463,370,833
06,06532,065320108,Mercedes,BUENOS AIRES,270,375,380,295,675
06,06532,065320111,Mercedes,BUENOS AIRES,336,357,513,457,970
06,06532,065320112,Mercedes,BUENOS AIRES,312,362,491,421,912
06,06532,065320205,Mercedes,BUENOS AIRES,205,234,307,236,543
06,06532,065320311,Mercedes,BUENOS AIRES,263,276,436,429,865
06,06532,065321408,Mercedes,BUENOS AIRES,278,336,405,339,744
06,06532,065321503,Mercedes,BUENOS AIRES,281,280,452,426,878
06,06532,065321505,Mercedes,BUENOS AIRES,311,313,584,579,1163
06,06532,065320403,Mercedes,BUENOS AIRES,91,117,125,149,274
06,06532,065320903,Mercedes,BUENOS AIRES,122,162,212,196,408
06,06532,065320107,Mercedes,BUENOS AIRES,246,307,344,277,621
06,06532,065321401,Mercedes,BUENOS AIRES,277,331,357,302,659
06,06532,065320803,Mercedes,BUENOS AIRES,14,34,22,26,48
06,06532,065321005,Mercedes,BUENOS AIRES,23,37,33,52,85
06,06532,065321103,Mercedes,BUENOS AIRES,25,54,30,33,63
06,06532,065321104,Mercedes,BUENOS AIRES,11,14,11,18,29
06,06532,065320102,Mercedes,BUENOS AIRES,377,408,553,475,1028
06,06532,065320202,Mercedes,BUENOS AIRES,295,352,428,361,789
06,06532,065320307,Mercedes,BUENOS AIRES,309,283,554,572,1126
06,06532,065320310,Mercedes,BUENOS AIRES,277,273,475,486,961
06,06532,065321403,Mercedes,BUENOS AIRES,352,411,531,431,962
06,06532,065321502,Mercedes,BUENOS AIRES,315,360,524,509,1033
06,06532,065320308,Mercedes,BUENOS AIRES,355,355,596,577,1173
06,06532,065320402,Mercedes,BUENOS AIRES,24,57,33,38,71
06,06532,065320602,Mercedes,BUENOS AIRES,8,17,11,14,25
06,06532,065320906,Mercedes,BUENOS AIRES,93,130,147,144,291
06,06532,065321003,Mercedes,BUENOS AIRES,32,54,45,51,96
06,06532,065321004,Mercedes,BUENOS AIRES,18,36,29,39,68
06,06532,065321102,Mercedes,BUENOS AIRES,64,108,79,101,180
06,06532,065321201,Mercedes,BUENOS AIRES,16,35,18,26,44
06,06532,065321202,Mercedes,BUENOS AIRES,9,18,15,13,28
06,06532,065320109,Mercedes,BUENOS AIRES,233,302,371,269,640
06,06532,065320203,Mercedes,BUENOS AIRES,305,347,450,399,849
06,06532,065320207,Mercedes,BUENOS AIRES,349,389,526,477,1003
06,06532,065320302,Mercedes,BUENOS AIRES,504,537,836,788,1624
06,06532,065320911,Mercedes,BUENOS AIRES,239,292,379,403,782
06,06532,065321407,Mercedes,BUENOS AIRES,195,256,281,219,500
06,06532,065321511,Mercedes,BUENOS AIRES,409,462,654,553,1207
06,06532,065320701,Mercedes,BUENOS AIRES,42,73,65,84,149
06,06532,065320503,Mercedes,BUENOS AIRES,49,66,61,78,139
06,06532,065320604,Mercedes,BUENOS AIRES,10,19,12,20,32
06,06532,065321302,Mercedes,BUENOS AIRES,11,12,21,23,44
06,06532,065320104,Mercedes,BUENOS AIRES,334,361,455,442,897
06,06532,065320208,Mercedes,BUENOS AIRES,258,333,377,339,716
06,06532,065320301,Mercedes,BUENOS AIRES,320,323,546,491,1037
06,06532,065320303,Mercedes,BUENOS AIRES,281,309,479,448,927
06,06532,065321404,Mercedes,BUENOS AIRES,316,366,456,420,876
06,06532,065321405,Mercedes,BUENOS AIRES,293,363,447,363,810
06,06532,065321508,Mercedes,BUENOS AIRES,293,296,501,489,990
06,06532,065320905,Mercedes,BUENOS AIRES,178,248,298,305,603
06,06532,065320801,Mercedes,BUENOS AIRES,22,39,29,34,63
06,06532,065320804,Mercedes,BUENOS AIRES,35,46,38,42,80
06,06532,065320902,Mercedes,BUENOS AIRES,215,312,337,377,714
06,06532,065320201,Mercedes,BUENOS AIRES,235,376,279,210,489
06,06532,065320312,Mercedes,BUENOS AIRES,230,249,347,422,769
06,06532,065321512,Mercedes,BUENOS AIRES,431,476,690,644,1334
06,06532,065321406,Mercedes,BUENOS AIRES,276,384,366,271,637
06,06532,065321504,Mercedes,BUENOS AIRES,304,325,522,501,1023
06,06532,065321506,Mercedes,BUENOS AIRES,341,347,622,591,1213
06,06532,065320907,Mercedes,BUENOS AIRES,116,192,163,200,363
06,06532,065321509,Mercedes,BUENOS AIRES,363,390,558,571,1129
06,06532,065321203,Mercedes,BUENOS AIRES,16,25,27,28,55
06,06532,065320601,Mercedes,BUENOS AIRES,7,16,10,12,22
06,06532,065320802,Mercedes,BUENOS AIRES,29,43,35,34,69
06,06532,065320101,Mercedes,BUENOS AIRES,574,566,985,1511,2496
06,06532,065320103,Mercedes,BUENOS AIRES,299,326,410,360,770
06,06532,065320105,Mercedes,BUENOS AIRES,295,337,407,355,762
06,06532,065320110,Mercedes,BUENOS AIRES,284,345,395,339,734
06,06532,065320206,Mercedes,BUENOS AIRES,248,291,340,313,653
06,06532,065320313,Mercedes,BUENOS AIRES,192,200,365,326,691
06,06532,065320909,Mercedes,BUENOS AIRES,159,289,243,250,493
06,06532,065321001,Mercedes,BUENOS AIRES,336,391,598,595,1193
06,06532,065321507,Mercedes,BUENOS AIRES,255,295,414,385,799
06,06648,066480316,Presidente Perón,BUENOS AIRES,111,135,222,250,472
06,06648,066480114,Presidente Perón,BUENOS AIRES,458,473,928,865,1793
06,06648,066480210,Presidente Perón,BUENOS AIRES,407,412,762,800,1562
06,06648,066480212,Presidente Perón,BUENOS AIRES,364,397,648,651,1299
06,06648,066480305,Presidente Perón,BUENOS AIRES,257,236,508,458,966
06,06648,066480306,Presidente Perón,BUENOS AIRES,291,305,542,550,1092
06,06648,066480313,Presidente Perón,BUENOS AIRES,178,318,294,294,588
06,06648,066480403,Presidente Perón,BUENOS AIRES,309,328,645,690,1335
06,06648,066480410,Presidente Perón,BUENOS AIRES,43,72,55,63,118
06,06648,066480513,Presidente Perón,BUENOS AIRES,445,443,892,822,1714
06,06648,066480514,Presidente Perón,BUENOS AIRES,296,306,514,464,978
06,06648,066480211,Presidente Perón,BUENOS AIRES,234,253,409,433,842
06,06648,066480506,Presidente Perón,BUENOS AIRES,474,483,1015,965,1980
06,06648,066480104,Presidente Perón,BUENOS AIRES,336,378,600,502,1102
06,06648,066480405,Presidente Perón,BUENOS AIRES,19,24,19,23,42
06,06648,066480507,Presidente Perón,BUENOS AIRES,466,454,944,944,1888
06,06648,066480508,Presidente Perón,BUENOS AIRES,263,269,525,455,980
06,06648,066480109,Presidente Perón,BUENOS AIRES,258,266,480,436,916
06,06648,066480118,Presidente Perón,BUENOS AIRES,299,288,570,611,1181
06,06648,066480201,Presidente Perón,BUENOS AIRES,391,383,817,822,1639
06,06648,066480205,Presidente Perón,BUENOS AIRES,299,303,597,603,1200
06,06648,066480207,Presidente Perón,BUENOS AIRES,410,408,774,794,1568
06,06648,066480208,Presidente Perón,BUENOS AIRES,375,373,722,713,1435
06,06648,066480401,Presidente Perón,BUENOS AIRES,290,282,588,582,1170
06,06648,066480509,Presidente Perón,BUENOS AIRES,457,412,766,725,1491
06,06648,066480502,Presidente Perón,BUENOS AIRES,400,391,822,810,1632
06,06648,066480407,Presidente Perón,BUENOS AIRES,37,59,59,73,132
06,06648,066480105,Presidente Perón,BUENOS AIRES,389,401,649,548,1197
06,06648,066480110,Presidente Perón,BUENOS AIRES,454,464,873,883,1756
06,06648,066480115,Presidente Perón,BUENOS AIRES,263,263,526,526,1052
06,06648,066480501,Presidente Perón,BUENOS AIRES,228,240,454,474,928
06,06648,066480302,Presidente Perón,BUENOS AIRES,363,373,681,662,1343
06,06648,066480504,Presidente Perón,BUENOS AIRES,312,319,623,600,1223
06,06648,066480406,Presidente Perón,BUENOS AIRES,245,249,465,481,946
06,06648,066480101,Presidente Perón,BUENOS AIRES,360,358,676,678,1354
06,06648,066480111,Presidente Perón,BUENOS AIRES,348,353,689,665,1354
06,06648,066480117,Presidente Perón,BUENOS AIRES,274,293,501,492,993
06,06648,066480213,Presidente Perón,BUENOS AIRES,404,417,684,645,1329
06,06648,066480307,Presidente Perón,BUENOS AIRES,233,241,500,481,981
06,06648,066480308,Presidente Perón,BUENOS AIRES,449,445,925,936,1861
06,06648,066480404,Presidente Perón,BUENOS AIRES,318,347,661,690,1351
06,06648,066480510,Presidente Perón,BUENOS AIRES,255,260,513,469,982
06,06648,066480203,Presidente Perón,BUENOS AIRES,161,333,246,255,501
06,06648,066480102,Presidente Perón,BUENOS AIRES,326,327,594,599,1193
06,06648,066480108,Presidente Perón,BUENOS AIRES,275,271,546,505,1051
06,06648,066480113,Presidente Perón,BUENOS AIRES,330,330,646,610,1256
06,06648,066480202,Presidente Perón,BUENOS AIRES,252,270,450,482,932
06,06648,066480301,Presidente Perón,BUENOS AIRES,314,324,572,508,1080
06,06648,066480310,Presidente Perón,BUENOS AIRES,413,444,803,777,1580
06,06648,066480411,Presidente Perón,BUENOS AIRES,47,89,81,82,163
06,06648,066480511,Presidente Perón,BUENOS AIRES,366,341,740,718,1458
06,06648,066480512,Presidente Perón,BUENOS AIRES,270,265,534,521,1055
06,06648,066480315,Presidente Perón,BUENOS AIRES,326,370,650,691,1341
06,06648,066480103,Presidente Perón,BUENOS AIRES,455,458,784,706,1490
06,06648,066480106,Presidente Perón,BUENOS AIRES,376,416,589,541,1130
06,06648,066480112,Presidente Perón,BUENOS AIRES,376,361,757,754,1511
06,06648,066480116,Presidente Perón,BUENOS AIRES,280,274,479,527,1006
06,06648,066480119,Presidente Perón,BUENOS AIRES,313,307,598,591,1189
06,06648,066480503,Presidente Perón,BUENOS AIRES,263,261,499,525,1024
06,06648,066480204,Presidente Perón,BUENOS AIRES,310,344,608,605,1213
06,06648,066480303,Presidente Perón,BUENOS AIRES,60,69,133,139,272
06,06648,066480309,Presidente Perón,BUENOS AIRES,417,422,761,790,1551
06,06648,066480311,Presidente Perón,BUENOS AIRES,258,275,510,508,1018
06,06648,066480312,Presidente Perón,BUENOS AIRES,325,343,621,627,1248
06,06648,066480402,Presidente Perón,BUENOS AIRES,238,241,489,497,986
06,06648,066480409,Presidente Perón,BUENOS AIRES,37,90,40,54,94
06,06648,066480505,Presidente Perón,BUENOS AIRES,261,282,534,563,1097
06,06648,066480408,Presidente Perón,BUENOS AIRES,7,11,7,9,16
06,06648,066480107,Presidente Perón,BUENOS AIRES,265,280,487,425,912
06,06648,066480206,Presidente Perón,BUENOS AIRES,278,329,541,552,1093
06,06648,066480209,Presidente Perón,BUENOS AIRES,329,348,614,618,1232
06,06648,066480304,Presidente Perón,BUENOS AIRES,321,320,648,648,1296
06,06648,066480314,Presidente Perón,BUENOS AIRES,111,230,193,195,388
06,06679,066791102,Rivadavia,BUENOS AIRES,41,56,52,68,120
06,06679,066790102,Rivadavia,BUENOS AIRES,21,47,26,34,60
06,06679,066790201,Rivadavia,BUENOS AIRES,18,18,16,25,41
06,06679,066790301,Rivadavia,BUENOS AIRES,21,25,22,42,64
06,06679,066791206,Rivadavia,BUENOS AIRES,28,48,28,48,76
06,06679,066790105,Rivadavia,BUENOS AIRES,91,112,135,138,273
06,06679,066790601,Rivadavia,BUENOS AIRES,365,390,618,643,1261
06,06679,066790613,Rivadavia,BUENOS AIRES,239,309,312,318,630
06,06679,066791201,Rivadavia,BUENOS AIRES,94,124,107,132,239
06,06679,066790402,Rivadavia,BUENOS AIRES,12,18,13,29,42
06,06679,066790405,Rivadavia,BUENOS AIRES,6,21,13,6,19
06,06679,066790702,Rivadavia,BUENOS AIRES,13,24,12,22,34
06,06679,066791204,Rivadavia,BUENOS AIRES,31,58,22,42,64
06,06679,066790904,Rivadavia,BUENOS AIRES,79,115,122,144,266
06,06679,066790303,Rivadavia,BUENOS AIRES,159,196,230,235,465
06,06679,066790905,Rivadavia,BUENOS AIRES,165,182,223,243,466
06,06679,066790503,Rivadavia,BUENOS AIRES,10,24,13,18,31
06,06679,066790103,Rivadavia,BUENOS AIRES,17,21,24,26,50
06,06679,066790610,Rivadavia,BUENOS AIRES,291,338,412,409,821
06,06679,066790901,Rivadavia,BUENOS AIRES,163,195,255,252,507
06,06679,066790403,Rivadavia,BUENOS AIRES,11,14,14,19,33
06,06679,066790801,Rivadavia,BUENOS AIRES,21,32,21,30,51
06,06679,066790903,Rivadavia,BUENOS AIRES,13,21,24,25,49
06,06679,066791002,Rivadavia,BUENOS AIRES,10,26,12,15,27
06,06679,066790603,Rivadavia,BUENOS AIRES,238,270,380,369,749
06,06679,066790605,Rivadavia,BUENOS AIRES,389,436,664,597,1261
06,06679,066790607,Rivadavia,BUENOS AIRES,264,314,416,468,884
06,06679,066790609,Rivadavia,BUENOS AIRES,244,310,354,362,716
06,06679,066790104,Rivadavia,BUENOS AIRES,11,42,11,17,28
06,06679,066790202,Rivadavia,BUENOS AIRES,12,29,12,19,31
06,06679,066790306,Rivadavia,BUENOS AIRES,14,26,18,22,40
06,06679,066790501,Rivadavia,BUENOS AIRES,4,15,5,5,10
06,06679,066790701,Rivadavia,BUENOS AIRES,12,23,13,18,31
06,06679,066790608,Rivadavia,BUENOS AIRES,185,242,304,349,653
06,06679,066791001,Rivadavia,BUENOS AIRES,266,165,556,578,1134
06,06679,066790305,Rivadavia,BUENOS AIRES,107,129,152,171,323
06,06679,066790401,Rivadavia,BUENOS AIRES,6,17,6,12,18
06,06679,066790101,Rivadavia,BUENOS AIRES,78,108,117,132,249
06,06679,066790302,Rivadavia,BUENOS AIRES,149,181,239,248,487
06,06679,066790304,Rivadavia,BUENOS AIRES,111,128,164,171,335
06,06679,066790602,Rivadavia,BUENOS AIRES,265,295,426,465,891
06,06679,066790611,Rivadavia,BUENOS AIRES,266,319,357,357,714
06,06679,066790612,Rivadavia,BUENOS AIRES,217,239,319,297,616
06,06679,066791202,Rivadavia,BUENOS AIRES,16,22,17,23,40
06,06679,066790404,Rivadavia,BUENOS AIRES,8,12,10,15,25
06,06679,066790502,Rivadavia,BUENOS AIRES,26,34,40,45,85
06,06679,066790802,Rivadavia,BUENOS AIRES,31,38,39,49,88
06,06679,066790902,Rivadavia,BUENOS AIRES,30,36,37,52,89
06,06679,066791003,Rivadavia,BUENOS AIRES,22,37,28,43,71
06,06679,066791101,Rivadavia,BUENOS AIRES,18,32,30,32,62
06,06679,066791103,Rivadavia,BUENOS AIRES,17,31,22,24,46
06,06679,066790604,Rivadavia,BUENOS AIRES,270,298,426,380,806
06,06679,066790606,Rivadavia,BUENOS AIRES,266,290,451,463,914
06,06679,066791205,Rivadavia,BUENOS AIRES,2,18,5,7,12
06,06679,066791203,Rivadavia,BUENOS AIRES,20,40,20,26,46
06,06778,067780301,San Vicente,BUENOS AIRES,52,91,65,100,165
06,06778,067780603,San Vicente,BUENOS AIRES,135,159,228,251,479
06,06778,067780111,San Vicente,BUENOS AIRES,53,53,77,88,165
06,06778,067780208,San Vicente,BUENOS AIRES,239,262,349,318,667
06,06778,067780902,San Vicente,BUENOS AIRES,127,199,211,216,427
06,06778,067780903,San Vicente,BUENOS AIRES,262,295,496,480,976
06,06778,067780908,San Vicente,BUENOS AIRES,113,137,202,215,417
06,06778,067781014,San Vicente,BUENOS AIRES,283,291,575,589,1164
06,06778,067780905,San Vicente,BUENOS AIRES,393,436,710,719,1429
06,06778,067780505,San Vicente,BUENOS AIRES,27,43,26,39,65
06,06778,067780502,San Vicente,BUENOS AIRES,76,104,110,125,235
06,06778,067780704,San Vicente,BUENOS AIRES,14,33,20,18,38
06,06778,067780101,San Vicente,BUENOS AIRES,279,319,485,432,917
06,06778,067780105,San Vicente,BUENOS AIRES,368,454,649,572,1221
06,06778,067780216,San Vicente,BUENOS AIRES,172,184,314,334,648
06,06778,067781009,San Vicente,BUENOS AIRES,419,461,764,713,1477
06,06778,067780406,San Vicente,BUENOS AIRES,105,146,172,170,342
06,06778,067780503,San Vicente,BUENOS AIRES,14,23,21,24,45
06,06778,067780103,San Vicente,BUENOS AIRES,233,273,387,360,747
06,06778,067780106,San Vicente,BUENOS AIRES,349,386,625,625,1250
06,06778,067780110,San Vicente,BUENOS AIRES,37,47,47,66,113
06,06778,067780201,San Vicente,BUENOS AIRES,211,247,365,395,760
06,06778,067780203,San Vicente,BUENOS AIRES,165,182,285,304,589
06,06778,067780214,San Vicente,BUENOS AIRES,290,310,472,458,930
06,06778,067780218,San Vicente,BUENOS AIRES,220,231,422,404,826
06,06778,067780506,San Vicente,BUENOS AIRES,329,353,609,621,1230
06,06778,067781005,San Vicente,BUENOS AIRES,321,321,538,527,1065
06,06778,067781011,San Vicente,BUENOS AIRES,270,296,442,383,825
06,06778,067780504,San Vicente,BUENOS AIRES,29,32,32,47,79
06,06778,067780701,San Vicente,BUENOS AIRES,15,19,16,23,39
06,06778,067780403,San Vicente,BUENOS AIRES,61,119,99,91,190
06,06778,067780202,San Vicente,BUENOS AIRES,150,167,292,294,586
06,06778,067780204,San Vicente,BUENOS AIRES,267,292,506,548,1054
06,06778,067780904,San Vicente,BUENOS AIRES,133,161,231,240,471
06,06778,067781008,San Vicente,BUENOS AIRES,387,390,743,727,1470
06,06778,067780801,San Vicente,BUENOS AIRES,16,35,30,25,55
06,06778,067780109,San Vicente,BUENOS AIRES,241,293,345,389,734
06,06778,067780205,San Vicente,BUENOS AIRES,392,437,705,672,1377
06,06778,067780206,San Vicente,BUENOS AIRES,256,290,426,402,828
06,06778,067780209,San Vicente,BUENOS AIRES,360,347,664,576,1240
06,06778,067780211,San Vicente,BUENOS AIRES,184,223,363,316,679
06,06778,067780213,San Vicente,BUENOS AIRES,175,192,332,327,659
06,06778,067780401,San Vicente,BUENOS AIRES,19,30,21,26,47
06,06778,067781004,San Vicente,BUENOS AIRES,308,319,574,540,1114
06,06778,067780906,San Vicente,BUENOS AIRES,357,429,618,618,1236
06,06778,067780909,San Vicente,BUENOS AIRES,248,287,427,390,817
06,06778,067780913,San Vicente,BUENOS AIRES,307,370,455,442,897
06,06778,067781003,San Vicente,BUENOS AIRES,258,271,493,548,1041
06,06778,067780207,San Vicente,BUENOS AIRES,394,403,742,768,1510
06,06778,067780910,San Vicente,BUENOS AIRES,243,256,379,354,733
06,06778,067780802,San Vicente,BUENOS AIRES,2,6,4,3,7
06,06778,067780601,San Vicente,BUENOS AIRES,4,4,3,12,15
06,06778,067780602,San Vicente,BUENOS AIRES,176,304,330,303,633
06,06778,067780210,San Vicente,BUENOS AIRES,309,378,469,386,855
06,06778,067780215,San Vicente,BUENOS AIRES,317,374,625,588,1213
06,06778,067780907,San Vicente,BUENOS AIRES,152,191,292,288,580
06,06778,067781001,San Vicente,BUENOS AIRES,415,434,741,741,1482
06,06778,067780402,San Vicente,BUENOS AIRES,32,55,63,54,117
06,06778,067780404,San Vicente,BUENOS AIRES,126,159,275,254,529
06,06778,067780107,San Vicente,BUENOS AIRES,227,242,410,390,800
06,06778,067780217,San Vicente,BUENOS AIRES,187,195,303,308,611
06,06778,067780405,San Vicente,BUENOS AIRES,164,145,298,299,597
06,06778,067780501,San Vicente,BUENOS AIRES,206,216,390,342,732
06,06778,067780507,San Vicente,BUENOS AIRES,246,264,476,473,949
06,06778,067780912,San Vicente,BUENOS AIRES,311,356,465,409,874
06,06778,067781002,San Vicente,BUENOS AIRES,254,253,504,475,979
06,06778,067781006,San Vicente,BUENOS AIRES,205,212,306,297,603
06,06778,067781007,San Vicente,BUENOS AIRES,341,361,591,589,1180
06,06778,067781010,San Vicente,BUENOS AIRES,197,211,300,282,582
06,06778,067781012,San Vicente,BUENOS AIRES,297,317,511,469,980
06,06778,067781013,San Vicente,BUENOS AIRES,410,419,783,794,1577
06,06778,067780901,San Vicente,BUENOS AIRES,9,20,15,17,32
06,06778,067780102,San Vicente,BUENOS AIRES,233,268,361,313,674
06,06778,067780104,San Vicente,BUENOS AIRES,221,239,425,403,828
06,06778,067780108,San Vicente,BUENOS AIRES,243,284,462,452,914
06,06778,067780212,San Vicente,BUENOS AIRES,212,231,372,361,733
06,06778,067780407,San Vicente,BUENOS AIRES,309,359,531,469,1000
06,06778,067780604,San Vicente,BUENOS AIRES,338,384,672,632,1304
06,06778,067780911,San Vicente,BUENOS AIRES,334,371,533,463,996
06,06778,067781015,San Vicente,BUENOS AIRES,239,279,456,439,895
06,06778,067780702,San Vicente,BUENOS AIRES,17,21,24,32,56
06,06778,067780703,San Vicente,BUENOS AIRES,11,18,14,20,34
06,06778,067780803,San Vicente,BUENOS AIRES,16,19,27,22,49
06,06868,068680502,Villa Gesell,BUENOS AIRES,352,393,630,684,1314
06,06868,068680504,Villa Gesell,BUENOS AIRES,194,616,267,301,568
06,06868,068680104,Villa Gesell,BUENOS AIRES,204,315,276,264,540
06,06868,068680202,Villa Gesell,BUENOS AIRES,50,495,92,75,167
06,06868,068680203,Villa Gesell,BUENOS AIRES,78,380,102,109,211
06,06868,068680210,Villa Gesell,BUENOS AIRES,71,450,75,81,156
06,06868,068680303,Villa Gesell,BUENOS AIRES,196,275,282,280,562
06,06868,068680304,Villa Gesell,BUENOS AIRES,182,280,282,274,556
06,06868,068680610,Villa Gesell,BUENOS AIRES,24,307,25,24,49
06,06868,068680710,Villa Gesell,BUENOS AIRES,21,423,24,22,46
06,06868,068680804,Villa Gesell,BUENOS AIRES,177,477,235,233,468
06,06868,068680609,Villa Gesell,BUENOS AIRES,76,384,88,87,175
06,06868,068680213,Villa Gesell,BUENOS AIRES,460,541,784,778,1562
06,06868,068680307,Villa Gesell,BUENOS AIRES,168,511,243,227,470
06,06868,068680410,Villa Gesell,BUENOS AIRES,29,158,33,42,75
06,06868,068680507,Villa Gesell,BUENOS AIRES,94,590,92,113,205
06,06868,068680606,Villa Gesell,BUENOS AIRES,19,295,18,22,40
06,06868,068680702,Villa Gesell,BUENOS AIRES,245,479,381,340,721
06,06868,068680803,Villa Gesell,BUENOS AIRES,119,169,193,205,398
06,06868,068680807,Villa Gesell,BUENOS AIRES,25,245,33,42,75
06,06868,068680501,Villa Gesell,BUENOS AIRES,14,14,9,15,24
06,06868,068680206,Villa Gesell,BUENOS AIRES,211,487,315,298,613
06,06868,068680204,Villa Gesell,BUENOS AIRES,179,285,270,256,526
06,06868,068680211,Villa Gesell,BUENOS AIRES,34,309,47,45,92
06,06868,068680308,Villa Gesell,BUENOS AIRES,44,365,80,72,152
06,06868,068680401,Villa Gesell,BUENOS AIRES,28,325,38,37,75
06,06868,068680404,Villa Gesell,BUENOS AIRES,5,201,7,8,15
06,06868,068680503,Villa Gesell,BUENOS AIRES,373,414,701,780,1481
06,06868,068680604,Villa Gesell,BUENOS AIRES,90,415,97,92,189
06,06868,068680704,Villa Gesell,BUENOS AIRES,90,434,131,126,257
06,06868,068680712,Villa Gesell,BUENOS AIRES,47,48,75,78,153
06,06868,068680802,Villa Gesell,BUENOS AIRES,252,261,407,409,816
06,06868,068680810,Villa Gesell,BUENOS AIRES,45,248,67,49,116
06,06868,068680102,Villa Gesell,BUENOS AIRES,233,275,418,428,846
06,06868,068680103,Villa Gesell,BUENOS AIRES,212,250,371,361,732
06,06868,068680106,Villa Gesell,BUENOS AIRES,74,239,103,88,191
06,06868,068680108,Villa Gesell,BUENOS AIRES,205,396,369,331,700
06,06868,068680201,Villa Gesell,BUENOS AIRES,180,288,260,260,520
06,06868,068680209,Villa Gesell,BUENOS AIRES,26,399,40,50,90
06,06868,068680310,Villa Gesell,BUENOS AIRES,44,278,66,62,128
06,06868,068680405,Villa Gesell,BUENOS AIRES,32,350,46,53,99
06,06868,068680406,Villa Gesell,BUENOS AIRES,9,109,10,12,22
06,06868,068680505,Villa Gesell,BUENOS AIRES,68,456,88,93,181
06,06868,068680508,Villa Gesell,BUENOS AIRES,149,484,204,250,454
06,06868,068680707,Villa Gesell,BUENOS AIRES,32,316,43,39,82
06,06868,068680708,Villa Gesell,BUENOS AIRES,47,402,48,49,97
06,06868,068680711,Villa Gesell,BUENOS AIRES,48,421,60,60,120
06,06868,068680205,Villa Gesell,BUENOS AIRES,367,492,503,478,981
06,06868,068680208,Villa Gesell,BUENOS AIRES,9,115,20,16,36
06,06868,068680301,Villa Gesell,BUENOS AIRES,411,461,784,770,1554
06,06868,068680312,Villa Gesell,BUENOS AIRES,38,350,42,39,81
06,06868,068680407,Villa Gesell,BUENOS AIRES,56,394,80,80,160
06,06868,068680603,Villa Gesell,BUENOS AIRES,75,511,82,86,168
06,06868,068680701,Villa Gesell,BUENOS AIRES,284,306,455,450,905
06,06868,068680403,Villa Gesell,BUENOS AIRES,19,274,29,20,49
06,06868,068680511,Villa Gesell,BUENOS AIRES,2,3,0,3,3
06,06868,068680105,Villa Gesell,BUENOS AIRES,102,257,140,130,270
06,06868,068680306,Villa Gesell,BUENOS AIRES,204,469,299,262,561
06,06868,068680313,Villa Gesell,BUENOS AIRES,37,350,35,44,79
06,06868,068680402,Villa Gesell,BUENOS AIRES,24,218,25,32,57
06,06868,068680409,Villa Gesell,BUENOS AIRES,29,480,48,37,85
06,06868,068680602,Villa Gesell,BUENOS AIRES,37,248,41,44,85
06,06868,068680605,Villa Gesell,BUENOS AIRES,34,86,45,34,79
06,06868,068680703,Villa Gesell,BUENOS AIRES,121,296,176,157,333
06,06868,068680705,Villa Gesell,BUENOS AIRES,70,290,82,90,172
06,06868,068680709,Villa Gesell,BUENOS AIRES,26,386,27,34,61
06,06868,068680801,Villa Gesell,BUENOS AIRES,305,455,484,501,985
06,06868,068680607,Villa Gesell,BUENOS AIRES,39,344,49,36,85
06,06868,068680107,Villa Gesell,BUENOS AIRES,63,174,83,84,167
06,06868,068680207,Villa Gesell,BUENOS AIRES,74,332,93,88,181
06,06868,068680212,Villa Gesell,BUENOS AIRES,87,170,119,129,248
06,06868,068680302,Villa Gesell,BUENOS AIRES,310,337,487,490,977
06,06868,068680309,Villa Gesell,BUENOS AIRES,36,448,35,41,76
06,06868,068680408,Villa Gesell,BUENOS AIRES,81,377,114,127,241
06,06868,068680601,Villa Gesell,BUENOS AIRES,31,430,37,39,76
06,06868,068680806,Villa Gesell,BUENOS AIRES,38,409,80,69,149
06,06868,068680808,Villa Gesell,BUENOS AIRES,25,239,21,25,46
06,06868,068680809,Villa Gesell,BUENOS AIRES,171,539,259,276,535
06,06868,068680101,Villa Gesell,BUENOS AIRES,489,503,872,912,1784
06,06868,068680109,Villa Gesell,BUENOS AIRES,284,340,466,469,935
06,06868,068680110,Villa Gesell,BUENOS AIRES,278,314,452,438,890
06,06868,068680305,Villa Gesell,BUENOS AIRES,112,210,174,152,326
06,06868,068680311,Villa Gesell,BUENOS AIRES,33,361,43,40,83
06,06868,068680506,Villa Gesell,BUENOS AIRES,68,560,71,93,164
06,06868,068680509,Villa Gesell,BUENOS AIRES,119,528,148,191,339
06,06868,068680510,Villa Gesell,BUENOS AIRES,71,512,74,104,178
06,06868,068680608,Villa Gesell,BUENOS AIRES,29,321,32,31,63
06,06868,068680706,Villa Gesell,BUENOS AIRES,107,341,159,143,302
06,06868,068680805,Villa Gesell,BUENOS AIRES,24,311,20,32,52
06,06805,068050108,Tigre,BUENOS AIRES,163,218,296,285,581
06,06805,068051605,Tigre,BUENOS AIRES,281,301,437,426,863
06,06805,068050201,Tigre,BUENOS AIRES,112,139,183,188,371
06,06805,068050301,Tigre,BUENOS AIRES,88,351,121,123,244
06,06805,068050402,Tigre,BUENOS AIRES,246,242,421,421,842
06,06805,068050406,Tigre,BUENOS AIRES,347,314,573,557,1130
06,06805,068050411,Tigre,BUENOS AIRES,429,580,799,764,1563
06,06805,068050508,Tigre,BUENOS AIRES,381,395,579,533,1112
06,06805,068050511,Tigre,BUENOS AIRES,510,465,895,790,1685
06,06805,068050704,Tigre,BUENOS AIRES,275,384,438,430,868
06,06805,068050705,Tigre,BUENOS AIRES,295,370,514,494,1008
06,06805,068050801,Tigre,BUENOS AIRES,137,518,213,186,399
06,06805,068050802,Tigre,BUENOS AIRES,91,423,110,117,227
06,06805,068050813,Tigre,BUENOS AIRES,562,512,1008,1086,2094
06,06805,068051001,Tigre,BUENOS AIRES,501,529,881,788,1669
06,06805,068051005,Tigre,BUENOS AIRES,277,275,443,423,866
06,06805,068051013,Tigre,BUENOS AIRES,228,251,516,485,1001
06,06805,068051101,Tigre,BUENOS AIRES,367,339,699,639,1338
06,06805,068051107,Tigre,BUENOS AIRES,386,390,808,786,1594
06,06805,068051201,Tigre,BUENOS AIRES,252,283,407,372,779
06,06805,068051204,Tigre,BUENOS AIRES,266,296,494,430,924
06,06805,068051209,Tigre,BUENOS AIRES,213,232,299,292,591
06,06805,068051301,Tigre,BUENOS AIRES,392,475,781,771,1552
06,06805,068051305,Tigre,BUENOS AIRES,362,385,599,561,1160
06,06805,068051308,Tigre,BUENOS AIRES,597,595,1052,1035,2087
06,06805,068051309,Tigre,BUENOS AIRES,304,255,577,555,1132
06,06805,068051317,Tigre,BUENOS AIRES,269,277,447,409,856
06,06805,068051402,Tigre,BUENOS AIRES,278,236,520,480,1000
06,06805,068051403,Tigre,BUENOS AIRES,373,362,614,637,1251
06,06805,068051410,Tigre,BUENOS AIRES,304,309,513,486,999
06,06805,068051511,Tigre,BUENOS AIRES,299,306,628,530,1158
06,06805,068051512,Tigre,BUENOS AIRES,244,251,389,383,772
06,06805,068051704,Tigre,BUENOS AIRES,267,285,455,396,851
06,06805,068051906,Tigre,BUENOS AIRES,491,454,829,817,1646
06,06805,068051912,Tigre,BUENOS AIRES,403,447,688,647,1335
06,06805,068052002,Tigre,BUENOS AIRES,278,259,471,475,946
06,06805,068052006,Tigre,BUENOS AIRES,329,303,778,724,1502
06,06805,068052101,Tigre,BUENOS AIRES,334,300,576,605,1181
06,06805,068052105,Tigre,BUENOS AIRES,353,360,628,609,1237
06,06805,068052307,Tigre,BUENOS AIRES,456,392,891,946,1837
06,06805,068052309,Tigre,BUENOS AIRES,204,211,422,424,846
06,06805,068052502,Tigre,BUENOS AIRES,307,325,565,532,1097
06,06805,068052505,Tigre,BUENOS AIRES,420,432,772,728,1500
06,06805,068052608,Tigre,BUENOS AIRES,82,295,105,109,214
06,06805,068052602,Tigre,BUENOS AIRES,75,325,78,116,194
06,06805,068050608,Tigre,BUENOS AIRES,340,481,425,371,796
06,06805,068050306,Tigre,BUENOS AIRES,402,835,476,484,960
06,06805,068050607,Tigre,BUENOS AIRES,122,168,143,155,298
06,06805,068050410,Tigre,BUENOS AIRES,519,454,862,872,1734
06,06805,068050505,Tigre,BUENOS AIRES,266,276,461,429,890
06,06805,068050509,Tigre,BUENOS AIRES,271,280,411,390,801
06,06805,068050602,Tigre,BUENOS AIRES,300,248,393,399,792
06,06805,068050604,Tigre,BUENOS AIRES,401,434,583,527,1110
06,06805,068050707,Tigre,BUENOS AIRES,148,337,235,213,448
06,06805,068050710,Tigre,BUENOS AIRES,28,327,59,45,104
06,06805,068050808,Tigre,BUENOS AIRES,575,353,956,910,1866
06,06805,068050903,Tigre,BUENOS AIRES,301,321,518,513,1031
06,06805,068051106,Tigre,BUENOS AIRES,347,344,617,629,1246
06,06805,068051311,Tigre,BUENOS AIRES,438,411,834,823,1657
06,06805,068051312,Tigre,BUENOS AIRES,405,422,750,672,1422
06,06805,068051909,Tigre,BUENOS AIRES,325,309,573,518,1091
06,06805,068051315,Tigre,BUENOS AIRES,278,290,442,441,883
06,06805,068051318,Tigre,BUENOS AIRES,488,502,808,750,1558
06,06805,068051406,Tigre,BUENOS AIRES,313,317,576,529,1105
06,06805,068051505,Tigre,BUENOS AIRES,340,347,592,548,1140
06,06805,068051701,Tigre,BUENOS AIRES,393,360,745,724,1469
06,06805,068051804,Tigre,BUENOS AIRES,430,430,684,622,1306
06,06805,068051809,Tigre,BUENOS AIRES,404,393,716,651,1367
06,06805,068051904,Tigre,BUENOS AIRES,229,251,399,376,775
06,06805,068051905,Tigre,BUENOS AIRES,300,294,521,516,1037
06,06805,068051914,Tigre,BUENOS AIRES,287,321,444,399,843
06,06805,068052001,Tigre,BUENOS AIRES,170,178,252,250,502
06,06805,068052004,Tigre,BUENOS AIRES,550,557,975,927,1902
06,06805,068052009,Tigre,BUENOS AIRES,351,349,674,604,1278
06,06805,068052205,Tigre,BUENOS AIRES,543,555,963,991,1954
06,06805,068052206,Tigre,BUENOS AIRES,412,401,754,768,1522
06,06805,068052303,Tigre,BUENOS AIRES,479,521,849,871,1720
06,06805,068052407,Tigre,BUENOS AIRES,186,226,339,366,705
06,06805,068052618,Tigre,BUENOS AIRES,74,230,113,123,236
06,06805,068052609,Tigre,BUENOS AIRES,299,707,413,441,854
06,06805,068052615,Tigre,BUENOS AIRES,121,312,175,173,348
06,06805,068052613,Tigre,BUENOS AIRES,84,373,91,114,205
06,06805,068052601,Tigre,BUENOS AIRES,49,235,46,81,127
06,06805,068052616,Tigre,BUENOS AIRES,57,236,57,86,143
06,06805,068050307,Tigre,BUENOS AIRES,411,539,809,732,1541
06,06805,068052501,Tigre,BUENOS AIRES,309,367,583,552,1135
06,06805,068050105,Tigre,BUENOS AIRES,110,184,203,200,403
06,06805,068050204,Tigre,BUENOS AIRES,395,424,701,698,1399
06,06805,068050205,Tigre,BUENOS AIRES,469,467,869,826,1695
06,06805,068050408,Tigre,BUENOS AIRES,297,285,487,465,952
06,06805,068050501,Tigre,BUENOS AIRES,347,376,541,510,1051
06,06805,068050512,Tigre,BUENOS AIRES,462,454,820,803,1623
06,06805,068050706,Tigre,BUENOS AIRES,156,556,246,251,497
06,06805,068050811,Tigre,BUENOS AIRES,477,414,898,872,1770
06,06805,068051104,Tigre,BUENOS AIRES,510,519,906,831,1737
06,06805,068051205,Tigre,BUENOS AIRES,301,319,472,392,864
06,06805,068051404,Tigre,BUENOS AIRES,414,343,688,617,1305
06,06805,068051416,Tigre,BUENOS AIRES,556,513,976,938,1914
06,06805,068051702,Tigre,BUENOS AIRES,433,378,703,615,1318
06,06805,068051707,Tigre,BUENOS AIRES,472,479,824,770,1594
06,06805,068051801,Tigre,BUENOS AIRES,227,195,420,407,827
06,06805,068051911,Tigre,BUENOS AIRES,475,527,803,723,1526
06,06805,068052005,Tigre,BUENOS AIRES,423,436,734,697,1431
06,06805,068052014,Tigre,BUENOS AIRES,312,342,512,475,987
06,06805,068052102,Tigre,BUENOS AIRES,289,261,551,517,1068
06,06805,068052110,Tigre,BUENOS AIRES,329,321,633,584,1217
06,06805,068052204,Tigre,BUENOS AIRES,523,473,923,1019,1942
06,06805,068052304,Tigre,BUENOS AIRES,462,435,859,821,1680
06,06805,068052405,Tigre,BUENOS AIRES,506,431,955,953,1908
06,06805,068052313,Tigre,BUENOS AIRES,350,479,664,631,1295
06,06805,068052314,Tigre,BUENOS AIRES,457,456,924,940,1864
06,06805,068052409,Tigre,BUENOS AIRES,401,399,778,819,1597
06,06805,068052504,Tigre,BUENOS AIRES,139,180,221,203,424
06,06805,068052617,Tigre,BUENOS AIRES,18,56,12,26,38
06,06805,068052620,Tigre,BUENOS AIRES,179,477,227,245,472
06,06805,068052621,Tigre,BUENOS AIRES,72,225,100,102,202
06,06805,068050203,Tigre,BUENOS AIRES,368,383,654,704,1358
06,06805,068052108,Tigre,BUENOS AIRES,312,315,573,572,1145
06,06805,068052408,Tigre,BUENOS AIRES,352,385,645,655,1300
06,06805,068050302,Tigre,BUENOS AIRES,149,166,232,249,481
06,06805,068050303,Tigre,BUENOS AIRES,329,323,576,594,1170
06,06805,068050310,Tigre,BUENOS AIRES,140,173,293,225,518
06,06805,068050404,Tigre,BUENOS AIRES,464,442,867,807,1674
06,06805,068050405,Tigre,BUENOS AIRES,501,445,959,975,1934
06,06805,068050409,Tigre,BUENOS AIRES,490,408,848,778,1626
06,06805,068050601,Tigre,BUENOS AIRES,672,673,1109,1128,2237
06,06805,068050603,Tigre,BUENOS AIRES,399,397,577,535,1112
06,06805,068050605,Tigre,BUENOS AIRES,208,368,309,271,580
06,06805,068050609,Tigre,BUENOS AIRES,407,512,509,450,959
06,06805,068050708,Tigre,BUENOS AIRES,26,372,52,34,86
06,06805,068050709,Tigre,BUENOS AIRES,77,219,123,126,249
06,06805,068050810,Tigre,BUENOS AIRES,214,206,414,394,808
06,06805,068050814,Tigre,BUENOS AIRES,467,416,833,816,1649
06,06805,068051002,Tigre,BUENOS AIRES,293,308,506,488,994
06,06805,068051103,Tigre,BUENOS AIRES,512,545,1051,1040,2091
06,06805,068051908,Tigre,BUENOS AIRES,226,247,376,330,706
06,06805,068051313,Tigre,BUENOS AIRES,374,381,640,632,1272
06,06805,068051411,Tigre,BUENOS AIRES,343,344,618,571,1189
06,06805,068051412,Tigre,BUENOS AIRES,344,296,607,585,1192
06,06805,068051503,Tigre,BUENOS AIRES,381,426,596,543,1139
06,06805,068051510,Tigre,BUENOS AIRES,364,368,619,600,1219
06,06805,068051603,Tigre,BUENOS AIRES,347,319,621,592,1213
06,06805,068051705,Tigre,BUENOS AIRES,417,452,700,633,1333
06,06805,068051706,Tigre,BUENOS AIRES,447,449,749,716,1465
06,06805,068051806,Tigre,BUENOS AIRES,273,279,469,413,882
06,06805,068051811,Tigre,BUENOS AIRES,468,497,737,618,1355
06,06805,068052012,Tigre,BUENOS AIRES,313,291,532,528,1060
06,06805,068052111,Tigre,BUENOS AIRES,424,379,705,662,1367
06,06805,068052112,Tigre,BUENOS AIRES,370,348,642,669,1311
06,06805,068052201,Tigre,BUENOS AIRES,436,417,862,857,1719
06,06805,068052403,Tigre,BUENOS AIRES,322,384,511,554,1065
06,06805,068052507,Tigre,BUENOS AIRES,601,626,1228,1275,2503
06,06805,068052511,Tigre,BUENOS AIRES,359,372,627,591,1218
06,06805,068052512,Tigre,BUENOS AIRES,473,454,809,807,1616
06,06805,068052610,Tigre,BUENOS AIRES,222,521,283,314,597
06,06805,068052614,Tigre,BUENOS AIRES,37,168,54,61,115
06,06805,068052311,Tigre,BUENOS AIRES,212,217,397,417,814
06,06805,068050101,Tigre,BUENOS AIRES,214,275,347,338,685
06,06805,068050107,Tigre,BUENOS AIRES,247,333,465,446,911
06,06805,068050305,Tigre,BUENOS AIRES,453,676,787,772,1559
06,06805,068050308,Tigre,BUENOS AIRES,220,254,488,445,933
06,06805,068050502,Tigre,BUENOS AIRES,346,376,580,484,1064
06,06805,068050513,Tigre,BUENOS AIRES,387,381,718,760,1478
06,06805,068050702,Tigre,BUENOS AIRES,285,274,405,385,790
06,06805,068050703,Tigre,BUENOS AIRES,349,373,587,507,1094
06,06805,068050804,Tigre,BUENOS AIRES,249,454,273,271,544
06,06805,068050806,Tigre,BUENOS AIRES,291,333,477,448,925
06,06805,068050809,Tigre,BUENOS AIRES,474,426,898,927,1825
06,06805,068050904,Tigre,BUENOS AIRES,611,635,1045,1037,2082
06,06805,068050906,Tigre,BUENOS AIRES,585,696,1292,1148,2440
06,06805,068051108,Tigre,BUENOS AIRES,565,455,1216,1151,2367
06,06805,068051202,Tigre,BUENOS AIRES,321,356,505,493,998
06,06805,068051206,Tigre,BUENOS AIRES,232,258,344,305,649
06,06805,068051211,Tigre,BUENOS AIRES,349,375,565,504,1069
06,06805,068051213,Tigre,BUENOS AIRES,281,311,438,403,841
06,06805,068051306,Tigre,BUENOS AIRES,277,264,484,515,999
06,06805,068051310,Tigre,BUENOS AIRES,242,201,453,410,863
06,06805,068051316,Tigre,BUENOS AIRES,380,417,596,555,1151
06,06805,068051401,Tigre,BUENOS AIRES,403,407,745,727,1472
06,06805,068051405,Tigre,BUENOS AIRES,484,455,893,825,1718
06,06805,068051507,Tigre,BUENOS AIRES,404,415,667,640,1307
06,06805,068051601,Tigre,BUENOS AIRES,448,356,887,873,1760
06,06805,068051910,Tigre,BUENOS AIRES,227,233,360,372,732
06,06805,068051901,Tigre,BUENOS AIRES,259,208,445,440,885
06,06805,068051902,Tigre,BUENOS AIRES,274,291,492,475,967
06,06805,068052008,Tigre,BUENOS AIRES,285,247,492,452,944
06,06805,068052013,Tigre,BUENOS AIRES,318,270,617,625,1242
06,06805,068052106,Tigre,BUENOS AIRES,345,297,610,626,1236
06,06805,068052114,Tigre,BUENOS AIRES,307,293,554,544,1098
06,06805,068052202,Tigre,BUENOS AIRES,499,498,921,1021,1942
06,06805,068052203,Tigre,BUENOS AIRES,482,478,894,883,1777
06,06805,068052207,Tigre,BUENOS AIRES,381,349,712,671,1383
06,06805,068052208,Tigre,BUENOS AIRES,340,363,588,567,1155
06,06805,068052306,Tigre,BUENOS AIRES,333,373,581,514,1095
06,06805,068052312,Tigre,BUENOS AIRES,1326,1128,2793,2826,5619
06,06805,068052315,Tigre,BUENOS AIRES,362,340,741,754,1495
06,06805,068052406,Tigre,BUENOS AIRES,226,232,385,394,779
06,06805,068052506,Tigre,BUENOS AIRES,460,407,847,864,1711
06,06805,068052611,Tigre,BUENOS AIRES,112,391,149,148,297
06,06805,068052603,Tigre,BUENOS AIRES,157,423,184,200,384
06,06805,068051903,Tigre,BUENOS AIRES,295,350,468,473,941
06,06805,068052509,Tigre,BUENOS AIRES,283,286,433,407,840
06,06805,068050104,Tigre,BUENOS AIRES,318,411,493,498,991
06,06805,068050106,Tigre,BUENOS AIRES,158,242,280,284,564
06,06805,068050304,Tigre,BUENOS AIRES,607,729,1210,1120,2330
06,06805,068050407,Tigre,BUENOS AIRES,719,647,1340,1328,2668
06,06805,068050504,Tigre,BUENOS AIRES,251,290,349,343,692
06,06805,068050507,Tigre,BUENOS AIRES,521,541,843,749,1592
06,06805,068050510,Tigre,BUENOS AIRES,269,278,439,387,826
06,06805,068050606,Tigre,BUENOS AIRES,227,276,302,294,596
06,06805,068050711,Tigre,BUENOS AIRES,35,336,49,45,94
06,06805,068050901,Tigre,BUENOS AIRES,1,14,1,2,3
06,06805,068051007,Tigre,BUENOS AIRES,418,381,828,837,1665
06,06805,068051010,Tigre,BUENOS AIRES,379,300,775,815,1590
06,06805,068051102,Tigre,BUENOS AIRES,253,248,433,405,838
06,06805,068051210,Tigre,BUENOS AIRES,595,647,953,887,1840
06,06805,068051307,Tigre,BUENOS AIRES,311,322,507,488,995
06,06805,068051501,Tigre,BUENOS AIRES,275,290,460,402,862
06,06805,068051508,Tigre,BUENOS AIRES,433,455,778,737,1515
06,06805,068051602,Tigre,BUENOS AIRES,550,540,979,957,1936
06,06805,068051609,Tigre,BUENOS AIRES,316,325,640,598,1238
06,06805,068051610,Tigre,BUENOS AIRES,594,353,1089,1088,2177
06,06805,068051710,Tigre,BUENOS AIRES,431,327,803,761,1564
06,06805,068051711,Tigre,BUENOS AIRES,443,376,841,777,1618
06,06805,068051913,Tigre,BUENOS AIRES,82,99,87,91,178
06,06805,068052007,Tigre,BUENOS AIRES,533,546,1142,1121,2263
06,06805,068052104,Tigre,BUENOS AIRES,577,558,1041,1014,2055
06,06805,068052107,Tigre,BUENOS AIRES,271,214,583,582,1165
06,06805,068052113,Tigre,BUENOS AIRES,374,319,709,703,1412
06,06805,068052301,Tigre,BUENOS AIRES,344,332,682,671,1353
06,06805,068052305,Tigre,BUENOS AIRES,365,348,688,644,1332
06,06805,068052308,Tigre,BUENOS AIRES,250,241,435,463,898
06,06805,068052310,Tigre,BUENOS AIRES,392,339,746,808,1554
06,06805,068052402,Tigre,BUENOS AIRES,447,452,756,743,1499
06,06805,068052404,Tigre,BUENOS AIRES,374,415,623,616,1239
06,06805,068052410,Tigre,BUENOS AIRES,431,375,762,780,1542
06,06805,068052503,Tigre,BUENOS AIRES,156,198,254,267,521
06,06805,068052612,Tigre,BUENOS AIRES,82,327,100,128,228
06,06805,068052607,Tigre,BUENOS AIRES,27,131,29,35,64
06,06805,068052604,Tigre,BUENOS AIRES,71,341,83,94,177
06,06805,068050403,Tigre,BUENOS AIRES,535,525,1000,1026,2026
06,06805,068051109,Tigre,BUENOS AIRES,430,362,879,869,1748
06,06805,068051703,Tigre,BUENOS AIRES,236,266,387,319,706
06,06805,068052109,Tigre,BUENOS AIRES,325,299,626,562,1188
06,06805,068052510,Tigre,BUENOS AIRES,282,283,475,387,862
06,06805,068050610,Tigre,BUENOS AIRES,365,523,498,423,921
06,06805,068050202,Tigre,BUENOS AIRES,204,295,331,379,710
06,06805,068050309,Tigre,BUENOS AIRES,151,244,310,300,610
06,06805,068050506,Tigre,BUENOS AIRES,293,289,511,443,954
06,06805,068050611,Tigre,BUENOS AIRES,303,349,447,442,889
06,06805,068050803,Tigre,BUENOS AIRES,237,438,348,346,694
06,06805,068050807,Tigre,BUENOS AIRES,469,388,842,760,1602
06,06805,068050902,Tigre,BUENOS AIRES,295,299,518,496,1014
06,06805,068051004,Tigre,BUENOS AIRES,523,505,923,902,1825
06,06805,068051008,Tigre,BUENOS AIRES,546,506,1098,1085,2183
06,06805,068051011,Tigre,BUENOS AIRES,360,289,659,657,1316
06,06805,068051012,Tigre,BUENOS AIRES,294,328,667,614,1281
06,06805,068051203,Tigre,BUENOS AIRES,361,397,523,475,998
06,06805,068051207,Tigre,BUENOS AIRES,263,283,455,416,871
06,06805,068051302,Tigre,BUENOS AIRES,396,472,778,811,1589
06,06805,068051303,Tigre,BUENOS AIRES,465,481,900,835,1735
06,06805,068051407,Tigre,BUENOS AIRES,309,321,533,527,1060
06,06805,068051413,Tigre,BUENOS AIRES,375,356,725,689,1414
06,06805,068051414,Tigre,BUENOS AIRES,369,367,716,717,1433
06,06805,068051509,Tigre,BUENOS AIRES,419,431,632,584,1216
06,06805,068051513,Tigre,BUENOS AIRES,366,395,609,594,1203
06,06805,068051604,Tigre,BUENOS AIRES,476,428,918,927,1845
06,06805,068051606,Tigre,BUENOS AIRES,332,327,588,585,1173
06,06805,068051608,Tigre,BUENOS AIRES,350,299,659,628,1287
06,06805,068051709,Tigre,BUENOS AIRES,526,425,902,883,1785
06,06805,068051803,Tigre,BUENOS AIRES,470,468,781,739,1520
06,06805,068051807,Tigre,BUENOS AIRES,282,284,477,391,868
06,06805,068051808,Tigre,BUENOS AIRES,440,435,693,657,1350
06,06805,068051810,Tigre,BUENOS AIRES,439,453,737,670,1407
06,06805,068051907,Tigre,BUENOS AIRES,256,275,424,382,806
06,06805,068052003,Tigre,BUENOS AIRES,253,226,410,359,769
06,06805,068052010,Tigre,BUENOS AIRES,352,310,615,582,1197
06,06805,068052011,Tigre,BUENOS AIRES,380,362,739,727,1466
06,06805,068052209,Tigre,BUENOS AIRES,430,524,742,770,1512
06,06805,068052210,Tigre,BUENOS AIRES,272,314,465,472,937
06,06805,068052508,Tigre,BUENOS AIRES,217,392,483,540,1023
06,06805,068052619,Tigre,BUENOS AIRES,119,250,160,173,333
06,06805,068052605,Tigre,BUENOS AIRES,52,278,54,73,127
06,06805,068051110,Tigre,BUENOS AIRES,487,467,1002,944,1946
06,06805,068051304,Tigre,BUENOS AIRES,403,426,697,626,1323
06,06805,068051408,Tigre,BUENOS AIRES,295,290,551,527,1078
06,06805,068051409,Tigre,BUENOS AIRES,333,345,559,519,1078
06,06805,068050102,Tigre,BUENOS AIRES,207,245,339,346,685
06,06805,068050103,Tigre,BUENOS AIRES,221,182,413,417,830
06,06805,068050311,Tigre,BUENOS AIRES,381,454,755,703,1458
06,06805,068050401,Tigre,BUENOS AIRES,225,312,395,389,784
06,06805,068050412,Tigre,BUENOS AIRES,687,735,1354,1288,2642
06,06805,068050503,Tigre,BUENOS AIRES,412,446,691,580,1271
06,06805,068050612,Tigre,BUENOS AIRES,351,465,541,431,972
06,06805,068050701,Tigre,BUENOS AIRES,161,329,256,227,483
06,06805,068050805,Tigre,BUENOS AIRES,186,323,271,259,530
06,06805,068050812,Tigre,BUENOS AIRES,239,253,457,446,903
06,06805,068050905,Tigre,BUENOS AIRES,611,775,1236,1151,2387
06,06805,068051003,Tigre,BUENOS AIRES,302,312,543,479,1022
06,06805,068051006,Tigre,BUENOS AIRES,429,412,741,668,1409
06,06805,068051009,Tigre,BUENOS AIRES,485,483,1008,956,1964
06,06805,068051105,Tigre,BUENOS AIRES,405,436,758,699,1457
06,06805,068051208,Tigre,BUENOS AIRES,255,276,413,370,783
06,06805,068051212,Tigre,BUENOS AIRES,429,492,651,563,1214
06,06805,068051214,Tigre,BUENOS AIRES,272,314,483,446,929
06,06805,068051314,Tigre,BUENOS AIRES,352,344,588,543,1131
06,06805,068051415,Tigre,BUENOS AIRES,353,361,700,648,1348
06,06805,068051502,Tigre,BUENOS AIRES,285,311,431,419,850
06,06805,068051504,Tigre,BUENOS AIRES,336,350,592,520,1112
06,06805,068051506,Tigre,BUENOS AIRES,503,481,871,816,1687
06,06805,068051607,Tigre,BUENOS AIRES,361,367,615,620,1235
06,06805,068051611,Tigre,BUENOS AIRES,384,384,612,624,1236
06,06805,068051708,Tigre,BUENOS AIRES,469,460,809,740,1549
06,06805,068051802,Tigre,BUENOS AIRES,249,250,423,419,842
06,06805,068051805,Tigre,BUENOS AIRES,351,404,590,562,1152
06,06805,068051812,Tigre,BUENOS AIRES,431,230,861,923,1784
06,06805,068052103,Tigre,BUENOS AIRES,506,515,981,979,1960
06,06805,068052302,Tigre,BUENOS AIRES,411,404,836,825,1661
06,06805,068052401,Tigre,BUENOS AIRES,415,473,774,702,1476
06,06805,068052606,Tigre,BUENOS AIRES,44,161,50,63,113
06,06574,065740412,Navarro,BUENOS AIRES,275,316,410,395,805
06,06574,065740602,Navarro,BUENOS AIRES,25,52,22,35,57
06,06574,065740403,Navarro,BUENOS AIRES,356,394,633,639,1272
06,06574,065740409,Navarro,BUENOS AIRES,259,322,402,361,763
06,06574,065740414,Navarro,BUENOS AIRES,318,382,512,520,1032
06,06574,065740102,Navarro,BUENOS AIRES,28,47,39,47,86
06,06574,065740502,Navarro,BUENOS AIRES,39,62,65,77,142
06,06574,065740706,Navarro,BUENOS AIRES,29,61,44,50,94
06,06574,065740901,Navarro,BUENOS AIRES,15,25,30,31,61
06,06574,065740802,Navarro,BUENOS AIRES,28,43,40,42,82
06,06574,065740402,Navarro,BUENOS AIRES,374,465,737,721,1458
06,06574,065740410,Navarro,BUENOS AIRES,370,421,581,479,1060
06,06574,065740503,Navarro,BUENOS AIRES,41,55,53,70,123
06,06574,065740404,Navarro,BUENOS AIRES,297,307,503,469,972
06,06574,065740411,Navarro,BUENOS AIRES,256,291,423,369,792
06,06574,065740407,Navarro,BUENOS AIRES,291,353,424,369,793
06,06574,065740701,Navarro,BUENOS AIRES,169,221,234,216,450
06,06574,065740302,Navarro,BUENOS AIRES,32,50,45,65,110
06,06574,065740401,Navarro,BUENOS AIRES,71,94,121,132,253
06,06574,065740703,Navarro,BUENOS AIRES,27,44,34,40,74
06,06574,065740707,Navarro,BUENOS AIRES,22,51,35,40,75
06,06574,065740405,Navarro,BUENOS AIRES,254,292,430,454,884
06,06574,065740301,Navarro,BUENOS AIRES,10,13,17,21,38
06,06574,065740303,Navarro,BUENOS AIRES,56,92,98,109,207
06,06574,065740413,Navarro,BUENOS AIRES,8,15,12,9,21
06,06574,065740601,Navarro,BUENOS AIRES,43,74,67,86,153
06,06574,065740704,Navarro,BUENOS AIRES,15,26,23,20,43
06,06574,065740705,Navarro,BUENOS AIRES,32,50,54,76,130
06,06574,065740708,Navarro,BUENOS AIRES,24,45,35,46,81
06,06574,065740702,Navarro,BUENOS AIRES,66,102,108,99,207
06,06574,065740801,Navarro,BUENOS AIRES,104,138,137,148,285
06,06574,065740501,Navarro,BUENOS AIRES,26,40,48,60,108
06,06574,065740803,Navarro,BUENOS AIRES,27,64,37,44,81
06,06574,065740416,Navarro,BUENOS AIRES,237,299,388,408,796
06,06574,065740805,Navarro,BUENOS AIRES,94,132,152,153,305
06,06574,065740201,Navarro,BUENOS AIRES,14,27,11,26,37
06,06574,065740804,Navarro,BUENOS AIRES,23,48,29,41,70
06,06574,065740902,Navarro,BUENOS AIRES,25,45,41,45,86
06,06574,065740406,Navarro,BUENOS AIRES,236,260,392,378,770
06,06574,065740408,Navarro,BUENOS AIRES,311,366,438,391,829
06,06574,065740415,Navarro,BUENOS AIRES,278,343,509,489,998
06,06574,065740101,Navarro,BUENOS AIRES,21,40,35,46,81
06,06574,065740202,Navarro,BUENOS AIRES,56,77,90,97,187
06,06574,065740903,Navarro,BUENOS AIRES,39,47,45,58,103
06,06840,068400508,Tres de Febrero,BUENOS AIRES,433,482,681,568,1249
06,06840,068400206,Tres de Febrero,BUENOS AIRES,329,374,471,456,927
06,06840,068400106,Tres de Febrero,BUENOS AIRES,409,367,776,740,1516
06,06840,068400201,Tres de Febrero,BUENOS AIRES,398,344,722,672,1394
06,06840,068400202,Tres de Febrero,BUENOS AIRES,437,387,760,737,1497
06,06840,068400311,Tres de Febrero,BUENOS AIRES,475,498,812,766,1578
06,06840,068400402,Tres de Febrero,BUENOS AIRES,459,383,959,995,1954
06,06840,068400412,Tres de Febrero,BUENOS AIRES,212,187,375,315,690
06,06840,068400501,Tres de Febrero,BUENOS AIRES,346,277,653,626,1279
06,06840,068400503,Tres de Febrero,BUENOS AIRES,318,340,528,474,1002
06,06840,068400608,Tres de Febrero,BUENOS AIRES,211,232,308,276,584
06,06840,068400611,Tres de Febrero,BUENOS AIRES,204,235,323,278,601
06,06840,068400614,Tres de Febrero,BUENOS AIRES,369,376,595,574,1169
06,06840,068400615,Tres de Febrero,BUENOS AIRES,309,333,518,446,964
06,06840,068400710,Tres de Febrero,BUENOS AIRES,391,478,581,515,1096
06,06840,068400803,Tres de Febrero,BUENOS AIRES,177,191,308,256,564
06,06840,068401209,Tres de Febrero,BUENOS AIRES,273,293,447,364,811
06,06840,068401408,Tres de Febrero,BUENOS AIRES,159,174,243,235,478
06,06840,068401409,Tres de Febrero,BUENOS AIRES,291,341,456,414,870
06,06840,068401702,Tres de Febrero,BUENOS AIRES,438,485,610,525,1135
06,06840,068401704,Tres de Febrero,BUENOS AIRES,266,337,391,339,730
06,06840,068401707,Tres de Febrero,BUENOS AIRES,237,267,348,304,652
06,06840,068401901,Tres de Febrero,BUENOS AIRES,203,263,270,209,479
06,06840,068401902,Tres de Febrero,BUENOS AIRES,228,320,362,277,639
06,06840,068401911,Tres de Febrero,BUENOS AIRES,332,315,547,471,1018
06,06840,068402010,Tres de Febrero,BUENOS AIRES,245,262,388,354,742
06,06840,068402306,Tres de Febrero,BUENOS AIRES,191,206,302,285,587
06,06840,068402308,Tres de Febrero,BUENOS AIRES,444,417,775,764,1539
06,06840,068402309,Tres de Febrero,BUENOS AIRES,238,281,361,348,709
06,06840,068402401,Tres de Febrero,BUENOS AIRES,346,352,537,503,1040
06,06840,068402405,Tres de Febrero,BUENOS AIRES,269,208,476,484,960
06,06840,068402410,Tres de Febrero,BUENOS AIRES,189,233,290,235,525
06,06840,068402502,Tres de Febrero,BUENOS AIRES,59,59,107,112,219
06,06840,068402503,Tres de Febrero,BUENOS AIRES,170,159,307,318,625
06,06840,068402509,Tres de Febrero,BUENOS AIRES,160,174,313,290,603
06,06840,068402707,Tres de Febrero,BUENOS AIRES,275,258,402,369,771
06,06840,068402811,Tres de Febrero,BUENOS AIRES,344,286,579,514,1093
06,06840,068402908,Tres de Febrero,BUENOS AIRES,302,319,453,383,836
06,06840,068403006,Tres de Febrero,BUENOS AIRES,230,253,362,313,675
06,06840,068403011,Tres de Febrero,BUENOS AIRES,296,359,443,364,807
06,06840,068403104,Tres de Febrero,BUENOS AIRES,227,244,394,354,748
06,06840,068403107,Tres de Febrero,BUENOS AIRES,303,365,442,382,824
06,06840,068403204,Tres de Febrero,BUENOS AIRES,321,368,483,407,890
06,06840,068400706,Tres de Febrero,BUENOS AIRES,292,325,436,379,815
06,06840,068402205,Tres de Febrero,BUENOS AIRES,284,285,461,420,881
06,06840,068400105,Tres de Febrero,BUENOS AIRES,503,510,951,931,1882
06,06840,068400112,Tres de Febrero,BUENOS AIRES,357,319,633,601,1234
06,06840,068400212,Tres de Febrero,BUENOS AIRES,399,398,644,645,1289
06,06840,068400307,Tres de Febrero,BUENOS AIRES,415,383,709,671,1380
06,06840,068400401,Tres de Febrero,BUENOS AIRES,489,495,881,872,1753
06,06840,068400604,Tres de Febrero,BUENOS AIRES,306,288,502,502,1004
06,06840,068401604,Tres de Febrero,BUENOS AIRES,311,351,393,400,793
06,06840,068400704,Tres de Febrero,BUENOS AIRES,316,363,458,411,869
06,06840,068400707,Tres de Febrero,BUENOS AIRES,316,348,493,439,932
06,06840,068400901,Tres de Febrero,BUENOS AIRES,302,330,495,461,956
06,06840,068401004,Tres de Febrero,BUENOS AIRES,320,353,401,320,721
06,06840,068401013,Tres de Febrero,BUENOS AIRES,232,260,298,263,561
06,06840,068401101,Tres de Febrero,BUENOS AIRES,282,315,412,377,789
06,06840,068401102,Tres de Febrero,BUENOS AIRES,236,249,377,359,736
06,06840,068401204,Tres de Febrero,BUENOS AIRES,200,195,305,251,556
06,06840,068401403,Tres de Febrero,BUENOS AIRES,251,271,366,353,719
06,06840,068401301,Tres de Febrero,BUENOS AIRES,333,346,494,456,950
06,06840,068401304,Tres de Febrero,BUENOS AIRES,347,384,498,452,950
06,06840,068401308,Tres de Febrero,BUENOS AIRES,222,243,322,280,602
06,06840,068401310,Tres de Febrero,BUENOS AIRES,431,457,648,568,1216
06,06840,068401510,Tres de Febrero,BUENOS AIRES,376,503,521,454,975
06,06840,068401601,Tres de Febrero,BUENOS AIRES,254,292,379,344,723
06,06840,068401803,Tres de Febrero,BUENOS AIRES,190,228,286,206,492
06,06840,068401806,Tres de Febrero,BUENOS AIRES,390,532,517,421,938
06,06840,068401811,Tres de Febrero,BUENOS AIRES,229,260,343,299,642
06,06840,068401912,Tres de Febrero,BUENOS AIRES,304,279,471,438,909
06,06840,068402005,Tres de Febrero,BUENOS AIRES,334,359,512,453,965
06,06840,068402108,Tres de Febrero,BUENOS AIRES,305,278,564,502,1066
06,06840,068402202,Tres de Febrero,BUENOS AIRES,327,337,512,459,971
06,06840,068402404,Tres de Febrero,BUENOS AIRES,241,245,397,363,760
06,06840,068402605,Tres de Febrero,BUENOS AIRES,319,323,549,494,1043
06,06840,068402809,Tres de Febrero,BUENOS AIRES,297,289,501,438,939
06,06840,068403009,Tres de Febrero,BUENOS AIRES,241,294,350,278,628
06,06840,068403013,Tres de Febrero,BUENOS AIRES,216,296,269,222,491
06,06840,068403208,Tres de Febrero,BUENOS AIRES,314,344,501,437,938
06,06840,068401009,Tres de Febrero,BUENOS AIRES,187,254,224,169,393
06,06840,068400409,Tres de Febrero,BUENOS AIRES,286,297,453,432,885
06,06840,068400108,Tres de Febrero,BUENOS AIRES,198,168,415,418,833
06,06840,068400203,Tres de Febrero,BUENOS AIRES,331,333,485,452,937
06,06840,068400306,Tres de Febrero,BUENOS AIRES,363,335,666,611,1277
06,06840,068400309,Tres de Febrero,BUENOS AIRES,292,306,516,492,1008
06,06840,068400403,Tres de Febrero,BUENOS AIRES,279,250,506,495,1001
06,06840,068400410,Tres de Febrero,BUENOS AIRES,433,443,770,761,1531
06,06840,068400414,Tres de Febrero,BUENOS AIRES,342,399,513,503,1016
06,06840,068400416,Tres de Febrero,BUENOS AIRES,399,421,579,561,1140
06,06840,068400701,Tres de Febrero,BUENOS AIRES,418,429,689,601,1290
06,06840,068400709,Tres de Febrero,BUENOS AIRES,355,406,530,458,988
06,06840,068400808,Tres de Febrero,BUENOS AIRES,237,241,353,340,693
06,06840,068400903,Tres de Febrero,BUENOS AIRES,327,369,439,413,852
06,06840,068400909,Tres de Febrero,BUENOS AIRES,242,254,343,298,641
06,06840,068401010,Tres de Febrero,BUENOS AIRES,250,322,301,299,600
06,06840,068401103,Tres de Febrero,BUENOS AIRES,170,189,261,256,517
06,06840,068401105,Tres de Febrero,BUENOS AIRES,266,276,416,404,820
06,06840,068401205,Tres de Febrero,BUENOS AIRES,317,327,483,421,904
06,06840,068401206,Tres de Febrero,BUENOS AIRES,4,4,8,10,18
06,06840,068401207,Tres de Febrero,BUENOS AIRES,214,213,335,299,634
06,06840,068401302,Tres de Febrero,BUENOS AIRES,205,216,292,280,572
06,06840,068401305,Tres de Febrero,BUENOS AIRES,282,313,423,363,786
06,06840,068401307,Tres de Febrero,BUENOS AIRES,210,247,296,237,533
06,06840,068401309,Tres de Febrero,BUENOS AIRES,337,409,466,425,891
06,06840,068401503,Tres de Febrero,BUENOS AIRES,261,318,375,336,711
06,06840,068401504,Tres de Febrero,BUENOS AIRES,256,261,378,312,690
06,06840,068401508,Tres de Febrero,BUENOS AIRES,249,312,298,246,544
06,06840,068401511,Tres de Febrero,BUENOS AIRES,182,238,262,230,492
06,06840,068401514,Tres de Febrero,BUENOS AIRES,335,387,489,431,920
06,06840,068401708,Tres de Febrero,BUENOS AIRES,306,327,446,419,865
06,06840,068401711,Tres de Febrero,BUENOS AIRES,196,212,300,272,572
06,06840,068401712,Tres de Febrero,BUENOS AIRES,217,241,336,303,639
06,06840,068401713,Tres de Febrero,BUENOS AIRES,215,248,302,279,581
06,06840,068401809,Tres de Febrero,BUENOS AIRES,347,382,551,496,1047
06,06840,068401813,Tres de Febrero,BUENOS AIRES,350,392,531,466,997
06,06840,068401906,Tres de Febrero,BUENOS AIRES,398,391,630,575,1205
06,06840,068402403,Tres de Febrero,BUENOS AIRES,202,202,313,274,587
06,06840,068401909,Tres de Febrero,BUENOS AIRES,243,263,405,367,772
06,06840,068402002,Tres de Febrero,BUENOS AIRES,275,303,445,396,841
06,06840,068402007,Tres de Febrero,BUENOS AIRES,295,321,440,421,861
06,06840,068402102,Tres de Febrero,BUENOS AIRES,218,252,337,285,622
06,06840,068402109,Tres de Febrero,BUENOS AIRES,362,327,694,656,1350
06,06840,068402305,Tres de Febrero,BUENOS AIRES,367,402,565,500,1065
06,06840,068402407,Tres de Febrero,BUENOS AIRES,298,302,484,433,917
06,06840,068402504,Tres de Febrero,BUENOS AIRES,248,232,429,485,914
06,06840,068402604,Tres de Febrero,BUENOS AIRES,162,177,268,236,504
06,06840,068402606,Tres de Febrero,BUENOS AIRES,938,947,1697,1574,3271
06,06840,068402708,Tres de Febrero,BUENOS AIRES,277,314,465,411,876
06,06840,068402710,Tres de Febrero,BUENOS AIRES,351,344,549,489,1038
06,06840,068402711,Tres de Febrero,BUENOS AIRES,240,221,360,343,703
06,06840,068402712,Tres de Febrero,BUENOS AIRES,324,355,549,452,1001
06,06840,068402802,Tres de Febrero,BUENOS AIRES,313,292,488,448,936
06,06840,068402806,Tres de Febrero,BUENOS AIRES,277,287,466,462,928
06,06840,068402905,Tres de Febrero,BUENOS AIRES,389,397,628,546,1174
06,06840,068403005,Tres de Febrero,BUENOS AIRES,170,203,260,228,488
06,06840,068403202,Tres de Febrero,BUENOS AIRES,305,357,455,420,875
06,06840,068400708,Tres de Febrero,BUENOS AIRES,359,384,555,500,1055
06,06840,068401609,Tres de Febrero,BUENOS AIRES,319,387,445,366,811
06,06840,068401610,Tres de Febrero,BUENOS AIRES,221,228,323,288,611
06,06840,068400208,Tres de Febrero,BUENOS AIRES,241,279,344,362,706
06,06840,068400209,Tres de Febrero,BUENOS AIRES,350,363,606,567,1173
06,06840,068400205,Tres de Febrero,BUENOS AIRES,320,320,543,488,1031
06,06840,068400102,Tres de Febrero,BUENOS AIRES,338,347,614,609,1223
06,06840,068400107,Tres de Febrero,BUENOS AIRES,422,278,821,835,1656
06,06840,068400110,Tres de Febrero,BUENOS AIRES,430,423,809,791,1600
06,06840,068400504,Tres de Febrero,BUENOS AIRES,300,305,468,409,877
06,06840,068400505,Tres de Febrero,BUENOS AIRES,300,265,481,450,931
06,06840,068400510,Tres de Febrero,BUENOS AIRES,302,347,474,471,945
06,06840,068400602,Tres de Febrero,BUENOS AIRES,208,207,341,313,654
06,06840,068400607,Tres de Febrero,BUENOS AIRES,297,335,435,412,847
06,06840,068400703,Tres de Febrero,BUENOS AIRES,304,332,471,397,868
06,06840,068400804,Tres de Febrero,BUENOS AIRES,291,326,505,429,934
06,06840,068400805,Tres de Febrero,BUENOS AIRES,333,371,567,487,1054
06,06840,068400809,Tres de Febrero,BUENOS AIRES,388,412,619,548,1167
06,06840,068400812,Tres de Febrero,BUENOS AIRES,366,410,593,517,1110
06,06840,068400910,Tres de Febrero,BUENOS AIRES,320,307,436,407,843
06,06840,068401006,Tres de Febrero,BUENOS AIRES,328,355,403,333,736
06,06840,068401109,Tres de Febrero,BUENOS AIRES,315,318,451,394,845
06,06840,068401112,Tres de Febrero,BUENOS AIRES,336,347,528,425,953
06,06840,068401203,Tres de Febrero,BUENOS AIRES,366,386,533,503,1036
06,06840,068401606,Tres de Febrero,BUENOS AIRES,317,405,442,395,837
06,06840,068401607,Tres de Febrero,BUENOS AIRES,224,245,350,290,640
06,06840,068401701,Tres de Febrero,BUENOS AIRES,273,323,395,338,733
06,06840,068401802,Tres de Febrero,BUENOS AIRES,285,349,394,322,716
06,06840,068401805,Tres de Febrero,BUENOS AIRES,177,238,248,196,444
06,06840,068401807,Tres de Febrero,BUENOS AIRES,394,474,544,472,1016
06,06840,068402001,Tres de Febrero,BUENOS AIRES,293,338,437,378,815
06,06840,068402203,Tres de Febrero,BUENOS AIRES,353,343,564,507,1071
06,06840,068402204,Tres de Febrero,BUENOS AIRES,322,330,476,479,955
06,06840,068402601,Tres de Febrero,BUENOS AIRES,422,359,865,889,1754
06,06840,068402803,Tres de Febrero,BUENOS AIRES,204,208,383,333,716
06,06840,068402804,Tres de Febrero,BUENOS AIRES,274,236,457,434,891
06,06840,068402903,Tres de Febrero,BUENOS AIRES,452,476,819,757,1576
06,06840,068402904,Tres de Febrero,BUENOS AIRES,303,263,509,428,937
06,06840,068402906,Tres de Febrero,BUENOS AIRES,266,323,378,315,693
06,06840,068403004,Tres de Febrero,BUENOS AIRES,304,312,452,405,857
06,06840,068403101,Tres de Febrero,BUENOS AIRES,122,112,182,202,384
06,06840,068403105,Tres de Febrero,BUENOS AIRES,335,348,531,468,999
06,06840,068403201,Tres de Febrero,BUENOS AIRES,148,176,214,198,412
06,06840,068403207,Tres de Febrero,BUENOS AIRES,308,356,461,404,865
06,06840,068403209,Tres de Febrero,BUENOS AIRES,312,345,473,421,894
06,06840,068400204,Tres de Febrero,BUENOS AIRES,294,298,499,442,941
06,06840,068400104,Tres de Febrero,BUENOS AIRES,292,259,544,504,1048
06,06840,068400305,Tres de Febrero,BUENOS AIRES,391,397,706,679,1385
06,06840,068400312,Tres de Febrero,BUENOS AIRES,426,433,759,734,1493
06,06840,068400413,Tres de Febrero,BUENOS AIRES,381,378,614,610,1224
06,06840,068400415,Tres de Febrero,BUENOS AIRES,383,380,658,608,1266
06,06840,068400509,Tres de Febrero,BUENOS AIRES,235,254,375,344,719
06,06840,068400605,Tres de Febrero,BUENOS AIRES,382,381,607,524,1131
06,06840,068400612,Tres de Febrero,BUENOS AIRES,197,216,317,308,625
06,06840,068400705,Tres de Febrero,BUENOS AIRES,252,277,373,370,743
06,06840,068400711,Tres de Febrero,BUENOS AIRES,341,395,677,455,1132
06,06840,068400801,Tres de Febrero,BUENOS AIRES,301,337,451,383,834
06,06840,068400811,Tres de Febrero,BUENOS AIRES,315,370,483,415,898
06,06840,068400904,Tres de Febrero,BUENOS AIRES,210,238,382,329,711
06,06840,068400906,Tres de Febrero,BUENOS AIRES,306,318,396,342,738
06,06840,068400908,Tres de Febrero,BUENOS AIRES,235,260,349,295,644
06,06840,068401005,Tres de Febrero,BUENOS AIRES,207,220,321,267,588
06,06840,068401007,Tres de Febrero,BUENOS AIRES,305,336,410,354,764
06,06840,068401011,Tres de Febrero,BUENOS AIRES,259,331,338,305,643
06,06840,068401104,Tres de Febrero,BUENOS AIRES,105,99,169,138,307
06,06840,068401311,Tres de Febrero,BUENOS AIRES,249,281,417,363,780
06,06840,068401312,Tres de Febrero,BUENOS AIRES,357,443,542,417,959
06,06840,068401401,Tres de Febrero,BUENOS AIRES,337,389,538,467,1005
06,06840,068401407,Tres de Febrero,BUENOS AIRES,294,326,435,366,801
06,06840,068401513,Tres de Febrero,BUENOS AIRES,324,393,460,416,876
06,06840,068401611,Tres de Febrero,BUENOS AIRES,195,224,270,235,505
06,06840,068401801,Tres de Febrero,BUENOS AIRES,117,114,230,213,443
06,06840,068401812,Tres de Febrero,BUENOS AIRES,218,246,328,316,644
06,06840,068401907,Tres de Febrero,BUENOS AIRES,282,292,409,349,758
06,06840,068402003,Tres de Febrero,BUENOS AIRES,378,395,596,536,1132
06,06840,068402004,Tres de Febrero,BUENOS AIRES,358,395,541,486,1027
06,06840,068402107,Tres de Febrero,BUENOS AIRES,381,426,565,519,1084
06,06840,068402207,Tres de Febrero,BUENOS AIRES,380,407,589,531,1120
06,06840,068402302,Tres de Febrero,BUENOS AIRES,293,300,443,394,837
06,06840,068402402,Tres de Febrero,BUENOS AIRES,288,326,430,385,815
06,06840,068402501,Tres de Febrero,BUENOS AIRES,125,128,230,230,460
06,06840,068402510,Tres de Febrero,BUENOS AIRES,257,227,496,462,958
06,06840,068402511,Tres de Febrero,BUENOS AIRES,211,195,433,391,824
06,06840,068402607,Tres de Febrero,BUENOS AIRES,199,214,285,288,573
06,06840,068402608,Tres de Febrero,BUENOS AIRES,6,26,9,7,16
06,06840,068402702,Tres de Febrero,BUENOS AIRES,373,399,616,610,1226
06,06840,068402703,Tres de Febrero,BUENOS AIRES,303,289,582,542,1124
06,06840,068402705,Tres de Febrero,BUENOS AIRES,103,141,127,135,262
06,06840,068402902,Tres de Febrero,BUENOS AIRES,263,277,403,368,771
06,06840,068402909,Tres de Febrero,BUENOS AIRES,351,388,554,475,1029
06,06840,068402910,Tres de Febrero,BUENOS AIRES,371,401,590,547,1137
06,06840,068402911,Tres de Febrero,BUENOS AIRES,179,192,292,261,553
06,06840,068403103,Tres de Febrero,BUENOS AIRES,363,455,499,390,889
06,06840,068403205,Tres de Febrero,BUENOS AIRES,260,310,453,432,885
06,06840,068400303,Tres de Febrero,BUENOS AIRES,316,321,514,510,1024
06,06840,068401804,Tres de Febrero,BUENOS AIRES,220,273,267,228,495
06,06840,068400210,Tres de Febrero,BUENOS AIRES,279,306,443,421,864
06,06840,068400207,Tres de Febrero,BUENOS AIRES,213,238,451,371,822
06,06840,068400103,Tres de Febrero,BUENOS AIRES,537,496,1003,945,1948
06,06840,068400109,Tres de Febrero,BUENOS AIRES,313,294,595,556,1151
06,06840,068400301,Tres de Febrero,BUENOS AIRES,368,391,585,523,1108
06,06840,068400304,Tres de Febrero,BUENOS AIRES,403,408,710,623,1333
06,06840,068400310,Tres de Febrero,BUENOS AIRES,270,269,459,427,886
06,06840,068400601,Tres de Febrero,BUENOS AIRES,407,352,748,726,1474
06,06840,068400610,Tres de Febrero,BUENOS AIRES,249,263,373,353,726
06,06840,068400616,Tres de Febrero,BUENOS AIRES,328,359,526,508,1034
06,06840,068401402,Tres de Febrero,BUENOS AIRES,231,195,348,298,646
06,06840,068401001,Tres de Febrero,BUENOS AIRES,411,454,596,544,1140
06,06840,068401002,Tres de Febrero,BUENOS AIRES,441,470,646,576,1222
06,06840,068401106,Tres de Febrero,BUENOS AIRES,378,418,568,542,1110
06,06840,068401107,Tres de Febrero,BUENOS AIRES,279,315,399,369,768
06,06840,068401110,Tres de Febrero,BUENOS AIRES,410,387,635,536,1171
06,06840,068401201,Tres de Febrero,BUENOS AIRES,365,398,555,479,1034
06,06840,068401202,Tres de Febrero,BUENOS AIRES,376,406,575,499,1074
06,06840,068401314,Tres de Febrero,BUENOS AIRES,180,264,354,249,603
06,06840,068401406,Tres de Febrero,BUENOS AIRES,262,303,384,309,693
06,06840,068401502,Tres de Febrero,BUENOS AIRES,407,474,569,492,1061
06,06840,068401608,Tres de Febrero,BUENOS AIRES,336,422,467,418,885
06,06840,068401703,Tres de Febrero,BUENOS AIRES,332,402,509,430,939
06,06840,068403110,Tres de Febrero,BUENOS AIRES,268,294,430,368,798
06,06840,068401905,Tres de Febrero,BUENOS AIRES,335,364,514,454,968
06,06840,068402006,Tres de Febrero,BUENOS AIRES,322,367,494,462,956
06,06840,068402009,Tres de Febrero,BUENOS AIRES,311,298,524,481,1005
06,06840,068402106,Tres de Febrero,BUENOS AIRES,391,400,579,558,1137
06,06840,068402110,Tres de Febrero,BUENOS AIRES,393,357,717,627,1344
06,06840,068402201,Tres de Febrero,BUENOS AIRES,399,409,677,642,1319
06,06840,068402304,Tres de Febrero,BUENOS AIRES,225,240,345,318,663
06,06840,068402307,Tres de Febrero,BUENOS AIRES,189,206,291,290,581
06,06840,068402310,Tres de Febrero,BUENOS AIRES,305,297,486,459,945
06,06840,068402603,Tres de Febrero,BUENOS AIRES,359,379,629,633,1262
06,06840,068402701,Tres de Febrero,BUENOS AIRES,250,279,385,349,734
06,06840,068403109,Tres de Febrero,BUENOS AIRES,380,435,557,498,1055
06,06840,068402805,Tres de Febrero,BUENOS AIRES,380,358,649,622,1271
06,06840,068402901,Tres de Febrero,BUENOS AIRES,333,352,505,507,1012
06,06840,068403007,Tres de Febrero,BUENOS AIRES,231,274,356,335,691
06,06840,068403108,Tres de Febrero,BUENOS AIRES,333,384,496,410,906
06,06840,068403206,Tres de Febrero,BUENOS AIRES,267,270,398,355,753
06,06840,068400408,Tres de Febrero,BUENOS AIRES,150,163,227,234,461
06,06840,068400111,Tres de Febrero,BUENOS AIRES,335,315,597,544,1141
06,06840,068400308,Tres de Febrero,BUENOS AIRES,477,463,801,766,1567
06,06840,068400407,Tres de Febrero,BUENOS AIRES,327,346,489,473,962
06,06840,068400502,Tres de Febrero,BUENOS AIRES,293,296,463,455,918
06,06840,068400506,Tres de Febrero,BUENOS AIRES,216,223,385,295,680
06,06840,068400507,Tres de Febrero,BUENOS AIRES,295,397,476,427,903
06,06840,068400511,Tres de Febrero,BUENOS AIRES,485,538,770,760,1530
06,06840,068400606,Tres de Febrero,BUENOS AIRES,410,430,646,604,1250
06,06840,068400613,Tres de Febrero,BUENOS AIRES,288,284,499,487,986
06,06840,068400802,Tres de Febrero,BUENOS AIRES,188,195,321,284,605
06,06840,068400807,Tres de Febrero,BUENOS AIRES,273,284,418,371,789
06,06840,068400810,Tres de Febrero,BUENOS AIRES,242,265,360,304,664
06,06840,068400902,Tres de Febrero,BUENOS AIRES,217,249,319,292,611
06,06840,068400905,Tres de Febrero,BUENOS AIRES,222,226,297,262,559
06,06840,068401003,Tres de Febrero,BUENOS AIRES,240,299,316,266,582
06,06840,068401012,Tres de Febrero,BUENOS AIRES,180,188,280,234,514
06,06840,068401108,Tres de Febrero,BUENOS AIRES,422,443,609,587,1196
06,06840,068401111,Tres de Febrero,BUENOS AIRES,368,362,540,488,1028
06,06840,068401208,Tres de Febrero,BUENOS AIRES,237,265,348,328,676
06,06840,068401306,Tres de Febrero,BUENOS AIRES,233,269,348,299,647
06,06840,068401404,Tres de Febrero,BUENOS AIRES,430,431,702,626,1328
06,06840,068401405,Tres de Febrero,BUENOS AIRES,304,265,442,421,863
06,06840,068401410,Tres de Febrero,BUENOS AIRES,307,345,488,430,918
06,06840,068401507,Tres de Febrero,BUENOS AIRES,195,228,269,230,499
06,06840,068401509,Tres de Febrero,BUENOS AIRES,343,404,489,431,920
06,06840,068401512,Tres de Febrero,BUENOS AIRES,224,256,279,275,554
06,06840,068401602,Tres de Febrero,BUENOS AIRES,284,314,402,350,752
06,06840,068401603,Tres de Febrero,BUENOS AIRES,303,356,418,392,810
06,06840,068401605,Tres de Febrero,BUENOS AIRES,323,411,475,427,902
06,06840,068401612,Tres de Febrero,BUENOS AIRES,210,267,298,269,567
06,06840,068401614,Tres de Febrero,BUENOS AIRES,158,200,245,218,463
06,06840,068401705,Tres de Febrero,BUENOS AIRES,313,325,454,436,890
06,06840,068401709,Tres de Febrero,BUENOS AIRES,201,230,310,278,588
06,06840,068401710,Tres de Febrero,BUENOS AIRES,251,279,390,353,743
06,06840,068401908,Tres de Febrero,BUENOS AIRES,334,307,535,459,994
06,06840,068401810,Tres de Febrero,BUENOS AIRES,360,374,573,505,1078
06,06840,068401910,Tres de Febrero,BUENOS AIRES,222,260,308,291,599
06,06840,068402008,Tres de Febrero,BUENOS AIRES,257,218,427,368,795
06,06840,068402011,Tres de Febrero,BUENOS AIRES,370,384,621,511,1132
06,06840,068402104,Tres de Febrero,BUENOS AIRES,237,230,368,330,698
06,06840,068402105,Tres de Febrero,BUENOS AIRES,216,179,374,346,720
06,06840,068402206,Tres de Febrero,BUENOS AIRES,322,355,497,487,984
06,06840,068402301,Tres de Febrero,BUENOS AIRES,260,271,387,357,744
06,06840,068402303,Tres de Febrero,BUENOS AIRES,172,190,287,228,515
06,06840,068402408,Tres de Febrero,BUENOS AIRES,264,265,378,343,721
06,06840,068402505,Tres de Febrero,BUENOS AIRES,151,144,275,272,547
06,06840,068402506,Tres de Febrero,BUENOS AIRES,332,277,661,697,1358
06,06840,068402508,Tres de Febrero,BUENOS AIRES,164,205,303,274,577
06,06840,068402709,Tres de Febrero,BUENOS AIRES,306,311,460,381,841
06,06840,068402713,Tres de Febrero,BUENOS AIRES,288,322,443,404,847
06,06840,068402801,Tres de Febrero,BUENOS AIRES,305,294,542,492,1034
06,06840,068402807,Tres de Febrero,BUENOS AIRES,390,424,666,542,1208
06,06840,068403001,Tres de Febrero,BUENOS AIRES,273,239,406,320,726
06,06840,068403002,Tres de Febrero,BUENOS AIRES,157,162,257,228,485
06,06840,068403003,Tres de Febrero,BUENOS AIRES,263,319,427,346,773
06,06840,068403008,Tres de Febrero,BUENOS AIRES,323,385,527,467,994
06,06840,068403010,Tres de Febrero,BUENOS AIRES,215,294,273,253,526
06,06840,068403203,Tres de Febrero,BUENOS AIRES,243,293,365,315,680
06,06840,068400406,Tres de Febrero,BUENOS AIRES,262,253,458,414,872
06,06840,068400405,Tres de Febrero,BUENOS AIRES,287,278,463,423,886
06,06840,068400101,Tres de Febrero,BUENOS AIRES,121,123,215,236,451
06,06840,068400113,Tres de Febrero,BUENOS AIRES,572,605,977,937,1914
06,06840,068400211,Tres de Febrero,BUENOS AIRES,303,310,500,460,960
06,06840,068400302,Tres de Febrero,BUENOS AIRES,427,437,697,650,1347
06,06840,068400404,Tres de Febrero,BUENOS AIRES,247,256,423,386,809
06,06840,068400411,Tres de Febrero,BUENOS AIRES,311,313,557,508,1065
06,06840,068400417,Tres de Febrero,BUENOS AIRES,406,416,700,694,1394
06,06840,068400512,Tres de Febrero,BUENOS AIRES,418,420,690,652,1342
06,06840,068400603,Tres de Febrero,BUENOS AIRES,266,221,455,411,866
06,06840,068400609,Tres de Febrero,BUENOS AIRES,223,201,361,305,666
06,06840,068400702,Tres de Febrero,BUENOS AIRES,402,447,634,550,1184
06,06840,068400806,Tres de Febrero,BUENOS AIRES,231,246,364,339,703
06,06840,068400907,Tres de Febrero,BUENOS AIRES,287,298,398,355,753
06,06840,068401008,Tres de Febrero,BUENOS AIRES,258,317,315,254,569
06,06840,068401210,Tres de Febrero,BUENOS AIRES,320,338,485,422,907
06,06840,068401211,Tres de Febrero,BUENOS AIRES,358,393,546,523,1069
06,06840,068401303,Tres de Febrero,BUENOS AIRES,403,431,614,523,1137
06,06840,068401501,Tres de Febrero,BUENOS AIRES,214,377,305,306,611
06,06840,068401505,Tres de Febrero,BUENOS AIRES,388,482,532,474,1006
06,06840,068401506,Tres de Febrero,BUENOS AIRES,381,447,523,467,990
06,06840,068401613,Tres de Febrero,BUENOS AIRES,325,393,387,382,769
06,06840,068401706,Tres de Febrero,BUENOS AIRES,419,492,615,580,1195
06,06840,068401808,Tres de Febrero,BUENOS AIRES,398,415,612,549,1161
06,06840,068401814,Tres de Febrero,BUENOS AIRES,275,310,408,337,745
06,06840,068401903,Tres de Febrero,BUENOS AIRES,338,422,493,424,917
06,06840,068401904,Tres de Febrero,BUENOS AIRES,480,549,633,596,1229
06,06840,068402101,Tres de Febrero,BUENOS AIRES,271,270,407,350,757
06,06840,068402103,Tres de Febrero,BUENOS AIRES,176,188,255,211,466
06,06840,068402208,Tres de Febrero,BUENOS AIRES,407,369,664,585,1249
06,06840,068402406,Tres de Febrero,BUENOS AIRES,280,179,467,458,925
06,06840,068402409,Tres de Febrero,BUENOS AIRES,279,234,406,352,758
06,06840,068402507,Tres de Febrero,BUENOS AIRES,123,122,242,257,499
06,06840,068402602,Tres de Febrero,BUENOS AIRES,1015,995,1940,1708,3648
06,06840,068402704,Tres de Febrero,BUENOS AIRES,363,354,573,555,1128
06,06840,068402706,Tres de Febrero,BUENOS AIRES,145,127,212,182,394
06,06840,068402808,Tres de Febrero,BUENOS AIRES,232,258,374,334,708
06,06840,068402810,Tres de Febrero,BUENOS AIRES,245,246,410,335,745
06,06840,068402907,Tres de Febrero,BUENOS AIRES,315,351,531,456,987
06,06840,068403012,Tres de Febrero,BUENOS AIRES,189,231,276,195,471
06,06840,068403102,Tres de Febrero,BUENOS AIRES,343,325,515,470,985
06,06840,068403106,Tres de Febrero,BUENOS AIRES,352,400,557,479,1036
06,06840,068401313,Tres de Febrero,BUENOS AIRES,205,310,242,222,464
06,06749,067491407,San Fernando,BUENOS AIRES,365,366,678,665,1343
06,06749,067491408,San Fernando,BUENOS AIRES,325,332,623,626,1249
06,06749,067490301,San Fernando,BUENOS AIRES,319,391,546,465,1011
06,06749,067490102,San Fernando,BUENOS AIRES,378,317,733,767,1500
06,06749,067490204,San Fernando,BUENOS AIRES,354,379,543,448,991
06,06749,067490208,San Fernando,BUENOS AIRES,297,374,531,492,1023
06,06749,067490402,San Fernando,BUENOS AIRES,98,50,177,183,360
06,06749,067490403,San Fernando,BUENOS AIRES,228,269,350,241,591
06,06749,067490404,San Fernando,BUENOS AIRES,317,426,541,328,869
06,06749,067490504,San Fernando,BUENOS AIRES,309,391,404,321,725
06,06749,067490506,San Fernando,BUENOS AIRES,303,376,350,235,585
06,06749,067490509,San Fernando,BUENOS AIRES,240,295,316,278,594
06,06749,067490513,San Fernando,BUENOS AIRES,125,188,198,147,345
06,06749,067490604,San Fernando,BUENOS AIRES,216,237,294,310,604
06,06749,067490803,San Fernando,BUENOS AIRES,236,233,389,366,755
06,06749,067490806,San Fernando,BUENOS AIRES,310,263,502,522,1024
06,06749,067490809,San Fernando,BUENOS AIRES,331,270,542,499,1041
06,06749,067490908,San Fernando,BUENOS AIRES,320,338,563,498,1061
06,06749,067491008,San Fernando,BUENOS AIRES,174,190,353,319,672
06,06749,067491010,San Fernando,BUENOS AIRES,227,241,383,359,742
06,06749,067491104,San Fernando,BUENOS AIRES,206,119,374,302,676
06,06749,067491202,San Fernando,BUENOS AIRES,342,350,583,532,1115
06,06749,067491209,San Fernando,BUENOS AIRES,246,236,434,435,869
06,06749,067491301,San Fernando,BUENOS AIRES,333,272,765,739,1504
06,06749,067491305,San Fernando,BUENOS AIRES,418,388,844,816,1660
06,06749,067491413,San Fernando,BUENOS AIRES,410,420,678,609,1287
06,06749,067491418,San Fernando,BUENOS AIRES,156,215,243,240,483
06,06749,067491503,San Fernando,BUENOS AIRES,34,104,40,69,109
06,06749,067491511,San Fernando,BUENOS AIRES,131,355,184,213,397
06,06749,067490307,San Fernando,BUENOS AIRES,216,248,349,309,658
06,06749,067490308,San Fernando,BUENOS AIRES,255,305,391,313,704
06,06749,067490305,San Fernando,BUENOS AIRES,292,334,418,378,796
06,06749,067490304,San Fernando,BUENOS AIRES,344,386,484,418,902
06,06749,067490103,San Fernando,BUENOS AIRES,335,340,511,592,1103
06,06749,067490202,San Fernando,BUENOS AIRES,362,369,586,562,1148
06,06749,067490206,San Fernando,BUENOS AIRES,121,177,179,163,342
06,06749,067490211,San Fernando,BUENOS AIRES,263,299,422,386,808
06,06749,067490310,San Fernando,BUENOS AIRES,257,350,358,290,648
06,06749,067490312,San Fernando,BUENOS AIRES,364,445,506,433,939
06,06749,067490405,San Fernando,BUENOS AIRES,100,54,246,225,471
06,06749,067490501,San Fernando,BUENOS AIRES,157,185,258,210,468
06,06749,067490601,San Fernando,BUENOS AIRES,204,285,274,271,545
06,06749,067490901,San Fernando,BUENOS AIRES,322,331,501,432,933
06,06749,067491012,San Fernando,BUENOS AIRES,300,385,596,585,1181
06,06749,067491105,San Fernando,BUENOS AIRES,289,264,520,466,986
06,06749,067491113,San Fernando,BUENOS AIRES,408,442,685,626,1311
06,06749,067491201,San Fernando,BUENOS AIRES,327,288,581,544,1125
06,06749,067491310,San Fernando,BUENOS AIRES,272,285,483,405,888
06,06749,067491505,San Fernando,BUENOS AIRES,80,230,104,126,230
06,06749,067491510,San Fernando,BUENOS AIRES,120,321,177,192,369
06,06749,067490902,San Fernando,BUENOS AIRES,372,400,634,578,1212
06,06749,067491405,San Fernando,BUENOS AIRES,317,325,581,547,1128
06,06749,067490306,San Fernando,BUENOS AIRES,167,194,302,232,534
06,06749,067490104,San Fernando,BUENOS AIRES,132,80,232,244,476
06,06749,067490210,San Fernando,BUENOS AIRES,347,384,611,481,1092
06,06749,067490508,San Fernando,BUENOS AIRES,170,250,260,168,428
06,06749,067490602,San Fernando,BUENOS AIRES,331,392,392,315,707
06,06749,067490704,San Fernando,BUENOS AIRES,369,385,577,559,1136
06,06749,067490705,San Fernando,BUENOS AIRES,451,463,728,668,1396
06,06749,067490807,San Fernando,BUENOS AIRES,453,399,739,683,1422
06,06749,067490904,San Fernando,BUENOS AIRES,429,425,707,645,1352
06,06749,067491005,San Fernando,BUENOS AIRES,418,412,673,599,1272
06,06749,067491108,San Fernando,BUENOS AIRES,182,161,351,397,748
06,06749,067491208,San Fernando,BUENOS AIRES,340,377,565,525,1090
06,06749,067491401,San Fernando,BUENOS AIRES,199,194,332,341,673
06,06749,067491403,San Fernando,BUENOS AIRES,285,170,525,510,1035
06,06749,067491404,San Fernando,BUENOS AIRES,289,286,544,503,1047
06,06749,067491509,San Fernando,BUENOS AIRES,107,256,155,189,344
06,06749,067491513,San Fernando,BUENOS AIRES,75,116,105,136,241
06,06749,067490512,San Fernando,BUENOS AIRES,200,265,248,186,434
06,06749,067491111,San Fernando,BUENOS AIRES,295,265,514,491,1005
06,06749,067491112,San Fernando,BUENOS AIRES,229,205,371,337,708
06,06749,067491410,San Fernando,BUENOS AIRES,277,278,547,526,1073
06,06749,067490302,San Fernando,BUENOS AIRES,143,195,204,161,365
06,06749,067490105,San Fernando,BUENOS AIRES,147,134,258,244,502
06,06749,067490201,San Fernando,BUENOS AIRES,198,218,302,274,576
06,06749,067490203,San Fernando,BUENOS AIRES,341,364,567,452,1019
06,06749,067490503,San Fernando,BUENOS AIRES,291,395,373,341,714
06,06749,067490912,San Fernando,BUENOS AIRES,434,419,705,680,1385
06,06749,067491003,San Fernando,BUENOS AIRES,411,401,664,630,1294
06,06749,067491011,San Fernando,BUENOS AIRES,384,357,671,571,1242
06,06749,067491103,San Fernando,BUENOS AIRES,276,253,588,539,1127
06,06749,067491109,San Fernando,BUENOS AIRES,154,167,245,257,502
06,06749,067491211,San Fernando,BUENOS AIRES,394,395,718,741,1459
06,06749,067491306,San Fernando,BUENOS AIRES,442,430,916,880,1796
06,06749,067491312,San Fernando,BUENOS AIRES,278,300,487,474,961
06,06749,067491314,San Fernando,BUENOS AIRES,295,280,519,501,1020
06,06749,067491315,San Fernando,BUENOS AIRES,230,249,405,391,796
06,06749,067491320,San Fernando,BUENOS AIRES,255,157,537,515,1052
06,06749,067491412,San Fernando,BUENOS AIRES,397,383,656,627,1283
06,06749,067491419,San Fernando,BUENOS AIRES,387,348,867,854,1721
06,06749,067491501,San Fernando,BUENOS AIRES,29,93,26,49,75
06,06749,067491406,San Fernando,BUENOS AIRES,327,319,648,583,1231
06,06749,067491411,San Fernando,BUENOS AIRES,97,96,186,201,387
06,06749,067490401,San Fernando,BUENOS AIRES,91,36,172,148,320
06,06749,067490406,San Fernando,BUENOS AIRES,265,283,407,364,771
06,06749,067490507,San Fernando,BUENOS AIRES,195,300,227,179,406
06,06749,067490511,San Fernando,BUENOS AIRES,145,205,178,155,333
06,06749,067490603,San Fernando,BUENOS AIRES,348,455,493,429,922
06,06749,067490605,San Fernando,BUENOS AIRES,306,345,462,401,863
06,06749,067490709,San Fernando,BUENOS AIRES,238,96,471,481,952
06,06749,067490801,San Fernando,BUENOS AIRES,272,299,426,391,817
06,06749,067490802,San Fernando,BUENOS AIRES,178,196,287,263,550
06,06749,067490911,San Fernando,BUENOS AIRES,409,435,652,651,1303
06,06749,067490913,San Fernando,BUENOS AIRES,128,127,278,277,555
06,06749,067491004,San Fernando,BUENOS AIRES,380,334,621,567,1188
06,06749,067491009,San Fernando,BUENOS AIRES,289,277,557,500,1057
06,06749,067491106,San Fernando,BUENOS AIRES,216,186,360,340,700
06,06749,067491107,San Fernando,BUENOS AIRES,330,299,588,551,1139
06,06749,067491206,San Fernando,BUENOS AIRES,273,262,527,539,1066
06,06749,067491207,San Fernando,BUENOS AIRES,286,285,548,522,1070
06,06749,067491303,San Fernando,BUENOS AIRES,265,264,591,590,1181
06,06749,067491309,San Fernando,BUENOS AIRES,266,232,488,439,927
06,06749,067491414,San Fernando,BUENOS AIRES,414,391,707,650,1357
06,06749,067491415,San Fernando,BUENOS AIRES,355,320,619,555,1174
06,06749,067491416,San Fernando,BUENOS AIRES,320,301,628,657,1285
06,06749,067491512,San Fernando,BUENOS AIRES,102,187,143,180,323
06,06749,067491504,San Fernando,BUENOS AIRES,86,253,123,161,284
06,06749,067491321,San Fernando,BUENOS AIRES,204,203,374,345,719
06,06749,067491420,San Fernando,BUENOS AIRES,210,152,454,471,925
06,06749,067491409,San Fernando,BUENOS AIRES,338,269,684,626,1310
06,06749,067490303,San Fernando,BUENOS AIRES,228,290,273,263,536
06,06749,067490309,San Fernando,BUENOS AIRES,239,291,317,275,592
06,06749,067490311,San Fernando,BUENOS AIRES,316,462,374,284,658
06,06749,067490502,San Fernando,BUENOS AIRES,249,320,387,325,712
06,06749,067490505,San Fernando,BUENOS AIRES,253,294,327,259,586
06,06749,067490708,San Fernando,BUENOS AIRES,438,489,733,667,1400
06,06749,067490804,San Fernando,BUENOS AIRES,346,330,652,616,1268
06,06749,067490805,San Fernando,BUENOS AIRES,404,374,733,651,1384
06,06749,067490905,San Fernando,BUENOS AIRES,416,429,770,692,1462
06,06749,067490906,San Fernando,BUENOS AIRES,324,291,575,632,1207
06,06749,067490907,San Fernando,BUENOS AIRES,248,269,370,327,697
06,06749,067491002,San Fernando,BUENOS AIRES,366,351,655,571,1226
06,06749,067491007,San Fernando,BUENOS AIRES,291,318,499,416,915
06,06749,067491013,San Fernando,BUENOS AIRES,191,199,292,306,598
06,06749,067491102,San Fernando,BUENOS AIRES,375,340,782,794,1576
06,06749,067491203,San Fernando,BUENOS AIRES,446,426,894,868,1762
06,06749,067491307,San Fernando,BUENOS AIRES,9,9,24,28,52
06,06749,067491308,San Fernando,BUENOS AIRES,242,199,434,437,871
06,06749,067491311,San Fernando,BUENOS AIRES,246,220,421,408,829
06,06749,067491316,San Fernando,BUENOS AIRES,504,497,905,915,1820
06,06749,067491317,San Fernando,BUENOS AIRES,264,230,523,463,986
06,06749,067491508,San Fernando,BUENOS AIRES,58,134,84,86,170
06,06749,067490101,San Fernando,BUENOS AIRES,25,30,48,49,97
06,06749,067490205,San Fernando,BUENOS AIRES,328,352,588,549,1137
06,06749,067490207,San Fernando,BUENOS AIRES,246,275,412,391,803
06,06749,067490209,San Fernando,BUENOS AIRES,343,395,542,472,1014
06,06749,067490701,San Fernando,BUENOS AIRES,382,395,645,591,1236
06,06749,067490707,San Fernando,BUENOS AIRES,375,425,554,477,1031
06,06749,067490903,San Fernando,BUENOS AIRES,447,458,846,793,1639
06,06749,067490909,San Fernando,BUENOS AIRES,329,341,518,467,985
06,06749,067490910,San Fernando,BUENOS AIRES,261,279,413,352,765
06,06749,067491006,San Fernando,BUENOS AIRES,400,412,618,567,1185
06,06749,067491101,San Fernando,BUENOS AIRES,295,238,566,540,1106
06,06749,067491110,San Fernando,BUENOS AIRES,329,297,620,540,1160
06,06749,067491204,San Fernando,BUENOS AIRES,423,408,736,719,1455
06,06749,067491302,San Fernando,BUENOS AIRES,437,402,1078,1040,2118
06,06749,067491304,San Fernando,BUENOS AIRES,434,415,864,882,1746
06,06749,067491319,San Fernando,BUENOS AIRES,337,294,618,610,1228
06,06749,067490212,San Fernando,BUENOS AIRES,237,261,381,345,726
06,06749,067490213,San Fernando,BUENOS AIRES,262,313,386,325,711
06,06749,067490510,San Fernando,BUENOS AIRES,236,289,377,302,679
06,06749,067490703,San Fernando,BUENOS AIRES,292,319,479,405,884
06,06749,067490706,San Fernando,BUENOS AIRES,304,340,450,432,882
06,06749,067490808,San Fernando,BUENOS AIRES,378,303,660,553,1213
06,06749,067491001,San Fernando,BUENOS AIRES,482,484,780,731,1511
06,06749,067491114,San Fernando,BUENOS AIRES,393,407,714,656,1370
06,06749,067491205,San Fernando,BUENOS AIRES,417,450,723,566,1289
06,06749,067491210,San Fernando,BUENOS AIRES,377,396,697,664,1361
06,06749,067491313,San Fernando,BUENOS AIRES,280,227,496,456,952
06,06749,067491318,San Fernando,BUENOS AIRES,311,284,552,534,1086
06,06749,067491402,San Fernando,BUENOS AIRES,303,290,485,454,939
06,06749,067491417,San Fernando,BUENOS AIRES,467,461,1028,1054,2082
06,06749,067491506,San Fernando,BUENOS AIRES,24,46,29,51,80
06,06749,067491502,San Fernando,BUENOS AIRES,75,137,115,144,259
06,06749,067491507,San Fernando,BUENOS AIRES,29,64,38,37,75
06,06749,067490702,San Fernando,BUENOS AIRES,284,326,425,407,832
06,06854,068540102,25 de Mayo,BUENOS AIRES,295,356,401,310,711
06,06854,068540106,25 de Mayo,BUENOS AIRES,257,323,398,298,696
06,06854,068540114,25 de Mayo,BUENOS AIRES,210,227,364,333,697
06,06854,068540601,25 de Mayo,BUENOS AIRES,64,116,91,87,178
06,06854,068540702,25 de Mayo,BUENOS AIRES,31,71,46,53,99
06,06854,068540802,25 de Mayo,BUENOS AIRES,79,117,110,112,222
06,06854,068541001,25 de Mayo,BUENOS AIRES,172,198,267,267,534
06,06854,068540101,25 de Mayo,BUENOS AIRES,177,221,266,274,540
06,06854,068540108,25 de Mayo,BUENOS AIRES,297,351,411,334,745
06,06854,068540110,25 de Mayo,BUENOS AIRES,393,460,539,485,1024
06,06854,068540701,25 de Mayo,BUENOS AIRES,26,42,40,48,88
06,06854,068541011,25 de Mayo,BUENOS AIRES,46,81,57,72,129
06,06854,068541103,25 de Mayo,BUENOS AIRES,23,46,33,39,72
06,06854,068541003,25 de Mayo,BUENOS AIRES,287,345,423,327,750
06,06854,068541005,25 de Mayo,BUENOS AIRES,270,321,351,320,671
06,06854,068541009,25 de Mayo,BUENOS AIRES,62,102,72,73,145
06,06854,068541014,25 de Mayo,BUENOS AIRES,179,207,244,250,494
06,06854,068540112,25 de Mayo,BUENOS AIRES,287,340,441,363,804
06,06854,068540202,25 de Mayo,BUENOS AIRES,455,516,816,763,1579
06,06854,068540803,25 de Mayo,BUENOS AIRES,31,69,25,46,71
06,06854,068541010,25 de Mayo,BUENOS AIRES,52,87,68,83,151
06,06854,068541101,25 de Mayo,BUENOS AIRES,31,51,39,56,95
06,06854,068540301,25 de Mayo,BUENOS AIRES,91,109,136,129,265
06,06854,068541007,25 de Mayo,BUENOS AIRES,101,122,146,148,294
06,06854,068541008,25 de Mayo,BUENOS AIRES,112,153,153,146,299
06,06854,068541015,25 de Mayo,BUENOS AIRES,124,154,180,165,345
06,06854,068541402,25 de Mayo,BUENOS AIRES,98,142,134,145,279
06,06854,068541406,25 de Mayo,BUENOS AIRES,153,187,243,251,494
06,06854,068540201,25 de Mayo,BUENOS AIRES,390,454,682,691,1373
06,06854,068540109,25 de Mayo,BUENOS AIRES,371,418,590,571,1161
06,06854,068540115,25 de Mayo,BUENOS AIRES,165,193,267,253,520
06,06854,068540205,25 de Mayo,BUENOS AIRES,242,306,369,268,637
06,06854,068540502,25 de Mayo,BUENOS AIRES,54,95,58,91,149
06,06854,068541102,25 de Mayo,BUENOS AIRES,26,65,29,41,70
06,06854,068541201,25 de Mayo,BUENOS AIRES,54,94,72,95,167
06,06854,068540210,25 de Mayo,BUENOS AIRES,196,234,303,311,614
06,06854,068541401,25 de Mayo,BUENOS AIRES,155,203,206,199,405
06,06854,068540403,25 de Mayo,BUENOS AIRES,81,143,103,121,224
06,06854,068540211,25 de Mayo,BUENOS AIRES,261,266,376,367,743
06,06854,068540401,25 de Mayo,BUENOS AIRES,188,222,268,267,535
06,06854,068540207,25 de Mayo,BUENOS AIRES,348,406,513,467,980
06,06854,068540402,25 de Mayo,BUENOS AIRES,91,129,128,146,274
06,06854,068540602,25 de Mayo,BUENOS AIRES,152,389,185,208,393
06,06854,068541301,25 de Mayo,BUENOS AIRES,51,72,61,88,149
06,06854,068541006,25 de Mayo,BUENOS AIRES,321,406,526,503,1029
06,06854,068540503,25 de Mayo,BUENOS AIRES,18,47,23,31,54
06,06854,068541202,25 de Mayo,BUENOS AIRES,20,26,28,35,63
06,06854,068540303,25 de Mayo,BUENOS AIRES,30,60,39,37,76
06,06854,068540103,25 de Mayo,BUENOS AIRES,300,331,462,375,837
06,06854,068540104,25 de Mayo,BUENOS AIRES,267,306,376,308,684
06,06854,068540204,25 de Mayo,BUENOS AIRES,286,348,397,296,693
06,06854,068540206,25 de Mayo,BUENOS AIRES,309,387,416,321,737
06,06854,068540209,25 de Mayo,BUENOS AIRES,422,499,667,656,1323
06,06854,068540501,25 de Mayo,BUENOS AIRES,43,82,44,55,99
06,06854,068540901,25 de Mayo,BUENOS AIRES,47,83,71,73,144
06,06854,068541405,25 de Mayo,BUENOS AIRES,29,47,33,51,84
06,06854,068540801,25 de Mayo,BUENOS AIRES,102,152,159,166,325
06,06854,068541004,25 de Mayo,BUENOS AIRES,315,369,456,445,901
06,06854,068540111,25 de Mayo,BUENOS AIRES,596,551,1069,1031,2100
06,06854,068540302,25 de Mayo,BUENOS AIRES,28,57,26,40,66
06,06854,068541012,25 de Mayo,BUENOS AIRES,36,66,53,66,119
06,06854,068541013,25 de Mayo,BUENOS AIRES,83,140,98,129,227
06,06854,068541404,25 de Mayo,BUENOS AIRES,14,22,26,19,45
06,06854,068541002,25 de Mayo,BUENOS AIRES,248,295,325,314,639
06,06854,068541302,25 de Mayo,BUENOS AIRES,38,97,37,55,92
06,06854,068540203,25 de Mayo,BUENOS AIRES,332,400,477,438,915
06,06854,068540105,25 de Mayo,BUENOS AIRES,309,356,461,385,846
06,06854,068540107,25 de Mayo,BUENOS AIRES,270,358,365,278,643
06,06854,068540113,25 de Mayo,BUENOS AIRES,353,380,663,631,1294
06,06854,068540208,25 de Mayo,BUENOS AIRES,281,329,402,300,702
06,06854,068541203,25 de Mayo,BUENOS AIRES,29,72,33,49,82
06,06854,068541403,25 de Mayo,BUENOS AIRES,62,127,66,92,158
06,06644,066440106,Pinamar,BUENOS AIRES,52,268,73,72,145
06,06644,066440105,Pinamar,BUENOS AIRES,33,375,44,39,83
06,06644,066440107,Pinamar,BUENOS AIRES,48,274,75,78,153
06,06644,066440111,Pinamar,BUENOS AIRES,29,265,53,48,101
06,06644,066440208,Pinamar,BUENOS AIRES,80,390,104,93,197
06,06644,066440301,Pinamar,BUENOS AIRES,234,292,360,392,752
06,06644,066440408,Pinamar,BUENOS AIRES,35,353,39,39,78
06,06644,066440612,Pinamar,BUENOS AIRES,294,317,517,547,1064
06,06644,066440303,Pinamar,BUENOS AIRES,5,19,7,4,11
06,06644,066440110,Pinamar,BUENOS AIRES,34,444,39,33,72
06,06644,066440201,Pinamar,BUENOS AIRES,201,360,295,274,569
06,06644,066440304,Pinamar,BUENOS AIRES,171,395,262,271,533
06,06644,066440309,Pinamar,BUENOS AIRES,40,318,46,57,103
06,06644,066440310,Pinamar,BUENOS AIRES,30,292,43,40,83
06,06644,066440503,Pinamar,BUENOS AIRES,206,239,339,381,720
06,06644,066440506,Pinamar,BUENOS AIRES,398,526,605,572,1177
06,06644,066440618,Pinamar,BUENOS AIRES,69,319,89,92,181
06,06644,066440621,Pinamar,BUENOS AIRES,96,234,132,142,274
06,06644,066440305,Pinamar,BUENOS AIRES,89,197,137,142,279
06,06644,066440205,Pinamar,BUENOS AIRES,36,286,48,44,92
06,06644,066440308,Pinamar,BUENOS AIRES,34,365,63,60,123
06,06644,066440312,Pinamar,BUENOS AIRES,31,256,28,36,64
06,06644,066440602,Pinamar,BUENOS AIRES,154,165,284,283,567
06,06644,066440407,Pinamar,BUENOS AIRES,47,453,64,56,120
06,06644,066440508,Pinamar,BUENOS AIRES,101,358,116,120,236
06,06644,066440607,Pinamar,BUENOS AIRES,179,201,296,317,613
06,06644,066440613,Pinamar,BUENOS AIRES,241,371,439,466,905
06,06644,066440622,Pinamar,BUENOS AIRES,158,272,236,251,487
06,06644,066440102,Pinamar,BUENOS AIRES,58,267,93,66,159
06,06644,066440108,Pinamar,BUENOS AIRES,20,130,18,23,41
06,06644,066440206,Pinamar,BUENOS AIRES,71,539,117,98,215
06,06644,066440302,Pinamar,BUENOS AIRES,161,219,277,267,544
06,06644,066440316,Pinamar,BUENOS AIRES,10,189,82,89,171
06,06644,066440315,Pinamar,BUENOS AIRES,18,136,156,160,316
06,06644,066440403,Pinamar,BUENOS AIRES,56,345,73,69,142
06,06644,066440405,Pinamar,BUENOS AIRES,61,394,70,79,149
06,06644,066440504,Pinamar,BUENOS AIRES,144,157,272,267,539
06,06644,066440507,Pinamar,BUENOS AIRES,218,314,285,287,572
06,06644,066440511,Pinamar,BUENOS AIRES,53,343,67,53,120
06,06644,066440404,Pinamar,BUENOS AIRES,47,344,63,55,118
06,06644,066440109,Pinamar,BUENOS AIRES,12,150,15,20,35
06,06644,066440207,Pinamar,BUENOS AIRES,99,449,137,133,270
06,06644,066440615,Pinamar,BUENOS AIRES,243,295,407,421,828
06,06644,066440306,Pinamar,BUENOS AIRES,49,198,76,62,138
06,06644,066440307,Pinamar,BUENOS AIRES,92,439,136,118,254
06,06644,066440311,Pinamar,BUENOS AIRES,58,363,67,89,156
06,06644,066440406,Pinamar,BUENOS AIRES,26,389,36,35,71
06,06644,066440501,Pinamar,BUENOS AIRES,42,548,53,59,112
06,06644,066440512,Pinamar,BUENOS AIRES,79,412,83,84,167
06,06644,066440513,Pinamar,BUENOS AIRES,35,357,33,23,56
06,06644,066440604,Pinamar,BUENOS AIRES,121,313,190,158,348
06,06644,066440605,Pinamar,BUENOS AIRES,91,291,138,124,262
06,06644,066440609,Pinamar,BUENOS AIRES,235,242,410,451,861
06,06644,066440616,Pinamar,BUENOS AIRES,120,297,165,154,319
06,06644,066440617,Pinamar,BUENOS AIRES,57,222,84,86,170
06,06644,066440104,Pinamar,BUENOS AIRES,43,325,51,46,97
06,06644,066440505,Pinamar,BUENOS AIRES,446,552,677,664,1341
06,06644,066440620,Pinamar,BUENOS AIRES,106,460,157,149,306
06,06644,066440510,Pinamar,BUENOS AIRES,47,310,79,65,144
06,06644,066440502,Pinamar,BUENOS AIRES,141,377,229,240,469
06,06644,066440103,Pinamar,BUENOS AIRES,114,393,152,149,301
06,06644,066440601,Pinamar,BUENOS AIRES,259,279,442,406,848
06,06644,066440603,Pinamar,BUENOS AIRES,135,175,230,230,460
06,06644,066440611,Pinamar,BUENOS AIRES,82,80,127,161,288
06,06644,066440101,Pinamar,BUENOS AIRES,65,286,102,84,186
06,06644,066440203,Pinamar,BUENOS AIRES,48,307,56,57,113
06,06644,066440402,Pinamar,BUENOS AIRES,68,392,106,101,207
06,06644,066440202,Pinamar,BUENOS AIRES,95,291,144,136,280
06,06644,066440204,Pinamar,BUENOS AIRES,33,321,37,39,76
06,06644,066440313,Pinamar,BUENOS AIRES,80,131,134,115,249
06,06644,066440314,Pinamar,BUENOS AIRES,21,292,58,49,107
06,06644,066440401,Pinamar,BUENOS AIRES,77,492,87,101,188
06,06644,066440509,Pinamar,BUENOS AIRES,99,427,141,114,255
06,06644,066440606,Pinamar,BUENOS AIRES,122,331,195,214,409
06,06644,066440608,Pinamar,BUENOS AIRES,286,367,475,448,923
06,06644,066440610,Pinamar,BUENOS AIRES,194,212,364,356,720
06,06644,066440614,Pinamar,BUENOS AIRES,157,216,299,290,589
06,06644,066440619,Pinamar,BUENOS AIRES,86,407,130,127,257
06,06655,066550303,Punta Indio,BUENOS AIRES,43,143,51,74,125
06,06655,066550204,Punta Indio,BUENOS AIRES,306,389,428,387,815
06,06655,066550310,Punta Indio,BUENOS AIRES,272,316,426,395,821
06,06655,066550304,Punta Indio,BUENOS AIRES,41,171,51,55,106
06,06655,066550211,Punta Indio,BUENOS AIRES,176,221,254,243,497
06,06655,066550302,Punta Indio,BUENOS AIRES,33,151,38,41,79
06,06655,066550208,Punta Indio,BUENOS AIRES,25,64,27,38,65
06,06655,066550202,Punta Indio,BUENOS AIRES,225,260,371,340,711
06,06655,066550104,Punta Indio,BUENOS AIRES,29,45,35,53,88
06,06655,066550106,Punta Indio,BUENOS AIRES,19,42,24,26,50
06,06655,066550203,Punta Indio,BUENOS AIRES,220,282,302,281,583
06,06655,066550205,Punta Indio,BUENOS AIRES,233,276,387,370,757
06,06655,066550305,Punta Indio,BUENOS AIRES,65,267,81,79,160
06,06655,066550207,Punta Indio,BUENOS AIRES,29,56,33,40,73
06,06655,066550105,Punta Indio,BUENOS AIRES,50,94,59,81,140
06,06655,066550308,Punta Indio,BUENOS AIRES,122,192,188,209,397
06,06655,066550101,Punta Indio,BUENOS AIRES,24,30,25,34,59
06,06655,066550309,Punta Indio,BUENOS AIRES,275,313,432,416,848
06,06655,066550311,Punta Indio,BUENOS AIRES,407,513,621,551,1172
06,06655,066550209,Punta Indio,BUENOS AIRES,60,97,107,111,218
06,06655,066550210,Punta Indio,BUENOS AIRES,158,214,206,186,392
06,06655,066550301,Punta Indio,BUENOS AIRES,38,172,48,51,99
06,06655,066550102,Punta Indio,BUENOS AIRES,17,35,23,24,47
06,06655,066550206,Punta Indio,BUENOS AIRES,166,202,258,275,533
06,06655,066550312,Punta Indio,BUENOS AIRES,209,244,244,224,468
06,06655,066550103,Punta Indio,BUENOS AIRES,39,91,51,56,107
06,06655,066550201,Punta Indio,BUENOS AIRES,36,82,41,61,102
06,06655,066550306,Punta Indio,BUENOS AIRES,51,99,76,95,171
06,06655,066550307,Punta Indio,BUENOS AIRES,45,102,64,141,205
06,06672,066721205,Rauch,BUENOS AIRES,347,413,484,416,900
06,06672,066721216,Rauch,BUENOS AIRES,286,304,488,449,937
06,06672,066720601,Rauch,BUENOS AIRES,7,11,9,11,20
06,06672,066721002,Rauch,BUENOS AIRES,20,44,19,29,48
06,06672,066721215,Rauch,BUENOS AIRES,294,326,412,390,802
06,06672,066720102,Rauch,BUENOS AIRES,21,31,26,33,59
06,06672,066720103,Rauch,BUENOS AIRES,8,9,9,10,19
06,06672,066720602,Rauch,BUENOS AIRES,9,19,11,16,27
06,06672,066721103,Rauch,BUENOS AIRES,15,22,18,29,47
06,06672,066721211,Rauch,BUENOS AIRES,20,40,31,28,59
06,06672,066721303,Rauch,LA RIOJA,19,42,27,26,53
06,06672,066721401,Rauch,BUENOS AIRES,9,18,6,14,20
06,06672,066721402,Rauch,BUENOS AIRES,51,89,57,76,133
06,06672,066721202,Rauch,BUENOS AIRES,263,312,392,323,715
06,06672,066721204,Rauch,BUENOS AIRES,376,433,539,462,1001
06,06672,066720701,Rauch,BUENOS AIRES,34,54,49,50,99
06,06672,066721001,Rauch,BUENOS AIRES,18,39,19,27,46
06,06672,066721403,Rauch,BUENOS AIRES,62,86,80,104,184
06,06672,066720404,Rauch,BUENOS AIRES,15,34,18,25,43
06,06672,066721212,Rauch,BUENOS AIRES,43,79,48,68,116
06,06672,066720604,Rauch,BUENOS AIRES,6,14,6,8,14
06,06672,066720801,Rauch,BUENOS AIRES,13,13,19,16,35
06,06672,066720503,Rauch,BUENOS AIRES,8,22,6,14,20
06,06672,066720603,Rauch,BUENOS AIRES,4,15,4,6,10
06,06672,066720902,Rauch,BUENOS AIRES,13,36,8,22,30
06,06672,066721102,Rauch,BUENOS AIRES,16,29,10,18,28
06,06672,066721104,Rauch,BUENOS AIRES,15,26,18,22,40
06,06672,066721301,Rauch,BUENOS AIRES,13,24,17,19,36
06,06672,066721203,Rauch,BUENOS AIRES,333,363,476,456,932
06,06672,066721206,Rauch,BUENOS AIRES,346,421,459,385,844
06,06672,066720302,Rauch,BUENOS AIRES,15,18,30,27,57
06,06672,066720802,Rauch,BUENOS AIRES,14,26,13,20,33
06,06672,066720901,Rauch,BUENOS AIRES,18,36,17,30,47
06,06672,066721101,Rauch,BUENOS AIRES,7,22,8,11,19
06,06672,066721214,Rauch,BUENOS AIRES,170,238,303,276,579
06,06672,066721201,Rauch,BUENOS AIRES,483,503,726,747,1473
06,06672,066721208,Rauch,BUENOS AIRES,384,447,532,487,1019
06,06672,066720104,Rauch,BUENOS AIRES,14,18,19,27,46
06,06672,066720502,Rauch,BUENOS AIRES,6,17,6,8,14
06,06672,066720903,Rauch,BUENOS AIRES,15,25,15,19,34
06,06672,066721302,Rauch,BUENOS AIRES,10,20,14,15,29
06,06672,066721210,Rauch,BUENOS AIRES,651,712,1146,1135,2281
06,06672,066721209,Rauch,BUENOS AIRES,287,328,417,353,770
06,06672,066720101,Rauch,BUENOS AIRES,10,19,12,17,29
06,06672,066720301,Rauch,BUENOS AIRES,3,8,3,7,10
06,06672,066720401,Rauch,BUENOS AIRES,14,25,11,23,34
06,06672,066720702,Rauch,BUENOS AIRES,29,46,22,39,61
06,06672,066720202,Rauch,BUENOS AIRES,15,22,23,23,46
06,06672,066720303,Rauch,BUENOS AIRES,12,21,10,16,26
06,06672,066720403,Rauch,BUENOS AIRES,40,82,54,64,118
06,06672,066720501,Rauch,BUENOS AIRES,14,19,8,18,26
06,06672,066720504,Rauch,BUENOS AIRES,6,9,7,13,20
06,06672,066721207,Rauch,BUENOS AIRES,380,418,512,455,967
06,06672,066721213,Rauch,BUENOS AIRES,13,24,18,22,40
06,06672,066720201,Rauch,BUENOS AIRES,12,21,18,22,40
06,06672,066720402,Rauch,BUENOS AIRES,19,29,17,24,41
06,06686,066860107,Rojas,BUENOS AIRES,237,297,363,288,651
06,06686,066860110,Rojas,BUENOS AIRES,347,386,521,483,1004
06,06686,066861101,Rojas,BUENOS AIRES,321,377,461,440,901
06,06686,066860706,Rojas,BUENOS AIRES,7,15,10,19,29
06,06686,066860208,Rojas,BUENOS AIRES,5,17,4,5,9
06,06686,066860209,Rojas,BUENOS AIRES,10,22,13,19,32
06,06686,066860303,Rojas,BUENOS AIRES,13,30,22,21,43
06,06686,066860402,Rojas,BUENOS AIRES,7,20,15,17,32
06,06686,066860501,Rojas,BUENOS AIRES,10,14,18,18,36
06,06686,066861201,Rojas,BUENOS AIRES,10,24,6,14,20
06,06686,066860903,Rojas,BUENOS AIRES,9,29,18,17,35
06,06686,066860302,Rojas,BUENOS AIRES,24,41,20,42,62
06,06686,066860101,Rojas,BUENOS AIRES,199,208,332,299,631
06,06686,066861309,Rojas,BUENOS AIRES,301,336,450,383,833
06,06686,066860605,Rojas,BUENOS AIRES,19,26,17,26,43
06,06686,066860203,Rojas,BUENOS AIRES,28,53,44,46,90
06,06686,066860603,Rojas,BUENOS AIRES,24,105,40,45,85
06,06686,066860701,Rojas,BUENOS AIRES,21,49,25,33,58
06,06686,066860102,Rojas,BUENOS AIRES,418,410,757,678,1435
06,06686,066860108,Rojas,BUENOS AIRES,254,325,332,274,606
06,06686,066861310,Rojas,BUENOS AIRES,299,347,412,361,773
06,06686,066860401,Rojas,BUENOS AIRES,4,14,3,4,7
06,06686,066860704,Rojas,BUENOS AIRES,1,6,3,2,5
06,06686,066861003,Rojas,BUENOS AIRES,15,23,26,21,47
06,06686,066861002,Rojas,BUENOS AIRES,36,37,53,65,118
06,06686,066860609,Rojas,BUENOS AIRES,189,221,294,330,624
06,06686,066861304,Rojas,BUENOS AIRES,262,286,492,463,955
06,06686,066861305,Rojas,BUENOS AIRES,274,290,501,534,1035
06,06686,066861311,Rojas,BUENOS AIRES,268,319,358,297,655
06,06686,066861103,Rojas,BUENOS AIRES,13,41,14,16,30
06,06686,066860205,Rojas,BUENOS AIRES,3,17,1,4,5
06,06686,066860705,Rojas,BUENOS AIRES,7,15,12,11,23
06,06686,066860707,Rojas,BUENOS AIRES,16,37,23,26,49
06,06686,066861204,Rojas,BUENOS AIRES,7,13,8,11,19
06,06686,066860805,Rojas,BUENOS AIRES,33,51,45,50,95
06,06686,066860202,Rojas,BUENOS AIRES,142,174,198,191,389
06,06686,066860105,Rojas,BUENOS AIRES,281,332,370,301,671
06,06686,066861302,Rojas,BUENOS AIRES,198,224,337,394,731
06,06686,066861307,Rojas,BUENOS AIRES,234,266,364,349,713
06,06686,066860109,Rojas,BUENOS AIRES,255,337,328,263,591
06,06686,066860403,Rojas,BUENOS AIRES,4,17,4,6,10
06,06686,066861203,Rojas,BUENOS AIRES,15,21,14,38,52
06,06686,066860602,Rojas,BUENOS AIRES,57,111,77,87,164
06,06686,066860201,Rojas,BUENOS AIRES,244,294,370,348,718
06,06686,066860608,Rojas,BUENOS AIRES,178,182,264,254,518
06,06686,066861312,Rojas,BUENOS AIRES,266,313,364,305,669
06,06686,066860304,Rojas,BUENOS AIRES,21,41,35,33,68
06,06686,066860204,Rojas,BUENOS AIRES,2,17,2,3,5
06,06686,066860206,Rojas,BUENOS AIRES,3,14,3,7,10
06,06686,066860210,Rojas,BUENOS AIRES,1,11,1,1,2
06,06686,066860502,Rojas,BUENOS AIRES,14,58,18,14,32
06,06686,066861202,Rojas,BUENOS AIRES,4,17,3,6,9
06,06686,066860801,Rojas,BUENOS AIRES,7,18,11,15,26
06,06686,066860901,Rojas,BUENOS AIRES,7,21,9,10,19
06,06686,066861001,Rojas,BUENOS AIRES,4,42,6,7,13
06,06686,066861102,Rojas,BUENOS AIRES,10,33,8,14,22
06,06686,066860103,Rojas,BUENOS AIRES,346,387,505,454,959
06,06686,066860104,Rojas,BUENOS AIRES,340,384,491,438,929
06,06686,066861301,Rojas,BUENOS AIRES,140,169,234,228,462
06,06686,066861308,Rojas,BUENOS AIRES,146,179,246,251,497
06,06686,066861313,Rojas,BUENOS AIRES,283,340,393,320,713
06,06686,066861314,Rojas,BUENOS AIRES,190,203,291,279,570
06,06686,066860601,Rojas,BUENOS AIRES,177,194,303,293,596
06,06686,066860301,Rojas,BUENOS AIRES,14,35,19,26,45
06,06686,066860606,Rojas,BUENOS AIRES,18,35,18,19,37
06,06686,066860703,Rojas,BUENOS AIRES,15,22,16,20,36
06,06686,066860802,Rojas,BUENOS AIRES,5,14,6,10,16
06,06686,066860804,Rojas,BUENOS AIRES,8,46,9,11,20
06,06686,066860902,Rojas,BUENOS AIRES,7,23,6,9,15
06,06686,066860604,Rojas,BUENOS AIRES,24,81,31,37,68
06,06686,066860106,Rojas,BUENOS AIRES,267,319,346,324,670
06,06686,066861303,Rojas,BUENOS AIRES,181,190,291,282,573
06,06686,066861306,Rojas,BUENOS AIRES,182,210,309,288,597
06,06686,066860207,Rojas,BUENOS AIRES,2,12,3,2,5
06,06686,066860607,Rojas,BUENOS AIRES,8,18,9,12,21
06,06686,066860702,Rojas,BUENOS AIRES,10,22,11,57,68
06,06686,066860803,Rojas,BUENOS AIRES,9,21,14,14,28
06,06693,066930311,Roque Pérez,BUENOS AIRES,396,422,642,628,1270
06,06693,066930319,Roque Pérez,BUENOS AIRES,281,306,553,537,1090
06,06693,066930102,Roque Pérez,BUENOS AIRES,23,34,28,30,58
06,06693,066930201,Roque Pérez,BUENOS AIRES,32,59,36,49,85
06,06693,066930315,Roque Pérez,BUENOS AIRES,4,4,4,6,10
06,06693,066930402,Roque Pérez,BUENOS AIRES,46,76,47,70,117
06,06693,066930604,Roque Pérez,BUENOS AIRES,19,45,30,29,59
06,06693,066930312,Roque Pérez,BUENOS AIRES,241,317,331,280,611
06,06693,066930305,Roque Pérez,BUENOS AIRES,154,183,209,234,443
06,06693,066930318,Roque Pérez,BUENOS AIRES,239,263,358,363,721
06,06693,066930202,Roque Pérez,BUENOS AIRES,40,64,52,58,110
06,06693,066930302,Roque Pérez,BUENOS AIRES,32,67,42,53,95
06,06693,066930303,Roque Pérez,BUENOS AIRES,58,84,81,90,171
06,06693,066930304,Roque Pérez,BUENOS AIRES,58,90,61,86,147
06,06693,066930601,Roque Pérez,BUENOS AIRES,15,28,23,22,45
06,06693,066930602,Roque Pérez,BUENOS AIRES,15,30,29,28,57
06,06693,066930703,Roque Pérez,BUENOS AIRES,92,132,125,126,251
06,06693,066930502,Roque Pérez,BUENOS AIRES,20,36,39,36,75
06,06693,066930702,Roque Pérez,BUENOS AIRES,16,33,25,27,52
06,06693,066930309,Roque Pérez,BUENOS AIRES,180,207,238,216,454
06,06693,066930307,Roque Pérez,BUENOS AIRES,434,479,574,555,1129
06,06693,066930603,Roque Pérez,BUENOS AIRES,11,20,26,23,49
06,06693,066930701,Roque Pérez,BUENOS AIRES,18,35,21,31,52
06,06693,066930313,Roque Pérez,BUENOS AIRES,269,302,380,330,710
06,06693,066930317,Roque Pérez,BUENOS AIRES,254,302,311,308,619
06,06693,066930704,Roque Pérez,BUENOS AIRES,51,96,71,77,148
06,06693,066930101,Roque Pérez,BUENOS AIRES,48,68,63,79,142
06,06693,066930308,Roque Pérez,BUENOS AIRES,234,271,335,254,589
06,06693,066930314,Roque Pérez,BUENOS AIRES,187,227,312,302,614
06,06693,066930310,Roque Pérez,BUENOS AIRES,180,198,258,226,484
06,06693,066930203,Roque Pérez,BUENOS AIRES,16,34,24,23,47
06,06693,066930501,Roque Pérez,BUENOS AIRES,16,30,18,24,42
06,06693,066930306,Roque Pérez,BUENOS AIRES,184,223,231,267,498
06,06693,066930316,Roque Pérez,BUENOS AIRES,315,321,560,566,1126
06,06693,066930301,Roque Pérez,BUENOS AIRES,53,93,69,90,159
06,06693,066930401,Roque Pérez,BUENOS AIRES,64,101,87,97,184
06,06700,067001004,Saavedra,BUENOS AIRES,4,76,5,4,9
06,06700,067000109,Saavedra,BUENOS AIRES,2,11,1,3,4
06,06700,067000703,Saavedra,BUENOS AIRES,10,13,11,17,28
06,06700,067000904,Saavedra,BUENOS AIRES,9,17,7,12,19
06,06700,067001003,Saavedra,BUENOS AIRES,55,99,53,67,120
06,06700,067000205,Saavedra,BUENOS AIRES,194,248,272,286,558
06,06700,067000501,Saavedra,BUENOS AIRES,66,103,96,86,182
06,06700,067001204,Saavedra,BUENOS AIRES,234,248,340,315,655
06,06700,067001207,Saavedra,BUENOS AIRES,307,354,416,354,770
06,06700,067001209,Saavedra,BUENOS AIRES,175,190,266,241,507
06,06700,067000103,Saavedra,BUENOS AIRES,7,11,7,11,18
06,06700,067000301,Saavedra,BUENOS AIRES,7,29,3,7,10
06,06700,067000302,Saavedra,BUENOS AIRES,10,30,8,11,19
06,06700,067000401,Saavedra,BUENOS AIRES,16,18,10,32,42
06,06700,067000402,Saavedra,BUENOS AIRES,14,22,10,21,31
06,06700,067000601,Saavedra,BUENOS AIRES,3,14,2,5,7
06,06700,067000602,Saavedra,BUENOS AIRES,12,36,17,701,718
06,06700,067000702,Saavedra,BUENOS AIRES,7,18,9,11,20
06,06700,067001102,Saavedra,BUENOS AIRES,5,15,4,9,13
06,06700,067000603,Saavedra,BUENOS AIRES,152,175,206,195,401
06,06700,067001213,Saavedra,BUENOS AIRES,199,233,269,258,527
06,06700,067001201,Saavedra,BUENOS AIRES,8,19,4,13,17
06,06700,067000105,Saavedra,BUENOS AIRES,6,15,7,13,20
06,06700,067000303,Saavedra,BUENOS AIRES,6,14,4,6,10
06,06700,067000804,Saavedra,BUENOS AIRES,7,13,8,11,19
06,06700,067000805,Saavedra,BUENOS AIRES,6,16,0,7,7
06,06700,067000107,Saavedra,BUENOS AIRES,12,16,16,16,32
06,06700,067000102,Saavedra,BUENOS AIRES,174,222,242,257,499
06,06700,067000208,Saavedra,BUENOS AIRES,191,237,257,199,456
06,06700,067000209,Saavedra,BUENOS AIRES,361,458,512,416,928
06,06700,067000211,Saavedra,BUENOS AIRES,237,283,366,334,700
06,06700,067000215,Saavedra,BUENOS AIRES,315,344,519,485,1004
06,06700,067000216,Saavedra,BUENOS AIRES,290,303,473,471,944
06,06700,067000502,Saavedra,BUENOS AIRES,6,31,8,10,18
06,06700,067000808,Saavedra,BUENOS AIRES,0,12,0,0,0
06,06700,067000201,Saavedra,BUENOS AIRES,14,22,10,18,28
06,06700,067000806,Saavedra,BUENOS AIRES,3,17,3,4,7
06,06700,067000809,Saavedra,BUENOS AIRES,5,12,4,7,11
06,06700,067000902,Saavedra,BUENOS AIRES,5,17,2,7,9
06,06700,067001002,Saavedra,BUENOS AIRES,8,13,10,16,26
06,06700,067001101,Saavedra,BUENOS AIRES,14,30,18,20,38
06,06700,067001202,Saavedra,BUENOS AIRES,16,24,19,18,37
06,06700,067000213,Saavedra,BUENOS AIRES,296,348,400,344,744
06,06700,067000206,Saavedra,BUENOS AIRES,227,254,315,330,645
06,06700,067000214,Saavedra,BUENOS AIRES,305,344,416,409,825
06,06700,067000606,Saavedra,BUENOS AIRES,183,226,311,246,557
06,06700,067000701,Saavedra,BUENOS AIRES,199,262,263,253,516
06,06700,067001205,Saavedra,BUENOS AIRES,182,206,286,291,577
06,06700,067000503,Saavedra,BUENOS AIRES,8,11,8,13,21
06,06700,067000504,Saavedra,BUENOS AIRES,6,12,11,8,19
06,06700,067000108,Saavedra,BUENOS AIRES,4,17,2,9,11
06,06700,067000106,Saavedra,BUENOS AIRES,6,11,7,11,18
06,06700,067000204,Saavedra,BUENOS AIRES,78,93,149,225,374
06,06700,067000707,Saavedra,BUENOS AIRES,11,25,12,19,31
06,06700,067000807,Saavedra,BUENOS AIRES,7,26,4,11,15
06,06700,067001001,Saavedra,BUENOS AIRES,5,11,3,6,9
06,06700,067000207,Saavedra,BUENOS AIRES,150,195,193,186,379
06,06700,067001206,Saavedra,BUENOS AIRES,148,181,184,188,372
06,06700,067001211,Saavedra,BUENOS AIRES,328,374,521,490,1011
06,06700,067001210,Saavedra,BUENOS AIRES,267,307,371,308,679
06,06700,067000104,Saavedra,BUENOS AIRES,5,18,9,9,18
06,06700,067000801,Saavedra,BUENOS AIRES,8,17,4,12,16
06,06700,067000903,Saavedra,BUENOS AIRES,5,8,4,5,9
06,06700,067000212,Saavedra,BUENOS AIRES,236,263,352,320,672
06,06700,067000604,Saavedra,BUENOS AIRES,252,293,337,312,649
06,06700,067001212,Saavedra,BUENOS AIRES,375,433,488,442,930
06,06700,067000605,Saavedra,BUENOS AIRES,236,276,331,338,669
06,06700,067000202,Saavedra,BUENOS AIRES,11,23,12,19,31
06,06700,067000505,Saavedra,BUENOS AIRES,19,32,19,25,44
06,06700,067000704,Saavedra,BUENOS AIRES,8,13,6,13,19
06,06700,067000705,Saavedra,BUENOS AIRES,15,36,22,22,44
06,06700,067000706,Saavedra,BUENOS AIRES,9,18,8,12,20
06,06700,067000802,Saavedra,BUENOS AIRES,6,14,7,7,14
06,06700,067000803,Saavedra,BUENOS AIRES,4,21,3,5,8
06,06700,067000901,Saavedra,BUENOS AIRES,6,15,6,8,14
06,06700,067000101,Saavedra,BUENOS AIRES,115,144,143,149,292
06,06700,067000110,Saavedra,BUENOS AIRES,192,231,256,237,493
06,06700,067000210,Saavedra,BUENOS AIRES,216,264,263,237,500
06,06700,067000203,Saavedra,BUENOS AIRES,5,13,5,7,12
06,06700,067001203,Saavedra,BUENOS AIRES,8,14,10,12,22
06,06700,067001208,Saavedra,BUENOS AIRES,2,20,0,2,2
06,06707,067070107,Saladillo,BUENOS AIRES,278,341,397,319,716
06,06707,067070109,Saladillo,BUENOS AIRES,303,370,408,349,757
06,06707,067070113,Saladillo,BUENOS AIRES,244,275,441,454,895
06,06707,067070604,Saladillo,BUENOS AIRES,157,205,223,192,415
06,06707,067071103,Saladillo,BUENOS AIRES,248,298,393,383,776
06,06707,067070111,Saladillo,BUENOS AIRES,145,156,213,213,426
06,06707,067070801,Saladillo,BUENOS AIRES,81,124,109,104,213
06,06707,067070701,Saladillo,BUENOS AIRES,1,5,4,3,7
06,06707,067070202,Saladillo,BUENOS AIRES,34,52,36,61,97
06,06707,067070106,Saladillo,BUENOS AIRES,403,464,576,525,1101
06,06707,067070605,Saladillo,BUENOS AIRES,147,180,231,231,462
06,06707,067070405,Saladillo,BUENOS AIRES,278,301,502,511,1013
06,06707,067070607,Saladillo,BUENOS AIRES,158,209,199,193,392
06,06707,067070402,Saladillo,BUENOS AIRES,101,158,137,176,313
06,06707,067070502,Saladillo,BUENOS AIRES,32,55,41,54,95
06,06707,067070503,Saladillo,BUENOS AIRES,34,76,50,45,95
06,06707,067071112,Saladillo,BUENOS AIRES,205,241,329,331,660
06,06707,067071113,Saladillo,BUENOS AIRES,341,391,550,537,1087
06,06707,067070104,Saladillo,BUENOS AIRES,227,239,360,366,726
06,06707,067070105,Saladillo,BUENOS AIRES,396,470,545,471,1016
06,06707,067070110,Saladillo,BUENOS AIRES,237,273,341,287,628
06,06707,067070115,Saladillo,BUENOS AIRES,247,290,370,359,729
06,06707,067070116,Saladillo,BUENOS AIRES,178,194,322,306,628
06,06707,067070117,Saladillo,BUENOS AIRES,295,338,479,469,948
06,06707,067070501,Saladillo,BUENOS AIRES,77,111,102,107,209
06,06707,067071104,Saladillo,BUENOS AIRES,377,432,626,580,1206
06,06707,067070504,Saladillo,BUENOS AIRES,44,79,61,71,132
06,06707,067071108,Saladillo,BUENOS AIRES,302,369,464,368,832
06,06707,067071102,Saladillo,BUENOS AIRES,342,400,549,562,1111
06,06707,067070201,Saladillo,BUENOS AIRES,26,53,15,30,45
06,06707,067070601,Saladillo,BUENOS AIRES,9,13,8,14,22
06,06707,067070608,Saladillo,BUENOS AIRES,31,74,43,47,90
06,06707,067071001,Saladillo,BUENOS AIRES,23,40,31,39,70
06,06707,067070102,Saladillo,BUENOS AIRES,458,506,842,719,1561
06,06707,067070108,Saladillo,BUENOS AIRES,227,294,328,264,592
06,06707,067071109,Saladillo,BUENOS AIRES,218,279,300,260,560
06,06707,067070101,Saladillo,BUENOS AIRES,334,353,555,569,1124
06,06707,067070603,Saladillo,BUENOS AIRES,130,169,197,196,393
06,06707,067071105,Saladillo,BUENOS AIRES,276,310,417,377,794
06,06707,067070401,Saladillo,BUENOS AIRES,138,223,234,261,495
06,06707,067070404,Saladillo,BUENOS AIRES,54,94,62,89,151
06,06707,067070602,Saladillo,BUENOS AIRES,43,99,49,62,111
06,06707,067070606,Saladillo,BUENOS AIRES,56,121,79,82,161
06,06707,067070702,Saladillo,BUENOS AIRES,48,79,60,83,143
06,06707,067070103,Saladillo,BUENOS AIRES,222,256,343,321,664
06,06707,067070114,Saladillo,BUENOS AIRES,151,173,228,200,428
06,06707,067070803,Saladillo,BUENOS AIRES,47,87,47,69,116
06,06707,067070901,Saladillo,BUENOS AIRES,57,98,79,90,169
06,06707,067070403,Saladillo,BUENOS AIRES,271,407,436,425,861
06,06707,067071111,Saladillo,BUENOS AIRES,231,283,348,321,669
06,06707,067070112,Saladillo,BUENOS AIRES,231,274,355,408,763
06,06707,067071110,Saladillo,BUENOS AIRES,380,426,548,510,1058
06,06707,067071101,Saladillo,BUENOS AIRES,334,374,593,531,1124
06,06707,067071106,Saladillo,BUENOS AIRES,278,338,420,334,754
06,06707,067071107,Saladillo,BUENOS AIRES,304,365,420,320,740
06,06707,067070301,Saladillo,BUENOS AIRES,87,168,104,136,240
06,06707,067070802,Saladillo,BUENOS AIRES,62,85,66,84,150
06,06707,067070902,Saladillo,BUENOS AIRES,67,110,90,104,194
06,06707,067070903,Saladillo,BUENOS AIRES,30,59,34,47,81
06,06707,067071002,Saladillo,BUENOS AIRES,33,46,31,64,95
06,06714,067140603,Salto,BUENOS AIRES,136,142,199,193,392
06,06714,067140304,Salto,BUENOS AIRES,6,12,7,13,20
06,06714,067140303,Salto,BUENOS AIRES,3,7,3,4,7
06,06714,067140401,Salto,BUENOS AIRES,13,23,16,21,37
06,06714,067140402,Salto,BUENOS AIRES,17,33,23,23,46
06,06714,067140502,Salto,BUENOS AIRES,14,24,17,21,38
06,06714,067140703,Salto,BUENOS AIRES,10,18,12,19,31
06,06714,067140103,Salto,BUENOS AIRES,311,363,441,410,851
06,06714,067140105,Salto,BUENOS AIRES,369,393,532,442,974
06,06714,067140501,Salto,BUENOS AIRES,217,257,309,339,648
06,06714,067140609,Salto,BUENOS AIRES,265,284,463,463,926
06,06714,067140614,Salto,BUENOS AIRES,7,12,11,18,29
06,06714,067140617,Salto,BUENOS AIRES,293,321,524,542,1066
06,06714,067140204,Salto,BUENOS AIRES,7,15,10,10,20
06,06714,067140504,Salto,BUENOS AIRES,59,85,111,127,238
06,06714,067140701,Salto,BUENOS AIRES,6,10,5,12,17
06,06714,067140803,Salto,BUENOS AIRES,8,16,6,12,18
06,06714,067140804,Salto,BUENOS AIRES,41,65,52,66,118
06,06714,067140104,Salto,BUENOS AIRES,321,367,440,362,802
06,06714,067140611,Salto,BUENOS AIRES,328,358,473,434,907
06,06714,067140801,Salto,BUENOS AIRES,138,161,192,186,378
06,06714,067140302,Salto,BUENOS AIRES,8,30,12,13,25
06,06714,067140207,Salto,BUENOS AIRES,12,16,11,25,36
06,06714,067140306,Salto,BUENOS AIRES,4,18,5,3,8
06,06714,067140906,Salto,BUENOS AIRES,11,16,16,19,35
06,06714,067140102,Salto,BUENOS AIRES,359,420,549,465,1014
06,06714,067140106,Salto,BUENOS AIRES,306,350,408,398,806
06,06714,067140108,Salto,BUENOS AIRES,316,453,458,378,836
06,06714,067140111,Salto,BUENOS AIRES,228,269,328,294,622
06,06714,067140608,Salto,BUENOS AIRES,264,277,463,467,930
06,06714,067140612,Salto,BUENOS AIRES,283,310,467,444,911
06,06714,067140201,Salto,BUENOS AIRES,6,15,14,12,26
06,06714,067140205,Salto,BUENOS AIRES,7,17,9,12,21
06,06714,067140206,Salto,BUENOS AIRES,10,12,10,13,23
06,06714,067140806,Salto,BUENOS AIRES,64,111,81,114,195
06,06714,067140903,Salto,BUENOS AIRES,12,30,8,17,25
06,06714,067140904,Salto,BUENOS AIRES,18,28,26,30,56
06,06714,067140901,Salto,BUENOS AIRES,51,83,98,93,191
06,06714,067140101,Salto,BUENOS AIRES,408,468,637,581,1218
06,06714,067140109,Salto,BUENOS AIRES,298,365,391,302,693
06,06714,067140112,Salto,BUENOS AIRES,298,351,452,370,822
06,06714,067140601,Salto,BUENOS AIRES,330,343,648,594,1242
06,06714,067140602,Salto,BUENOS AIRES,339,342,587,560,1147
06,06714,067140604,Salto,BUENOS AIRES,256,261,479,531,1010
06,06714,067140613,Salto,BUENOS AIRES,471,500,789,786,1575
06,06714,067140809,Salto,BUENOS AIRES,195,245,272,261,533
06,06714,067140203,Salto,BUENOS AIRES,11,25,18,19,37
06,06714,067140305,Salto,BUENOS AIRES,9,28,9,12,21
06,06714,067140403,Salto,BUENOS AIRES,20,47,25,28,53
06,06714,067140702,Salto,BUENOS AIRES,58,81,81,119,200
06,06714,067140802,Salto,BUENOS AIRES,5,24,5,6,11
06,06714,067140107,Salto,BUENOS AIRES,337,377,518,471,989
06,06714,067140110,Salto,BUENOS AIRES,375,436,595,536,1131
06,06714,067140113,Salto,BUENOS AIRES,199,212,331,306,637
06,06714,067140606,Salto,BUENOS AIRES,240,271,352,306,658
06,06714,067140607,Salto,BUENOS AIRES,254,289,398,380,778
06,06714,067140610,Salto,BUENOS AIRES,164,197,299,270,569
06,06714,067140115,Salto,BUENOS AIRES,211,225,319,291,610
06,06714,067140503,Salto,BUENOS AIRES,21,31,27,34,61
06,06714,067140905,Salto,BUENOS AIRES,6,10,6,6,12
06,06714,067140404,Salto,BUENOS AIRES,11,22,6,15,21
06,06714,067140808,Salto,BUENOS AIRES,14,22,9,19,28
06,06714,067140505,Salto,BUENOS AIRES,29,45,29,42,71
06,06714,067140301,Salto,BUENOS AIRES,618,697,870,848,1718
06,06714,067140605,Salto,BUENOS AIRES,302,313,473,495,968
06,06714,067140114,Salto,BUENOS AIRES,298,319,558,548,1106
06,06714,067140615,Salto,BUENOS AIRES,124,144,229,231,460
06,06714,067140616,Salto,BUENOS AIRES,205,211,393,394,787
06,06714,067140807,Salto,BUENOS AIRES,8,35,14,18,32
06,06714,067140202,Salto,BUENOS AIRES,15,34,20,23,43
06,06714,067140805,Salto,BUENOS AIRES,19,29,16,33,49
06,06714,067140902,Salto,BUENOS AIRES,13,22,20,20,40
06,06721,067210101,Salliqueló,BUENOS AIRES,227,264,336,317,653
06,06721,067210207,Salliqueló,BUENOS AIRES,272,303,432,397,829
06,06721,067210103,Salliqueló,BUENOS AIRES,17,40,19,22,41
06,06721,067210211,Salliqueló,BUENOS AIRES,12,28,21,18,39
06,06721,067210203,Salliqueló,BUENOS AIRES,223,275,275,221,496
06,06721,067210204,Salliqueló,BUENOS AIRES,409,491,539,514,1053
06,06721,067210217,Salliqueló,BUENOS AIRES,247,291,315,309,624
06,06721,067210208,Salliqueló,BUENOS AIRES,7,16,9,10,19
06,06721,067210201,Salliqueló,BUENOS AIRES,232,268,304,299,603
06,06721,067210202,Salliqueló,BUENOS AIRES,108,151,130,109,239
06,06721,067210213,Salliqueló,BUENOS AIRES,13,26,14,22,36
06,06721,067210215,Salliqueló,BUENOS AIRES,236,287,343,357,700
06,06721,067210216,Salliqueló,BUENOS AIRES,220,262,273,263,536
06,06721,067210209,Salliqueló,BUENOS AIRES,23,31,22,27,49
06,06721,067210210,Salliqueló,BUENOS AIRES,4,6,3,8,11
06,06721,067210206,Salliqueló,BUENOS AIRES,236,268,402,347,749
06,06721,067210214,Salliqueló,BUENOS AIRES,240,279,394,372,766
06,06721,067210102,Salliqueló,BUENOS AIRES,23,45,25,37,62
06,06721,067210205,Salliqueló,BUENOS AIRES,367,431,522,500,1022
06,06721,067210212,Salliqueló,BUENOS AIRES,14,45,12,19,31
06,06721,067210104,Salliqueló,BUENOS AIRES,32,52,37,49,86
06,06728,067280101,San Andrés de Giles,BUENOS AIRES,305,344,508,493,1001
06,06728,067281009,San Andrés de Giles,BUENOS AIRES,182,203,277,268,545
06,06728,067281016,San Andrés de Giles,BUENOS AIRES,207,240,312,248,560
06,06728,067280202,San Andrés de Giles,BUENOS AIRES,74,113,107,119,226
06,06728,067280203,San Andrés de Giles,BUENOS AIRES,22,32,32,41,73
06,06728,067280501,San Andrés de Giles,BUENOS AIRES,17,27,22,30,52
06,06728,067280701,San Andrés de Giles,BUENOS AIRES,12,19,19,21,40
06,06728,067281103,San Andrés de Giles,BUENOS AIRES,25,33,25,47,72
06,06728,067281404,San Andrés de Giles,BUENOS AIRES,26,26,35,52,87
06,06728,067281603,San Andrés de Giles,BUENOS AIRES,18,33,18,24,42
06,06728,067280201,San Andrés de Giles,BUENOS AIRES,102,123,156,156,312
06,06728,067281001,San Andrés de Giles,BUENOS AIRES,216,219,407,395,802
06,06728,067281002,San Andrés de Giles,BUENOS AIRES,162,183,254,237,491
06,06728,067281006,San Andrés de Giles,BUENOS AIRES,141,163,212,192,404
06,06728,067281020,San Andrés de Giles,BUENOS AIRES,257,276,452,421,873
06,06728,067280602,San Andrés de Giles,BUENOS AIRES,14,18,26,27,53
06,06728,067280603,San Andrés de Giles,BUENOS AIRES,4,9,4,4,8
06,06728,067281023,San Andrés de Giles,BUENOS AIRES,55,66,95,118,213
06,06728,067281026,San Andrés de Giles,BUENOS AIRES,13,38,18,19,37
06,06728,067281102,San Andrés de Giles,BUENOS AIRES,31,38,43,76,119
06,06728,067281408,San Andrés de Giles,BUENOS AIRES,28,32,44,47,91
06,06728,067281019,San Andrés de Giles,BUENOS AIRES,303,324,491,466,957
06,06728,067281021,San Andrés de Giles,BUENOS AIRES,267,299,452,411,863
06,06728,067281301,San Andrés de Giles,BUENOS AIRES,156,224,245,232,477
06,06728,067280303,San Andrés de Giles,BUENOS AIRES,27,41,34,47,81
06,06728,067280402,San Andrés de Giles,BUENOS AIRES,5,11,8,7,15
06,06728,067280803,San Andrés de Giles,BUENOS AIRES,18,28,21,27,48
06,06728,067281302,San Andrés de Giles,BUENOS AIRES,33,63,38,45,83
06,06728,067281501,San Andrés de Giles,BUENOS AIRES,50,64,64,101,165
06,06728,067281402,San Andrés de Giles,BUENOS AIRES,158,176,272,297,569
06,06728,067281004,San Andrés de Giles,BUENOS AIRES,170,188,242,238,480
06,06728,067281012,San Andrés de Giles,BUENOS AIRES,164,189,213,205,418
06,06728,067281024,San Andrés de Giles,BUENOS AIRES,263,276,476,505,981
06,06728,067280204,San Andrés de Giles,BUENOS AIRES,15,29,14,26,40
06,06728,067280401,San Andrés de Giles,BUENOS AIRES,16,19,33,25,58
06,06728,067280502,San Andrés de Giles,BUENOS AIRES,9,17,10,14,24
06,06728,067280702,San Andrés de Giles,BUENOS AIRES,8,19,24,30,54
06,06728,067280902,San Andrés de Giles,BUENOS AIRES,90,100,131,164,295
06,06728,067281101,San Andrés de Giles,BUENOS AIRES,6,8,6,8,14
06,06728,067281503,San Andrés de Giles,BUENOS AIRES,22,36,21,36,57
06,06728,067280904,San Andrés de Giles,BUENOS AIRES,224,252,437,446,883
06,06728,067281008,San Andrés de Giles,BUENOS AIRES,186,198,278,261,539
06,06728,067281015,San Andrés de Giles,BUENOS AIRES,194,222,260,243,503
06,06728,067281018,San Andrés de Giles,BUENOS AIRES,248,266,438,377,815
06,06728,067280102,San Andrés de Giles,BUENOS AIRES,60,79,78,96,174
06,06728,067280302,San Andrés de Giles,BUENOS AIRES,15,30,17,19,36
06,06728,067280304,San Andrés de Giles,BUENOS AIRES,10,12,10,17,27
06,06728,067280901,San Andrés de Giles,BUENOS AIRES,112,120,148,202,350
06,06728,067281303,San Andrés de Giles,BUENOS AIRES,21,59,25,32,57
06,06728,067280703,San Andrés de Giles,BUENOS AIRES,29,38,57,55,112
06,06728,067281005,San Andrés de Giles,BUENOS AIRES,158,185,229,202,431
06,06728,067281007,San Andrés de Giles,BUENOS AIRES,162,175,256,228,484
06,06728,067281010,San Andrés de Giles,BUENOS AIRES,269,289,459,406,865
06,06728,067280601,San Andrés de Giles,BUENOS AIRES,9,14,12,10,22
06,06728,067280403,San Andrés de Giles,BUENOS AIRES,4,10,2,5,7
06,06728,067281201,San Andrés de Giles,BUENOS AIRES,21,44,23,37,60
06,06728,067281403,San Andrés de Giles,BUENOS AIRES,40,45,46,78,124
06,06728,067281405,San Andrés de Giles,BUENOS AIRES,35,57,76,61,137
06,06728,067281407,San Andrés de Giles,BUENOS AIRES,18,22,26,35,61
06,06728,067281502,San Andrés de Giles,BUENOS AIRES,20,25,28,34,62
06,06728,067280903,San Andrés de Giles,BUENOS AIRES,130,183,185,209,394
06,06728,067281003,San Andrés de Giles,BUENOS AIRES,283,311,441,416,857
06,06728,067281013,San Andrés de Giles,BUENOS AIRES,209,231,326,312,638
06,06728,067281014,San Andrés de Giles,BUENOS AIRES,171,187,264,215,479
06,06728,067281017,San Andrés de Giles,BUENOS AIRES,182,210,265,246,511
06,06728,067281025,San Andrés de Giles,BUENOS AIRES,42,47,86,96,182
06,06728,067280503,San Andrés de Giles,BUENOS AIRES,15,27,17,17,34
06,06728,067280301,San Andrés de Giles,BUENOS AIRES,14,19,22,20,42
06,06728,067280801,San Andrés de Giles,BUENOS AIRES,38,63,52,62,114
06,06728,067281202,San Andrés de Giles,BUENOS AIRES,21,35,22,34,56
06,06728,067281406,San Andrés de Giles,BUENOS AIRES,54,82,76,95,171
06,06728,067281602,San Andrés de Giles,BUENOS AIRES,9,13,10,11,21
06,06728,067281011,San Andrés de Giles,BUENOS AIRES,228,248,384,343,727
06,06728,067281022,San Andrés de Giles,BUENOS AIRES,289,318,490,534,1024
06,06728,067281401,San Andrés de Giles,BUENOS AIRES,40,53,74,83,157
06,06728,067280802,San Andrés de Giles,BUENOS AIRES,23,32,31,37,68
06,06728,067281601,San Andrés de Giles,BUENOS AIRES,10,18,7,16,23
06,06735,067350103,San Antonio de Areco,BUENOS AIRES,256,282,409,405,814
06,06735,067350108,San Antonio de Areco,BUENOS AIRES,234,279,361,268,629
06,06735,067350702,San Antonio de Areco,BUENOS AIRES,345,399,638,668,1306
06,06735,067350709,San Antonio de Areco,BUENOS AIRES,316,350,522,474,996
06,06735,067350402,San Antonio de Areco,BUENOS AIRES,53,64,76,98,174
06,06735,067350102,San Antonio de Areco,BUENOS AIRES,172,192,251,253,504
06,06735,067350105,San Antonio de Areco,BUENOS AIRES,387,427,606,493,1099
06,06735,067350710,San Antonio de Areco,BUENOS AIRES,249,266,513,513,1026
06,06735,067350205,San Antonio de Areco,BUENOS AIRES,43,61,44,78,122
06,06735,067350404,San Antonio de Areco,BUENOS AIRES,124,149,200,219,419
06,06735,067350201,San Antonio de Areco,BUENOS AIRES,184,249,285,288,573
06,06735,067350308,San Antonio de Areco,BUENOS AIRES,182,235,328,325,653
06,06735,067350701,San Antonio de Areco,BUENOS AIRES,229,260,369,368,737
06,06735,067350704,San Antonio de Areco,BUENOS AIRES,149,157,252,235,487
06,06735,067350305,San Antonio de Areco,BUENOS AIRES,22,44,37,50,87
06,06735,067350306,San Antonio de Areco,BUENOS AIRES,39,118,57,85,142
06,06735,067350503,San Antonio de Areco,BUENOS AIRES,14,26,16,24,40
06,06735,067350101,San Antonio de Areco,BUENOS AIRES,153,178,231,268,499
06,06735,067350705,San Antonio de Areco,BUENOS AIRES,370,367,588,563,1151
06,06735,067350203,San Antonio de Areco,BUENOS AIRES,4,10,7,7,14
06,06735,067350302,San Antonio de Areco,BUENOS AIRES,26,49,41,44,85
06,06735,067350303,San Antonio de Areco,BUENOS AIRES,15,35,18,26,44
06,06735,067350501,San Antonio de Areco,BUENOS AIRES,8,13,14,20,34
06,06735,067350110,San Antonio de Areco,BUENOS AIRES,403,420,632,552,1184
06,06735,067350708,San Antonio de Areco,BUENOS AIRES,344,382,553,469,1022
06,06735,067350403,San Antonio de Areco,BUENOS AIRES,22,28,55,66,121
06,06735,067350204,San Antonio de Areco,BUENOS AIRES,47,72,56,82,138
06,06735,067350207,San Antonio de Areco,BUENOS AIRES,21,38,34,29,63
06,06735,067350601,San Antonio de Areco,BUENOS AIRES,14,23,14,20,34
06,06735,067350502,San Antonio de Areco,BUENOS AIRES,4,6,4,7,11
06,06735,067350504,San Antonio de Areco,BUENOS AIRES,2,7,1,3,4
06,06735,067350703,San Antonio de Areco,BUENOS AIRES,381,372,735,691,1426
06,06735,067350104,San Antonio de Areco,BUENOS AIRES,239,304,362,286,648
06,06735,067350107,San Antonio de Areco,BUENOS AIRES,329,391,532,403,935
06,06735,067350301,San Antonio de Areco,BUENOS AIRES,151,253,253,276,529
06,06735,067350707,San Antonio de Areco,BUENOS AIRES,346,358,580,586,1166
06,06735,067350202,San Antonio de Areco,BUENOS AIRES,22,25,33,37,70
06,06735,067350206,San Antonio de Areco,BUENOS AIRES,32,46,41,50,91
06,06735,067350307,San Antonio de Areco,BUENOS AIRES,31,42,35,48,83
06,06735,067350603,San Antonio de Areco,BUENOS AIRES,2,8,1,3,4
06,06735,067350106,San Antonio de Areco,BUENOS AIRES,379,409,543,537,1080
06,06735,067350706,San Antonio de Areco,BUENOS AIRES,400,416,729,755,1484
06,06735,067350304,San Antonio de Areco,BUENOS AIRES,16,25,23,24,47
06,06735,067350401,San Antonio de Areco,BUENOS AIRES,12,19,29,20,49
06,06735,067350109,San Antonio de Areco,BUENOS AIRES,397,398,661,600,1261
06,06735,067350208,San Antonio de Areco,BUENOS AIRES,14,28,12,23,35
06,06735,067350602,San Antonio de Areco,BUENOS AIRES,9,14,4,14,18
06,06756,067560507,San Isidro,BUENOS AIRES,248,322,377,320,697
06,06756,067560104,San Isidro,BUENOS AIRES,307,316,520,475,995
06,06756,067560105,San Isidro,BUENOS AIRES,275,287,473,453,926
06,06756,067560110,San Isidro,BUENOS AIRES,404,424,653,551,1204
06,06756,067560113,San Isidro,BUENOS AIRES,308,363,487,444,931
06,06756,067560205,San Isidro,BUENOS AIRES,296,297,521,497,1018
06,06756,067560302,San Isidro,BUENOS AIRES,133,314,162,115,277
06,06756,067560307,San Isidro,BUENOS AIRES,400,532,420,349,769
06,06756,067560801,San Isidro,BUENOS AIRES,316,368,504,420,924
06,06756,067560802,San Isidro,BUENOS AIRES,309,316,480,409,889
06,06756,067560904,San Isidro,BUENOS AIRES,367,404,543,480,1023
06,06756,067560916,San Isidro,BUENOS AIRES,287,308,459,423,882
06,06756,067561007,San Isidro,BUENOS AIRES,246,313,318,269,587
06,06756,067561009,San Isidro,BUENOS AIRES,139,208,153,98,251
06,06756,067561101,San Isidro,BUENOS AIRES,204,261,289,241,530
06,06756,067561302,San Isidro,BUENOS AIRES,193,221,282,225,507
06,06756,067561404,San Isidro,BUENOS AIRES,238,234,369,346,715
06,06756,067561409,San Isidro,BUENOS AIRES,405,370,842,761,1603
06,06756,067561411,San Isidro,BUENOS AIRES,319,266,666,653,1319
06,06756,067561609,San Isidro,BUENOS AIRES,304,301,463,456,919
06,06756,067561510,San Isidro,BUENOS AIRES,303,354,525,484,1009
06,06756,067561511,San Isidro,BUENOS AIRES,331,387,649,600,1249
06,06756,067561707,San Isidro,BUENOS AIRES,357,377,526,507,1033
06,06756,067561709,San Isidro,BUENOS AIRES,398,454,633,581,1214
06,06756,067561801,San Isidro,BUENOS AIRES,269,290,401,370,771
06,06756,067561809,San Isidro,BUENOS AIRES,229,279,308,257,565
06,06756,067561904,San Isidro,BUENOS AIRES,224,244,332,312,644
06,06756,067561905,San Isidro,BUENOS AIRES,431,449,690,648,1338
06,06756,067561910,San Isidro,BUENOS AIRES,288,301,452,401,853
06,06756,067562111,San Isidro,BUENOS AIRES,290,335,545,421,966
06,06756,067562006,San Isidro,BUENOS AIRES,194,199,318,274,592
06,06756,067562108,San Isidro,BUENOS AIRES,332,396,647,602,1249
06,06756,067562208,San Isidro,BUENOS AIRES,230,227,419,377,796
06,06756,067562211,San Isidro,BUENOS AIRES,351,388,545,553,1098
06,06756,067562412,San Isidro,BUENOS AIRES,423,428,682,576,1258
06,06756,067562503,San Isidro,BUENOS AIRES,208,226,291,254,545
06,06756,067562514,San Isidro,BUENOS AIRES,295,327,449,367,816
06,06756,067562517,San Isidro,BUENOS AIRES,261,296,413,335,748
06,06756,067562518,San Isidro,BUENOS AIRES,396,428,606,559,1165
06,06756,067562609,San Isidro,BUENOS AIRES,229,234,357,334,691
06,06756,067561102,San Isidro,BUENOS AIRES,211,275,288,243,531
06,06756,067561108,San Isidro,BUENOS AIRES,234,285,285,206,491
06,06756,067561403,San Isidro,BUENOS AIRES,221,236,345,274,619
06,06756,067561605,San Isidro,BUENOS AIRES,209,263,412,308,720
06,06756,067560303,San Isidro,BUENOS AIRES,200,307,271,221,492
06,06756,067560108,San Isidro,BUENOS AIRES,197,222,272,222,494
06,06756,067560114,San Isidro,BUENOS AIRES,390,428,657,547,1204
06,06756,067560116,San Isidro,BUENOS AIRES,356,399,530,453,983
06,06756,067560208,San Isidro,BUENOS AIRES,225,256,366,338,704
06,06756,067560504,San Isidro,BUENOS AIRES,301,407,516,496,1012
06,06756,067560603,San Isidro,BUENOS AIRES,188,254,241,185,426
06,06756,067560606,San Isidro,BUENOS AIRES,248,373,290,201,491
06,06756,067560607,San Isidro,BUENOS AIRES,341,457,379,252,631
06,06756,067560610,San Isidro,BUENOS AIRES,346,441,400,292,692
06,06756,067560612,San Isidro,BUENOS AIRES,219,269,342,307,649
06,06756,067560808,San Isidro,BUENOS AIRES,362,397,533,465,998
06,06756,067560809,San Isidro,BUENOS AIRES,313,375,509,433,942
06,06756,067560909,San Isidro,BUENOS AIRES,337,369,526,462,988
06,06756,067560915,San Isidro,BUENOS AIRES,339,383,546,497,1043
06,06756,067561113,San Isidro,BUENOS AIRES,254,285,397,364,761
06,06756,067561202,San Isidro,BUENOS AIRES,234,289,336,280,616
06,06756,067561205,San Isidro,BUENOS AIRES,310,332,472,431,903
06,06756,067561210,San Isidro,BUENOS AIRES,281,294,464,408,872
06,06756,067561303,San Isidro,BUENOS AIRES,409,419,773,670,1443
06,06756,067561401,San Isidro,BUENOS AIRES,617,540,1187,1142,2329
06,06756,067561601,San Isidro,BUENOS AIRES,345,357,545,494,1039
06,06756,067561604,San Isidro,BUENOS AIRES,309,330,485,442,927
06,06756,067561703,San Isidro,BUENOS AIRES,338,340,531,476,1007
06,06756,067562004,San Isidro,BUENOS AIRES,187,188,322,281,603
06,06756,067562308,San Isidro,BUENOS AIRES,352,388,578,482,1060
06,06756,067562403,San Isidro,BUENOS AIRES,214,197,361,330,691
06,06756,067562404,San Isidro,BUENOS AIRES,227,237,359,340,699
06,06756,067562406,San Isidro,BUENOS AIRES,325,325,551,462,1013
06,06756,067562519,San Isidro,BUENOS AIRES,369,412,560,516,1076
06,06756,067562603,San Isidro,BUENOS AIRES,189,201,289,250,539
06,06756,067562706,San Isidro,BUENOS AIRES,498,476,881,808,1689
06,06756,067562709,San Isidro,BUENOS AIRES,220,226,352,339,691
06,06756,067561005,San Isidro,BUENOS AIRES,197,242,250,181,431
06,06756,067560209,San Isidro,BUENOS AIRES,302,403,298,230,528
06,06756,067560401,San Isidro,BUENOS AIRES,265,319,411,363,774
06,06756,067560503,San Isidro,BUENOS AIRES,243,306,356,312,668
06,06756,067560508,San Isidro,BUENOS AIRES,279,365,376,319,695
06,06756,067560509,San Isidro,BUENOS AIRES,245,339,351,272,623
06,06756,067560510,San Isidro,BUENOS AIRES,261,308,428,388,816
06,06756,067560707,San Isidro,BUENOS AIRES,304,413,456,322,778
06,06756,067560902,San Isidro,BUENOS AIRES,184,278,234,219,453
06,06756,067560903,San Isidro,BUENOS AIRES,336,370,530,462,992
06,06756,067560907,San Isidro,BUENOS AIRES,415,461,696,586,1282
06,06756,067561001,San Isidro,BUENOS AIRES,221,277,300,235,535
06,06756,067561010,San Isidro,BUENOS AIRES,322,398,512,430,942
06,06756,067561105,San Isidro,BUENOS AIRES,357,466,401,334,735
06,06756,067561112,San Isidro,BUENOS AIRES,335,462,457,436,893
06,06756,067561208,San Isidro,BUENOS AIRES,355,425,502,467,969
06,06756,067561314,San Isidro,BUENOS AIRES,512,508,1115,1062,2177
06,06756,067561406,San Isidro,BUENOS AIRES,252,274,402,317,719
06,06756,067561506,San Isidro,BUENOS AIRES,293,310,503,466,969
06,06756,067561512,San Isidro,BUENOS AIRES,209,252,346,348,694
06,06756,067561606,San Isidro,BUENOS AIRES,191,207,301,247,548
06,06756,067561607,San Isidro,BUENOS AIRES,279,376,288,275,563
06,06756,067561608,San Isidro,BUENOS AIRES,286,332,417,369,786
06,06756,067561708,San Isidro,BUENOS AIRES,407,438,611,582,1193
06,06756,067561802,San Isidro,BUENOS AIRES,394,445,587,549,1136
06,06756,067561810,San Isidro,BUENOS AIRES,301,350,412,319,731
06,06756,067561906,San Isidro,BUENOS AIRES,432,463,644,615,1259
06,06756,067561908,San Isidro,BUENOS AIRES,439,448,674,628,1302
06,06756,067561909,San Isidro,BUENOS AIRES,393,412,611,552,1163
06,06756,067562105,San Isidro,BUENOS AIRES,252,272,470,442,912
06,06756,067562109,San Isidro,BUENOS AIRES,298,361,520,501,1021
06,06756,067562110,San Isidro,BUENOS AIRES,77,99,136,110,246
06,06756,067562205,San Isidro,BUENOS AIRES,345,297,543,521,1064
06,06756,067562301,San Isidro,BUENOS AIRES,600,590,1320,1222,2542
06,06756,067562304,San Isidro,BUENOS AIRES,412,385,650,658,1308
06,06756,067562410,San Isidro,BUENOS AIRES,257,255,402,364,766
06,06756,067562508,San Isidro,BUENOS AIRES,190,203,274,242,516
06,06756,067562602,San Isidro,BUENOS AIRES,255,248,387,358,745
06,06756,067562607,San Isidro,BUENOS AIRES,393,394,597,538,1135
06,06756,067562701,San Isidro,BUENOS AIRES,456,367,900,904,1804
06,06756,067562704,San Isidro,BUENOS AIRES,320,302,630,614,1244
06,06756,067562711,San Isidro,BUENOS AIRES,453,434,712,677,1389
06,06756,067561305,San Isidro,BUENOS AIRES,348,385,539,493,1032
06,06756,067561508,San Isidro,BUENOS AIRES,202,234,287,267,554
06,06756,067560807,San Isidro,BUENOS AIRES,305,341,456,432,888
06,06756,067560506,San Isidro,BUENOS AIRES,238,335,377,352,729
06,06756,067560102,San Isidro,BUENOS AIRES,172,189,293,279,572
06,06756,067560115,San Isidro,BUENOS AIRES,214,216,296,258,554
06,06756,067560204,San Isidro,BUENOS AIRES,278,287,525,460,985
06,06756,067560308,San Isidro,BUENOS AIRES,268,440,315,235,550
06,06756,067560310,San Isidro,BUENOS AIRES,328,467,378,282,660
06,06756,067560402,San Isidro,BUENOS AIRES,290,354,465,399,864
06,06756,067560404,San Isidro,BUENOS AIRES,288,381,472,393,865
06,06756,067560501,San Isidro,BUENOS AIRES,263,332,462,397,859
06,06756,067560601,San Isidro,BUENOS AIRES,375,452,522,410,932
06,06756,067560602,San Isidro,BUENOS AIRES,257,343,290,230,520
06,06756,067560611,San Isidro,BUENOS AIRES,220,239,330,252,582
06,06756,067560704,San Isidro,BUENOS AIRES,313,390,444,390,834
06,06756,067560805,San Isidro,BUENOS AIRES,370,420,544,484,1028
06,06756,067560901,San Isidro,BUENOS AIRES,204,255,317,289,606
06,06756,067560905,San Isidro,BUENOS AIRES,380,429,577,532,1109
06,06756,067560906,San Isidro,BUENOS AIRES,405,466,596,529,1125
06,06756,067560913,San Isidro,BUENOS AIRES,292,289,487,416,903
06,06756,067561002,San Isidro,BUENOS AIRES,192,270,318,242,560
06,06756,067561104,San Isidro,BUENOS AIRES,276,353,369,295,664
06,06756,067561309,San Isidro,BUENOS AIRES,363,356,636,619,1255
06,06756,067561407,San Isidro,BUENOS AIRES,402,429,630,515,1145
06,06756,067561410,San Isidro,BUENOS AIRES,556,495,1121,1113,2234
06,06756,067561414,San Isidro,BUENOS AIRES,281,270,545,562,1107
06,06756,067561503,San Isidro,BUENOS AIRES,315,339,591,535,1126
06,06756,067561504,San Isidro,BUENOS AIRES,449,489,757,744,1501
06,06756,067561602,San Isidro,BUENOS AIRES,257,284,368,331,699
06,06756,067561804,San Isidro,BUENOS AIRES,357,382,544,520,1064
06,06756,067561806,San Isidro,BUENOS AIRES,244,267,377,330,707
06,06756,067561903,San Isidro,BUENOS AIRES,261,279,405,381,786
06,06756,067562002,San Isidro,BUENOS AIRES,322,352,476,418,894
06,06756,067562003,San Isidro,BUENOS AIRES,390,378,643,569,1212
06,06756,067562102,San Isidro,BUENOS AIRES,365,266,685,660,1345
06,06756,067562103,San Isidro,BUENOS AIRES,245,232,487,433,920
06,06756,067562202,San Isidro,BUENOS AIRES,348,354,619,536,1155
06,06756,067562107,San Isidro,BUENOS AIRES,171,193,343,357,700
06,06756,067562209,San Isidro,BUENOS AIRES,279,302,453,427,880
06,06756,067562212,San Isidro,BUENOS AIRES,203,222,317,293,610
06,06756,067562213,San Isidro,BUENOS AIRES,190,207,304,306,610
06,06756,067562303,San Isidro,BUENOS AIRES,250,257,444,432,876
06,06756,067562309,San Isidro,BUENOS AIRES,385,362,667,669,1336
06,06756,067562402,San Isidro,BUENOS AIRES,195,182,300,253,553
06,06756,067562506,San Isidro,BUENOS AIRES,221,229,350,303,653
06,06756,067562511,San Isidro,BUENOS AIRES,280,215,584,578,1162
06,06756,067562513,San Isidro,BUENOS AIRES,305,330,484,443,927
06,06756,067562515,San Isidro,BUENOS AIRES,340,361,483,452,935
06,06756,067562605,San Isidro,BUENOS AIRES,244,240,363,314,677
06,06756,067562608,San Isidro,BUENOS AIRES,382,400,615,603,1218
06,06756,067562702,San Isidro,BUENOS AIRES,459,442,865,790,1655
06,06756,067562712,San Isidro,BUENOS AIRES,406,369,701,654,1355
06,06756,067562407,San Isidro,BUENOS AIRES,194,205,286,266,552
06,06756,067560605,San Isidro,BUENOS AIRES,240,318,272,210,482
06,06756,067560604,San Isidro,BUENOS AIRES,134,220,149,106,255
06,06756,067560106,San Isidro,BUENOS AIRES,257,280,442,373,815
06,06756,067560107,San Isidro,BUENOS AIRES,443,472,622,541,1163
06,06756,067560112,San Isidro,BUENOS AIRES,330,385,500,482,982
06,06756,067560304,San Isidro,BUENOS AIRES,250,339,275,216,491
06,06756,067560305,San Isidro,BUENOS AIRES,140,237,160,95,255
06,06756,067560505,San Isidro,BUENOS AIRES,232,298,392,344,736
06,06756,067560406,San Isidro,BUENOS AIRES,223,270,385,323,708
06,06756,067560804,San Isidro,BUENOS AIRES,367,406,541,538,1079
06,06756,067561008,San Isidro,BUENOS AIRES,245,350,276,190,466
06,06756,067561103,San Isidro,BUENOS AIRES,294,363,362,296,658
06,06756,067561402,San Isidro,BUENOS AIRES,704,683,1356,1348,2704
06,06756,067561415,San Isidro,BUENOS AIRES,278,285,513,484,997
06,06756,067561501,San Isidro,BUENOS AIRES,401,459,729,687,1416
06,06756,067561505,San Isidro,BUENOS AIRES,399,426,692,621,1313
06,06756,067561611,San Isidro,BUENOS AIRES,334,386,617,543,1160
06,06756,067561612,San Isidro,BUENOS AIRES,262,304,486,450,936
06,06756,067561613,San Isidro,BUENOS AIRES,290,321,476,446,922
06,06756,067561805,San Isidro,BUENOS AIRES,224,219,340,318,658
06,06756,067561807,San Isidro,BUENOS AIRES,206,233,323,277,600
06,06756,067561901,San Isidro,BUENOS AIRES,385,415,615,593,1208
06,06756,067562009,San Isidro,BUENOS AIRES,306,308,499,475,974
06,06756,067562104,San Isidro,BUENOS AIRES,436,502,902,800,1702
06,06756,067562210,San Isidro,BUENOS AIRES,293,295,477,418,895
06,06756,067562307,San Isidro,BUENOS AIRES,385,430,590,535,1125
06,06756,067562401,San Isidro,BUENOS AIRES,340,317,546,481,1027
06,06756,067562411,San Isidro,BUENOS AIRES,392,413,605,499,1104
06,06756,067562413,San Isidro,BUENOS AIRES,352,377,482,407,889
06,06756,067562512,San Isidro,BUENOS AIRES,387,386,679,619,1298
06,06756,067562606,San Isidro,BUENOS AIRES,363,393,566,521,1087
06,06756,067562705,San Isidro,BUENOS AIRES,420,385,774,732,1506
06,06756,067562707,San Isidro,BUENOS AIRES,224,197,340,298,638
06,06756,067562710,San Isidro,BUENOS AIRES,255,244,459,439,898
06,06756,067560202,San Isidro,BUENOS AIRES,237,261,429,379,808
06,06756,067560206,San Isidro,BUENOS AIRES,278,388,467,401,868
06,06756,067560408,San Isidro,BUENOS AIRES,195,247,273,252,525
06,06756,067560502,San Isidro,BUENOS AIRES,281,371,468,442,910
06,06756,067560608,San Isidro,BUENOS AIRES,235,267,358,324,682
06,06756,067560709,San Isidro,BUENOS AIRES,285,341,510,385,895
06,06756,067560710,San Isidro,BUENOS AIRES,326,368,563,481,1044
06,06756,067560912,San Isidro,BUENOS AIRES,322,349,487,436,923
06,06756,067561004,San Isidro,BUENOS AIRES,331,448,355,248,603
06,06756,067561012,San Isidro,BUENOS AIRES,337,378,560,452,1012
06,06756,067561106,San Isidro,BUENOS AIRES,341,419,376,360,736
06,06756,067561107,San Isidro,BUENOS AIRES,373,481,404,371,775
06,06756,067561109,San Isidro,BUENOS AIRES,175,222,208,155,363
06,06756,067561211,San Isidro,BUENOS AIRES,332,397,523,486,1009
06,06756,067561306,San Isidro,BUENOS AIRES,298,297,434,390,824
06,06756,067561308,San Isidro,BUENOS AIRES,377,426,571,492,1063
06,06756,067561312,San Isidro,BUENOS AIRES,373,389,624,547,1171
06,06756,067561313,San Isidro,BUENOS AIRES,400,432,589,505,1094
06,06756,067561412,San Isidro,BUENOS AIRES,270,252,533,531,1064
06,06756,067561502,San Isidro,BUENOS AIRES,365,355,658,617,1275
06,06756,067561701,San Isidro,BUENOS AIRES,309,373,439,372,811
06,06756,067561803,San Isidro,BUENOS AIRES,295,328,437,364,801
06,06756,067561811,San Isidro,BUENOS AIRES,425,487,656,555,1211
06,06756,067561902,San Isidro,BUENOS AIRES,421,436,625,608,1233
06,06756,067562001,San Isidro,BUENOS AIRES,285,298,596,492,1088
06,06756,067562007,San Isidro,BUENOS AIRES,468,476,739,706,1445
06,06756,067562008,San Isidro,BUENOS AIRES,362,393,605,540,1145
06,06756,067562101,San Isidro,BUENOS AIRES,415,446,764,680,1444
06,06756,067562204,San Isidro,BUENOS AIRES,465,333,856,819,1675
06,06756,067562306,San Isidro,BUENOS AIRES,279,323,439,411,850
06,06756,067562405,San Isidro,BUENOS AIRES,240,248,385,325,710
06,06756,067562502,San Isidro,BUENOS AIRES,317,355,492,432,924
06,06756,067562505,San Isidro,BUENOS AIRES,238,269,331,302,633
06,06756,067562507,San Isidro,BUENOS AIRES,203,218,300,283,583
06,06756,067562509,San Isidro,BUENOS AIRES,350,374,601,499,1100
06,06756,067561702,San Isidro,BUENOS AIRES,406,449,576,592,1168
06,06756,067560103,San Isidro,BUENOS AIRES,201,218,402,407,809
06,06756,067560201,San Isidro,BUENOS AIRES,275,288,474,438,912
06,06756,067560203,San Isidro,BUENOS AIRES,394,420,657,621,1278
06,06756,067560301,San Isidro,BUENOS AIRES,185,313,220,199,419
06,06756,067560309,San Isidro,BUENOS AIRES,238,429,344,221,565
06,06756,067560609,San Isidro,BUENOS AIRES,270,371,334,226,560
06,06756,067560702,San Isidro,BUENOS AIRES,223,297,301,232,533
06,06756,067560703,San Isidro,BUENOS AIRES,150,195,197,145,342
06,06756,067560803,San Isidro,BUENOS AIRES,328,370,494,413,907
06,06756,067560911,San Isidro,BUENOS AIRES,273,313,444,367,811
06,06756,067561110,San Isidro,BUENOS AIRES,242,304,248,190,438
06,06756,067561111,San Isidro,BUENOS AIRES,309,449,367,277,644
06,06756,067561204,San Isidro,BUENOS AIRES,513,500,832,756,1588
06,06756,067561206,San Isidro,BUENOS AIRES,188,255,219,201,420
06,06756,067561304,San Isidro,BUENOS AIRES,328,337,501,445,946
06,06756,067561307,San Isidro,BUENOS AIRES,322,336,483,446,929
06,06756,067561311,San Isidro,BUENOS AIRES,426,410,745,676,1421
06,06756,067561405,San Isidro,BUENOS AIRES,236,229,394,316,710
06,06756,067561413,San Isidro,BUENOS AIRES,207,203,428,443,871
06,06756,067561509,San Isidro,BUENOS AIRES,213,246,361,373,734
06,06756,067561603,San Isidro,BUENOS AIRES,340,302,496,469,965
06,06756,067561704,San Isidro,BUENOS AIRES,314,345,461,413,874
06,06756,067561706,San Isidro,BUENOS AIRES,313,315,487,433,920
06,06756,067562106,San Isidro,BUENOS AIRES,313,373,590,580,1170
06,06756,067562207,San Isidro,BUENOS AIRES,283,243,490,459,949
06,06756,067562310,San Isidro,BUENOS AIRES,307,289,585,543,1128
06,06756,067562501,San Isidro,BUENOS AIRES,297,276,643,619,1262
06,06756,067562516,San Isidro,BUENOS AIRES,359,395,559,514,1073
06,06756,067562604,San Isidro,BUENOS AIRES,249,267,380,336,716
06,06756,067562610,San Isidro,BUENOS AIRES,194,197,326,344,670
06,06756,067562611,San Isidro,BUENOS AIRES,400,405,631,614,1245
06,06756,067562703,San Isidro,BUENOS AIRES,342,293,703,689,1392
06,06756,067562708,San Isidro,BUENOS AIRES,249,227,392,407,799
06,06756,067562305,San Isidro,BUENOS AIRES,344,353,595,524,1119
06,06756,067560101,San Isidro,BUENOS AIRES,245,286,407,343,750
06,06756,067560109,San Isidro,BUENOS AIRES,219,211,289,249,538
06,06756,067560111,San Isidro,BUENOS AIRES,198,238,299,235,534
06,06756,067560117,San Isidro,BUENOS AIRES,344,326,556,499,1055
06,06756,067560207,San Isidro,BUENOS AIRES,331,401,598,511,1109
06,06756,067560306,San Isidro,BUENOS AIRES,148,243,206,144,350
06,06756,067560403,San Isidro,BUENOS AIRES,328,425,544,492,1036
06,06756,067560405,San Isidro,BUENOS AIRES,308,385,545,524,1069
06,06756,067560407,San Isidro,BUENOS AIRES,301,359,492,451,943
06,06756,067560701,San Isidro,BUENOS AIRES,280,338,412,311,723
06,06756,067560705,San Isidro,BUENOS AIRES,293,361,368,267,635
06,06756,067560706,San Isidro,BUENOS AIRES,317,453,400,284,684
06,06756,067560708,San Isidro,BUENOS AIRES,252,291,393,306,699
06,06756,067560806,San Isidro,BUENOS AIRES,418,464,641,601,1242
06,06756,067560908,San Isidro,BUENOS AIRES,389,428,572,532,1104
06,06756,067560910,San Isidro,BUENOS AIRES,337,383,530,482,1012
06,06756,067560914,San Isidro,BUENOS AIRES,356,386,568,518,1086
06,06756,067561003,San Isidro,BUENOS AIRES,330,402,363,275,638
06,06756,067561006,San Isidro,BUENOS AIRES,374,455,435,275,710
06,06756,067561011,San Isidro,BUENOS AIRES,317,366,497,455,952
06,06756,067561201,San Isidro,BUENOS AIRES,409,399,613,518,1131
06,06756,067561203,San Isidro,BUENOS AIRES,252,280,407,351,758
06,06756,067561207,San Isidro,BUENOS AIRES,167,243,164,149,313
06,06756,067561209,San Isidro,BUENOS AIRES,337,348,513,442,955
06,06756,067561301,San Isidro,BUENOS AIRES,285,318,327,303,630
06,06756,067561310,San Isidro,BUENOS AIRES,272,284,413,456,869
06,06756,067561408,San Isidro,BUENOS AIRES,348,385,625,536,1161
06,06756,067561507,San Isidro,BUENOS AIRES,229,248,361,332,693
06,06756,067561610,San Isidro,BUENOS AIRES,200,240,392,336,728
06,06756,067561705,San Isidro,BUENOS AIRES,205,238,293,275,568
06,06756,067561710,San Isidro,BUENOS AIRES,329,413,372,347,719
06,06756,067561808,San Isidro,BUENOS AIRES,62,74,90,75,165
06,06756,067561907,San Isidro,BUENOS AIRES,376,396,556,514,1070
06,06756,067562005,San Isidro,BUENOS AIRES,226,218,369,322,691
06,06756,067562201,San Isidro,BUENOS AIRES,608,578,1036,958,1994
06,06756,067562203,San Isidro,BUENOS AIRES,471,486,891,768,1659
06,06756,067562206,San Isidro,BUENOS AIRES,391,327,806,792,1598
06,06756,067562302,San Isidro,BUENOS AIRES,274,278,513,504,1017
06,06756,067562408,San Isidro,BUENOS AIRES,210,220,311,277,588
06,06756,067562409,San Isidro,BUENOS AIRES,235,245,369,313,682
06,06756,067562504,San Isidro,BUENOS AIRES,171,186,264,217,481
06,06756,067562510,San Isidro,BUENOS AIRES,352,330,576,546,1122
06,06756,067562601,San Isidro,BUENOS AIRES,388,407,607,575,1182
06,06760,067600315,San Miguel,BUENOS AIRES,278,360,329,299,628
06,06760,067600112,San Miguel,BUENOS AIRES,225,258,405,332,737
06,06760,067600113,San Miguel,BUENOS AIRES,311,376,517,457,974
06,06760,067600117,San Miguel,BUENOS AIRES,220,262,356,302,658
06,06760,067600202,San Miguel,BUENOS AIRES,410,439,592,541,1133
06,06760,067600209,San Miguel,BUENOS AIRES,166,247,239,192,431
06,06760,067600214,San Miguel,BUENOS AIRES,231,318,269,222,491
06,06760,067600217,San Miguel,BUENOS AIRES,219,275,235,170,405
06,06760,067600301,San Miguel,BUENOS AIRES,214,209,313,290,603
06,06760,067600305,San Miguel,BUENOS AIRES,368,404,617,558,1175
06,06760,067600307,San Miguel,BUENOS AIRES,97,122,135,126,261
06,06760,067600308,San Miguel,BUENOS AIRES,266,330,407,340,747
06,06760,067600401,San Miguel,BUENOS AIRES,223,233,423,424,847
06,06760,067600808,San Miguel,BUENOS AIRES,214,238,381,334,715
06,06760,067600802,San Miguel,BUENOS AIRES,465,487,757,689,1446
06,06760,067600807,San Miguel,BUENOS AIRES,495,554,925,854,1779
06,06760,067600809,San Miguel,BUENOS AIRES,368,393,574,543,1117
06,06760,067600904,San Miguel,BUENOS AIRES,265,292,413,361,774
06,06760,067600906,San Miguel,BUENOS AIRES,219,287,318,251,569
06,06760,067600915,San Miguel,BUENOS AIRES,184,204,342,318,660
06,06760,067600916,San Miguel,BUENOS AIRES,263,259,445,430,875
06,06760,067601003,San Miguel,BUENOS AIRES,185,177,316,321,637
06,06760,067601011,San Miguel,BUENOS AIRES,120,128,223,220,443
06,06760,067601208,San Miguel,BUENOS AIRES,234,262,506,506,1012
06,06760,067601211,San Miguel,BUENOS AIRES,295,335,581,569,1150
06,06760,067601213,San Miguel,BUENOS AIRES,7,251,8,9,17
06,06760,067601217,San Miguel,BUENOS AIRES,401,352,813,842,1655
06,06760,067601303,San Miguel,BUENOS AIRES,164,179,312,252,564
06,06760,067601304,San Miguel,BUENOS AIRES,230,211,395,399,794
06,06760,067601405,San Miguel,BUENOS AIRES,295,303,638,635,1273
06,06760,067601408,San Miguel,BUENOS AIRES,297,304,542,540,1082
06,06760,067601504,San Miguel,BUENOS AIRES,250,219,473,456,929
06,06760,067601506,San Miguel,BUENOS AIRES,223,198,458,474,932
06,06760,067601507,San Miguel,BUENOS AIRES,314,310,613,561,1174
06,06760,067601508,San Miguel,BUENOS AIRES,364,323,658,675,1333
06,06760,067601510,San Miguel,BUENOS AIRES,202,179,408,428,836
06,06760,067601801,San Miguel,BUENOS AIRES,292,285,633,589,1222
06,06760,067601804,San Miguel,BUENOS AIRES,439,329,835,857,1692
06,06760,067601810,San Miguel,BUENOS AIRES,291,292,550,547,1097
06,06760,067600101,San Miguel,BUENOS AIRES,338,298,560,531,1091
06,06760,067600105,San Miguel,BUENOS AIRES,485,492,748,739,1487
06,06760,067600106,San Miguel,BUENOS AIRES,287,280,450,387,837
06,06760,067600115,San Miguel,BUENOS AIRES,296,297,435,395,830
06,06760,067600210,San Miguel,BUENOS AIRES,414,453,666,575,1241
06,06760,067600310,San Miguel,BUENOS AIRES,74,88,121,117,238
06,06760,067600512,San Miguel,BUENOS AIRES,364,426,594,522,1116
06,06760,067600703,San Miguel,BUENOS AIRES,472,524,714,653,1367
06,06760,067600708,San Miguel,BUENOS AIRES,319,350,509,499,1008
06,06760,067600811,San Miguel,BUENOS AIRES,266,254,452,392,844
06,06760,067600907,San Miguel,BUENOS AIRES,421,489,639,555,1194
06,06760,067601004,San Miguel,BUENOS AIRES,250,238,466,399,865
06,06760,067601101,San Miguel,BUENOS AIRES,237,256,384,349,733
06,06760,067601105,San Miguel,BUENOS AIRES,197,207,382,295,677
06,06760,067601201,San Miguel,BUENOS AIRES,216,254,400,353,753
06,06760,067601202,San Miguel,BUENOS AIRES,232,249,415,403,818
06,06760,067601205,San Miguel,BUENOS AIRES,266,293,499,492,991
06,06760,067601212,San Miguel,BUENOS AIRES,311,330,612,642,1254
06,06760,067601307,San Miguel,BUENOS AIRES,259,241,460,473,933
06,06760,067601309,San Miguel,BUENOS AIRES,431,379,789,784,1573
06,06760,067601314,San Miguel,BUENOS AIRES,446,420,776,826,1602
06,06760,067601316,San Miguel,BUENOS AIRES,207,199,352,374,726
06,06760,067601414,San Miguel,BUENOS AIRES,248,236,477,475,952
06,06760,067601503,San Miguel,BUENOS AIRES,187,180,353,293,646
06,06760,067601603,San Miguel,BUENOS AIRES,359,360,694,638,1332
06,06760,067601604,San Miguel,BUENOS AIRES,324,323,609,587,1196
06,06760,067601606,San Miguel,BUENOS AIRES,383,403,770,786,1556
06,06760,067601612,San Miguel,BUENOS AIRES,183,198,295,263,558
06,06760,067601703,San Miguel,BUENOS AIRES,295,291,509,504,1013
06,06760,067601704,San Miguel,BUENOS AIRES,305,310,565,555,1120
06,06760,067601803,San Miguel,BUENOS AIRES,370,336,734,698,1432
06,06760,067601811,San Miguel,BUENOS AIRES,312,284,653,587,1240
06,06760,067601812,San Miguel,BUENOS AIRES,411,359,747,785,1532
06,06760,067601814,San Miguel,BUENOS AIRES,317,288,591,583,1174
06,06760,067600211,San Miguel,BUENOS AIRES,267,277,399,325,724
06,06760,067600104,San Miguel,BUENOS AIRES,304,280,491,474,965
06,06760,067600304,San Miguel,BUENOS AIRES,294,307,417,379,796
06,06760,067600306,San Miguel,BUENOS AIRES,228,275,394,315,709
06,06760,067600311,San Miguel,BUENOS AIRES,351,413,506,413,919
06,06760,067600312,San Miguel,BUENOS AIRES,76,106,112,116,228
06,06760,067600509,San Miguel,BUENOS AIRES,460,461,691,681,1372
06,06760,067600511,San Miguel,BUENOS AIRES,782,827,1252,1134,2386
06,06760,067600609,San Miguel,BUENOS AIRES,425,387,815,813,1628
06,06760,067600702,San Miguel,BUENOS AIRES,559,553,929,936,1865
06,06760,067600706,San Miguel,BUENOS AIRES,254,280,437,439,876
06,06760,067600709,San Miguel,BUENOS AIRES,367,391,668,593,1261
06,06760,067600801,San Miguel,BUENOS AIRES,338,419,475,453,928
06,06760,067600806,San Miguel,BUENOS AIRES,363,383,578,520,1098
06,06760,067601006,San Miguel,BUENOS AIRES,61,58,88,66,154
06,06760,067601108,San Miguel,BUENOS AIRES,595,561,1177,1144,2321
06,06760,067601207,San Miguel,BUENOS AIRES,111,127,266,252,518
06,06760,067601215,San Miguel,BUENOS AIRES,312,304,674,651,1325
06,06760,067601218,San Miguel,BUENOS AIRES,237,224,486,500,986
06,06760,067601301,San Miguel,BUENOS AIRES,196,230,340,304,644
06,06760,067601312,San Miguel,BUENOS AIRES,331,344,559,612,1171
06,06760,067601403,San Miguel,BUENOS AIRES,302,309,536,536,1072
06,06760,067601411,San Miguel,BUENOS AIRES,308,243,596,592,1188
06,06760,067601413,San Miguel,BUENOS AIRES,415,353,838,849,1687
06,06760,067601602,San Miguel,BUENOS AIRES,283,254,505,473,978
06,06760,067601710,San Miguel,BUENOS AIRES,307,317,556,573,1129
06,06760,067601715,San Miguel,BUENOS AIRES,342,343,659,608,1267
06,06760,067600102,San Miguel,BUENOS AIRES,324,287,603,547,1150
06,06760,067600107,San Miguel,BUENOS AIRES,472,449,767,776,1543
06,06760,067600114,San Miguel,BUENOS AIRES,453,442,793,696,1489
06,06760,067600208,San Miguel,BUENOS AIRES,135,172,203,172,375
06,06760,067600303,San Miguel,BUENOS AIRES,318,303,486,441,927
06,06760,067600314,San Miguel,BUENOS AIRES,317,498,334,306,640
06,06760,067600504,San Miguel,BUENOS AIRES,242,261,494,384,878
06,06760,067600508,San Miguel,BUENOS AIRES,532,555,882,850,1732
06,06760,067600602,San Miguel,BUENOS AIRES,383,407,607,553,1160
06,06760,067600603,San Miguel,BUENOS AIRES,285,314,461,427,888
06,06760,067600610,San Miguel,BUENOS AIRES,415,399,763,845,1608
06,06760,067600710,San Miguel,BUENOS AIRES,489,522,845,785,1630
06,06760,067600810,San Miguel,BUENOS AIRES,339,353,579,505,1084
06,06760,067600909,San Miguel,BUENOS AIRES,229,290,365,338,703
06,06760,067600912,San Miguel,BUENOS AIRES,447,485,767,670,1437
06,06760,067601002,San Miguel,BUENOS AIRES,262,267,478,472,950
06,06760,067601007,San Miguel,BUENOS AIRES,96,98,166,157,323
06,06760,067601102,San Miguel,BUENOS AIRES,298,272,554,504,1058
06,06760,067601113,San Miguel,BUENOS AIRES,238,240,405,375,780
06,06760,067601115,San Miguel,BUENOS AIRES,180,185,331,311,642
06,06760,067601203,San Miguel,BUENOS AIRES,102,115,176,206,382
06,06760,067601209,San Miguel,BUENOS AIRES,216,249,384,455,839
06,06760,067601306,San Miguel,BUENOS AIRES,429,362,870,911,1781
06,06760,067601310,San Miguel,BUENOS AIRES,443,412,858,843,1701
06,06760,067601311,San Miguel,BUENOS AIRES,378,347,695,643,1338
06,06760,067601401,San Miguel,BUENOS AIRES,234,238,434,446,880
06,06760,067601407,San Miguel,BUENOS AIRES,572,332,1046,1058,2104
06,06760,067601502,San Miguel,BUENOS AIRES,237,264,447,378,825
06,06760,067601512,San Miguel,BUENOS AIRES,358,377,629,596,1225
06,06760,067601514,San Miguel,BUENOS AIRES,250,242,450,439,889
06,06760,067601613,San Miguel,BUENOS AIRES,338,346,631,589,1220
06,06760,067601701,San Miguel,BUENOS AIRES,438,349,843,800,1643
06,06760,067601708,San Miguel,BUENOS AIRES,400,396,802,770,1572
06,06760,067601712,San Miguel,BUENOS AIRES,297,274,593,591,1184
06,06760,067601807,San Miguel,BUENOS AIRES,304,271,589,552,1141
06,06760,067601808,San Miguel,BUENOS AIRES,398,364,795,789,1584
06,06760,067600316,San Miguel,BUENOS AIRES,132,203,179,152,331
06,06760,067600103,San Miguel,BUENOS AIRES,385,326,594,581,1175
06,06760,067600302,San Miguel,BUENOS AIRES,501,502,769,677,1446
06,06760,067600317,San Miguel,BUENOS AIRES,328,394,447,369,816
06,06760,067600505,San Miguel,BUENOS AIRES,397,429,656,592,1248
06,06760,067600605,San Miguel,BUENOS AIRES,300,334,467,412,879
06,06760,067600701,San Miguel,BUENOS AIRES,571,581,1112,1021,2133
06,06760,067600803,San Miguel,BUENOS AIRES,386,434,542,486,1028
06,06760,067600804,San Miguel,BUENOS AIRES,367,389,575,545,1120
06,06760,067601010,San Miguel,BUENOS AIRES,82,71,170,158,328
06,06760,067601013,San Miguel,BUENOS AIRES,378,376,715,733,1448
06,06760,067601014,San Miguel,BUENOS AIRES,389,302,738,737,1475
06,06760,067601107,San Miguel,BUENOS AIRES,396,397,741,694,1435
06,06760,067601116,San Miguel,BUENOS AIRES,150,174,423,320,743
06,06760,067601204,San Miguel,BUENOS AIRES,229,229,363,358,721
06,06760,067601206,San Miguel,BUENOS AIRES,207,293,295,307,602
06,06760,067601214,San Miguel,BUENOS AIRES,338,316,650,668,1318
06,06760,067601305,San Miguel,BUENOS AIRES,306,285,493,453,946
06,06760,067601308,San Miguel,BUENOS AIRES,272,257,503,502,1005
06,06760,067601313,San Miguel,BUENOS AIRES,259,317,511,531,1042
06,06760,067601315,San Miguel,BUENOS AIRES,411,422,810,832,1642
06,06760,067601501,San Miguel,BUENOS AIRES,325,310,587,508,1095
06,06760,067601509,San Miguel,BUENOS AIRES,427,387,874,809,1683
06,06760,067601513,San Miguel,BUENOS AIRES,303,279,533,507,1040
06,06760,067601516,San Miguel,BUENOS AIRES,205,216,391,387,778
06,06760,067601611,San Miguel,BUENOS AIRES,234,238,416,389,805
06,06760,067601711,San Miguel,BUENOS AIRES,274,251,489,506,995
06,06760,067601714,San Miguel,BUENOS AIRES,278,298,502,490,992
06,06760,067601716,San Miguel,BUENOS AIRES,240,235,431,427,858
06,06760,067600913,San Miguel,BUENOS AIRES,390,431,784,719,1503
06,06760,067601614,San Miguel,BUENOS AIRES,305,312,570,611,1181
06,06760,067600111,San Miguel,BUENOS AIRES,222,231,356,339,695
06,06760,067600203,San Miguel,BUENOS AIRES,227,300,332,302,634
06,06760,067600215,San Miguel,BUENOS AIRES,208,307,228,193,421
06,06760,067600216,San Miguel,BUENOS AIRES,185,308,210,166,376
06,06760,067600501,San Miguel,BUENOS AIRES,542,569,913,849,1762
06,06760,067600503,San Miguel,BUENOS AIRES,480,526,813,698,1511
06,06760,067600707,San Miguel,BUENOS AIRES,242,279,404,389,793
06,06760,067600902,San Miguel,BUENOS AIRES,212,214,395,348,743
06,06760,067600911,San Miguel,BUENOS AIRES,459,513,788,700,1488
06,06760,067600914,San Miguel,BUENOS AIRES,350,347,624,610,1234
06,06760,067601001,San Miguel,BUENOS AIRES,228,175,376,441,817
06,06760,067601008,San Miguel,BUENOS AIRES,103,99,223,203,426
06,06760,067601012,San Miguel,BUENOS AIRES,415,412,894,797,1691
06,06760,067601015,San Miguel,BUENOS AIRES,386,389,751,754,1505
06,06760,067601106,San Miguel,BUENOS AIRES,681,689,1183,1146,2329
06,06760,067601210,San Miguel,BUENOS AIRES,234,232,450,455,905
06,06760,067601302,San Miguel,BUENOS AIRES,330,352,613,567,1180
06,06760,067601404,San Miguel,BUENOS AIRES,444,426,858,821,1679
06,06760,067601406,San Miguel,BUENOS AIRES,572,543,1095,1169,2264
06,06760,067601415,San Miguel,BUENOS AIRES,118,127,229,200,429
06,06760,067601505,San Miguel,BUENOS AIRES,447,442,878,848,1726
06,06760,067601607,San Miguel,BUENOS AIRES,310,306,576,580,1156
06,06760,067601609,San Miguel,BUENOS AIRES,262,217,475,482,957
06,06760,067601705,San Miguel,BUENOS AIRES,345,333,736,690,1426
06,06760,067601706,San Miguel,BUENOS AIRES,391,339,744,722,1466
06,06760,067601707,San Miguel,BUENOS AIRES,295,280,563,555,1118
06,06760,067601713,San Miguel,BUENOS AIRES,316,268,558,550,1108
06,06760,067601806,San Miguel,BUENOS AIRES,253,266,482,462,944
06,06760,067601813,San Miguel,BUENOS AIRES,274,260,545,519,1064
06,06760,067601815,San Miguel,BUENOS AIRES,284,252,547,542,1089
06,06760,067600601,San Miguel,BUENOS AIRES,346,389,531,522,1053
06,06760,067601110,San Miguel,BUENOS AIRES,422,414,805,767,1572
06,06760,067600108,San Miguel,BUENOS AIRES,456,377,778,755,1533
06,06760,067600109,San Miguel,BUENOS AIRES,495,421,875,843,1718
06,06760,067600116,San Miguel,BUENOS AIRES,224,243,339,326,665
06,06760,067600204,San Miguel,BUENOS AIRES,279,345,371,324,695
06,06760,067600207,San Miguel,BUENOS AIRES,321,533,473,380,853
06,06760,067600213,San Miguel,BUENOS AIRES,373,458,520,445,965
06,06760,067600309,San Miguel,BUENOS AIRES,203,250,315,290,605
06,06760,067600313,San Miguel,BUENOS AIRES,440,598,595,479,1074
06,06760,067600510,San Miguel,BUENOS AIRES,597,613,971,890,1861
06,06760,067600606,San Miguel,BUENOS AIRES,283,297,445,405,850
06,06760,067600607,San Miguel,BUENOS AIRES,341,352,579,567,1146
06,06760,067600608,San Miguel,BUENOS AIRES,380,307,667,621,1288
06,06760,067600805,San Miguel,BUENOS AIRES,226,258,330,287,617
06,06760,067600903,San Miguel,BUENOS AIRES,350,333,620,577,1197
06,06760,067600910,San Miguel,BUENOS AIRES,427,483,703,591,1294
06,06760,067601005,San Miguel,BUENOS AIRES,215,211,427,385,812
06,06760,067601009,San Miguel,BUENOS AIRES,249,232,484,443,927
06,06760,067601103,San Miguel,BUENOS AIRES,587,587,962,904,1866
06,06760,067601109,San Miguel,BUENOS AIRES,243,244,410,431,841
06,06760,067601112,San Miguel,BUENOS AIRES,226,196,409,371,780
06,06760,067601114,San Miguel,BUENOS AIRES,171,187,263,258,521
06,06760,067601117,San Miguel,BUENOS AIRES,226,255,410,479,889
06,06760,067601219,San Miguel,BUENOS AIRES,301,256,619,649,1268
06,06760,067601410,San Miguel,BUENOS AIRES,347,314,665,661,1326
06,06760,067601412,San Miguel,BUENOS AIRES,412,394,831,892,1723
06,06760,067601601,San Miguel,BUENOS AIRES,290,265,523,499,1022
06,06760,067601605,San Miguel,BUENOS AIRES,364,364,659,718,1377
06,06760,067601610,San Miguel,BUENOS AIRES,277,267,538,531,1069
06,06760,067601702,San Miguel,BUENOS AIRES,353,317,699,716,1415
06,06760,067601709,San Miguel,BUENOS AIRES,292,307,534,510,1044
06,06760,067601802,San Miguel,BUENOS AIRES,308,313,559,550,1109
06,06760,067601805,San Miguel,BUENOS AIRES,243,223,491,458,949
06,06760,067601816,San Miguel,BUENOS AIRES,256,255,526,503,1029
06,06760,067600507,San Miguel,BUENOS AIRES,387,434,567,553,1120
06,06760,067601511,San Miguel,BUENOS AIRES,260,207,529,555,1084
06,06760,067600110,San Miguel,BUENOS AIRES,400,317,737,631,1368
06,06760,067600201,San Miguel,BUENOS AIRES,426,454,658,591,1249
06,06760,067600205,San Miguel,BUENOS AIRES,278,376,358,265,623
06,06760,067600206,San Miguel,BUENOS AIRES,267,423,425,290,715
06,06760,067600212,San Miguel,BUENOS AIRES,283,329,452,403,855
06,06760,067600502,San Miguel,BUENOS AIRES,329,375,490,468,958
06,06760,067600506,San Miguel,BUENOS AIRES,298,351,458,426,884
06,06760,067600604,San Miguel,BUENOS AIRES,291,317,493,432,925
06,06760,067600704,San Miguel,BUENOS AIRES,397,436,624,576,1200
06,06760,067600705,San Miguel,BUENOS AIRES,436,480,779,770,1549
06,06760,067600812,San Miguel,BUENOS AIRES,382,425,603,549,1152
06,06760,067600901,San Miguel,BUENOS AIRES,237,257,403,341,744
06,06760,067600905,San Miguel,BUENOS AIRES,264,340,380,319,699
06,06760,067600908,San Miguel,BUENOS AIRES,222,264,338,319,657
06,06760,067601104,San Miguel,BUENOS AIRES,431,421,736,718,1454
06,06760,067601111,San Miguel,BUENOS AIRES,544,526,1007,986,1993
06,06760,067601216,San Miguel,BUENOS AIRES,368,334,718,646,1364
06,06760,067601402,San Miguel,BUENOS AIRES,266,222,490,526,1016
06,06760,067601409,San Miguel,BUENOS AIRES,383,378,680,644,1324
06,06760,067601515,San Miguel,BUENOS AIRES,201,220,350,347,697
06,06760,067601608,San Miguel,BUENOS AIRES,368,338,704,665,1369
06,06760,067601809,San Miguel,BUENOS AIRES,304,276,589,606,1195
06,06770,067700901,San Pedro,BUENOS AIRES,197,213,327,317,644
06,06770,067701009,San Pedro,BUENOS AIRES,335,380,540,508,1048
06,06770,067702212,San Pedro,BUENOS AIRES,326,348,630,552,1182
06,06770,067702102,San Pedro,BUENOS AIRES,301,370,455,374,829
06,06770,067702109,San Pedro,BUENOS AIRES,257,331,366,287,653
06,06770,067702201,San Pedro,BUENOS AIRES,291,286,525,567,1092
06,06770,067702207,San Pedro,BUENOS AIRES,280,293,432,450,882
06,06770,067702210,San Pedro,BUENOS AIRES,288,317,453,402,855
06,06770,067700502,San Pedro,BUENOS AIRES,1,2,0,1,1
06,06770,067700201,San Pedro,BUENOS AIRES,8,8,10,15,25
06,06770,067700303,San Pedro,BUENOS AIRES,7,12,5,14,19
06,06770,067700702,San Pedro,BUENOS AIRES,2,6,1,3,4
06,06770,067700703,San Pedro,BUENOS AIRES,1,4,1,1,2
06,06770,067700804,San Pedro,BUENOS AIRES,7,14,8,10,18
06,06770,067700904,San Pedro,BUENOS AIRES,3,6,2,2,4
06,06770,067700907,San Pedro,BUENOS AIRES,13,13,15,24,39
06,06770,067701104,San Pedro,BUENOS AIRES,15,15,20,20,40
06,06770,067701105,San Pedro,BUENOS AIRES,28,32,44,55,99
06,06770,067701202,San Pedro,BUENOS AIRES,38,49,62,69,131
06,06770,067701205,San Pedro,BUENOS AIRES,12,13,19,27,46
06,06770,067701303,San Pedro,BUENOS AIRES,19,34,27,29,56
06,06770,067701502,San Pedro,BUENOS AIRES,7,14,6,8,14
06,06770,067701704,San Pedro,BUENOS AIRES,6,19,8,11,19
06,06770,067702001,San Pedro,BUENOS AIRES,10,18,10,21,31
06,06770,067701013,San Pedro,BUENOS AIRES,513,434,901,990,1891
06,06770,067701001,San Pedro,BUENOS AIRES,255,271,448,474,922
06,06770,067702211,San Pedro,BUENOS AIRES,286,324,454,390,844
06,06770,067702213,San Pedro,BUENOS AIRES,199,230,273,273,546
06,06770,067702203,San Pedro,BUENOS AIRES,428,428,805,770,1575
06,06770,067702204,San Pedro,BUENOS AIRES,490,486,1126,1114,2240
06,06770,067702205,San Pedro,BUENOS AIRES,353,353,636,604,1240
06,06770,067702301,San Pedro,BUENOS AIRES,25,45,29,48,77
06,06770,067700302,San Pedro,BUENOS AIRES,4,7,7,6,13
06,06770,067700403,San Pedro,BUENOS AIRES,7,16,8,12,20
06,06770,067700404,San Pedro,BUENOS AIRES,5,15,4,9,13
06,06770,067700208,San Pedro,BUENOS AIRES,15,20,23,35,58
06,06770,067700301,San Pedro,BUENOS AIRES,13,17,33,28,61
06,06770,067701301,San Pedro,BUENOS AIRES,12,25,13,23,36
06,06770,067701705,San Pedro,BUENOS AIRES,14,33,16,26,42
06,06770,067701903,San Pedro,BUENOS AIRES,8,12,9,14,23
06,06770,067700203,San Pedro,BUENOS AIRES,44,67,53,56,109
06,06770,067701006,San Pedro,BUENOS AIRES,365,370,598,581,1179
06,06770,067702106,San Pedro,BUENOS AIRES,266,335,417,337,754
06,06770,067702108,San Pedro,BUENOS AIRES,244,275,336,325,661
06,06770,067702209,San Pedro,BUENOS AIRES,236,251,354,328,682
06,06770,067701306,San Pedro,BUENOS AIRES,8,14,16,16,32
06,06770,067701701,San Pedro,BUENOS AIRES,6,7,8,10,18
06,06770,067700905,San Pedro,BUENOS AIRES,5,8,4,7,11
06,06770,067700601,San Pedro,BUENOS AIRES,3,10,3,5,8
06,06770,067700704,San Pedro,BUENOS AIRES,5,6,4,10,14
06,06770,067701102,San Pedro,BUENOS AIRES,14,21,24,21,45
06,06770,067701206,San Pedro,BUENOS AIRES,6,13,12,16,28
06,06770,067701304,San Pedro,BUENOS AIRES,20,20,31,43,74
06,06770,067701607,San Pedro,BUENOS AIRES,9,10,14,18,32
06,06770,067701803,San Pedro,BUENOS AIRES,7,8,12,14,26
06,06770,067701203,San Pedro,BUENOS AIRES,136,151,244,249,493
06,06770,067701003,San Pedro,BUENOS AIRES,273,288,474,441,915
06,06770,067701004,San Pedro,BUENOS AIRES,222,267,377,382,759
06,06770,067701010,San Pedro,BUENOS AIRES,298,319,449,441,890
06,06770,067701012,San Pedro,BUENOS AIRES,119,131,168,172,340
06,06770,067701014,San Pedro,BUENOS AIRES,31,34,51,68,119
06,06770,067701603,San Pedro,BUENOS AIRES,244,314,356,339,695
06,06770,067701801,San Pedro,BUENOS AIRES,170,211,257,271,528
06,06770,067702103,San Pedro,BUENOS AIRES,254,350,341,308,649
06,06770,067700701,San Pedro,BUENOS AIRES,9,9,17,11,28
06,06770,067700906,San Pedro,BUENOS AIRES,44,54,69,81,150
06,06770,067701204,San Pedro,BUENOS AIRES,8,14,14,18,32
06,06770,067701402,San Pedro,BUENOS AIRES,15,26,20,22,42
06,06770,067701703,San Pedro,BUENOS AIRES,4,13,6,9,15
06,06770,067701805,San Pedro,BUENOS AIRES,16,25,32,29,61
06,06770,067700110,San Pedro,BUENOS AIRES,259,310,405,354,759
06,06770,067700107,San Pedro,BUENOS AIRES,379,431,599,498,1097
06,06770,067700206,San Pedro,BUENOS AIRES,198,238,271,266,537
06,06770,067702107,San Pedro,BUENOS AIRES,415,441,592,536,1128
06,06770,067702110,San Pedro,BUENOS AIRES,266,321,389,303,692
06,06770,067702206,San Pedro,BUENOS AIRES,411,419,681,647,1328
06,06770,067700204,San Pedro,BUENOS AIRES,18,34,29,31,60
06,06770,067700602,San Pedro,BUENOS AIRES,9,12,13,17,30
06,06770,067700801,San Pedro,BUENOS AIRES,26,31,37,48,85
06,06770,067700803,San Pedro,BUENOS AIRES,10,15,17,15,32
06,06770,067701101,San Pedro,BUENOS AIRES,35,35,46,62,108
06,06770,067701605,San Pedro,BUENOS AIRES,36,50,37,56,93
06,06770,067701702,San Pedro,BUENOS AIRES,7,12,13,9,22
06,06770,067701904,San Pedro,BUENOS AIRES,5,11,4,7,11
06,06770,067702002,San Pedro,BUENOS AIRES,2,5,2,5,7
06,06770,067701005,San Pedro,BUENOS AIRES,354,383,574,532,1106
06,06770,067700202,San Pedro,BUENOS AIRES,55,110,75,88,163
06,06770,067701002,San Pedro,BUENOS AIRES,275,314,451,486,937
06,06770,067700111,San Pedro,BUENOS AIRES,340,352,542,542,1084
06,06770,067700103,San Pedro,BUENOS AIRES,510,457,887,850,1737
06,06770,067700104,San Pedro,BUENOS AIRES,359,363,693,687,1380
06,06770,067700108,San Pedro,BUENOS AIRES,301,377,436,362,798
06,06770,067702105,San Pedro,BUENOS AIRES,313,367,433,374,807
06,06770,067702214,San Pedro,BUENOS AIRES,391,436,611,634,1245
06,06770,067700503,San Pedro,BUENOS AIRES,2,3,3,3,6
06,06770,067700305,San Pedro,BUENOS AIRES,3,8,3,6,9
06,06770,067700705,San Pedro,BUENOS AIRES,7,11,8,16,24
06,06770,067700802,San Pedro,BUENOS AIRES,4,6,4,6,10
06,06770,067700805,San Pedro,BUENOS AIRES,3,7,3,4,7
06,06770,067700908,San Pedro,BUENOS AIRES,43,77,48,77,125
06,06770,067701501,San Pedro,BUENOS AIRES,3,3,7,6,13
06,06770,067701505,San Pedro,BUENOS AIRES,11,14,19,13,32
06,06770,067701604,San Pedro,BUENOS AIRES,9,13,6,14,20
06,06770,067701802,San Pedro,BUENOS AIRES,8,22,11,10,21
06,06770,067701806,San Pedro,BUENOS AIRES,8,11,11,15,26
06,06770,067701804,San Pedro,BUENOS AIRES,10,18,21,13,34
06,06770,067702202,San Pedro,BUENOS AIRES,318,331,645,658,1303
06,06770,067700109,San Pedro,BUENOS AIRES,295,360,382,328,710
06,06770,067700101,San Pedro,BUENOS AIRES,120,137,193,209,402
06,06770,067700105,San Pedro,BUENOS AIRES,417,449,707,715,1422
06,06770,067700106,San Pedro,BUENOS AIRES,394,429,600,538,1138
06,06770,067700205,San Pedro,BUENOS AIRES,302,325,566,583,1149
06,06770,067701007,San Pedro,BUENOS AIRES,367,360,617,637,1254
06,06770,067701602,San Pedro,BUENOS AIRES,239,274,339,323,662
06,06770,067701601,San Pedro,BUENOS AIRES,296,337,508,495,1003
06,06770,067702101,San Pedro,BUENOS AIRES,248,321,382,313,695
06,06770,067702104,San Pedro,BUENOS AIRES,291,394,402,280,682
06,06770,067702208,San Pedro,BUENOS AIRES,265,271,387,375,762
06,06770,067701606,San Pedro,BUENOS AIRES,8,14,7,13,20
06,06770,067701901,San Pedro,BUENOS AIRES,4,8,1,4,5
06,06770,067701902,San Pedro,BUENOS AIRES,3,7,2,5,7
06,06770,067700504,San Pedro,BUENOS AIRES,4,7,4,7,11
06,06770,067700401,San Pedro,BUENOS AIRES,8,22,12,17,29
06,06770,067700402,San Pedro,BUENOS AIRES,4,3,15,10,25
06,06770,067700902,San Pedro,BUENOS AIRES,20,21,30,39,69
06,06770,067701302,San Pedro,BUENOS AIRES,14,27,18,27,45
06,06770,067701403,San Pedro,BUENOS AIRES,4,13,5,8,13
06,06770,067700102,San Pedro,BUENOS AIRES,196,209,359,370,729
06,06770,067700207,San Pedro,BUENOS AIRES,281,297,434,487,921
06,06770,067701008,San Pedro,BUENOS AIRES,371,408,626,574,1200
06,06770,067701011,San Pedro,BUENOS AIRES,146,177,265,245,510
06,06770,067701201,San Pedro,BUENOS AIRES,466,481,795,791,1586
06,06770,067701503,San Pedro,BUENOS AIRES,6,9,8,10,18
06,06770,067700501,San Pedro,BUENOS AIRES,1,2,2,2,4
06,06770,067700304,San Pedro,BUENOS AIRES,5,10,8,11,19
06,06770,067700903,San Pedro,BUENOS AIRES,23,29,45,51,96
06,06770,067701103,San Pedro,BUENOS AIRES,48,58,69,81,150
06,06770,067701305,San Pedro,BUENOS AIRES,9,15,19,15,34
06,06770,067701307,San Pedro,BUENOS AIRES,11,13,13,19,32
06,06770,067701401,San Pedro,BUENOS AIRES,7,8,6,12,18
06,06770,067701504,San Pedro,BUENOS AIRES,5,7,6,11,17
06,06812,068120502,Tordillo,BUENOS AIRES,174,250,283,297,580
06,06812,068120201,Tordillo,BUENOS AIRES,8,9,10,15,25
06,06812,068120303,Tordillo,BUENOS AIRES,2,12,3,3,6
06,06812,068120101,Tordillo,BUENOS AIRES,20,29,35,38,73
06,06812,068120601,Tordillo,BUENOS AIRES,4,13,2,7,9
06,06812,068120302,Tordillo,BUENOS AIRES,7,14,8,11,19
06,06812,068120403,Tordillo,BUENOS AIRES,9,26,8,12,20
06,06812,068120501,Tordillo,BUENOS AIRES,10,18,16,17,33
06,06812,068120503,Tordillo,BUENOS AIRES,217,262,327,353,680
06,06812,068120402,Tordillo,BUENOS AIRES,10,17,16,21,37
06,06812,068120401,Tordillo,BUENOS AIRES,30,31,51,58,109
06,06812,068120602,Tordillo,BUENOS AIRES,6,11,2,7,9
06,06812,068120102,Tordillo,BUENOS AIRES,28,44,33,35,68
06,06812,068120504,Tordillo,BUENOS AIRES,3,4,4,5,9
06,06812,068120301,Tordillo,BUENOS AIRES,21,25,26,30,56
06,06812,068120202,Tordillo,BUENOS AIRES,9,17,12,19,31
06,06819,068190402,Tornquist,BUENOS AIRES,428,513,663,629,1292
06,06819,068190910,Tornquist,BUENOS AIRES,157,203,234,201,435
06,06819,068190408,Tornquist,BUENOS AIRES,59,103,77,100,177
06,06819,068190502,Tornquist,BUENOS AIRES,24,58,51,56,107
06,06819,068190401,Tornquist,BUENOS AIRES,320,370,468,438,906
06,06819,068190601,Tornquist,BUENOS AIRES,30,47,40,42,82
06,06819,068190405,Tornquist,BUENOS AIRES,293,345,437,429,866
06,06819,068190602,Tornquist,BUENOS AIRES,44,98,47,64,111
06,06819,068190902,Tornquist,BUENOS AIRES,70,173,89,107,196
06,06819,068190906,Tornquist,BUENOS AIRES,106,236,143,139,282
06,06819,068190701,Tornquist,BUENOS AIRES,24,39,19,31,50
06,06819,068190802,Tornquist,BUENOS AIRES,32,85,36,60,96
06,06819,068190101,Tornquist,BUENOS AIRES,71,89,104,101,205
06,06819,068190505,Tornquist,BUENOS AIRES,140,502,171,174,345
06,06819,068190903,Tornquist,BUENOS AIRES,172,408,233,227,460
06,06819,068190603,Tornquist,BUENOS AIRES,21,48,25,38,63
06,06819,068190909,Tornquist,BUENOS AIRES,52,79,59,73,132
06,06819,068190403,Tornquist,BUENOS AIRES,283,335,396,305,701
06,06819,068190911,Tornquist,BUENOS AIRES,147,184,217,215,432
06,06819,068190901,Tornquist,BUENOS AIRES,60,175,86,82,168
06,06819,068190905,Tornquist,BUENOS AIRES,170,283,209,212,421
06,06819,068190912,Tornquist,BUENOS AIRES,166,199,243,241,484
06,06819,068190301,Tornquist,BUENOS AIRES,18,36,13,27,40
06,06819,068190407,Tornquist,BUENOS AIRES,262,308,412,435,847
06,06819,068190904,Tornquist,BUENOS AIRES,167,437,217,205,422
06,06819,068190103,Tornquist,BUENOS AIRES,30,147,28,42,70
06,06819,068190104,Tornquist,BUENOS AIRES,60,115,67,97,164
06,06819,068190302,Tornquist,BUENOS AIRES,29,67,28,50,78
06,06819,068190501,Tornquist,BUENOS AIRES,20,108,25,27,52
06,06819,068190504,Tornquist,BUENOS AIRES,102,409,126,138,264
06,06819,068190907,Tornquist,BUENOS AIRES,74,232,114,102,216
06,06819,068190201,Tornquist,BUENOS AIRES,58,120,75,95,170
06,06819,068190503,Tornquist,BUENOS AIRES,23,33,32,32,64
06,06819,068190801,Tornquist,BUENOS AIRES,21,53,28,37,65
06,06819,068190102,Tornquist,BUENOS AIRES,29,54,32,46,78
06,06819,068190404,Tornquist,BUENOS AIRES,339,421,502,416,918
06,06819,068190406,Tornquist,BUENOS AIRES,326,381,483,460,943
06,06819,068190202,Tornquist,BUENOS AIRES,31,57,38,47,85
06,06819,068190409,Tornquist,BUENOS AIRES,68,97,84,102,186
06,06819,068190908,Tornquist,BUENOS AIRES,12,21,18,32,50
06,06847,068470115,Tres Lomas,BUENOS AIRES,164,175,276,291,567
06,06847,068470102,Tres Lomas,BUENOS AIRES,350,380,511,483,994
06,06847,068470202,Tres Lomas,BUENOS AIRES,7,35,11,8,19
06,06847,068470101,Tres Lomas,BUENOS AIRES,158,191,222,215,437
06,06847,068470113,Tres Lomas,BUENOS AIRES,198,205,313,293,606
06,06847,068470204,Tres Lomas,BUENOS AIRES,32,62,38,51,89
06,06847,068470104,Tres Lomas,BUENOS AIRES,381,432,645,538,1183
06,06847,068470205,Tres Lomas,BUENOS AIRES,9,36,9,14,23
06,06847,068470114,Tres Lomas,BUENOS AIRES,286,307,494,460,954
06,06847,068470108,Tres Lomas,BUENOS AIRES,3,23,3,5,8
06,06847,068470109,Tres Lomas,BUENOS AIRES,10,28,11,18,29
06,06847,068470111,Tres Lomas,BUENOS AIRES,351,373,523,512,1035
06,06847,068470112,Tres Lomas,BUENOS AIRES,178,206,282,309,591
06,06847,068470106,Tres Lomas,BUENOS AIRES,14,20,18,21,39
06,06847,068470110,Tres Lomas,BUENOS AIRES,23,57,25,39,64
06,06847,068470203,Tres Lomas,BUENOS AIRES,25,43,42,50,92
06,06847,068470201,Tres Lomas,BUENOS AIRES,56,85,73,77,150
06,06847,068470107,Tres Lomas,BUENOS AIRES,48,94,44,82,126
06,06847,068470103,Tres Lomas,BUENOS AIRES,331,349,516,503,1019
06,06847,068470105,Tres Lomas,BUENOS AIRES,270,325,353,322,675
06,06861,068610107,Vicente López,BUENOS AIRES,253,329,329,237,566
06,06861,068610109,Vicente López,BUENOS AIRES,245,295,378,334,712
06,06861,068610204,Vicente López,BUENOS AIRES,340,388,490,437,927
06,06861,068610410,Vicente López,BUENOS AIRES,258,295,378,324,702
06,06861,068610608,Vicente López,BUENOS AIRES,164,250,163,172,335
06,06861,068610605,Vicente López,BUENOS AIRES,133,171,162,127,289
06,06861,068610611,Vicente López,BUENOS AIRES,150,192,183,161,344
06,06861,068610803,Vicente López,BUENOS AIRES,200,226,308,270,578
06,06861,068611003,Vicente López,BUENOS AIRES,366,425,579,504,1083
06,06861,068611005,Vicente López,BUENOS AIRES,324,347,500,448,948
06,06861,068611307,Vicente López,BUENOS AIRES,251,298,369,324,693
06,06861,068611412,Vicente López,BUENOS AIRES,229,336,236,210,446
06,06861,068611601,Vicente López,BUENOS AIRES,211,243,324,257,581
06,06861,068611605,Vicente López,BUENOS AIRES,292,317,478,389,867
06,06861,068611706,Vicente López,BUENOS AIRES,257,279,391,378,769
06,06861,068611805,Vicente López,BUENOS AIRES,205,240,291,272,563
06,06861,068611808,Vicente López,BUENOS AIRES,305,349,460,398,858
06,06861,068611906,Vicente López,BUENOS AIRES,296,316,445,404,849
06,06861,068611912,Vicente López,BUENOS AIRES,360,412,533,512,1045
06,06861,068612001,Vicente López,BUENOS AIRES,362,432,521,436,957
06,06861,068612002,Vicente López,BUENOS AIRES,270,343,403,299,702
06,06861,068612006,Vicente López,BUENOS AIRES,368,421,494,418,912
06,06861,068612204,Vicente López,BUENOS AIRES,309,356,443,394,837
06,06861,068612206,Vicente López,BUENOS AIRES,319,358,466,430,896
06,06861,068612305,Vicente López,BUENOS AIRES,404,331,738,752,1490
06,06861,068612411,Vicente López,BUENOS AIRES,429,491,670,593,1263
06,06861,068612610,Vicente López,BUENOS AIRES,309,337,474,424,898
06,06861,068612808,Vicente López,BUENOS AIRES,190,215,290,237,527
06,06861,068612912,Vicente López,BUENOS AIRES,193,213,265,226,491
06,06861,068613106,Vicente López,BUENOS AIRES,341,367,514,502,1016
06,06861,068613205,Vicente López,BUENOS AIRES,163,203,206,147,353
06,06861,068613208,Vicente López,BUENOS AIRES,254,339,344,289,633
06,06861,068613310,Vicente López,BUENOS AIRES,392,439,554,468,1022
06,06861,068612804,Vicente López,BUENOS AIRES,311,349,423,384,807
06,06861,068612910,Vicente López,BUENOS AIRES,351,364,486,434,920
06,06861,068610205,Vicente López,BUENOS AIRES,222,286,267,211,478
06,06861,068610304,Vicente López,BUENOS AIRES,363,396,464,321,785
06,06861,068610404,Vicente López,BUENOS AIRES,167,249,180,142,322
06,06861,068610503,Vicente López,BUENOS AIRES,228,286,291,266,557
06,06861,068610507,Vicente López,BUENOS AIRES,240,318,279,244,523
06,06861,068610601,Vicente López,BUENOS AIRES,104,219,133,114,247
06,06861,068610606,Vicente López,BUENOS AIRES,258,333,331,269,600
06,06861,068610706,Vicente López,BUENOS AIRES,180,215,257,215,472
06,06861,068610805,Vicente López,BUENOS AIRES,186,270,231,202,433
06,06861,068610901,Vicente López,BUENOS AIRES,346,419,448,396,844
06,06861,068611004,Vicente López,BUENOS AIRES,337,405,520,468,988
06,06861,068611101,Vicente López,BUENOS AIRES,335,372,515,444,959
06,06861,068611106,Vicente López,BUENOS AIRES,333,355,503,441,944
06,06861,068611110,Vicente López,BUENOS AIRES,249,308,348,269,617
06,06861,068611301,Vicente López,BUENOS AIRES,167,221,229,188,417
06,06861,068611304,Vicente López,BUENOS AIRES,282,334,400,300,700
06,06861,068611401,Vicente López,BUENOS AIRES,260,355,337,263,600
06,06861,068611404,Vicente López,BUENOS AIRES,290,328,452,386,838
06,06861,068611501,Vicente López,BUENOS AIRES,274,371,307,209,516
06,06861,068611506,Vicente López,BUENOS AIRES,278,333,392,320,712
06,06861,068611508,Vicente López,BUENOS AIRES,417,513,479,377,856
06,06861,068611604,Vicente López,BUENOS AIRES,332,380,488,399,887
06,06861,068611606,Vicente López,BUENOS AIRES,312,351,417,398,815
06,06861,068611701,Vicente López,BUENOS AIRES,326,356,490,450,940
06,06861,068611702,Vicente López,BUENOS AIRES,308,338,452,453,905
06,06861,068611707,Vicente López,BUENOS AIRES,344,365,539,495,1034
06,06861,068611902,Vicente López,BUENOS AIRES,119,149,161,124,285
06,06861,068611907,Vicente López,BUENOS AIRES,325,367,481,440,921
06,06861,068611910,Vicente López,BUENOS AIRES,274,311,421,351,772
06,06861,068612004,Vicente López,BUENOS AIRES,329,400,443,352,795
06,06861,068612105,Vicente López,BUENOS AIRES,306,336,418,386,804
06,06861,068612201,Vicente López,BUENOS AIRES,322,386,477,408,885
06,06861,068612209,Vicente López,BUENOS AIRES,212,219,335,301,636
06,06861,068612301,Vicente López,BUENOS AIRES,424,424,684,670,1354
06,06861,068612408,Vicente López,BUENOS AIRES,383,388,580,520,1100
06,06861,068612502,Vicente López,BUENOS AIRES,441,459,701,598,1299
06,06861,068612503,Vicente López,BUENOS AIRES,382,409,582,526,1108
06,06861,068612506,Vicente López,BUENOS AIRES,288,333,452,409,861
06,06861,068612508,Vicente López,BUENOS AIRES,390,424,551,531,1082
06,06861,068612606,Vicente López,BUENOS AIRES,337,413,483,390,873
06,06861,068612709,Vicente López,BUENOS AIRES,270,275,394,337,731
06,06861,068612802,Vicente López,BUENOS AIRES,351,405,511,452,963
06,06861,068612805,Vicente López,BUENOS AIRES,255,276,372,316,688
06,06861,068612806,Vicente López,BUENOS AIRES,285,350,393,348,741
06,06861,068612901,Vicente López,BUENOS AIRES,515,578,840,752,1592
06,06861,068612902,Vicente López,BUENOS AIRES,288,306,411,374,785
06,06861,068612905,Vicente López,BUENOS AIRES,296,307,458,410,868
06,06861,068612906,Vicente López,BUENOS AIRES,184,201,286,290,576
06,06861,068613107,Vicente López,BUENOS AIRES,441,458,671,607,1278
06,06861,068613204,Vicente López,BUENOS AIRES,107,137,131,101,232
06,06861,068610301,Vicente López,BUENOS AIRES,328,367,370,317,687
06,06861,068610106,Vicente López,BUENOS AIRES,222,274,307,252,559
06,06861,068610102,Vicente López,BUENOS AIRES,168,204,243,234,477
06,06861,068610211,Vicente López,BUENOS AIRES,246,297,384,367,751
06,06861,068610110,Vicente López,BUENOS AIRES,236,342,305,245,550
06,06861,068610206,Vicente López,BUENOS AIRES,173,246,228,200,428
06,06861,068610210,Vicente López,BUENOS AIRES,301,368,502,422,924
06,06861,068610307,Vicente López,BUENOS AIRES,248,288,312,217,529
06,06861,068610308,Vicente López,BUENOS AIRES,281,312,335,261,596
06,06861,068610401,Vicente López,BUENOS AIRES,286,434,271,219,490
06,06861,068610409,Vicente López,BUENOS AIRES,234,265,350,246,596
06,06861,068610502,Vicente López,BUENOS AIRES,223,322,223,205,428
06,06861,068610602,Vicente López,BUENOS AIRES,221,318,234,195,429
06,06861,068610903,Vicente López,BUENOS AIRES,224,249,300,292,592
06,06861,068610912,Vicente López,BUENOS AIRES,302,325,445,392,837
06,06861,068611006,Vicente López,BUENOS AIRES,314,365,472,449,921
06,06861,068611104,Vicente López,BUENOS AIRES,236,278,327,296,623
06,06861,068611108,Vicente López,BUENOS AIRES,236,275,343,302,645
06,06861,068611302,Vicente López,BUENOS AIRES,238,302,287,249,536
06,06861,068611602,Vicente López,BUENOS AIRES,201,231,280,253,533
06,06861,068611611,Vicente López,BUENOS AIRES,280,314,453,390,843
06,06861,068611708,Vicente López,BUENOS AIRES,323,377,505,453,958
06,06861,068611802,Vicente López,BUENOS AIRES,351,396,528,482,1010
06,06861,068611903,Vicente López,BUENOS AIRES,303,392,400,324,724
06,06861,068611911,Vicente López,BUENOS AIRES,341,391,493,442,935
06,06861,068612303,Vicente López,BUENOS AIRES,399,410,636,582,1218
06,06861,068612401,Vicente López,BUENOS AIRES,410,473,611,533,1144
06,06861,068612410,Vicente López,BUENOS AIRES,352,365,506,439,945
06,06861,068612504,Vicente López,BUENOS AIRES,206,192,352,385,737
06,06861,068612509,Vicente López,BUENOS AIRES,360,387,553,494,1047
06,06861,068612703,Vicente López,BUENOS AIRES,280,323,426,398,824
06,06861,068612807,Vicente López,BUENOS AIRES,268,325,386,340,726
06,06861,068612908,Vicente López,BUENOS AIRES,502,482,898,930,1828
06,06861,068612909,Vicente López,BUENOS AIRES,183,333,389,409,798
06,06861,068613004,Vicente López,BUENOS AIRES,492,407,972,884,1856
06,06861,068613006,Vicente López,BUENOS AIRES,259,254,488,436,924
06,06861,068613011,Vicente López,BUENOS AIRES,283,286,430,359,789
06,06861,068613101,Vicente López,BUENOS AIRES,442,512,646,600,1246
06,06861,068613109,Vicente López,BUENOS AIRES,320,331,502,524,1026
06,06861,068613201,Vicente López,BUENOS AIRES,213,257,286,239,525
06,06861,068613207,Vicente López,BUENOS AIRES,383,445,544,516,1060
06,06861,068613209,Vicente López,BUENOS AIRES,203,259,239,249,488
06,06861,068613210,Vicente López,BUENOS AIRES,364,454,485,445,930
06,06861,068613302,Vicente López,BUENOS AIRES,350,432,491,450,941
06,06861,068610202,Vicente López,BUENOS AIRES,211,301,309,282,591
06,06861,068610212,Vicente López,BUENOS AIRES,234,308,305,223,528
06,06861,068610302,Vicente López,BUENOS AIRES,233,249,332,265,597
06,06861,068610309,Vicente López,BUENOS AIRES,179,236,205,137,342
06,06861,068610407,Vicente López,BUENOS AIRES,353,391,463,372,835
06,06861,068610504,Vicente López,BUENOS AIRES,264,329,384,322,706
06,06861,068610505,Vicente López,BUENOS AIRES,232,305,340,291,631
06,06861,068610508,Vicente López,BUENOS AIRES,338,388,550,473,1023
06,06861,068610509,Vicente López,BUENOS AIRES,325,408,380,285,665
06,06861,068610701,Vicente López,BUENOS AIRES,259,287,427,356,783
06,06861,068610708,Vicente López,BUENOS AIRES,285,348,367,313,680
06,06861,068610807,Vicente López,BUENOS AIRES,213,242,258,211,469
06,06861,068610809,Vicente López,BUENOS AIRES,164,198,230,198,428
06,06861,068610904,Vicente López,BUENOS AIRES,239,242,335,296,631
06,06861,068611308,Vicente López,BUENOS AIRES,228,258,349,311,660
06,06861,068611309,Vicente López,BUENOS AIRES,309,339,483,463,946
06,06861,068611402,Vicente López,BUENOS AIRES,232,317,284,220,504
06,06861,068611408,Vicente López,BUENOS AIRES,261,326,388,345,733
06,06861,068611609,Vicente López,BUENOS AIRES,364,413,559,503,1062
06,06861,068611703,Vicente López,BUENOS AIRES,259,295,412,334,746
06,06861,068611804,Vicente López,BUENOS AIRES,263,297,388,315,703
06,06861,068611904,Vicente López,BUENOS AIRES,314,322,459,360,819
06,06861,068611905,Vicente López,BUENOS AIRES,341,384,534,433,967
06,06861,068612003,Vicente López,BUENOS AIRES,359,430,500,408,908
06,06861,068612005,Vicente López,BUENOS AIRES,358,443,486,372,858
06,06861,068612008,Vicente López,BUENOS AIRES,246,372,340,261,601
06,06861,068612205,Vicente López,BUENOS AIRES,350,391,505,471,976
06,06861,068612212,Vicente López,BUENOS AIRES,187,219,294,278,572
06,06861,068612302,Vicente López,BUENOS AIRES,398,401,625,540,1165
06,06861,068612304,Vicente López,BUENOS AIRES,310,235,602,567,1169
06,06861,068612309,Vicente López,BUENOS AIRES,245,249,399,388,787
06,06861,068612507,Vicente López,BUENOS AIRES,316,331,423,408,831
06,06861,068612602,Vicente López,BUENOS AIRES,292,334,442,383,825
06,06861,068612604,Vicente López,BUENOS AIRES,311,354,452,395,847
06,06861,068612609,Vicente López,BUENOS AIRES,328,361,472,452,924
06,06861,068612702,Vicente López,BUENOS AIRES,311,351,446,384,830
06,06861,068612801,Vicente López,BUENOS AIRES,191,236,264,215,479
06,06861,068612809,Vicente López,BUENOS AIRES,253,288,403,320,723
06,06861,068613002,Vicente López,BUENOS AIRES,291,263,572,542,1114
06,06861,068613012,Vicente López,BUENOS AIRES,349,384,517,460,977
06,06861,068613203,Vicente López,BUENOS AIRES,79,97,97,87,184
06,06861,068613206,Vicente López,BUENOS AIRES,249,280,334,351,685
06,06861,068613306,Vicente López,BUENOS AIRES,273,349,378,287,665
06,06861,068610305,Vicente López,BUENOS AIRES,280,310,319,236,555
06,06861,068610105,Vicente López,BUENOS AIRES,314,379,416,367,783
06,06861,068610208,Vicente López,BUENOS AIRES,139,229,127,174,301
06,06861,068610303,Vicente López,BUENOS AIRES,323,353,448,336,784
06,06861,068610603,Vicente López,BUENOS AIRES,257,303,387,348,735
06,06861,068610607,Vicente López,BUENOS AIRES,296,336,298,254,552
06,06861,068610707,Vicente López,BUENOS AIRES,275,361,380,304,684
06,06861,068612810,Vicente López,BUENOS AIRES,298,319,452,366,818
06,06861,068610806,Vicente López,BUENOS AIRES,234,279,319,289,608
06,06861,068610810,Vicente López,BUENOS AIRES,277,296,422,421,843
06,06861,068610902,Vicente López,BUENOS AIRES,227,312,244,212,456
06,06861,068610905,Vicente López,BUENOS AIRES,397,460,565,503,1068
06,06861,068610907,Vicente López,BUENOS AIRES,322,352,452,389,841
06,06861,068610908,Vicente López,BUENOS AIRES,274,363,352,249,601
06,06861,068611002,Vicente López,BUENOS AIRES,409,496,531,552,1083
06,06861,068611206,Vicente López,BUENOS AIRES,252,284,363,314,677
06,06861,068611405,Vicente López,BUENOS AIRES,206,231,311,232,543
06,06861,068611409,Vicente López,BUENOS AIRES,355,425,556,401,957
06,06861,068611505,Vicente López,BUENOS AIRES,185,257,214,164,378
06,06861,068611801,Vicente López,BUENOS AIRES,388,421,552,509,1061
06,06861,068611803,Vicente López,BUENOS AIRES,302,326,488,396,884
06,06861,068612407,Vicente López,BUENOS AIRES,433,445,659,598,1257
06,06861,068611909,Vicente López,BUENOS AIRES,280,299,452,406,858
06,06861,068612101,Vicente López,BUENOS AIRES,331,371,539,469,1008
06,06861,068612103,Vicente López,BUENOS AIRES,318,379,449,412,861
06,06861,068612104,Vicente López,BUENOS AIRES,313,358,494,410,904
06,06861,068612106,Vicente López,BUENOS AIRES,360,400,557,462,1019
06,06861,068612607,Vicente López,BUENOS AIRES,346,402,463,435,898
06,06861,068612108,Vicente López,BUENOS AIRES,403,457,573,523,1096
06,06861,068612203,Vicente López,BUENOS AIRES,334,334,492,443,935
06,06861,068612307,Vicente López,BUENOS AIRES,401,418,640,634,1274
06,06861,068612405,Vicente López,BUENOS AIRES,380,369,580,560,1140
06,06861,068612505,Vicente López,BUENOS AIRES,290,313,475,437,912
06,06861,068612603,Vicente López,BUENOS AIRES,270,316,400,345,745
06,06861,068612704,Vicente López,BUENOS AIRES,243,278,367,325,692
06,06861,068612708,Vicente López,BUENOS AIRES,333,350,496,450,946
06,06861,068612803,Vicente López,BUENOS AIRES,238,273,369,316,685
06,06861,068613001,Vicente López,BUENOS AIRES,277,292,428,369,797
06,06861,068613005,Vicente López,BUENOS AIRES,250,221,493,426,919
06,06861,068613007,Vicente López,BUENOS AIRES,255,246,539,530,1069
06,06861,068613010,Vicente López,BUENOS AIRES,217,236,303,293,596
06,06861,068613103,Vicente López,BUENOS AIRES,362,386,531,450,981
06,06861,068613104,Vicente López,BUENOS AIRES,661,774,984,866,1850
06,06861,068613304,Vicente López,BUENOS AIRES,252,304,323,297,620
06,06861,068613309,Vicente López,BUENOS AIRES,364,436,529,437,966
06,06861,068610306,Vicente López,BUENOS AIRES,258,293,285,202,487
06,06861,068612308,Vicente López,BUENOS AIRES,234,271,325,325,650
06,06861,068610201,Vicente López,BUENOS AIRES,273,306,437,396,833
06,06861,068610203,Vicente López,BUENOS AIRES,143,203,214,159,373
06,06861,068610209,Vicente López,BUENOS AIRES,266,291,458,416,874
06,06861,068610310,Vicente López,BUENOS AIRES,233,343,285,181,466
06,06861,068610411,Vicente López,BUENOS AIRES,199,265,269,215,484
06,06861,068610703,Vicente López,BUENOS AIRES,286,396,293,228,521
06,06861,068610704,Vicente López,BUENOS AIRES,248,269,399,321,720
06,06861,068610801,Vicente López,BUENOS AIRES,341,465,395,338,733
06,06861,068610808,Vicente López,BUENOS AIRES,257,335,352,303,655
06,06861,068611103,Vicente López,BUENOS AIRES,300,343,402,398,800
06,06861,068611107,Vicente López,BUENOS AIRES,375,427,585,530,1115
06,06861,068611109,Vicente López,BUENOS AIRES,308,346,438,385,823
06,06861,068611201,Vicente López,BUENOS AIRES,265,347,342,318,660
06,06861,068611205,Vicente López,BUENOS AIRES,339,410,493,406,899
06,06861,068611207,Vicente López,BUENOS AIRES,309,367,461,436,897
06,06861,068611305,Vicente López,BUENOS AIRES,296,390,384,328,712
06,06861,068611406,Vicente López,BUENOS AIRES,189,234,267,226,493
06,06861,068611410,Vicente López,BUENOS AIRES,248,288,342,313,655
06,06861,068611503,Vicente López,BUENOS AIRES,392,472,566,418,984
06,06861,068611507,Vicente López,BUENOS AIRES,289,353,410,348,758
06,06861,068611607,Vicente López,BUENOS AIRES,318,359,472,422,894
06,06861,068611608,Vicente López,BUENOS AIRES,266,308,378,390,768
06,06861,068611914,Vicente López,BUENOS AIRES,239,255,404,358,762
06,06861,068612107,Vicente López,BUENOS AIRES,338,369,513,452,965
06,06861,068612207,Vicente López,BUENOS AIRES,332,366,536,462,998
06,06861,068612306,Vicente López,BUENOS AIRES,162,172,246,242,488
06,06861,068612409,Vicente López,BUENOS AIRES,333,373,499,420,919
06,06861,068612701,Vicente López,BUENOS AIRES,367,424,512,418,930
06,06861,068612705,Vicente López,BUENOS AIRES,242,266,376,345,721
06,06861,068612707,Vicente López,BUENOS AIRES,346,408,467,448,915
06,06861,068612710,Vicente López,BUENOS AIRES,287,278,434,399,833
06,06861,068612907,Vicente López,BUENOS AIRES,262,193,437,409,846
06,06861,068613105,Vicente López,BUENOS AIRES,237,263,365,324,689
06,06861,068613202,Vicente López,BUENOS AIRES,404,485,564,448,1012
06,06861,068613303,Vicente López,BUENOS AIRES,371,481,523,422,945
06,06861,068611509,Vicente López,BUENOS AIRES,255,314,310,204,514
06,06861,068611915,Vicente López,BUENOS AIRES,199,256,263,275,538
06,06861,068613307,Vicente López,BUENOS AIRES,322,384,474,382,856
06,06861,068610104,Vicente López,BUENOS AIRES,308,394,421,339,760
06,06861,068610111,Vicente López,BUENOS AIRES,200,239,269,237,506
06,06861,068610207,Vicente López,BUENOS AIRES,202,248,308,249,557
06,06861,068610311,Vicente López,BUENOS AIRES,324,406,370,250,620
06,06861,068610402,Vicente López,BUENOS AIRES,270,383,252,248,500
06,06861,068610403,Vicente López,BUENOS AIRES,282,356,287,230,517
06,06861,068610405,Vicente López,BUENOS AIRES,267,395,299,240,539
06,06861,068610604,Vicente López,BUENOS AIRES,274,368,305,252,557
06,06861,068610609,Vicente López,BUENOS AIRES,273,392,342,239,581
06,06861,068610610,Vicente López,BUENOS AIRES,393,464,502,410,912
06,06861,068610709,Vicente López,BUENOS AIRES,270,329,477,371,848
06,06861,068610811,Vicente López,BUENOS AIRES,233,344,254,240,494
06,06861,068610906,Vicente López,BUENOS AIRES,335,373,466,404,870
06,06861,068610911,Vicente López,BUENOS AIRES,400,455,580,570,1150
06,06861,068611001,Vicente López,BUENOS AIRES,338,389,509,454,963
06,06861,068611007,Vicente López,BUENOS AIRES,333,379,430,426,856
06,06861,068611010,Vicente López,BUENOS AIRES,304,334,442,402,844
06,06861,068611105,Vicente López,BUENOS AIRES,207,228,319,293,612
06,06861,068611203,Vicente López,BUENOS AIRES,190,226,274,228,502
06,06861,068611208,Vicente López,BUENOS AIRES,323,365,488,424,912
06,06861,068611303,Vicente López,BUENOS AIRES,241,301,296,248,544
06,06861,068611306,Vicente López,BUENOS AIRES,327,373,506,441,947
06,06861,068611403,Vicente López,BUENOS AIRES,249,298,338,283,621
06,06861,068611411,Vicente López,BUENOS AIRES,146,178,182,158,340
06,06861,068611502,Vicente López,BUENOS AIRES,315,413,342,245,587
06,06861,068611504,Vicente López,BUENOS AIRES,96,106,124,110,234
06,06861,068611603,Vicente López,BUENOS AIRES,269,308,405,361,766
06,06861,068611610,Vicente López,BUENOS AIRES,321,382,465,447,912
06,06861,068611704,Vicente López,BUENOS AIRES,228,265,333,301,634
06,06861,068611709,Vicente López,BUENOS AIRES,327,377,460,435,895
06,06861,068611806,Vicente López,BUENOS AIRES,348,392,528,446,974
06,06861,068611807,Vicente López,BUENOS AIRES,309,353,463,406,869
06,06861,068611809,Vicente López,BUENOS AIRES,322,371,453,460,913
06,06861,068611810,Vicente López,BUENOS AIRES,371,419,554,473,1027
06,06861,068611901,Vicente López,BUENOS AIRES,298,337,423,364,787
06,06861,068611908,Vicente López,BUENOS AIRES,259,291,411,359,770
06,06861,068612102,Vicente López,BUENOS AIRES,276,308,428,357,785
06,06861,068612208,Vicente López,BUENOS AIRES,375,419,564,474,1038
06,06861,068612210,Vicente López,BUENOS AIRES,216,238,361,301,662
06,06861,068612211,Vicente López,BUENOS AIRES,207,236,323,273,596
06,06861,068612406,Vicente López,BUENOS AIRES,281,303,426,370,796
06,06861,068612605,Vicente López,BUENOS AIRES,302,334,467,404,871
06,06861,068612904,Vicente López,BUENOS AIRES,265,263,401,348,749
06,06861,068612911,Vicente López,BUENOS AIRES,252,284,360,355,715
06,06861,068613003,Vicente López,BUENOS AIRES,393,329,688,626,1314
06,06861,068613008,Vicente López,BUENOS AIRES,68,72,112,104,216
06,06861,068613102,Vicente López,BUENOS AIRES,609,653,848,707,1555
06,06861,068613108,Vicente López,BUENOS AIRES,399,416,668,604,1272
06,06861,068613110,Vicente López,BUENOS AIRES,410,423,620,580,1200
06,06861,068613301,Vicente López,BUENOS AIRES,343,424,485,423,908
06,06861,068613308,Vicente López,BUENOS AIRES,329,420,467,372,839
06,06861,068612402,Vicente López,BUENOS AIRES,394,400,627,537,1164
06,06861,068610101,Vicente López,BUENOS AIRES,243,297,363,336,699
06,06861,068610103,Vicente López,BUENOS AIRES,250,320,307,282,589
06,06861,068610108,Vicente López,BUENOS AIRES,261,302,409,336,745
06,06861,068610406,Vicente López,BUENOS AIRES,284,358,343,295,638
06,06861,068610408,Vicente López,BUENOS AIRES,214,280,219,193,412
06,06861,068610501,Vicente López,BUENOS AIRES,252,336,334,271,605
06,06861,068610506,Vicente López,BUENOS AIRES,0,1,0,0,0
06,06861,068610702,Vicente López,BUENOS AIRES,250,334,292,209,501
06,06861,068610705,Vicente López,BUENOS AIRES,310,372,413,338,751
06,06861,068610802,Vicente López,BUENOS AIRES,306,359,439,347,786
06,06861,068610804,Vicente López,BUENOS AIRES,288,297,443,368,811
06,06861,068610909,Vicente López,BUENOS AIRES,126,198,165,142,307
06,06861,068610910,Vicente López,BUENOS AIRES,277,328,367,312,679
06,06861,068611008,Vicente López,BUENOS AIRES,337,391,493,433,926
06,06861,068611009,Vicente López,BUENOS AIRES,280,315,410,370,780
06,06861,068611102,Vicente López,BUENOS AIRES,243,256,385,354,739
06,06861,068611202,Vicente López,BUENOS AIRES,264,308,378,358,736
06,06861,068611204,Vicente López,BUENOS AIRES,189,212,281,265,546
06,06861,068611209,Vicente López,BUENOS AIRES,281,315,449,401,850
06,06861,068611407,Vicente López,BUENOS AIRES,322,394,476,392,868
06,06861,068611510,Vicente López,BUENOS AIRES,322,391,515,505,1020
06,06861,068611705,Vicente López,BUENOS AIRES,254,284,373,361,734
06,06861,068611913,Vicente López,BUENOS AIRES,267,291,347,295,642
06,06861,068612007,Vicente López,BUENOS AIRES,306,352,435,355,790
06,06861,068612109,Vicente López,BUENOS AIRES,284,339,411,353,764
06,06861,068612202,Vicente López,BUENOS AIRES,332,360,517,458,975
06,06861,068612403,Vicente López,BUENOS AIRES,251,278,387,353,740
06,06861,068612404,Vicente López,BUENOS AIRES,237,258,380,320,700
06,06861,068612501,Vicente López,BUENOS AIRES,230,251,353,311,664
06,06861,068612601,Vicente López,BUENOS AIRES,396,456,605,496,1101
06,06861,068612608,Vicente López,BUENOS AIRES,412,448,608,572,1180
06,06861,068612706,Vicente López,BUENOS AIRES,292,324,430,407,837
06,06861,068612903,Vicente López,BUENOS AIRES,349,367,497,458,955
06,06861,068613009,Vicente López,BUENOS AIRES,453,403,790,690,1480
06,06861,068613305,Vicente López,BUENOS AIRES,357,420,484,442,926
06,06217,062170903,Chascomús,BUENOS AIRES,24,40,25,44,69
06,06217,062171211,Chascomús,BUENOS AIRES,195,231,301,286,587
06,06217,062170105,Chascomús,BUENOS AIRES,302,339,451,405,856
06,06217,062170106,Chascomús,BUENOS AIRES,171,252,252,215,467
06,06217,062170110,Chascomús,BUENOS AIRES,237,299,325,281,606
06,06217,062170413,Chascomús,BUENOS AIRES,418,458,722,772,1494
06,06217,062171206,Chascomús,BUENOS AIRES,249,294,340,311,651
06,06217,062170905,Chascomús,BUENOS AIRES,11,18,19,15,34
06,06217,062170202,Chascomús,BUENOS AIRES,24,32,26,32,58
06,06217,062170901,Chascomús,BUENOS AIRES,18,35,25,29,54
06,06217,062170904,Chascomús,BUENOS AIRES,24,27,35,37,72
06,06217,062170907,Chascomús,BUENOS AIRES,18,29,24,31,55
06,06217,062171010,Chascomús,BUENOS AIRES,74,110,88,119,207
06,06217,062170416,Chascomús,BUENOS AIRES,255,286,407,391,798
06,06217,062170504,Chascomús,BUENOS AIRES,5,21,5,4,9
06,06217,062171212,Chascomús,BUENOS AIRES,299,357,561,534,1095
06,06217,062171214,Chascomús,BUENOS AIRES,178,251,261,226,487
06,06217,062171205,Chascomús,BUENOS AIRES,325,355,528,513,1041
06,06217,062171210,Chascomús,BUENOS AIRES,432,505,719,639,1358
06,06217,062171102,Chascomús,BUENOS AIRES,18,32,20,25,45
06,06217,062170301,Chascomús,BUENOS AIRES,48,68,78,81,159
06,06217,062170506,Chascomús,BUENOS AIRES,15,30,16,20,36
06,06217,062170803,Chascomús,BUENOS AIRES,22,39,37,37,74
06,06217,062171101,Chascomús,BUENOS AIRES,57,92,53,94,147
06,06217,062171104,Chascomús,BUENOS AIRES,9,20,11,17,28
06,06217,062171201,Chascomús,BUENOS AIRES,245,350,386,405,791
06,06217,062170505,Chascomús,BUENOS AIRES,56,173,56,75,131
06,06217,062170102,Chascomús,BUENOS AIRES,302,371,461,371,832
06,06217,062170101,Chascomús,BUENOS AIRES,285,343,395,357,752
06,06217,062170103,Chascomús,BUENOS AIRES,254,314,368,346,714
06,06217,062170303,Chascomús,BUENOS AIRES,79,96,138,149,287
06,06217,062170406,Chascomús,BUENOS AIRES,83,167,124,130,254
06,06217,062170501,Chascomús,BUENOS AIRES,11,35,11,18,29
06,06217,062170503,Chascomús,BUENOS AIRES,6,28,6,8,14
06,06217,062170510,Chascomús,BUENOS AIRES,7,26,14,13,27
06,06217,062170201,Chascomús,BUENOS AIRES,30,75,39,54,93
06,06217,062170304,Chascomús,BUENOS AIRES,37,84,45,58,103
06,06217,062170702,Chascomús,BUENOS AIRES,12,22,8,20,28
06,06217,062171005,Chascomús,BUENOS AIRES,18,32,18,28,46
06,06217,062170509,Chascomús,BUENOS AIRES,4,19,6,8,14
06,06217,062170108,Chascomús,BUENOS AIRES,218,282,327,257,584
06,06217,062170111,Chascomús,BUENOS AIRES,214,277,294,268,562
06,06217,062170403,Chascomús,BUENOS AIRES,125,176,216,214,430
06,06217,062170407,Chascomús,BUENOS AIRES,90,170,138,139,277
06,06217,062170410,Chascomús,BUENOS AIRES,223,249,384,326,710
06,06217,062171003,Chascomús,BUENOS AIRES,377,429,550,519,1069
06,06217,062171013,Chascomús,BUENOS AIRES,223,267,339,311,650
06,06217,062171202,Chascomús,BUENOS AIRES,592,596,1210,1057,2267
06,06217,062171208,Chascomús,BUENOS AIRES,257,283,366,332,698
06,06217,062171209,Chascomús,BUENOS AIRES,226,248,322,329,651
06,06217,062171215,Chascomús,BUENOS AIRES,216,318,340,328,668
06,06217,062170603,Chascomús,BUENOS AIRES,9,28,14,11,25
06,06217,062170207,Chascomús,BUENOS AIRES,15,30,16,32,48
06,06217,062170507,Chascomús,BUENOS AIRES,20,32,29,33,62
06,06217,062170404,Chascomús,BUENOS AIRES,169,194,244,268,512
06,06217,062170109,Chascomús,BUENOS AIRES,256,330,355,310,665
06,06217,062170114,Chascomús,BUENOS AIRES,147,207,193,180,373
06,06217,062170412,Chascomús,BUENOS AIRES,194,230,369,356,725
06,06217,062171001,Chascomús,BUENOS AIRES,263,299,377,392,769
06,06217,062171203,Chascomús,BUENOS AIRES,300,335,483,445,928
06,06217,062171011,Chascomús,BUENOS AIRES,77,114,123,120,243
06,06217,062170511,Chascomús,BUENOS AIRES,12,14,17,21,38
06,06217,062170604,Chascomús,BUENOS AIRES,22,50,24,42,66
06,06217,062170801,Chascomús,BUENOS AIRES,27,54,38,47,85
06,06217,062170902,Chascomús,BUENOS AIRES,31,33,33,51,84
06,06217,062170906,Chascomús,BUENOS AIRES,20,22,26,30,56
06,06217,062171006,Chascomús,BUENOS AIRES,22,33,37,33,70
06,06217,062171009,Chascomús,BUENOS AIRES,22,53,29,38,67
06,06217,062170104,Chascomús,BUENOS AIRES,331,374,501,458,959
06,06217,062170302,Chascomús,BUENOS AIRES,49,65,91,101,192
06,06217,062170402,Chascomús,BUENOS AIRES,199,211,359,422,781
06,06217,062170408,Chascomús,BUENOS AIRES,94,199,138,172,310
06,06217,062170411,Chascomús,BUENOS AIRES,220,249,348,378,726
06,06217,062171213,Chascomús,BUENOS AIRES,271,348,473,420,893
06,06217,062171204,Chascomús,BUENOS AIRES,215,217,402,397,799
06,06217,062170206,Chascomús,BUENOS AIRES,15,15,20,16,36
06,06217,062170203,Chascomús,BUENOS AIRES,9,26,20,16,36
06,06217,062170205,Chascomús,BUENOS AIRES,21,54,34,33,67
06,06217,062170512,Chascomús,BUENOS AIRES,6,10,9,14,23
06,06217,062170601,Chascomús,BUENOS AIRES,9,49,5,9,14
06,06217,062170602,Chascomús,BUENOS AIRES,6,17,9,11,20
06,06217,062170605,Chascomús,BUENOS AIRES,17,81,20,23,43
06,06217,062171007,Chascomús,BUENOS AIRES,18,26,16,29,45
06,06217,062171012,Chascomús,BUENOS AIRES,11,38,6,15,21
06,06217,062171103,Chascomús,BUENOS AIRES,20,39,26,28,54
06,06217,062170107,Chascomús,BUENOS AIRES,285,375,401,322,723
06,06217,062170112,Chascomús,BUENOS AIRES,266,328,356,315,671
06,06217,062170113,Chascomús,BUENOS AIRES,404,475,613,548,1161
06,06217,062170405,Chascomús,BUENOS AIRES,101,152,184,188,372
06,06217,062170414,Chascomús,BUENOS AIRES,432,441,689,681,1370
06,06217,062170502,Chascomús,BUENOS AIRES,3,27,5,4,9
06,06217,062171004,Chascomús,BUENOS AIRES,295,353,460,393,853
06,06217,062171207,Chascomús,BUENOS AIRES,235,267,353,297,650
06,06217,062170701,Chascomús,BUENOS AIRES,8,13,10,12,22
06,06217,062170508,Chascomús,BUENOS AIRES,19,37,23,25,48
06,06217,062170802,Chascomús,BUENOS AIRES,21,38,29,32,61
06,06217,062171105,Chascomús,BUENOS AIRES,37,67,56,64,120
06,06217,062171106,Chascomús,BUENOS AIRES,13,27,13,22,35
06,06217,062170409,Chascomús,BUENOS AIRES,175,262,292,302,594
06,06217,062170415,Chascomús,BUENOS AIRES,244,266,379,361,740
06,06217,062171002,Chascomús,BUENOS AIRES,440,458,674,632,1306
06,06217,062170204,Chascomús,BUENOS AIRES,23,41,26,32,58
06,06217,062170401,Chascomús,BUENOS AIRES,146,193,210,214,424
06,06217,062171008,Chascomús,BUENOS AIRES,21,47,23,34,57
06,06049,060492002,Azul,BUENOS AIRES,357,381,544,504,1048
06,06049,060492501,Azul,BUENOS AIRES,272,302,470,509,979
06,06049,060490109,Azul,BUENOS AIRES,274,330,340,244,584
06,06049,060490208,Azul,BUENOS AIRES,304,354,446,369,815
06,06049,060490213,Azul,BUENOS AIRES,235,259,398,382,780
06,06049,060490406,Azul,BUENOS AIRES,154,171,243,240,483
06,06049,060490507,Azul,BUENOS AIRES,315,330,454,381,835
06,06049,060490604,Azul,BUENOS AIRES,289,311,413,351,764
06,06049,060490610,Azul,BUENOS AIRES,156,199,238,236,474
06,06049,060490701,Azul,BUENOS AIRES,4,14,10,6,16
06,06049,060491006,Azul,BUENOS AIRES,117,142,172,152,324
06,06049,060490301,Azul,BUENOS AIRES,54,73,60,68,128
06,06049,060490302,Azul,BUENOS AIRES,31,42,35,40,75
06,06049,060491801,Azul,BUENOS AIRES,92,130,91,164,255
06,06049,060492005,Azul,BUENOS AIRES,16,36,27,25,52
06,06049,060490206,Azul,BUENOS AIRES,301,343,420,358,778
06,06049,060490209,Azul,BUENOS AIRES,318,334,505,453,958
06,06049,060490403,Azul,BUENOS AIRES,92,130,155,141,296
06,06049,060490405,Azul,BUENOS AIRES,142,161,215,245,460
06,06049,060490505,Azul,BUENOS AIRES,329,372,447,412,859
06,06049,060490613,Azul,BUENOS AIRES,423,480,764,724,1488
06,06049,060491004,Azul,BUENOS AIRES,111,147,139,141,280
06,06049,060491005,Azul,BUENOS AIRES,97,114,182,141,323
06,06049,060491008,Azul,BUENOS AIRES,177,218,261,246,507
06,06049,060492505,Azul,BUENOS AIRES,240,225,498,508,1006
06,06049,060490702,Azul,BUENOS AIRES,35,38,41,50,91
06,06049,060492301,Azul,BUENOS AIRES,64,88,70,91,161
06,06049,060490104,Azul,BUENOS AIRES,291,416,371,278,649
06,06049,060490105,Azul,BUENOS AIRES,265,406,351,266,617
06,06049,060490108,Azul,BUENOS AIRES,299,398,421,331,752
06,06049,060490114,Azul,BUENOS AIRES,255,277,437,435,872
06,06049,060490202,Azul,BUENOS AIRES,283,335,415,322,737
06,06049,060490204,Azul,BUENOS AIRES,365,389,549,511,1060
06,06049,060490602,Azul,BUENOS AIRES,212,148,434,379,813
06,06049,060491007,Azul,BUENOS AIRES,115,143,186,191,377
06,06049,060490901,Azul,BUENOS AIRES,31,61,33,58,91
06,06049,060491009,Azul,BUENOS AIRES,57,67,78,84,162
06,06049,060491402,Azul,BUENOS AIRES,21,36,21,30,51
06,06049,060491601,Azul,BUENOS AIRES,32,61,45,52,97
06,06049,060490211,Azul,BUENOS AIRES,279,304,439,412,851
06,06049,060490506,Azul,BUENOS AIRES,282,337,373,303,676
06,06049,060490606,Azul,BUENOS AIRES,373,406,556,452,1008
06,06049,060490615,Azul,BUENOS AIRES,142,163,239,254,493
06,06049,060492001,Azul,BUENOS AIRES,391,419,532,485,1017
06,06049,060492507,Azul,BUENOS AIRES,437,490,689,636,1325
06,06049,060490401,Azul,BUENOS AIRES,128,232,173,199,372
06,06049,060491501,Azul,BUENOS AIRES,35,57,29,62,91
06,06049,060492102,Azul,BUENOS AIRES,48,79,64,105,169
06,06049,060492401,Azul,BUENOS AIRES,19,35,21,35,56
06,06049,060490210,Azul,BUENOS AIRES,217,222,354,377,731
06,06049,060490608,Azul,BUENOS AIRES,420,455,693,664,1357
06,06049,060491001,Azul,BUENOS AIRES,116,158,158,165,323
06,06049,060492003,Azul,BUENOS AIRES,35,64,48,63,111
06,06049,060492503,Azul,BUENOS AIRES,225,281,283,300,583
06,06049,060492502,Azul,BUENOS AIRES,431,436,845,799,1644
06,06049,060492509,Azul,BUENOS AIRES,415,420,704,684,1388
06,06049,060490801,Azul,BUENOS AIRES,20,31,21,32,53
06,06049,060492004,Azul,BUENOS AIRES,34,81,34,51,85
06,06049,060492006,Azul,BUENOS AIRES,189,247,263,270,533
06,06049,060490201,Azul,BUENOS AIRES,258,329,368,286,654
06,06049,060490501,Azul,BUENOS AIRES,261,316,353,293,646
06,06049,060491002,Azul,BUENOS AIRES,124,159,159,150,309
06,06049,060490102,Azul,BUENOS AIRES,210,254,273,210,483
06,06049,060490103,Azul,BUENOS AIRES,259,355,362,308,670
06,06049,060490106,Azul,BUENOS AIRES,246,346,297,254,551
06,06049,060490113,Azul,BUENOS AIRES,241,285,396,311,707
06,06049,060490116,Azul,BUENOS AIRES,189,187,344,320,664
06,06049,060490404,Azul,BUENOS AIRES,103,145,130,156,286
06,06049,060490609,Azul,BUENOS AIRES,318,326,513,501,1014
06,06049,060492508,Azul,BUENOS AIRES,387,420,565,532,1097
06,06049,060492510,Azul,BUENOS AIRES,292,312,557,502,1059
06,06049,060492101,Azul,BUENOS AIRES,46,54,52,81,133
06,06049,060490407,Azul,BUENOS AIRES,176,235,286,335,621
06,06049,060490612,Azul,BUENOS AIRES,303,323,543,498,1041
06,06049,060490107,Azul,BUENOS AIRES,268,338,422,291,713
06,06049,060490110,Azul,BUENOS AIRES,289,298,456,442,898
06,06049,060490115,Azul,BUENOS AIRES,188,203,359,344,703
06,06049,060490203,Azul,BUENOS AIRES,284,324,370,331,701
06,06049,060490207,Azul,BUENOS AIRES,248,307,357,286,643
06,06049,060490212,Azul,BUENOS AIRES,297,320,501,478,979
06,06049,060490502,Azul,BUENOS AIRES,238,311,317,256,573
06,06049,060490603,Azul,BUENOS AIRES,400,398,614,587,1201
06,06049,060492007,Azul,BUENOS AIRES,202,246,290,253,543
06,06049,060492504,Azul,BUENOS AIRES,276,314,476,549,1025
06,06049,060491102,Azul,BUENOS AIRES,42,75,41,60,101
06,06049,060491301,Azul,BUENOS AIRES,38,82,33,56,89
06,06049,060491401,Azul,BUENOS AIRES,18,41,19,27,46
06,06049,060490402,Azul,BUENOS AIRES,89,144,140,157,297
06,06049,060490101,Azul,BUENOS AIRES,219,259,351,267,618
06,06049,060490111,Azul,BUENOS AIRES,253,271,402,405,807
06,06049,060490112,Azul,BUENOS AIRES,163,175,253,249,502
06,06049,060490205,Azul,BUENOS AIRES,360,370,688,656,1344
06,06049,060490503,Azul,BUENOS AIRES,236,289,312,268,580
06,06049,060490504,Azul,BUENOS AIRES,414,461,625,572,1197
06,06049,060490508,Azul,BUENOS AIRES,382,440,585,523,1108
06,06049,060490601,Azul,BUENOS AIRES,317,315,447,400,847
06,06049,060490605,Azul,BUENOS AIRES,268,300,383,327,710
06,06049,060490607,Azul,BUENOS AIRES,345,380,508,518,1026
06,06049,060490611,Azul,BUENOS AIRES,335,360,599,607,1206
06,06049,060490614,Azul,BUENOS AIRES,291,320,492,488,980
06,06049,060491003,Azul,BUENOS AIRES,188,226,266,251,517
06,06049,060492506,Azul,BUENOS AIRES,249,306,367,369,736
06,06049,060491101,Azul,BUENOS AIRES,32,61,41,40,81
06,06049,060491201,Azul,BUENOS AIRES,42,57,43,63,106
06,06049,060491701,Azul,BUENOS AIRES,40,56,40,61,101
06,06049,060491901,Azul,BUENOS AIRES,56,103,60,100,160
06,06049,060492201,Azul,BUENOS AIRES,79,129,80,164,244
06,06091,060910205,Berazategui,BUENOS AIRES,269,337,380,349,729
06,06091,060910206,Berazategui,BUENOS AIRES,202,230,335,258,593
06,06091,060912206,Berazategui,BUENOS AIRES,414,462,816,805,1621
06,06091,060910302,Berazategui,BUENOS AIRES,414,431,754,694,1448
06,06091,060910102,Berazategui,BUENOS AIRES,433,413,879,856,1735
06,06091,060910105,Berazategui,BUENOS AIRES,233,247,376,351,727
06,06091,060910107,Berazategui,BUENOS AIRES,391,395,643,582,1225
06,06091,060910201,Berazategui,BUENOS AIRES,375,426,601,615,1216
06,06091,060910405,Berazategui,BUENOS AIRES,465,508,785,722,1507
06,06091,060910406,Berazategui,BUENOS AIRES,402,387,845,831,1676
06,06091,060910505,Berazategui,BUENOS AIRES,407,438,615,553,1168
06,06091,060910508,Berazategui,BUENOS AIRES,223,226,416,445,861
06,06091,060910602,Berazategui,BUENOS AIRES,318,319,512,438,950
06,06091,060910806,Berazategui,BUENOS AIRES,299,293,516,488,1004
06,06091,060910903,Berazategui,BUENOS AIRES,418,438,687,652,1339
06,06091,060911011,Berazategui,BUENOS AIRES,419,455,753,738,1491
06,06091,060911101,Berazategui,BUENOS AIRES,454,432,691,631,1322
06,06091,060911204,Berazategui,BUENOS AIRES,381,394,606,612,1218
06,06091,060911401,Berazategui,BUENOS AIRES,480,374,1072,941,2013
06,06091,060911403,Berazategui,BUENOS AIRES,277,285,562,485,1047
06,06091,060911413,Berazategui,BUENOS AIRES,290,293,553,533,1086
06,06091,060911503,Berazategui,BUENOS AIRES,299,317,491,472,963
06,06091,060911507,Berazategui,BUENOS AIRES,245,246,439,395,834
06,06091,060911509,Berazategui,BUENOS AIRES,238,260,383,329,712
06,06091,060911609,Berazategui,BUENOS AIRES,258,260,448,432,880
06,06091,060911702,Berazategui,BUENOS AIRES,434,412,772,737,1509
06,06091,060911811,Berazategui,BUENOS AIRES,485,480,841,829,1670
06,06091,060911902,Berazategui,BUENOS AIRES,440,430,768,786,1554
06,06091,060911910,Berazategui,BUENOS AIRES,302,309,522,512,1034
06,06091,060912002,Berazategui,BUENOS AIRES,370,373,709,693,1402
06,06091,060912007,Berazategui,BUENOS AIRES,356,426,547,564,1111
06,06091,060912008,Berazategui,BUENOS AIRES,215,253,338,301,639
06,06091,060912009,Berazategui,BUENOS AIRES,228,271,410,403,813
06,06091,060912106,Berazategui,BUENOS AIRES,254,232,496,506,1002
06,06091,060912108,Berazategui,BUENOS AIRES,243,248,448,392,840
06,06091,060912109,Berazategui,BUENOS AIRES,291,348,439,342,781
06,06091,060912216,Berazategui,BUENOS AIRES,415,436,769,769,1538
06,06091,060912217,Berazategui,BUENOS AIRES,211,328,378,385,763
06,06091,060912406,Berazategui,BUENOS AIRES,285,342,455,439,894
06,06091,060912410,Berazategui,BUENOS AIRES,241,333,441,405,846
06,06091,060911607,Berazategui,BUENOS AIRES,174,201,289,267,556
06,06091,060912403,Berazategui,BUENOS AIRES,273,298,569,558,1127
06,06091,060910305,Berazategui,BUENOS AIRES,236,245,394,356,750
06,06091,060910307,Berazategui,BUENOS AIRES,403,407,682,656,1338
06,06091,060910104,Berazategui,BUENOS AIRES,255,282,360,303,663
06,06091,060910109,Berazategui,BUENOS AIRES,449,464,677,659,1336
06,06091,060910202,Berazategui,BUENOS AIRES,297,330,488,471,959
06,06091,060910204,Berazategui,BUENOS AIRES,327,408,437,365,802
06,06091,060910310,Berazategui,BUENOS AIRES,402,440,581,481,1062
06,06091,060910410,Berazategui,BUENOS AIRES,520,502,1003,1055,2058
06,06091,060910412,Berazategui,BUENOS AIRES,398,385,686,687,1373
06,06091,060910604,Berazategui,BUENOS AIRES,267,292,396,419,815
06,06091,060910608,Berazategui,BUENOS AIRES,473,471,944,929,1873
06,06091,060910704,Berazategui,BUENOS AIRES,305,308,531,518,1049
06,06091,060910707,Berazategui,BUENOS AIRES,424,427,784,802,1586
06,06091,060910802,Berazategui,BUENOS AIRES,213,209,305,298,603
06,06091,060910803,Berazategui,BUENOS AIRES,248,247,451,426,877
06,06091,060910804,Berazategui,BUENOS AIRES,308,277,587,529,1116
06,06091,060910805,Berazategui,BUENOS AIRES,244,257,424,392,816
06,06091,060910905,Berazategui,BUENOS AIRES,210,217,318,270,588
06,06091,060911004,Berazategui,BUENOS AIRES,242,255,388,328,716
06,06091,060911005,Berazategui,BUENOS AIRES,453,467,689,653,1342
06,06091,060911108,Berazategui,BUENOS AIRES,426,448,716,651,1367
06,06091,060911109,Berazategui,BUENOS AIRES,428,446,719,643,1362
06,06091,060911205,Berazategui,BUENOS AIRES,335,339,593,543,1136
06,06091,060911301,Berazategui,BUENOS AIRES,363,349,706,675,1381
06,06091,060911306,Berazategui,BUENOS AIRES,362,317,687,599,1286
06,06091,060911309,Berazategui,BUENOS AIRES,469,476,818,752,1570
06,06091,060911405,Berazategui,BUENOS AIRES,364,340,758,779,1537
06,06091,060911410,Berazategui,BUENOS AIRES,522,443,948,919,1867
06,06091,060911504,Berazategui,BUENOS AIRES,446,529,728,611,1339
06,06091,060911510,Berazategui,BUENOS AIRES,285,295,507,517,1024
06,06091,060911602,Berazategui,BUENOS AIRES,436,453,757,724,1481
06,06091,060911614,Berazategui,BUENOS AIRES,373,357,664,619,1283
06,06091,060911703,Berazategui,BUENOS AIRES,470,472,868,800,1668
06,06091,060911802,Berazategui,BUENOS AIRES,244,267,412,410,822
06,06091,060911804,Berazategui,BUENOS AIRES,414,465,748,640,1388
06,06091,060911807,Berazategui,BUENOS AIRES,417,433,759,715,1474
06,06091,060911907,Berazategui,BUENOS AIRES,236,260,389,311,700
06,06091,060911911,Berazategui,BUENOS AIRES,280,257,490,481,971
06,06091,060912010,Berazategui,BUENOS AIRES,317,301,591,588,1179
06,06091,060912011,Berazategui,BUENOS AIRES,373,443,637,562,1199
06,06091,060912116,Berazategui,BUENOS AIRES,314,310,677,661,1338
06,06091,060912202,Berazategui,BUENOS AIRES,317,351,536,497,1033
06,06091,060912210,Berazategui,BUENOS AIRES,493,479,935,893,1828
06,06091,060912301,Berazategui,BUENOS AIRES,266,288,500,479,979
06,06091,060912302,Berazategui,BUENOS AIRES,301,314,578,529,1107
06,06091,060912304,Berazategui,BUENOS AIRES,400,431,694,649,1343
06,06091,060912315,Berazategui,BUENOS AIRES,232,123,409,464,873
06,06091,060912401,Berazategui,BUENOS AIRES,204,209,347,361,708
06,06091,060912402,Berazategui,BUENOS AIRES,223,267,390,378,768
06,06091,060912408,Berazategui,BUENOS AIRES,136,207,208,220,428
06,06091,060911105,Berazategui,BUENOS AIRES,326,330,520,444,964
06,06091,060910103,Berazategui,BUENOS AIRES,226,249,327,298,625
06,06091,060910401,Berazategui,BUENOS AIRES,396,408,869,803,1672
06,06091,060910501,Berazategui,BUENOS AIRES,479,422,1059,986,2045
06,06091,060910503,Berazategui,BUENOS AIRES,449,459,838,874,1712
06,06091,060910601,Berazategui,BUENOS AIRES,343,303,639,592,1231
06,06091,060910705,Berazategui,BUENOS AIRES,268,263,445,482,927
06,06091,060910907,Berazategui,BUENOS AIRES,445,470,674,651,1325
06,06091,060911010,Berazategui,BUENOS AIRES,555,544,899,868,1767
06,06091,060911202,Berazategui,BUENOS AIRES,453,414,782,757,1539
06,06091,060911203,Berazategui,BUENOS AIRES,358,342,633,602,1235
06,06091,060911304,Berazategui,BUENOS AIRES,361,320,673,777,1450
06,06091,060911502,Berazategui,BUENOS AIRES,249,224,457,461,918
06,06091,060911505,Berazategui,BUENOS AIRES,299,294,524,467,991
06,06091,060911506,Berazategui,BUENOS AIRES,307,282,554,510,1064
06,06091,060911508,Berazategui,BUENOS AIRES,297,268,625,557,1182
06,06091,060911511,Berazategui,BUENOS AIRES,410,414,747,766,1513
06,06091,060911512,Berazategui,BUENOS AIRES,286,271,479,432,911
06,06091,060911601,Berazategui,BUENOS AIRES,382,373,674,626,1300
06,06091,060911709,Berazategui,BUENOS AIRES,379,361,719,678,1397
06,06091,060911710,Berazategui,BUENOS AIRES,369,365,677,634,1311
06,06091,060911801,Berazategui,BUENOS AIRES,236,246,457,473,930
06,06091,060911805,Berazategui,BUENOS AIRES,385,385,688,661,1349
06,06091,060911806,Berazategui,BUENOS AIRES,391,380,791,772,1563
06,06091,060912101,Berazategui,BUENOS AIRES,266,264,527,536,1063
06,06091,060912102,Berazategui,BUENOS AIRES,312,351,484,412,896
06,06091,060912213,Berazategui,BUENOS AIRES,254,334,487,476,963
06,06091,060912305,Berazategui,BUENOS AIRES,228,245,363,330,693
06,06091,060912310,Berazategui,BUENOS AIRES,455,445,811,804,1615
06,06091,060912317,Berazategui,BUENOS AIRES,147,232,251,248,499
06,06091,060912319,Berazategui,BUENOS AIRES,85,146,119,142,261
06,06091,060912411,Berazategui,BUENOS AIRES,250,429,447,487,934
06,06091,060910801,Berazategui,BUENOS AIRES,266,297,388,393,781
06,06091,060910306,Berazategui,BUENOS AIRES,422,439,709,667,1376
06,06091,060910106,Berazategui,BUENOS AIRES,224,232,354,350,704
06,06091,060910309,Berazategui,BUENOS AIRES,396,416,597,545,1142
06,06091,060910312,Berazategui,BUENOS AIRES,156,210,234,197,431
06,06091,060910402,Berazategui,BUENOS AIRES,353,330,717,678,1395
06,06091,060910403,Berazategui,BUENOS AIRES,447,451,834,808,1642
06,06091,060910404,Berazategui,BUENOS AIRES,459,462,920,917,1837
06,06091,060910408,Berazategui,BUENOS AIRES,223,232,382,327,709
06,06091,060910502,Berazategui,BUENOS AIRES,378,391,644,574,1218
06,06091,060910504,Berazategui,BUENOS AIRES,245,274,425,404,829
06,06091,060910509,Berazategui,BUENOS AIRES,160,153,292,295,587
06,06091,060910611,Berazategui,BUENOS AIRES,322,320,615,611,1226
06,06091,060910702,Berazategui,BUENOS AIRES,328,326,557,512,1069
06,06091,060910605,Berazategui,BUENOS AIRES,232,247,377,352,729
06,06091,060910606,Berazategui,BUENOS AIRES,307,314,588,583,1171
06,06091,060910906,Berazategui,BUENOS AIRES,360,339,546,523,1069
06,06091,060911002,Berazategui,BUENOS AIRES,209,207,335,278,613
06,06091,060911003,Berazategui,BUENOS AIRES,448,443,750,692,1442
06,06091,060911103,Berazategui,BUENOS AIRES,206,232,317,283,600
06,06091,060911107,Berazategui,BUENOS AIRES,406,433,620,563,1183
06,06091,060911409,Berazategui,BUENOS AIRES,261,268,468,462,930
06,06091,060911611,Berazategui,BUENOS AIRES,514,499,943,917,1860
06,06091,060911701,Berazategui,BUENOS AIRES,282,297,508,488,996
06,06091,060911808,Berazategui,BUENOS AIRES,343,355,589,530,1119
06,06091,060911904,Berazategui,BUENOS AIRES,382,382,858,747,1605
06,06091,060912103,Berazategui,BUENOS AIRES,275,283,481,526,1007
06,06091,060912104,Berazategui,BUENOS AIRES,262,273,406,373,779
06,06091,060912112,Berazategui,BUENOS AIRES,424,401,795,826,1621
06,06091,060912117,Berazategui,BUENOS AIRES,446,403,844,807,1651
06,06091,060912208,Berazategui,BUENOS AIRES,265,277,457,450,907
06,06091,060912214,Berazategui,BUENOS AIRES,175,260,294,301,595
06,06091,060912405,Berazategui,BUENOS AIRES,281,315,574,587,1161
06,06091,060911406,Berazategui,BUENOS AIRES,338,331,710,710,1420
06,06091,060910108,Berazategui,BUENOS AIRES,330,347,490,444,934
06,06091,060910208,Berazategui,BUENOS AIRES,372,422,566,474,1040
06,06091,060910311,Berazategui,BUENOS AIRES,307,349,415,362,777
06,06091,060910411,Berazategui,BUENOS AIRES,431,400,797,778,1575
06,06091,060910610,Berazategui,BUENOS AIRES,370,356,736,764,1500
06,06091,060910706,Berazategui,BUENOS AIRES,294,297,534,485,1019
06,06091,060910809,Berazategui,BUENOS AIRES,405,410,680,702,1382
06,06091,060910901,Berazategui,BUENOS AIRES,227,252,359,295,654
06,06091,060910904,Berazategui,BUENOS AIRES,422,440,705,631,1336
06,06091,060910908,Berazategui,BUENOS AIRES,224,223,360,304,664
06,06091,060911009,Berazategui,BUENOS AIRES,290,298,484,402,886
06,06091,060911302,Berazategui,BUENOS AIRES,327,273,625,600,1225
06,06091,060911305,Berazategui,BUENOS AIRES,418,430,821,802,1623
06,06091,060911311,Berazategui,BUENOS AIRES,270,266,472,481,953
06,06091,060911408,Berazategui,BUENOS AIRES,385,360,672,646,1318
06,06091,060911610,Berazategui,BUENOS AIRES,285,292,522,497,1019
06,06091,060911704,Berazategui,BUENOS AIRES,260,265,459,466,925
06,06091,060911708,Berazategui,BUENOS AIRES,250,233,538,490,1028
06,06091,060911905,Berazategui,BUENOS AIRES,208,236,359,319,678
06,06091,060911912,Berazategui,BUENOS AIRES,418,418,705,649,1354
06,06091,060912003,Berazategui,BUENOS AIRES,153,156,289,265,554
06,06091,060912013,Berazategui,BUENOS AIRES,229,241,439,434,873
06,06091,060912105,Berazategui,BUENOS AIRES,248,276,378,332,710
06,06091,060912203,Berazategui,BUENOS AIRES,370,387,670,585,1255
06,06091,060912205,Berazategui,BUENOS AIRES,265,354,534,493,1027
06,06091,060912312,Berazategui,BUENOS AIRES,193,203,347,343,690
06,06091,060912313,Berazategui,BUENOS AIRES,171,189,315,306,621
06,06091,060912314,Berazategui,BUENOS AIRES,72,159,752,1142,1894
06,06091,060912318,Berazategui,BUENOS AIRES,58,105,94,110,204
06,06091,060912407,Berazategui,BUENOS AIRES,153,210,211,240,451
06,06091,060912413,Berazategui,BUENOS AIRES,190,189,296,351,647
06,06091,060910510,Berazategui,BUENOS AIRES,27,20,35,53,88
06,06091,060911706,Berazategui,BUENOS AIRES,363,333,644,666,1310
06,06091,060912409,Berazategui,BUENOS AIRES,104,410,140,174,314
06,06091,060910209,Berazategui,BUENOS AIRES,424,425,716,671,1387
06,06091,060910303,Berazategui,BUENOS AIRES,221,258,349,285,634
06,06091,060910308,Berazategui,BUENOS AIRES,241,251,407,385,792
06,06091,060910101,Berazategui,BUENOS AIRES,420,382,786,820,1606
06,06091,060910507,Berazategui,BUENOS AIRES,299,316,522,514,1036
06,06091,060910603,Berazategui,BUENOS AIRES,258,285,418,393,811
06,06091,060910609,Berazategui,BUENOS AIRES,405,380,806,786,1592
06,06091,060910709,Berazategui,BUENOS AIRES,317,311,651,612,1263
06,06091,060910807,Berazategui,BUENOS AIRES,439,408,784,707,1491
06,06091,060910810,Berazategui,BUENOS AIRES,376,382,603,559,1162
06,06091,060911006,Berazategui,BUENOS AIRES,462,439,788,744,1532
06,06091,060911007,Berazategui,BUENOS AIRES,315,308,563,516,1079
06,06091,060911008,Berazategui,BUENOS AIRES,278,261,491,448,939
06,06091,060911106,Berazategui,BUENOS AIRES,339,342,521,444,965
06,06091,060911201,Berazategui,BUENOS AIRES,370,329,668,629,1297
06,06091,060911206,Berazategui,BUENOS AIRES,443,387,877,826,1703
06,06091,060911207,Berazategui,BUENOS AIRES,278,298,494,489,983
06,06091,060911208,Berazategui,BUENOS AIRES,475,479,908,838,1746
06,06091,060911308,Berazategui,BUENOS AIRES,308,278,598,634,1232
06,06091,060911501,Berazategui,BUENOS AIRES,247,252,442,422,864
06,06091,060911707,Berazategui,BUENOS AIRES,379,331,792,758,1550
06,06091,060911713,Berazategui,BUENOS AIRES,256,240,490,483,973
06,06091,060911714,Berazategui,BUENOS AIRES,452,441,903,944,1847
06,06091,060911812,Berazategui,BUENOS AIRES,415,469,739,726,1465
06,06091,060911909,Berazategui,BUENOS AIRES,226,271,359,319,678
06,06091,060912005,Berazategui,BUENOS AIRES,418,413,823,820,1643
06,06091,060912006,Berazategui,BUENOS AIRES,226,224,400,392,792
06,06091,060912107,Berazategui,BUENOS AIRES,360,315,691,694,1385
06,06091,060912110,Berazategui,BUENOS AIRES,316,345,477,424,901
06,06091,060912113,Berazategui,BUENOS AIRES,303,305,623,600,1223
06,06091,060912114,Berazategui,BUENOS AIRES,350,365,619,558,1177
06,06091,060912204,Berazategui,BUENOS AIRES,340,407,606,601,1207
06,06091,060912306,Berazategui,BUENOS AIRES,388,415,664,674,1338
06,06091,060912307,Berazategui,BUENOS AIRES,223,247,346,343,689
06,06091,060912308,Berazategui,BUENOS AIRES,231,246,381,403,784
06,06091,060912316,Berazategui,BUENOS AIRES,115,160,177,178,355
06,06091,060912412,Berazategui,BUENOS AIRES,179,226,297,329,626
06,06091,060911901,Berazategui,BUENOS AIRES,223,247,362,349,711
06,06091,060912004,Berazategui,BUENOS AIRES,216,217,392,354,746
06,06091,060911104,Berazategui,BUENOS AIRES,224,250,323,267,590
06,06091,060910304,Berazategui,BUENOS AIRES,300,274,541,524,1065
06,06091,060910313,Berazategui,BUENOS AIRES,220,318,274,207,481
06,06091,060910407,Berazategui,BUENOS AIRES,391,350,816,760,1576
06,06091,060910506,Berazategui,BUENOS AIRES,252,249,422,384,806
06,06091,060910607,Berazategui,BUENOS AIRES,409,415,755,715,1470
06,06091,060910703,Berazategui,BUENOS AIRES,245,245,395,381,776
06,06091,060910708,Berazategui,BUENOS AIRES,362,342,714,739,1453
06,06091,060910808,Berazategui,BUENOS AIRES,458,442,841,781,1622
06,06091,060911303,Berazategui,BUENOS AIRES,303,278,599,582,1181
06,06091,060911404,Berazategui,BUENOS AIRES,334,332,601,602,1203
06,06091,060911407,Berazategui,BUENOS AIRES,403,395,748,712,1460
06,06091,060911411,Berazategui,BUENOS AIRES,448,400,812,775,1587
06,06091,060911603,Berazategui,BUENOS AIRES,259,232,522,477,999
06,06091,060911608,Berazategui,BUENOS AIRES,270,280,432,440,872
06,06091,060911705,Berazategui,BUENOS AIRES,357,344,728,729,1457
06,06091,060911803,Berazategui,BUENOS AIRES,551,565,975,977,1952
06,06091,060911809,Berazategui,BUENOS AIRES,258,282,406,384,790
06,06091,060911908,Berazategui,BUENOS AIRES,373,410,608,633,1241
06,06091,060912001,Berazategui,BUENOS AIRES,340,394,608,595,1203
06,06091,060912111,Berazategui,BUENOS AIRES,356,364,693,700,1393
06,06091,060912201,Berazategui,BUENOS AIRES,367,332,665,624,1289
06,06091,060912211,Berazategui,BUENOS AIRES,144,246,231,233,464
06,06091,060912212,Berazategui,BUENOS AIRES,124,232,187,203,390
06,06091,060912215,Berazategui,BUENOS AIRES,410,426,749,740,1489
06,06091,060912309,Berazategui,BUENOS AIRES,179,179,315,313,628
06,06091,060912303,Berazategui,BUENOS AIRES,248,275,422,389,811
06,06091,060910301,Berazategui,BUENOS AIRES,400,432,552,466,1018
06,06091,060910110,Berazategui,BUENOS AIRES,271,195,493,485,978
06,06091,060910203,Berazategui,BUENOS AIRES,212,253,292,286,578
06,06091,060910207,Berazategui,BUENOS AIRES,224,267,340,311,651
06,06091,060910409,Berazategui,BUENOS AIRES,518,491,1049,1001,2050
06,06091,060910701,Berazategui,BUENOS AIRES,374,368,667,589,1256
06,06091,060910710,Berazategui,BUENOS AIRES,390,404,674,710,1384
06,06091,060910902,Berazategui,BUENOS AIRES,402,441,659,570,1229
06,06091,060911001,Berazategui,BUENOS AIRES,354,365,527,490,1017
06,06091,060911102,Berazategui,BUENOS AIRES,453,463,723,631,1354
06,06091,060911307,Berazategui,BUENOS AIRES,298,299,543,513,1056
06,06091,060911310,Berazategui,BUENOS AIRES,413,389,724,711,1435
06,06091,060911312,Berazategui,BUENOS AIRES,277,265,479,467,946
06,06091,060911402,Berazategui,BUENOS AIRES,400,397,776,744,1520
06,06091,060911412,Berazategui,BUENOS AIRES,305,312,512,523,1035
06,06091,060911711,Berazategui,BUENOS AIRES,361,321,646,661,1307
06,06091,060911513,Berazategui,BUENOS AIRES,246,256,407,406,813
06,06091,060911604,Berazategui,BUENOS AIRES,416,389,741,720,1461
06,06091,060911605,Berazategui,BUENOS AIRES,437,416,841,703,1544
06,06091,060911606,Berazategui,BUENOS AIRES,261,256,491,493,984
06,06091,060911612,Berazategui,BUENOS AIRES,234,229,426,413,839
06,06091,060911613,Berazategui,BUENOS AIRES,432,443,820,721,1541
06,06091,060911712,Berazategui,BUENOS AIRES,363,346,650,598,1248
06,06091,060911810,Berazategui,BUENOS AIRES,225,242,382,395,777
06,06091,060911903,Berazategui,BUENOS AIRES,349,334,631,613,1244
06,06091,060911906,Berazategui,BUENOS AIRES,196,236,314,294,608
06,06091,060912012,Berazategui,BUENOS AIRES,227,275,444,396,840
06,06091,060912115,Berazategui,BUENOS AIRES,281,276,519,472,991
06,06091,060912207,Berazategui,BUENOS AIRES,309,282,578,571,1149
06,06091,060912209,Berazategui,BUENOS AIRES,224,232,373,400,773
06,06091,060912311,Berazategui,BUENOS AIRES,322,329,635,598,1233
06,06091,060912404,Berazategui,BUENOS AIRES,403,447,760,791,1551
06,06245,062450408,Ensenada,BUENOS AIRES,139,233,209,221,430
06,06245,062450101,Ensenada,BUENOS AIRES,404,417,644,587,1231
06,06245,062450210,Ensenada,BUENOS AIRES,186,210,276,258,534
06,06245,062450311,Ensenada,BUENOS AIRES,317,332,643,556,1199
06,06245,062450111,Ensenada,BUENOS AIRES,301,372,450,421,871
06,06245,062450307,Ensenada,BUENOS AIRES,272,314,395,391,786
06,06245,062450206,Ensenada,BUENOS AIRES,494,510,860,855,1715
06,06245,062450310,Ensenada,BUENOS AIRES,317,300,566,529,1095
06,06245,062450401,Ensenada,BUENOS AIRES,210,346,348,322,670
06,06245,062450403,Ensenada,BUENOS AIRES,256,398,405,441,846
06,06245,062450502,Ensenada,BUENOS AIRES,206,236,320,288,608
06,06245,062450507,Ensenada,BUENOS AIRES,54,92,76,267,343
06,06245,062450414,Ensenada,BUENOS AIRES,100,175,149,144,293
06,06245,062450110,Ensenada,BUENOS AIRES,311,329,507,462,969
06,06245,062450203,Ensenada,BUENOS AIRES,186,185,305,299,604
06,06245,062450207,Ensenada,BUENOS AIRES,397,413,620,501,1121
06,06245,062450304,Ensenada,BUENOS AIRES,501,446,876,866,1742
06,06245,062450404,Ensenada,BUENOS AIRES,235,342,407,404,811
06,06245,062450405,Ensenada,BUENOS AIRES,232,373,354,357,711
06,06245,062450411,Ensenada,BUENOS AIRES,41,70,68,70,138
06,06245,062450504,Ensenada,BUENOS AIRES,278,298,442,432,874
06,06245,062450211,Ensenada,BUENOS AIRES,488,499,880,905,1785
06,06245,062450214,Ensenada,BUENOS AIRES,267,285,449,430,879
06,06245,062450301,Ensenada,BUENOS AIRES,312,329,463,439,902
06,06245,062450302,Ensenada,BUENOS AIRES,382,406,630,588,1218
06,06245,062450410,Ensenada,BUENOS AIRES,233,241,417,418,835
06,06245,062450506,Ensenada,BUENOS AIRES,3,3,1,4,5
06,06245,062450409,Ensenada,BUENOS AIRES,231,272,401,403,804
06,06245,062450309,Ensenada,BUENOS AIRES,392,398,687,675,1362
06,06245,062450201,Ensenada,BUENOS AIRES,395,415,680,664,1344
06,06245,062450308,Ensenada,BUENOS AIRES,259,286,409,396,805
06,06245,062450413,Ensenada,BUENOS AIRES,236,281,389,418,807
06,06245,062450306,Ensenada,BUENOS AIRES,405,428,697,704,1401
06,06245,062450104,Ensenada,BUENOS AIRES,270,298,402,346,748
06,06245,062450105,Ensenada,BUENOS AIRES,351,423,554,499,1053
06,06245,062450205,Ensenada,BUENOS AIRES,372,381,615,569,1184
06,06245,062450213,Ensenada,BUENOS AIRES,270,283,478,455,933
06,06245,062450305,Ensenada,BUENOS AIRES,423,389,774,787,1561
06,06245,062450501,Ensenada,BUENOS AIRES,302,327,495,480,975
06,06245,062450416,Ensenada,BUENOS AIRES,121,201,178,179,357
06,06245,062450412,Ensenada,BUENOS AIRES,82,106,134,118,252
06,06245,062450407,Ensenada,BUENOS AIRES,272,306,418,418,836
06,06245,062450102,Ensenada,BUENOS AIRES,376,394,606,561,1167
06,06245,062450204,Ensenada,BUENOS AIRES,219,215,340,309,649
06,06245,062450208,Ensenada,BUENOS AIRES,309,352,474,436,910
06,06245,062450417,Ensenada,BUENOS AIRES,92,105,119,140,259
06,06245,062450418,Ensenada,BUENOS AIRES,130,157,225,216,441
06,06245,062450503,Ensenada,BUENOS AIRES,212,220,357,342,699
06,06245,062450107,Ensenada,BUENOS AIRES,259,303,405,344,749
06,06245,062450103,Ensenada,BUENOS AIRES,420,442,636,592,1228
06,06245,062450106,Ensenada,BUENOS AIRES,424,452,779,661,1440
06,06245,062450108,Ensenada,BUENOS AIRES,290,348,427,388,815
06,06245,062450109,Ensenada,BUENOS AIRES,262,307,375,337,712
06,06245,062450202,Ensenada,BUENOS AIRES,248,256,414,431,845
06,06245,062450209,Ensenada,BUENOS AIRES,356,334,599,547,1146
06,06245,062450212,Ensenada,BUENOS AIRES,417,411,770,759,1529
06,06245,062450215,Ensenada,BUENOS AIRES,242,228,467,452,919
06,06245,062450303,Ensenada,BUENOS AIRES,366,385,572,535,1107
06,06245,062450402,Ensenada,BUENOS AIRES,145,219,230,242,472
06,06245,062450406,Ensenada,BUENOS AIRES,191,216,320,300,620
06,06245,062450415,Ensenada,BUENOS AIRES,453,492,892,828,1720
06,06245,062450505,Ensenada,BUENOS AIRES,529,559,861,804,1665
06,06077,060770103,Arrecifes,BUENOS AIRES,229,277,388,288,676
06,06077,060770105,Arrecifes,BUENOS AIRES,304,340,419,355,774
06,06077,060770108,Arrecifes,BUENOS AIRES,210,247,334,272,606
06,06077,060770501,Arrecifes,BUENOS AIRES,398,422,577,542,1119
06,06077,060771404,Arrecifes,BUENOS AIRES,358,409,520,430,950
06,06077,060771408,Arrecifes,BUENOS AIRES,432,436,798,742,1540
06,06077,060771409,Arrecifes,BUENOS AIRES,343,361,623,569,1192
06,06077,060771202,Arrecifes,BUENOS AIRES,13,16,17,27,44
06,06077,060771001,Arrecifes,BUENOS AIRES,4,15,1,4,5
06,06077,060771002,Arrecifes,BUENOS AIRES,10,14,9,16,25
06,06077,060771101,Arrecifes,BUENOS AIRES,5,10,4,9,13
06,06077,060771302,Arrecifes,BUENOS AIRES,19,21,16,27,43
06,06077,060770510,Arrecifes,BUENOS AIRES,587,617,1170,1049,2219
06,06077,060771401,Arrecifes,BUENOS AIRES,354,340,687,646,1333
06,06077,060771303,Arrecifes,BUENOS AIRES,13,16,17,22,39
06,06077,060770405,Arrecifes,BUENOS AIRES,17,23,23,25,48
06,06077,060770508,Arrecifes,BUENOS AIRES,22,29,20,39,59
06,06077,060771301,Arrecifes,BUENOS AIRES,0,0,0,0,0
06,06077,060770101,Arrecifes,BUENOS AIRES,324,349,587,584,1171
06,06077,060770502,Arrecifes,BUENOS AIRES,215,235,318,342,660
06,06077,060770505,Arrecifes,BUENOS AIRES,257,269,457,478,935
06,06077,060770403,Arrecifes,BUENOS AIRES,16,21,14,26,40
06,06077,060770301,Arrecifes,BUENOS AIRES,13,15,16,27,43
06,06077,060770601,Arrecifes,BUENOS AIRES,21,25,34,33,67
06,06077,060770602,Arrecifes,BUENOS AIRES,31,50,37,47,84
06,06077,060770603,Arrecifes,BUENOS AIRES,18,31,23,53,76
06,06077,060771003,Arrecifes,BUENOS AIRES,8,11,8,11,19
06,06077,060771201,Arrecifes,BUENOS AIRES,21,20,32,28,60
06,06077,060770107,Arrecifes,BUENOS AIRES,107,137,177,187,364
06,06077,060771406,Arrecifes,BUENOS AIRES,335,430,481,378,859
06,06077,060771407,Arrecifes,BUENOS AIRES,285,348,403,333,736
06,06077,060770701,Arrecifes,BUENOS AIRES,14,21,12,23,35
06,06077,060770904,Arrecifes,BUENOS AIRES,24,33,27,33,60
06,06077,060770509,Arrecifes,BUENOS AIRES,467,487,757,726,1483
06,06077,060770512,Arrecifes,BUENOS AIRES,191,206,300,274,574
06,06077,060770401,Arrecifes,BUENOS AIRES,255,315,361,371,732
06,06077,060770102,Arrecifes,BUENOS AIRES,272,278,481,477,958
06,06077,060770106,Arrecifes,BUENOS AIRES,400,435,588,497,1085
06,06077,060770504,Arrecifes,BUENOS AIRES,176,195,259,241,500
06,06077,060770511,Arrecifes,BUENOS AIRES,329,352,474,458,932
06,06077,060770514,Arrecifes,BUENOS AIRES,97,101,163,155,318
06,06077,060770302,Arrecifes,BUENOS AIRES,8,18,6,12,18
06,06077,060770902,Arrecifes,BUENOS AIRES,8,10,14,13,27
06,06077,060770513,Arrecifes,BUENOS AIRES,200,227,321,295,616
06,06077,060770402,Arrecifes,BUENOS AIRES,168,238,243,221,464
06,06077,060770104,Arrecifes,BUENOS AIRES,257,307,352,283,635
06,06077,060770503,Arrecifes,BUENOS AIRES,308,341,527,515,1042
06,06077,060771402,Arrecifes,BUENOS AIRES,380,422,545,470,1015
06,06077,060771403,Arrecifes,BUENOS AIRES,320,373,466,397,863
06,06077,060770506,Arrecifes,BUENOS AIRES,30,33,36,46,82
06,06077,060770801,Arrecifes,BUENOS AIRES,14,32,12,18,30
06,06077,060770901,Arrecifes,BUENOS AIRES,12,31,12,19,31
06,06077,060770903,Arrecifes,BUENOS AIRES,13,18,20,23,43
06,06077,060770905,Arrecifes,BUENOS AIRES,11,18,13,13,26
06,06077,060771102,Arrecifes,BUENOS AIRES,8,8,10,16,26
06,06077,060770109,Arrecifes,BUENOS AIRES,293,356,418,382,800
06,06077,060771405,Arrecifes,BUENOS AIRES,249,339,342,293,635
06,06077,060770201,Arrecifes,BUENOS AIRES,22,35,29,35,64
06,06077,060770202,Arrecifes,BUENOS AIRES,17,37,24,33,57
06,06077,060770404,Arrecifes,BUENOS AIRES,11,26,8,14,22
06,06077,060770507,Arrecifes,BUENOS AIRES,12,21,18,22,40
06,06077,060771103,Arrecifes,BUENOS AIRES,11,23,17,15,32
06,06084,060840704,Benito Juárez,BUENOS AIRES,320,372,431,373,804
06,06084,060840705,Benito Juárez,BUENOS AIRES,170,191,249,248,497
06,06084,060840709,Benito Juárez,BUENOS AIRES,245,338,338,260,598
06,06084,060840801,Benito Juárez,BUENOS AIRES,43,64,65,73,138
06,06084,060840902,Benito Juárez,BUENOS AIRES,238,285,346,349,695
06,06084,060841209,Benito Juárez,BUENOS AIRES,199,230,296,321,617
06,06084,060841210,Benito Juárez,BUENOS AIRES,306,332,522,497,1019
06,06084,060840302,Benito Juárez,BUENOS AIRES,18,35,31,35,66
06,06084,060840305,Benito Juárez,BUENOS AIRES,13,19,14,21,35
06,06084,060840501,Benito Juárez,BUENOS AIRES,34,46,39,49,88
06,06084,060840301,Benito Juárez,BUENOS AIRES,57,90,75,82,157
06,06084,060840710,Benito Juárez,BUENOS AIRES,285,332,360,317,677
06,06084,060841206,Benito Juárez,BUENOS AIRES,413,459,702,664,1366
06,06084,060841207,Benito Juárez,BUENOS AIRES,200,246,273,221,494
06,06084,060840908,Benito Juárez,BUENOS AIRES,6,11,11,8,19
06,06084,060840403,Benito Juárez,BUENOS AIRES,16,34,26,31,57
06,06084,060840605,Benito Juárez,BUENOS AIRES,9,19,7,15,22
06,06084,060840701,Benito Juárez,BUENOS AIRES,67,107,91,104,195
06,06084,060841001,Benito Juárez,BUENOS AIRES,12,24,20,24,44
06,06084,060840702,Benito Juárez,BUENOS AIRES,191,213,324,318,642
06,06084,060840707,Benito Juárez,BUENOS AIRES,273,335,375,311,686
06,06084,060840303,Benito Juárez,BUENOS AIRES,13,28,17,18,35
06,06084,060840804,Benito Juárez,BUENOS AIRES,6,24,8,8,16
06,06084,060840103,Benito Juárez,BUENOS AIRES,32,51,32,48,80
06,06084,060840304,Benito Juárez,BUENOS AIRES,17,35,21,27,48
06,06084,060840402,Benito Juárez,BUENOS AIRES,30,48,30,68,98
06,06084,060840604,Benito Juárez,BUENOS AIRES,10,22,13,15,28
06,06084,060840802,Benito Juárez,BUENOS AIRES,12,22,13,25,38
06,06084,060840901,Benito Juárez,BUENOS AIRES,179,232,265,941,1206
06,06084,060840101,Benito Juárez,BUENOS AIRES,19,23,27,30,57
06,06084,060840603,Benito Juárez,BUENOS AIRES,6,11,7,9,16
06,06084,060840703,Benito Juárez,BUENOS AIRES,207,248,325,347,672
06,06084,060840708,Benito Juárez,BUENOS AIRES,292,376,395,316,711
06,06084,060840903,Benito Juárez,BUENOS AIRES,129,143,194,202,396
06,06084,060840906,Benito Juárez,BUENOS AIRES,225,274,335,319,654
06,06084,060840502,Benito Juárez,BUENOS AIRES,17,31,23,33,56
06,06084,060841002,Benito Juárez,BUENOS AIRES,7,18,3,8,11
06,06084,060841003,Benito Juárez,BUENOS AIRES,10,23,14,14,28
06,06084,060840711,Benito Juárez,BUENOS AIRES,342,401,621,539,1160
06,06084,060840905,Benito Juárez,BUENOS AIRES,205,231,310,277,587
06,06084,060841202,Benito Juárez,BUENOS AIRES,140,171,231,229,460
06,06084,060840602,Benito Juárez,BUENOS AIRES,5,9,8,9,17
06,06084,060840201,Benito Juárez,BUENOS AIRES,18,36,15,32,47
06,06084,060840401,Benito Juárez,BUENOS AIRES,4,25,4,6,10
06,06084,060840601,Benito Juárez,BUENOS AIRES,0,0,0,0,0
06,06084,060840803,Benito Juárez,BUENOS AIRES,30,57,37,40,77
06,06084,060840909,Benito Juárez,BUENOS AIRES,13,15,18,25,43
06,06084,060841203,Benito Juárez,BUENOS AIRES,206,230,317,299,616
06,06084,060841204,Benito Juárez,BUENOS AIRES,331,375,452,426,878
06,06084,060841208,Benito Juárez,BUENOS AIRES,335,390,484,425,909
06,06084,060840907,Benito Juárez,BUENOS AIRES,30,47,38,52,90
06,06084,060840706,Benito Juárez,BUENOS AIRES,285,320,360,343,703
06,06084,060840904,Benito Juárez,BUENOS AIRES,138,176,188,204,392
06,06084,060841205,Benito Juárez,BUENOS AIRES,233,250,415,355,770
06,06084,060840102,Benito Juárez,BUENOS AIRES,16,38,19,27,46
06,06084,060840202,Benito Juárez,BUENOS AIRES,13,29,20,21,41
06,06084,060841101,Benito Juárez,BUENOS AIRES,8,41,9,11,20
06,06084,060841102,Benito Juárez,BUENOS AIRES,33,71,43,50,93
06,06084,060841201,Benito Juárez,BUENOS AIRES,75,134,94,120,214
06,06274,062741004,Florencio Varela,BUENOS AIRES,272,275,535,567,1102
06,06274,062742209,Florencio Varela,BUENOS AIRES,148,169,270,285,555
06,06274,062740213,Florencio Varela,BUENOS AIRES,323,319,607,564,1171
06,06274,062740215,Florencio Varela,BUENOS AIRES,408,404,665,611,1276
06,06274,062740304,Florencio Varela,BUENOS AIRES,452,437,869,899,1768
06,06274,062740305,Florencio Varela,BUENOS AIRES,399,374,787,718,1505
06,06274,062740312,Florencio Varela,BUENOS AIRES,394,378,834,813,1647
06,06274,062740313,Florencio Varela,BUENOS AIRES,377,392,759,713,1472
06,06274,062740405,Florencio Varela,BUENOS AIRES,329,312,542,585,1127
06,06274,062740407,Florencio Varela,BUENOS AIRES,266,260,506,492,998
06,06274,062740502,Florencio Varela,BUENOS AIRES,269,261,489,448,937
06,06274,062740511,Florencio Varela,BUENOS AIRES,366,364,638,609,1247
06,06274,062740608,Florencio Varela,BUENOS AIRES,245,259,464,471,935
06,06274,062740612,Florencio Varela,BUENOS AIRES,274,257,498,506,1004
06,06274,062740702,Florencio Varela,BUENOS AIRES,252,264,489,489,978
06,06274,062740711,Florencio Varela,BUENOS AIRES,239,231,421,473,894
06,06274,062740808,Florencio Varela,BUENOS AIRES,261,296,480,431,911
06,06274,062740911,Florencio Varela,BUENOS AIRES,226,218,458,434,892
06,06274,062740817,Florencio Varela,BUENOS AIRES,247,261,490,502,992
06,06274,062740907,Florencio Varela,BUENOS AIRES,231,241,455,446,901
06,06274,062741001,Florencio Varela,BUENOS AIRES,336,352,610,685,1295
06,06274,062741006,Florencio Varela,BUENOS AIRES,229,230,494,494,988
06,06274,062741008,Florencio Varela,BUENOS AIRES,349,366,730,698,1428
06,06274,062741101,Florencio Varela,BUENOS AIRES,293,303,491,488,979
06,06274,062741107,Florencio Varela,BUENOS AIRES,324,283,607,625,1232
06,06274,062741109,Florencio Varela,BUENOS AIRES,525,510,1022,982,2004
06,06274,062741113,Florencio Varela,BUENOS AIRES,274,284,581,574,1155
06,06274,062741206,Florencio Varela,BUENOS AIRES,222,212,360,333,693
06,06274,062741208,Florencio Varela,BUENOS AIRES,447,452,818,780,1598
06,06274,062741311,Florencio Varela,BUENOS AIRES,273,288,472,421,893
06,06274,062741515,Florencio Varela,BUENOS AIRES,254,259,451,407,858
06,06274,062741808,Florencio Varela,BUENOS AIRES,236,240,562,564,1126
06,06274,062741811,Florencio Varela,BUENOS AIRES,411,414,820,830,1650
06,06274,062741813,Florencio Varela,BUENOS AIRES,303,307,594,628,1222
06,06274,062741816,Florencio Varela,BUENOS AIRES,405,393,804,789,1593
06,06274,062741901,Florencio Varela,BUENOS AIRES,317,332,602,556,1158
06,06274,062741902,Florencio Varela,BUENOS AIRES,414,387,797,770,1567
06,06274,062741912,Florencio Varela,BUENOS AIRES,396,415,808,790,1598
06,06274,062742003,Florencio Varela,BUENOS AIRES,346,342,625,664,1289
06,06274,062742112,Florencio Varela,BUENOS AIRES,234,230,451,433,884
06,06274,062742205,Florencio Varela,BUENOS AIRES,259,266,488,505,993
06,06274,062740805,Florencio Varela,BUENOS AIRES,243,249,435,391,826
06,06274,062741711,Florencio Varela,BUENOS AIRES,238,252,411,433,844
06,06274,062742118,Florencio Varela,BUENOS AIRES,355,350,679,693,1372
06,06274,062740609,Florencio Varela,BUENOS AIRES,252,256,497,471,968
06,06274,062740104,Florencio Varela,BUENOS AIRES,215,200,324,323,647
06,06274,062740109,Florencio Varela,BUENOS AIRES,261,249,478,432,910
06,06274,062740115,Florencio Varela,BUENOS AIRES,530,491,916,916,1832
06,06274,062740310,Florencio Varela,BUENOS AIRES,403,385,671,664,1335
06,06274,062740401,Florencio Varela,BUENOS AIRES,362,354,691,629,1320
06,06274,062740414,Florencio Varela,BUENOS AIRES,300,304,635,641,1276
06,06274,062740506,Florencio Varela,BUENOS AIRES,225,218,441,454,895
06,06274,062740509,Florencio Varela,BUENOS AIRES,268,275,487,503,990
06,06274,062740516,Florencio Varela,BUENOS AIRES,315,297,583,531,1114
06,06274,062740605,Florencio Varela,BUENOS AIRES,396,417,711,716,1427
06,06274,062740709,Florencio Varela,BUENOS AIRES,339,332,678,641,1319
06,06274,062740712,Florencio Varela,BUENOS AIRES,277,272,562,523,1085
06,06274,062740802,Florencio Varela,BUENOS AIRES,269,232,456,451,907
06,06274,062740818,Florencio Varela,BUENOS AIRES,300,309,593,612,1205
06,06274,062740901,Florencio Varela,BUENOS AIRES,344,373,622,659,1281
06,06274,062740904,Florencio Varela,BUENOS AIRES,292,316,604,585,1189
06,06274,062740905,Florencio Varela,BUENOS AIRES,256,267,527,526,1053
06,06274,062740922,Florencio Varela,BUENOS AIRES,282,315,538,552,1090
06,06274,062741002,Florencio Varela,BUENOS AIRES,302,313,518,586,1104
06,06274,062741112,Florencio Varela,BUENOS AIRES,301,313,581,575,1156
06,06274,062741114,Florencio Varela,BUENOS AIRES,299,314,601,621,1222
06,06274,062741201,Florencio Varela,BUENOS AIRES,455,464,757,707,1464
06,06274,062741203,Florencio Varela,BUENOS AIRES,312,348,557,484,1041
06,06274,062741204,Florencio Varela,BUENOS AIRES,186,228,378,320,698
06,06274,062741207,Florencio Varela,BUENOS AIRES,232,228,430,396,826
06,06274,062741212,Florencio Varela,BUENOS AIRES,398,413,798,785,1583
06,06274,062741304,Florencio Varela,BUENOS AIRES,250,256,415,411,826
06,06274,062741310,Florencio Varela,BUENOS AIRES,242,236,408,409,817
06,06274,062741312,Florencio Varela,BUENOS AIRES,387,405,646,599,1245
06,06274,062741317,Florencio Varela,BUENOS AIRES,440,470,758,680,1438
06,06274,062741404,Florencio Varela,BUENOS AIRES,298,332,419,402,821
06,06274,062741407,Florencio Varela,BUENOS AIRES,241,354,356,278,634
06,06274,062741517,Florencio Varela,BUENOS AIRES,366,339,717,746,1463
06,06274,062741613,Florencio Varela,BUENOS AIRES,384,298,705,714,1419
06,06274,062741608,Florencio Varela,BUENOS AIRES,290,302,541,511,1052
06,06274,062741609,Florencio Varela,BUENOS AIRES,238,235,434,441,875
06,06274,062741707,Florencio Varela,BUENOS AIRES,245,228,421,422,843
06,06274,062741710,Florencio Varela,BUENOS AIRES,331,313,605,635,1240
06,06274,062741803,Florencio Varela,BUENOS AIRES,280,242,520,526,1046
06,06274,062741805,Florencio Varela,BUENOS AIRES,252,242,545,555,1100
06,06274,062741809,Florencio Varela,BUENOS AIRES,306,301,646,679,1325
06,06274,062742005,Florencio Varela,BUENOS AIRES,494,439,931,948,1879
06,06274,062742012,Florencio Varela,BUENOS AIRES,343,325,701,684,1385
06,06274,062742109,Florencio Varela,BUENOS AIRES,263,251,542,555,1097
06,06274,062742111,Florencio Varela,BUENOS AIRES,260,265,493,486,979
06,06274,062742117,Florencio Varela,BUENOS AIRES,394,328,755,784,1539
06,06274,062742206,Florencio Varela,BUENOS AIRES,315,335,636,654,1290
06,06274,062742211,Florencio Varela,BUENOS AIRES,402,465,738,818,1556
06,06274,062740302,Florencio Varela,BUENOS AIRES,291,256,476,505,981
06,06274,062741709,Florencio Varela,BUENOS AIRES,329,339,559,574,1133
06,06274,062740114,Florencio Varela,BUENOS AIRES,243,233,450,427,877
06,06274,062740111,Florencio Varela,BUENOS AIRES,294,275,475,462,937
06,06274,062740202,Florencio Varela,BUENOS AIRES,376,370,657,660,1317
06,06274,062740203,Florencio Varela,BUENOS AIRES,414,417,748,705,1453
06,06274,062740413,Florencio Varela,BUENOS AIRES,318,307,637,631,1268
06,06274,062740311,Florencio Varela,BUENOS AIRES,350,364,603,616,1219
06,06274,062740410,Florencio Varela,BUENOS AIRES,342,341,625,650,1275
06,06274,062740411,Florencio Varela,BUENOS AIRES,283,295,544,551,1095
06,06274,062740501,Florencio Varela,BUENOS AIRES,275,303,470,418,888
06,06274,062740503,Florencio Varela,BUENOS AIRES,272,267,519,476,995
06,06274,062740615,Florencio Varela,BUENOS AIRES,345,347,728,787,1515
06,06274,062740617,Florencio Varela,BUENOS AIRES,274,269,596,566,1162
06,06274,062740707,Florencio Varela,BUENOS AIRES,360,354,703,765,1468
06,06274,062740813,Florencio Varela,BUENOS AIRES,416,428,825,878,1703
06,06274,062740816,Florencio Varela,BUENOS AIRES,283,288,515,514,1029
06,06274,062740908,Florencio Varela,BUENOS AIRES,208,230,418,373,791
06,06274,062740914,Florencio Varela,BUENOS AIRES,248,256,527,526,1053
06,06274,062740915,Florencio Varela,BUENOS AIRES,402,417,848,800,1648
06,06274,062741015,Florencio Varela,BUENOS AIRES,278,379,571,3647,4218
06,06274,062741115,Florencio Varela,BUENOS AIRES,308,317,616,585,1201
06,06274,062741116,Florencio Varela,BUENOS AIRES,278,264,550,559,1109
06,06274,062741117,Florencio Varela,BUENOS AIRES,401,387,789,785,1574
06,06274,062741215,Florencio Varela,BUENOS AIRES,349,318,684,707,1391
06,06274,062741302,Florencio Varela,BUENOS AIRES,199,213,325,315,640
06,06274,062741303,Florencio Varela,BUENOS AIRES,240,254,399,361,760
06,06274,062741306,Florencio Varela,BUENOS AIRES,311,308,718,724,1442
06,06274,062741307,Florencio Varela,BUENOS AIRES,276,277,486,455,941
06,06274,062741314,Florencio Varela,BUENOS AIRES,191,262,300,250,550
06,06274,062741403,Florencio Varela,BUENOS AIRES,220,261,304,242,546
06,06274,062741411,Florencio Varela,BUENOS AIRES,363,424,592,485,1077
06,06274,062741501,Florencio Varela,BUENOS AIRES,336,327,692,675,1367
06,06274,062741502,Florencio Varela,BUENOS AIRES,328,314,617,636,1253
06,06274,062741503,Florencio Varela,BUENOS AIRES,262,273,498,503,1001
06,06274,062741505,Florencio Varela,BUENOS AIRES,230,200,404,364,768
06,06274,062741507,Florencio Varela,BUENOS AIRES,304,300,551,544,1095
06,06274,062741703,Florencio Varela,BUENOS AIRES,299,288,588,510,1098
06,06274,062741802,Florencio Varela,BUENOS AIRES,288,267,544,600,1144
06,06274,062741804,Florencio Varela,BUENOS AIRES,243,225,498,508,1006
06,06274,062741806,Florencio Varela,BUENOS AIRES,408,360,914,929,1843
06,06274,062741903,Florencio Varela,BUENOS AIRES,300,281,601,652,1253
06,06274,062741906,Florencio Varela,BUENOS AIRES,413,358,796,774,1570
06,06274,062741911,Florencio Varela,BUENOS AIRES,463,473,949,933,1882
06,06274,062742001,Florencio Varela,BUENOS AIRES,417,363,920,922,1842
06,06274,062742009,Florencio Varela,BUENOS AIRES,320,285,591,551,1142
06,06274,062742013,Florencio Varela,BUENOS AIRES,384,359,810,790,1600
06,06274,062742107,Florencio Varela,BUENOS AIRES,410,413,1092,941,2033
06,06274,062742123,Florencio Varela,BUENOS AIRES,306,299,615,541,1156
06,06274,062742202,Florencio Varela,BUENOS AIRES,266,266,551,498,1049
06,06274,062742204,Florencio Varela,BUENOS AIRES,257,264,489,509,998
06,06274,062740807,Florencio Varela,BUENOS AIRES,376,363,752,657,1409
06,06274,062740103,Florencio Varela,BUENOS AIRES,227,242,349,328,677
06,06274,062740105,Florencio Varela,BUENOS AIRES,493,487,835,774,1609
06,06274,062740108,Florencio Varela,BUENOS AIRES,177,187,270,242,512
06,06274,062740205,Florencio Varela,BUENOS AIRES,331,324,586,554,1140
06,06274,062740206,Florencio Varela,BUENOS AIRES,496,459,859,764,1623
06,06274,062740209,Florencio Varela,BUENOS AIRES,273,265,481,476,957
06,06274,062740211,Florencio Varela,BUENOS AIRES,442,408,830,813,1643
06,06274,062740212,Florencio Varela,BUENOS AIRES,328,317,586,569,1155
06,06274,062740214,Florencio Varela,BUENOS AIRES,405,399,665,606,1271
06,06274,062740306,Florencio Varela,BUENOS AIRES,211,219,383,380,763
06,06274,062740307,Florencio Varela,BUENOS AIRES,458,375,827,788,1615
06,06274,062740512,Florencio Varela,BUENOS AIRES,359,341,659,622,1281
06,06274,062740606,Florencio Varela,BUENOS AIRES,396,390,752,709,1461
06,06274,062740705,Florencio Varela,BUENOS AIRES,324,312,580,572,1152
06,06274,062740710,Florencio Varela,BUENOS AIRES,303,304,591,626,1217
06,06274,062740804,Florencio Varela,BUENOS AIRES,257,258,511,457,968
06,06274,062740809,Florencio Varela,BUENOS AIRES,251,250,503,484,987
06,06274,062740903,Florencio Varela,BUENOS AIRES,327,359,651,649,1300
06,06274,062740917,Florencio Varela,BUENOS AIRES,297,310,590,582,1172
06,06274,062740921,Florencio Varela,BUENOS AIRES,344,308,666,640,1306
06,06274,062741105,Florencio Varela,BUENOS AIRES,437,397,796,791,1587
06,06274,062741213,Florencio Varela,BUENOS AIRES,232,213,461,426,887
06,06274,062741309,Florencio Varela,BUENOS AIRES,287,289,544,559,1103
06,06274,062741401,Florencio Varela,BUENOS AIRES,416,421,668,638,1306
06,06274,062741405,Florencio Varela,BUENOS AIRES,376,413,576,503,1079
06,06274,062741406,Florencio Varela,BUENOS AIRES,205,282,272,244,516
06,06274,062741408,Florencio Varela,BUENOS AIRES,313,352,485,409,894
06,06274,062741705,Florencio Varela,BUENOS AIRES,294,254,553,515,1068
06,06274,062742006,Florencio Varela,BUENOS AIRES,411,421,796,805,1601
06,06274,062742016,Florencio Varela,BUENOS AIRES,280,276,596,634,1230
06,06274,062742101,Florencio Varela,BUENOS AIRES,213,224,370,309,679
06,06274,062742121,Florencio Varela,BUENOS AIRES,225,240,401,406,807
06,06274,062742207,Florencio Varela,BUENOS AIRES,47,169,78,79,157
06,06274,062742208,Florencio Varela,BUENOS AIRES,93,154,180,165,345
06,06274,062742212,Florencio Varela,BUENOS AIRES,244,360,448,448,896
06,06274,062741003,Florencio Varela,BUENOS AIRES,400,329,787,780,1567
06,06274,062741701,Florencio Varela,BUENOS AIRES,228,224,376,338,714
06,06274,062740112,Florencio Varela,BUENOS AIRES,253,232,445,449,894
06,06274,062740113,Florencio Varela,BUENOS AIRES,463,430,849,816,1665
06,06274,062740208,Florencio Varela,BUENOS AIRES,301,265,551,523,1074
06,06274,062740303,Florencio Varela,BUENOS AIRES,228,235,436,395,831
06,06274,062740403,Florencio Varela,BUENOS AIRES,371,354,699,731,1430
06,06274,062740406,Florencio Varela,BUENOS AIRES,303,307,555,540,1095
06,06274,062740409,Florencio Varela,BUENOS AIRES,401,364,804,787,1591
06,06274,062740412,Florencio Varela,BUENOS AIRES,490,480,957,1011,1968
06,06274,062740505,Florencio Varela,BUENOS AIRES,241,228,485,482,967
06,06274,062740510,Florencio Varela,BUENOS AIRES,318,319,562,542,1104
06,06274,062740515,Florencio Varela,BUENOS AIRES,355,356,676,720,1396
06,06274,062740603,Florencio Varela,BUENOS AIRES,304,317,543,563,1106
06,06274,062740616,Florencio Varela,BUENOS AIRES,220,186,450,476,926
06,06274,062740619,Florencio Varela,BUENOS AIRES,198,203,403,413,816
06,06274,062740811,Florencio Varela,BUENOS AIRES,242,241,483,523,1006
06,06274,062740912,Florencio Varela,BUENOS AIRES,247,259,448,463,911
06,06274,062740913,Florencio Varela,BUENOS AIRES,257,262,511,517,1028
06,06274,062741009,Florencio Varela,BUENOS AIRES,235,210,551,558,1109
06,06274,062741014,Florencio Varela,BUENOS AIRES,249,267,455,516,971
06,06274,062741106,Florencio Varela,BUENOS AIRES,602,484,1074,1135,2209
06,06274,062741108,Florencio Varela,BUENOS AIRES,314,301,618,568,1186
06,06274,062741118,Florencio Varela,BUENOS AIRES,295,281,525,548,1073
06,06274,062741209,Florencio Varela,BUENOS AIRES,403,414,750,756,1506
06,06274,062741210,Florencio Varela,BUENOS AIRES,331,340,587,555,1142
06,06274,062741211,Florencio Varela,BUENOS AIRES,365,364,694,679,1373
06,06274,062741305,Florencio Varela,BUENOS AIRES,246,236,476,424,900
06,06274,062741308,Florencio Varela,BUENOS AIRES,242,259,436,416,852
06,06274,062741313,Florencio Varela,BUENOS AIRES,177,197,281,246,527
06,06274,062741504,Florencio Varela,BUENOS AIRES,440,387,812,775,1587
06,06274,062741506,Florencio Varela,BUENOS AIRES,236,224,415,365,780
06,06274,062741516,Florencio Varela,BUENOS AIRES,343,330,612,591,1203
06,06274,062741606,Florencio Varela,BUENOS AIRES,335,343,598,568,1166
06,06274,062741704,Florencio Varela,BUENOS AIRES,320,276,603,576,1179
06,06274,062741712,Florencio Varela,BUENOS AIRES,258,199,470,476,946
06,06274,062741713,Florencio Varela,BUENOS AIRES,353,320,605,598,1203
06,06274,062741812,Florencio Varela,BUENOS AIRES,202,214,374,407,781
06,06274,062741814,Florencio Varela,BUENOS AIRES,243,252,488,515,1003
06,06274,062741818,Florencio Varela,BUENOS AIRES,447,429,891,929,1820
06,06274,062741909,Florencio Varela,BUENOS AIRES,223,236,454,458,912
06,06274,062742015,Florencio Varela,BUENOS AIRES,10,482,22,26,48
06,06274,062742007,Florencio Varela,BUENOS AIRES,486,480,1071,1127,2198
06,06274,062742011,Florencio Varela,BUENOS AIRES,332,301,615,612,1227
06,06274,062742014,Florencio Varela,BUENOS AIRES,63,449,125,128,253
06,06274,062742105,Florencio Varela,BUENOS AIRES,375,361,886,808,1694
06,06274,062742110,Florencio Varela,BUENOS AIRES,265,252,494,469,963
06,06274,062742113,Florencio Varela,BUENOS AIRES,380,409,726,733,1459
06,06274,062742114,Florencio Varela,BUENOS AIRES,314,313,606,559,1165
06,06274,062740909,Florencio Varela,BUENOS AIRES,204,219,368,339,707
06,06274,062741702,Florencio Varela,BUENOS AIRES,244,247,435,391,826
06,06274,062740101,Florencio Varela,BUENOS AIRES,374,354,683,672,1355
06,06274,062740107,Florencio Varela,BUENOS AIRES,253,259,437,386,823
06,06274,062740614,Florencio Varela,BUENOS AIRES,264,258,499,522,1021
06,06274,062740806,Florencio Varela,BUENOS AIRES,189,188,354,333,687
06,06274,062740910,Florencio Varela,BUENOS AIRES,341,351,604,587,1191
06,06274,062740106,Florencio Varela,BUENOS AIRES,282,259,505,449,954
06,06274,062740201,Florencio Varela,BUENOS AIRES,413,404,674,601,1275
06,06274,062740204,Florencio Varela,BUENOS AIRES,288,300,453,418,871
06,06274,062740308,Florencio Varela,BUENOS AIRES,301,309,561,540,1101
06,06274,062740316,Florencio Varela,BUENOS AIRES,307,303,539,546,1085
06,06274,062740404,Florencio Varela,BUENOS AIRES,368,358,719,723,1442
06,06274,062740416,Florencio Varela,BUENOS AIRES,298,278,619,597,1216
06,06274,062740417,Florencio Varela,BUENOS AIRES,303,327,612,569,1181
06,06274,062740504,Florencio Varela,BUENOS AIRES,347,349,604,659,1263
06,06274,062740514,Florencio Varela,BUENOS AIRES,374,393,715,743,1458
06,06274,062740611,Florencio Varela,BUENOS AIRES,262,264,497,509,1006
06,06274,062740701,Florencio Varela,BUENOS AIRES,189,252,280,337,617
06,06274,062740704,Florencio Varela,BUENOS AIRES,287,289,592,610,1202
06,06274,062740803,Florencio Varela,BUENOS AIRES,262,270,424,358,782
06,06274,062740819,Florencio Varela,BUENOS AIRES,325,332,629,607,1236
06,06274,062740902,Florencio Varela,BUENOS AIRES,312,335,579,636,1215
06,06274,062740916,Florencio Varela,BUENOS AIRES,245,251,449,456,905
06,06274,062740918,Florencio Varela,BUENOS AIRES,287,314,556,568,1124
06,06274,062740919,Florencio Varela,BUENOS AIRES,355,372,661,740,1401
06,06274,062741007,Florencio Varela,BUENOS AIRES,366,343,706,719,1425
06,06274,062741202,Florencio Varela,BUENOS AIRES,245,272,452,423,875
06,06274,062741217,Florencio Varela,BUENOS AIRES,342,353,622,585,1207
06,06274,062741315,Florencio Varela,BUENOS AIRES,239,326,330,260,590
06,06274,062741316,Florencio Varela,BUENOS AIRES,271,291,424,401,825
06,06274,062741409,Florencio Varela,BUENOS AIRES,370,403,556,499,1055
06,06274,062741410,Florencio Varela,BUENOS AIRES,293,342,429,374,803
06,06274,062741509,Florencio Varela,BUENOS AIRES,266,221,490,467,957
06,06274,062741510,Florencio Varela,BUENOS AIRES,428,420,795,810,1605
06,06274,062741511,Florencio Varela,BUENOS AIRES,245,255,437,461,898
06,06274,062741512,Florencio Varela,BUENOS AIRES,248,241,485,463,948
06,06274,062741602,Florencio Varela,BUENOS AIRES,396,384,840,854,1694
06,06274,062741604,Florencio Varela,BUENOS AIRES,469,458,986,1020,2006
06,06274,062741607,Florencio Varela,BUENOS AIRES,274,282,511,528,1039
06,06274,062741611,Florencio Varela,BUENOS AIRES,233,236,439,433,872
06,06274,062741801,Florencio Varela,BUENOS AIRES,470,457,880,899,1779
06,06274,062741913,Florencio Varela,BUENOS AIRES,282,295,545,555,1100
06,06274,062742004,Florencio Varela,BUENOS AIRES,618,533,1216,1294,2510
06,06274,062742010,Florencio Varela,BUENOS AIRES,297,270,565,589,1154
06,06274,062742102,Florencio Varela,BUENOS AIRES,232,255,382,365,747
06,06274,062742104,Florencio Varela,BUENOS AIRES,363,353,661,686,1347
06,06274,062742106,Florencio Varela,BUENOS AIRES,412,400,1130,988,2118
06,06274,062742108,Florencio Varela,BUENOS AIRES,401,394,1018,990,2008
06,06274,062742115,Florencio Varela,BUENOS AIRES,432,416,796,789,1585
06,06274,062740613,Florencio Varela,BUENOS AIRES,238,231,474,477,951
06,06274,062741110,Florencio Varela,BUENOS AIRES,539,521,994,1026,2020
06,06274,062741708,Florencio Varela,BUENOS AIRES,235,233,390,366,756
06,06274,062742103,Florencio Varela,BUENOS AIRES,422,447,780,757,1537
06,06274,062740102,Florencio Varela,BUENOS AIRES,399,435,542,513,1055
06,06274,062740110,Florencio Varela,BUENOS AIRES,264,294,451,412,863
06,06274,062740207,Florencio Varela,BUENOS AIRES,321,325,577,518,1095
06,06274,062740301,Florencio Varela,BUENOS AIRES,383,371,660,660,1320
06,06274,062740314,Florencio Varela,BUENOS AIRES,340,311,699,684,1383
06,06274,062740402,Florencio Varela,BUENOS AIRES,410,402,786,730,1516
06,06274,062740415,Florencio Varela,BUENOS AIRES,348,346,707,685,1392
06,06274,062740508,Florencio Varela,BUENOS AIRES,401,407,692,651,1343
06,06274,062740513,Florencio Varela,BUENOS AIRES,303,280,568,574,1142
06,06274,062740602,Florencio Varela,BUENOS AIRES,306,313,514,521,1035
06,06274,062740618,Florencio Varela,BUENOS AIRES,229,203,533,514,1047
06,06274,062740703,Florencio Varela,BUENOS AIRES,302,302,604,612,1216
06,06274,062740706,Florencio Varela,BUENOS AIRES,375,388,759,743,1502
06,06274,062740801,Florencio Varela,BUENOS AIRES,189,183,332,350,682
06,06274,062740812,Florencio Varela,BUENOS AIRES,254,270,495,518,1013
06,06274,062740906,Florencio Varela,BUENOS AIRES,420,433,791,831,1622
06,06274,062740920,Florencio Varela,BUENOS AIRES,364,390,700,686,1386
06,06274,062741010,Florencio Varela,BUENOS AIRES,278,323,510,577,1087
06,06274,062741011,Florencio Varela,BUENOS AIRES,210,301,356,420,776
06,06274,062741012,Florencio Varela,BUENOS AIRES,308,330,568,623,1191
06,06274,062741013,Florencio Varela,BUENOS AIRES,165,141,281,310,591
06,06274,062741103,Florencio Varela,BUENOS AIRES,304,271,581,560,1141
06,06274,062741104,Florencio Varela,BUENOS AIRES,316,306,573,532,1105
06,06274,062741214,Florencio Varela,BUENOS AIRES,243,237,431,444,875
06,06274,062741402,Florencio Varela,BUENOS AIRES,362,425,535,477,1012
06,06274,062741508,Florencio Varela,BUENOS AIRES,287,234,524,536,1060
06,06274,062741513,Florencio Varela,BUENOS AIRES,305,278,586,545,1131
06,06274,062741514,Florencio Varela,BUENOS AIRES,266,265,481,465,946
06,06274,062741612,Florencio Varela,BUENOS AIRES,298,246,527,543,1070
06,06274,062741610,Florencio Varela,BUENOS AIRES,331,301,626,612,1238
06,06274,062741714,Florencio Varela,BUENOS AIRES,394,376,679,622,1301
06,06274,062741810,Florencio Varela,BUENOS AIRES,325,324,730,663,1393
06,06274,062741815,Florencio Varela,BUENOS AIRES,230,220,426,399,825
06,06274,062741817,Florencio Varela,BUENOS AIRES,373,365,688,724,1412
06,06274,062741904,Florencio Varela,BUENOS AIRES,430,437,767,833,1600
06,06274,062741907,Florencio Varela,BUENOS AIRES,417,414,893,880,1773
06,06274,062741908,Florencio Varela,BUENOS AIRES,217,228,463,471,934
06,06274,062741910,Florencio Varela,BUENOS AIRES,461,468,888,913,1801
06,06274,062742008,Florencio Varela,BUENOS AIRES,323,301,609,602,1211
06,06274,062742116,Florencio Varela,BUENOS AIRES,249,248,485,460,945
06,06274,062742119,Florencio Varela,BUENOS AIRES,327,326,628,628,1256
06,06274,062742122,Florencio Varela,BUENOS AIRES,261,264,517,503,1020
06,06274,062741005,Florencio Varela,BUENOS AIRES,237,242,468,417,885
06,06274,062740210,Florencio Varela,BUENOS AIRES,298,296,634,588,1222
06,06274,062740309,Florencio Varela,BUENOS AIRES,269,242,517,499,1016
06,06274,062740315,Florencio Varela,BUENOS AIRES,272,397,504,478,982
06,06274,062740408,Florencio Varela,BUENOS AIRES,243,257,430,413,843
06,06274,062740507,Florencio Varela,BUENOS AIRES,322,323,644,647,1291
06,06274,062740601,Florencio Varela,BUENOS AIRES,405,401,776,719,1495
06,06274,062740604,Florencio Varela,BUENOS AIRES,293,313,514,491,1005
06,06274,062740607,Florencio Varela,BUENOS AIRES,255,228,485,484,969
06,06274,062740610,Florencio Varela,BUENOS AIRES,279,304,463,439,902
06,06274,062740620,Florencio Varela,BUENOS AIRES,364,364,809,795,1604
06,06274,062740708,Florencio Varela,BUENOS AIRES,417,430,802,824,1626
06,06274,062740713,Florencio Varela,BUENOS AIRES,357,351,742,712,1454
06,06274,062740810,Florencio Varela,BUENOS AIRES,301,299,657,692,1349
06,06274,062740814,Florencio Varela,BUENOS AIRES,323,321,620,641,1261
06,06274,062740815,Florencio Varela,BUENOS AIRES,329,329,609,597,1206
06,06274,062740820,Florencio Varela,BUENOS AIRES,340,334,695,716,1411
06,06274,062741102,Florencio Varela,BUENOS AIRES,342,331,609,578,1187
06,06274,062741111,Florencio Varela,BUENOS AIRES,271,323,512,508,1020
06,06274,062741205,Florencio Varela,BUENOS AIRES,211,232,323,312,635
06,06274,062741216,Florencio Varela,BUENOS AIRES,331,347,597,664,1261
06,06274,062741301,Florencio Varela,BUENOS AIRES,393,418,669,656,1325
06,06274,062741518,Florencio Varela,BUENOS AIRES,428,443,743,704,1447
06,06274,062741614,Florencio Varela,BUENOS AIRES,299,270,545,563,1108
06,06274,062741601,Florencio Varela,BUENOS AIRES,373,359,754,783,1537
06,06274,062741603,Florencio Varela,BUENOS AIRES,374,399,744,788,1532
06,06274,062741605,Florencio Varela,BUENOS AIRES,269,256,463,435,898
06,06274,062741706,Florencio Varela,BUENOS AIRES,322,299,611,613,1224
06,06274,062741807,Florencio Varela,BUENOS AIRES,390,365,852,828,1680
06,06274,062741905,Florencio Varela,BUENOS AIRES,489,494,976,1050,2026
06,06274,062742002,Florencio Varela,BUENOS AIRES,396,360,815,787,1602
06,06274,062742120,Florencio Varela,BUENOS AIRES,234,231,407,422,829
06,06274,062742201,Florencio Varela,BUENOS AIRES,253,263,465,484,949
06,06274,062742203,Florencio Varela,BUENOS AIRES,447,428,871,821,1692
06,06274,062742210,Florencio Varela,BUENOS AIRES,345,381,633,622,1255
06,06280,062801003,General Alvarado,BUENOS AIRES,79,270,121,105,226
06,06280,062800208,General Alvarado,BUENOS AIRES,169,315,221,153,374
06,06280,062800302,General Alvarado,BUENOS AIRES,50,436,81,75,156
06,06280,062800615,General Alvarado,BUENOS AIRES,44,90,77,80,157
06,06280,062800801,General Alvarado,BUENOS AIRES,97,106,123,129,252
06,06280,062800902,General Alvarado,BUENOS AIRES,12,125,10,15,25
06,06280,062800911,General Alvarado,BUENOS AIRES,11,103,10,10,20
06,06280,062800507,General Alvarado,BUENOS AIRES,8,13,14,19,33
06,06280,062800601,General Alvarado,BUENOS AIRES,5,11,8,7,15
06,06280,062800709,General Alvarado,BUENOS AIRES,19,37,23,32,55
06,06280,062800905,General Alvarado,BUENOS AIRES,17,32,18,30,48
06,06280,062800906,General Alvarado,BUENOS AIRES,22,28,29,40,69
06,06280,062800816,General Alvarado,BUENOS AIRES,38,59,51,69,120
06,06280,062801006,General Alvarado,BUENOS AIRES,30,174,41,29,70
06,06280,062801205,General Alvarado,BUENOS AIRES,438,446,692,696,1388
06,06280,062800102,General Alvarado,BUENOS AIRES,177,222,305,343,648
06,06280,062800109,General Alvarado,BUENOS AIRES,129,145,237,240,477
06,06280,062800308,General Alvarado,BUENOS AIRES,48,351,102,76,178
06,06280,062800310,General Alvarado,BUENOS AIRES,52,353,63,55,118
06,06280,062800313,General Alvarado,BUENOS AIRES,29,332,41,30,71
06,06280,062800404,General Alvarado,BUENOS AIRES,13,368,11,12,23
06,06280,062800603,General Alvarado,BUENOS AIRES,33,115,46,50,96
06,06280,062800604,General Alvarado,BUENOS AIRES,24,126,28,28,56
06,06280,062800617,General Alvarado,BUENOS AIRES,26,79,36,28,64
06,06280,062801005,General Alvarado,BUENOS AIRES,95,377,118,100,218
06,06280,062800910,General Alvarado,BUENOS AIRES,10,130,8,15,23
06,06280,062800912,General Alvarado,BUENOS AIRES,57,171,82,84,166
06,06280,062801103,General Alvarado,BUENOS AIRES,363,467,598,487,1085
06,06280,062801210,General Alvarado,BUENOS AIRES,193,208,303,322,625
06,06280,062800509,General Alvarado,BUENOS AIRES,7,14,7,11,18
06,06280,062800602,General Alvarado,BUENOS AIRES,7,14,7,14,21
06,06280,062800702,General Alvarado,BUENOS AIRES,9,11,10,10,20
06,06280,062800708,General Alvarado,BUENOS AIRES,23,20,31,36,67
06,06280,062800808,General Alvarado,BUENOS AIRES,6,15,3,6,9
06,06280,062800814,General Alvarado,BUENOS AIRES,7,9,5,11,16
06,06280,062800818,General Alvarado,BUENOS AIRES,4,7,3,9,12
06,06280,062801203,General Alvarado,BUENOS AIRES,3,9,3,5,8
06,06280,062800101,General Alvarado,BUENOS AIRES,180,207,324,355,679
06,06280,062800304,General Alvarado,BUENOS AIRES,56,429,74,71,145
06,06280,062800306,General Alvarado,BUENOS AIRES,50,433,89,73,162
06,06280,062800307,General Alvarado,BUENOS AIRES,90,621,120,113,233
06,06280,062800405,General Alvarado,BUENOS AIRES,45,359,73,56,129
06,06280,062800409,General Alvarado,BUENOS AIRES,127,184,215,199,414
06,06280,062800605,General Alvarado,BUENOS AIRES,12,128,15,16,31
06,06280,062800616,General Alvarado,BUENOS AIRES,34,100,45,45,90
06,06280,062800610,General Alvarado,BUENOS AIRES,128,153,221,237,458
06,06280,062800612,General Alvarado,BUENOS AIRES,39,126,38,50,88
06,06280,062800613,General Alvarado,BUENOS AIRES,26,102,31,51,82
06,06280,062800804,General Alvarado,BUENOS AIRES,5,10,9,6,15
06,06280,062800810,General Alvarado,BUENOS AIRES,9,16,8,10,18
06,06280,062800817,General Alvarado,BUENOS AIRES,10,21,14,16,30
06,06280,062800609,General Alvarado,BUENOS AIRES,41,103,57,64,121
06,06280,062800103,General Alvarado,BUENOS AIRES,184,201,309,302,611
06,06280,062800203,General Alvarado,BUENOS AIRES,177,242,245,205,450
06,06280,062800205,General Alvarado,BUENOS AIRES,342,426,559,514,1073
06,06280,062800207,General Alvarado,BUENOS AIRES,290,418,419,337,756
06,06280,062800303,General Alvarado,BUENOS AIRES,62,430,88,82,170
06,06280,062800305,General Alvarado,BUENOS AIRES,83,334,121,117,238
06,06280,062800309,General Alvarado,BUENOS AIRES,46,346,67,36,103
06,06280,062800311,General Alvarado,BUENOS AIRES,37,813,39,39,78
06,06280,062800403,General Alvarado,BUENOS AIRES,35,212,46,35,81
06,06280,062801002,General Alvarado,BUENOS AIRES,197,314,300,265,565
06,06280,062801112,General Alvarado,BUENOS AIRES,137,175,232,223,455
06,06280,062801206,General Alvarado,BUENOS AIRES,336,360,555,496,1051
06,06280,062800502,General Alvarado,BUENOS AIRES,13,23,17,21,38
06,06280,062800505,General Alvarado,BUENOS AIRES,9,12,6,9,15
06,06280,062800809,General Alvarado,BUENOS AIRES,17,25,18,30,48
06,06280,062800204,General Alvarado,BUENOS AIRES,241,268,427,391,818
06,06280,062800104,General Alvarado,BUENOS AIRES,230,243,388,410,798
06,06280,062800106,General Alvarado,BUENOS AIRES,137,204,261,270,531
06,06280,062800407,General Alvarado,BUENOS AIRES,69,173,99,118,217
06,06280,062800408,General Alvarado,BUENOS AIRES,96,172,165,161,326
06,06280,062800611,General Alvarado,BUENOS AIRES,73,139,115,138,253
06,06280,062800819,General Alvarado,BUENOS AIRES,216,248,319,326,645
06,06280,062800820,General Alvarado,BUENOS AIRES,99,116,152,156,308
06,06280,062800909,General Alvarado,BUENOS AIRES,41,196,60,63,123
06,06280,062801008,General Alvarado,BUENOS AIRES,125,340,196,201,397
06,06280,062801107,General Alvarado,BUENOS AIRES,153,210,229,193,422
06,06280,062801109,General Alvarado,BUENOS AIRES,214,296,340,327,667
06,06280,062801111,General Alvarado,BUENOS AIRES,153,183,264,267,531
06,06280,062800704,General Alvarado,BUENOS AIRES,54,83,72,90,162
06,06280,062800812,General Alvarado,BUENOS AIRES,15,21,15,21,36
06,06280,062800705,General Alvarado,BUENOS AIRES,18,27,30,30,60
06,06280,062800706,General Alvarado,BUENOS AIRES,15,27,18,23,41
06,06280,062800707,General Alvarado,BUENOS AIRES,10,28,11,9,20
06,06280,062801204,General Alvarado,BUENOS AIRES,29,38,30,50,80
06,06280,062800202,General Alvarado,BUENOS AIRES,231,293,367,335,702
06,06280,062800107,General Alvarado,BUENOS AIRES,254,312,527,516,1043
06,06280,062800108,General Alvarado,BUENOS AIRES,162,198,341,361,702
06,06280,062800201,General Alvarado,BUENOS AIRES,302,318,535,523,1058
06,06280,062800614,General Alvarado,BUENOS AIRES,33,140,36,50,86
06,06280,062800406,General Alvarado,BUENOS AIRES,103,348,173,133,306
06,06280,062800606,General Alvarado,BUENOS AIRES,195,390,294,275,569
06,06280,062800607,General Alvarado,BUENOS AIRES,68,140,111,99,210
06,06280,062801102,General Alvarado,BUENOS AIRES,299,364,500,436,936
06,06280,062801104,General Alvarado,BUENOS AIRES,142,203,208,191,399
06,06280,062801108,General Alvarado,BUENOS AIRES,170,199,302,278,580
06,06280,062801207,General Alvarado,BUENOS AIRES,392,420,688,630,1318
06,06280,062801201,General Alvarado,BUENOS AIRES,39,49,54,62,116
06,06280,062800504,General Alvarado,BUENOS AIRES,3,13,1,2,3
06,06280,062800506,General Alvarado,BUENOS AIRES,12,18,15,14,29
06,06280,062800710,General Alvarado,BUENOS AIRES,10,22,15,19,34
06,06280,062800711,General Alvarado,BUENOS AIRES,11,82,11,14,25
06,06280,062800803,General Alvarado,BUENOS AIRES,5,16,6,5,11
06,06280,062800806,General Alvarado,BUENOS AIRES,7,14,9,9,18
06,06280,062800807,General Alvarado,BUENOS AIRES,13,25,10,20,30
06,06280,062800813,General Alvarado,BUENOS AIRES,11,15,14,14,28
06,06280,062800907,General Alvarado,BUENOS AIRES,6,6,10,12,22
06,06280,062800903,General Alvarado,BUENOS AIRES,5,10,4,7,11
06,06280,062801202,General Alvarado,BUENOS AIRES,30,36,48,53,101
06,06280,062800908,General Alvarado,BUENOS AIRES,11,34,16,18,34
06,06280,062800206,General Alvarado,BUENOS AIRES,244,307,384,310,694
06,06280,062800301,General Alvarado,BUENOS AIRES,56,230,85,72,157
06,06280,062800312,General Alvarado,BUENOS AIRES,28,426,31,27,58
06,06280,062800608,General Alvarado,BUENOS AIRES,116,159,176,187,363
06,06280,062801001,General Alvarado,BUENOS AIRES,200,343,274,219,493
06,06280,062801106,General Alvarado,BUENOS AIRES,176,248,276,233,509
06,06280,062801110,General Alvarado,BUENOS AIRES,134,174,238,200,438
06,06280,062801208,General Alvarado,BUENOS AIRES,458,496,804,805,1609
06,06280,062801209,General Alvarado,BUENOS AIRES,192,199,310,322,632
06,06280,062800508,General Alvarado,BUENOS AIRES,19,22,19,49,68
06,06280,062800811,General Alvarado,BUENOS AIRES,8,12,7,11,18
06,06280,062800501,General Alvarado,BUENOS AIRES,7,15,1,16,17
06,06280,062800503,General Alvarado,BUENOS AIRES,7,11,5,13,18
06,06280,062800701,General Alvarado,BUENOS AIRES,10,16,12,19,31
06,06280,062800703,General Alvarado,BUENOS AIRES,21,35,31,30,61
06,06280,062800802,General Alvarado,BUENOS AIRES,4,10,6,8,14
06,06280,062800805,General Alvarado,BUENOS AIRES,3,14,4,4,8
06,06280,062800815,General Alvarado,BUENOS AIRES,14,22,20,21,41
06,06280,062800401,General Alvarado,BUENOS AIRES,250,454,362,309,671
06,06280,062800402,General Alvarado,BUENOS AIRES,56,222,83,67,150
06,06280,062801007,General Alvarado,BUENOS AIRES,64,323,96,54,150
06,06280,062800105,General Alvarado,BUENOS AIRES,145,168,268,282,550
06,06280,062800110,General Alvarado,BUENOS AIRES,171,210,300,316,616
06,06280,062800410,General Alvarado,BUENOS AIRES,99,163,142,138,280
06,06280,062800901,General Alvarado,BUENOS AIRES,36,97,47,49,96
06,06280,062801004,General Alvarado,BUENOS AIRES,118,388,158,142,300
06,06280,062801101,General Alvarado,BUENOS AIRES,238,272,375,410,785
06,06280,062801105,General Alvarado,BUENOS AIRES,174,228,248,197,445
06,06280,062800904,General Alvarado,BUENOS AIRES,11,43,22,40,62
06,06112,061120112,Bragado,BUENOS AIRES,440,487,675,703,1378
06,06112,061120205,Bragado,BUENOS AIRES,342,384,474,422,896
06,06112,061120211,Bragado,BUENOS AIRES,470,444,711,656,1367
06,06112,061120710,Bragado,BUENOS AIRES,79,82,117,122,239
06,06112,061121101,Bragado,BUENOS AIRES,195,240,266,254,520
06,06112,061121102,Bragado,BUENOS AIRES,74,86,105,105,210
06,06112,061121404,Bragado,BUENOS AIRES,317,378,426,375,801
06,06112,061121406,Bragado,BUENOS AIRES,276,349,364,287,651
06,06112,061120606,Bragado,BUENOS AIRES,8,21,10,13,23
06,06112,061120402,Bragado,BUENOS AIRES,6,9,4,8,12
06,06112,061120505,Bragado,BUENOS AIRES,9,11,13,14,27
06,06112,061120707,Bragado,BUENOS AIRES,6,28,8,13,21
06,06112,061121201,Bragado,BUENOS AIRES,10,23,7,14,21
06,06112,061121205,Bragado,BUENOS AIRES,5,14,7,6,13
06,06112,061120105,Bragado,BUENOS AIRES,229,282,304,266,570
06,06112,061120110,Bragado,BUENOS AIRES,492,527,743,786,1529
06,06112,061120204,Bragado,BUENOS AIRES,178,206,257,268,525
06,06112,061120210,Bragado,BUENOS AIRES,297,334,402,386,788
06,06112,061120703,Bragado,BUENOS AIRES,78,94,139,122,261
06,06112,061121002,Bragado,BUENOS AIRES,162,211,249,217,466
06,06112,061121104,Bragado,BUENOS AIRES,53,54,87,78,165
06,06112,061121407,Bragado,BUENOS AIRES,274,336,377,268,645
06,06112,061120506,Bragado,BUENOS AIRES,7,21,7,9,16
06,06112,061120705,Bragado,BUENOS AIRES,8,16,8,17,25
06,06112,061120905,Bragado,BUENOS AIRES,6,11,7,9,16
06,06112,061120907,Bragado,BUENOS AIRES,10,11,13,15,28
06,06112,061121106,Bragado,BUENOS AIRES,36,110,44,57,101
06,06112,061120108,Bragado,BUENOS AIRES,263,319,466,306,772
06,06112,061120201,Bragado,BUENOS AIRES,318,338,567,535,1102
06,06112,061120206,Bragado,BUENOS AIRES,307,348,467,378,845
06,06112,061120310,Bragado,BUENOS AIRES,64,78,75,103,178
06,06112,061120601,Bragado,BUENOS AIRES,15,17,14,24,38
06,06112,061120702,Bragado,BUENOS AIRES,350,401,530,498,1028
06,06112,061120901,Bragado,BUENOS AIRES,40,56,62,65,127
06,06112,061120708,Bragado,BUENOS AIRES,6,20,17,7,24
06,06112,061120902,Bragado,BUENOS AIRES,2,6,3,5,8
06,06112,061120906,Bragado,BUENOS AIRES,27,34,38,44,82
06,06112,061121105,Bragado,BUENOS AIRES,0,2,0,0,0
06,06112,061120104,Bragado,BUENOS AIRES,172,233,228,189,417
06,06112,061120106,Bragado,BUENOS AIRES,284,333,408,323,731
06,06112,061120113,Bragado,BUENOS AIRES,271,278,491,516,1007
06,06112,061120701,Bragado,BUENOS AIRES,157,187,258,248,506
06,06112,061121305,Bragado,BUENOS AIRES,86,127,121,127,248
06,06112,061121403,Bragado,BUENOS AIRES,282,322,388,353,741
06,06112,061120307,Bragado,BUENOS AIRES,10,14,11,12,23
06,06112,061120504,Bragado,BUENOS AIRES,4,18,4,7,11
06,06112,061120706,Bragado,BUENOS AIRES,7,12,10,16,26
06,06112,061120903,Bragado,BUENOS AIRES,11,15,12,15,27
06,06112,061121203,Bragado,BUENOS AIRES,6,12,8,7,15
06,06112,061120801,Bragado,BUENOS AIRES,7,12,9,8,17
06,06112,061120103,Bragado,BUENOS AIRES,408,466,671,552,1223
06,06112,061120301,Bragado,BUENOS AIRES,72,91,111,111,222
06,06112,061121401,Bragado,BUENOS AIRES,291,308,501,458,959
06,06112,061121402,Bragado,BUENOS AIRES,334,358,535,493,1028
06,06112,061120304,Bragado,BUENOS AIRES,8,12,10,8,18
06,06112,061120306,Bragado,BUENOS AIRES,8,14,16,13,29
06,06112,061120502,Bragado,BUENOS AIRES,10,19,13,17,30
06,06112,061120803,Bragado,BUENOS AIRES,13,19,14,25,39
06,06112,061120908,Bragado,BUENOS AIRES,3,11,4,6,10
06,06112,061121302,Bragado,BUENOS AIRES,11,27,7,15,22
06,06112,061120111,Bragado,BUENOS AIRES,330,379,494,426,920
06,06112,061120101,Bragado,BUENOS AIRES,231,265,324,317,641
06,06112,061120208,Bragado,BUENOS AIRES,113,136,185,181,366
06,06112,061120709,Bragado,BUENOS AIRES,164,191,229,225,454
06,06112,061121410,Bragado,BUENOS AIRES,279,348,344,299,643
06,06112,061121107,Bragado,BUENOS AIRES,7,15,6,11,17
06,06112,061120309,Bragado,BUENOS AIRES,10,18,12,17,29
06,06112,061120604,Bragado,BUENOS AIRES,15,26,20,29,49
06,06112,061120403,Bragado,BUENOS AIRES,5,22,6,7,13
06,06112,061121004,Bragado,BUENOS AIRES,55,105,56,79,135
06,06112,061121003,Bragado,BUENOS AIRES,376,306,564,609,1173
06,06112,061121109,Bragado,BUENOS AIRES,435,346,730,740,1470
06,06112,061120202,Bragado,BUENOS AIRES,341,339,627,649,1276
06,06112,061120209,Bragado,BUENOS AIRES,197,208,295,259,554
06,06112,061120501,Bragado,BUENOS AIRES,156,193,196,241,437
06,06112,061121005,Bragado,BUENOS AIRES,194,220,308,292,600
06,06112,061121103,Bragado,BUENOS AIRES,181,214,255,264,519
06,06112,061121301,Bragado,BUENOS AIRES,128,155,199,187,386
06,06112,061121408,Bragado,BUENOS AIRES,299,369,397,332,729
06,06112,061120308,Bragado,BUENOS AIRES,9,20,14,17,31
06,06112,061120302,Bragado,BUENOS AIRES,9,12,10,17,27
06,06112,061120303,Bragado,BUENOS AIRES,7,16,18,16,34
06,06112,061120602,Bragado,BUENOS AIRES,9,15,9,12,21
06,06112,061120603,Bragado,BUENOS AIRES,14,36,17,26,43
06,06112,061120605,Bragado,BUENOS AIRES,10,17,14,16,30
06,06112,061120802,Bragado,BUENOS AIRES,25,32,19,41,60
06,06112,061120805,Bragado,BUENOS AIRES,13,17,15,27,42
06,06112,061121001,Bragado,BUENOS AIRES,46,73,55,69,124
06,06112,061121303,Bragado,BUENOS AIRES,24,73,22,36,58
06,06112,061121304,Bragado,BUENOS AIRES,13,40,13,19,32
06,06112,061121108,Bragado,BUENOS AIRES,336,360,590,547,1137
06,06112,061121204,Bragado,BUENOS AIRES,4,18,3,5,8
06,06112,061120102,Bragado,BUENOS AIRES,365,417,552,503,1055
06,06112,061120107,Bragado,BUENOS AIRES,271,322,370,302,672
06,06112,061120109,Bragado,BUENOS AIRES,409,422,620,587,1207
06,06112,061120203,Bragado,BUENOS AIRES,395,436,607,604,1211
06,06112,061120207,Bragado,BUENOS AIRES,274,288,359,331,690
06,06112,061121405,Bragado,BUENOS AIRES,299,341,376,315,691
06,06112,061121409,Bragado,BUENOS AIRES,272,333,419,314,733
06,06112,061120305,Bragado,BUENOS AIRES,12,20,16,23,39
06,06112,061120401,Bragado,BUENOS AIRES,6,10,14,10,24
06,06112,061120503,Bragado,BUENOS AIRES,4,6,3,5,8
06,06112,061120704,Bragado,BUENOS AIRES,10,28,9,13,22
06,06112,061120804,Bragado,BUENOS AIRES,6,11,7,11,18
06,06112,061120904,Bragado,BUENOS AIRES,14,15,15,16,31
06,06112,061121202,Bragado,BUENOS AIRES,5,10,5,5,10
06,06322,063220603,General La Madrid,BUENOS AIRES,191,231,245,180,425
06,06322,063220606,General La Madrid,BUENOS AIRES,140,162,207,164,371
06,06322,063221202,General La Madrid,BUENOS AIRES,4,12,4,8,12
06,06322,063220101,General La Madrid,BUENOS AIRES,2,7,2,4,6
06,06322,063220302,General La Madrid,BUENOS AIRES,19,31,17,28,45
06,06322,063221006,General La Madrid,BUENOS AIRES,9,20,8,17,25
06,06322,063221007,General La Madrid,BUENOS AIRES,44,66,44,71,115
06,06322,063221201,General La Madrid,BUENOS AIRES,10,14,11,16,27
06,06322,063221303,General La Madrid,BUENOS AIRES,12,17,13,21,34
06,06322,063220601,General La Madrid,BUENOS AIRES,388,475,577,580,1157
06,06322,063220604,General La Madrid,BUENOS AIRES,197,220,272,251,523
06,06322,063220617,General La Madrid,BUENOS AIRES,255,293,440,409,849
06,06322,063221002,General La Madrid,BUENOS AIRES,25,42,33,35,68
06,06322,063220505,General La Madrid,BUENOS AIRES,11,31,12,19,31
06,06322,063220705,General La Madrid,BUENOS AIRES,10,28,5,12,17
06,06322,063221103,General La Madrid,BUENOS AIRES,10,23,13,13,26
06,06322,063220611,General La Madrid,BUENOS AIRES,53,64,87,98,185
06,06322,063220702,General La Madrid,BUENOS AIRES,16,28,14,27,41
06,06322,063220305,General La Madrid,BUENOS AIRES,13,14,13,32,45
06,06322,063220401,General La Madrid,BUENOS AIRES,6,8,6,12,18
06,06322,063220403,General La Madrid,BUENOS AIRES,10,10,6,15,21
06,06322,063220902,General La Madrid,BUENOS AIRES,10,27,17,18,35
06,06322,063220802,General La Madrid,BUENOS AIRES,8,13,9,16,25
06,06322,063220607,General La Madrid,BUENOS AIRES,194,217,313,290,603
06,06322,063220616,General La Madrid,BUENOS AIRES,188,213,275,277,552
06,06322,063220103,General La Madrid,BUENOS AIRES,11,15,12,17,29
06,06322,063220304,General La Madrid,BUENOS AIRES,18,38,27,30,57
06,06322,063220803,General La Madrid,BUENOS AIRES,16,14,14,22,36
06,06322,063220801,General La Madrid,BUENOS AIRES,8,13,10,12,22
06,06322,063221101,General La Madrid,BUENOS AIRES,11,18,11,22,33
06,06322,063221102,General La Madrid,BUENOS AIRES,12,20,10,21,31
06,06322,063220307,General La Madrid,BUENOS AIRES,125,165,178,163,341
06,06322,063220602,General La Madrid,BUENOS AIRES,272,315,361,313,674
06,06322,063220612,General La Madrid,BUENOS AIRES,244,318,405,366,771
06,06322,063220701,General La Madrid,BUENOS AIRES,68,88,89,85,174
06,06322,063220903,General La Madrid,BUENOS AIRES,5,13,3,5,8
06,06322,063220102,General La Madrid,BUENOS AIRES,3,13,1,5,6
06,06322,063220203,General La Madrid,BUENOS AIRES,4,9,6,7,13
06,06322,063220405,General La Madrid,BUENOS AIRES,5,7,5,7,12
06,06322,063220502,General La Madrid,BUENOS AIRES,10,16,4,10,14
06,06322,063220609,General La Madrid,BUENOS AIRES,5,12,7,9,16
06,06322,063221004,General La Madrid,BUENOS AIRES,24,36,25,39,64
06,06322,063221005,General La Madrid,BUENOS AIRES,22,29,27,34,61
06,06322,063221301,General La Madrid,BUENOS AIRES,6,11,10,10,20
06,06322,063221302,General La Madrid,BUENOS AIRES,9,13,6,16,22
06,06322,063220615,General La Madrid,BUENOS AIRES,146,178,227,193,420
06,06322,063221001,General La Madrid,BUENOS AIRES,112,152,144,148,292
06,06322,063220504,General La Madrid,BUENOS AIRES,4,15,3,6,9
06,06322,063220202,General La Madrid,BUENOS AIRES,6,18,5,12,17
06,06322,063220303,General La Madrid,BUENOS AIRES,4,17,3,7,10
06,06322,063220402,General La Madrid,BUENOS AIRES,6,12,5,11,16
06,06322,063220901,General La Madrid,BUENOS AIRES,17,31,28,24,52
06,06322,063220608,General La Madrid,BUENOS AIRES,28,49,40,45,85
06,06322,063220610,General La Madrid,BUENOS AIRES,1,6,0,1,1
06,06322,063220703,General La Madrid,BUENOS AIRES,17,26,24,31,55
06,06322,063220704,General La Madrid,BUENOS AIRES,6,9,7,9,16
06,06322,063221304,General La Madrid,BUENOS AIRES,8,20,12,11,23
06,06322,063220301,General La Madrid,BUENOS AIRES,97,126,160,162,322
06,06322,063220605,General La Madrid,BUENOS AIRES,212,258,280,241,521
06,06322,063220613,General La Madrid,BUENOS AIRES,142,274,233,207,440
06,06322,063220201,General La Madrid,BUENOS AIRES,16,18,19,28,47
06,06322,063220306,General La Madrid,BUENOS AIRES,11,14,20,19,39
06,06322,063221008,General La Madrid,BUENOS AIRES,16,30,14,22,36
06,06322,063221203,General La Madrid,BUENOS AIRES,7,10,5,7,12
06,06322,063220614,General La Madrid,BUENOS AIRES,177,197,333,287,620
06,06322,063220204,General La Madrid,BUENOS AIRES,7,25,9,12,21
06,06322,063220404,General La Madrid,BUENOS AIRES,6,13,1,9,10
06,06322,063220501,General La Madrid,BUENOS AIRES,10,17,10,9,19
06,06322,063220503,General La Madrid,BUENOS AIRES,9,23,7,12,19
06,06322,063221003,General La Madrid,BUENOS AIRES,9,15,12,9,21
06,06168,061680903,Castelli,BUENOS AIRES,220,262,357,297,654
06,06168,061680906,Castelli,BUENOS AIRES,223,262,385,356,741
06,06168,061680102,Castelli,BUENOS AIRES,10,15,14,23,37
06,06168,061680101,Castelli,BUENOS AIRES,12,15,29,24,53
06,06168,061680301,Castelli,BUENOS AIRES,16,30,16,25,41
06,06168,061680601,Castelli,BUENOS AIRES,4,11,5,6,11
06,06168,061680604,Castelli,BUENOS AIRES,7,13,8,14,22
06,06168,061680805,Castelli,BUENOS AIRES,38,50,57,62,119
06,06168,061680806,Castelli,BUENOS AIRES,9,11,13,16,29
06,06168,061681101,Castelli,BUENOS AIRES,25,33,29,36,65
06,06168,061680204,Castelli,BUENOS AIRES,4,7,8,11,19
06,06168,061680804,Castelli,BUENOS AIRES,6,13,6,8,14
06,06168,061680403,Castelli,BUENOS AIRES,8,11,11,14,25
06,06168,061681002,Castelli,BUENOS AIRES,9,10,16,17,33
06,06168,061680904,Castelli,BUENOS AIRES,348,419,521,477,998
06,06168,061680104,Castelli,BUENOS AIRES,10,17,15,15,30
06,06168,061680702,Castelli,BUENOS AIRES,7,15,11,12,23
06,06168,061680801,Castelli,BUENOS AIRES,17,29,18,28,46
06,06168,061681102,Castelli,BUENOS AIRES,14,18,14,21,35
06,06168,061680802,Castelli,BUENOS AIRES,12,16,18,21,39
06,06168,061680803,Castelli,BUENOS AIRES,21,34,36,27,63
06,06168,061680901,Castelli,BUENOS AIRES,252,272,469,428,897
06,06168,061680902,Castelli,BUENOS AIRES,284,324,386,386,772
06,06168,061680908,Castelli,BUENOS AIRES,178,215,339,298,637
06,06168,061680201,Castelli,BUENOS AIRES,11,11,22,23,45
06,06168,061680202,Castelli,BUENOS AIRES,8,8,18,22,40
06,06168,061680502,Castelli,BUENOS AIRES,7,14,7,13,20
06,06168,061680603,Castelli,BUENOS AIRES,13,21,7,18,25
06,06168,061680807,Castelli,BUENOS AIRES,196,210,311,276,587
06,06168,061680907,Castelli,BUENOS AIRES,183,204,300,276,576
06,06168,061680303,Castelli,BUENOS AIRES,16,27,15,24,39
06,06168,061680402,Castelli,BUENOS AIRES,10,12,14,18,32
06,06168,061680405,Castelli,BUENOS AIRES,1,11,1,0,1
06,06168,061680503,Castelli,BUENOS AIRES,8,14,10,11,21
06,06168,061681003,Castelli,BUENOS AIRES,22,45,28,33,61
06,06168,061681001,Castelli,BUENOS AIRES,95,123,141,140,281
06,06168,061680905,Castelli,BUENOS AIRES,316,367,436,369,805
06,06168,061680404,Castelli,BUENOS AIRES,3,7,1,3,4
06,06168,061680501,Castelli,BUENOS AIRES,47,73,70,73,143
06,06168,061680103,Castelli,BUENOS AIRES,12,20,13,18,31
06,06168,061680406,Castelli,BUENOS AIRES,2,7,1,3,4
06,06168,061680203,Castelli,BUENOS AIRES,13,20,14,18,32
06,06168,061680302,Castelli,BUENOS AIRES,3,12,0,6,6
06,06168,061680401,Castelli,BUENOS AIRES,6,12,3,10,13
06,06168,061680602,Castelli,BUENOS AIRES,5,24,5,10,15
06,06168,061680701,Castelli,BUENOS AIRES,10,27,10,11,21
06,06371,063712308,General San Martín,BUENOS AIRES,296,340,493,382,875
06,06371,063710408,General San Martín,BUENOS AIRES,209,211,286,265,551
06,06371,063710109,General San Martín,BUENOS AIRES,323,235,687,626,1313
06,06371,063710204,General San Martín,BUENOS AIRES,387,381,735,690,1425
06,06371,063710302,General San Martín,BUENOS AIRES,265,243,446,387,833
06,06371,063710311,General San Martín,BUENOS AIRES,349,351,620,544,1164
06,06371,063710315,General San Martín,BUENOS AIRES,360,351,556,474,1030
06,06371,063710407,General San Martín,BUENOS AIRES,384,367,575,494,1069
06,06371,063710602,General San Martín,BUENOS AIRES,260,219,396,375,771
06,06371,063710709,General San Martín,BUENOS AIRES,402,379,604,557,1161
06,06371,063710801,General San Martín,BUENOS AIRES,440,445,756,736,1492
06,06371,063710807,General San Martín,BUENOS AIRES,276,301,416,358,774
06,06371,063710902,General San Martín,BUENOS AIRES,398,421,612,524,1136
06,06371,063710914,General San Martín,BUENOS AIRES,345,389,549,478,1027
06,06371,063710916,General San Martín,BUENOS AIRES,223,218,331,296,627
06,06371,063710917,General San Martín,BUENOS AIRES,332,348,549,475,1024
06,06371,063711007,General San Martín,BUENOS AIRES,453,422,651,588,1239
06,06371,063711009,General San Martín,BUENOS AIRES,309,349,448,409,857
06,06371,063711010,General San Martín,BUENOS AIRES,357,421,510,471,981
06,06371,063711013,General San Martín,BUENOS AIRES,416,374,691,651,1342
06,06371,063711107,General San Martín,BUENOS AIRES,356,410,550,457,1007
06,06371,063711206,General San Martín,BUENOS AIRES,196,266,280,241,521
06,06371,063711305,General San Martín,BUENOS AIRES,321,372,523,436,959
06,06371,063711306,General San Martín,BUENOS AIRES,370,394,613,528,1141
06,06371,063711405,General San Martín,BUENOS AIRES,202,178,374,383,757
06,06371,063711501,General San Martín,BUENOS AIRES,70,49,142,162,304
06,06371,063711503,General San Martín,BUENOS AIRES,382,345,764,767,1531
06,06371,063711506,General San Martín,BUENOS AIRES,460,471,792,789,1581
06,06371,063711507,General San Martín,BUENOS AIRES,203,203,403,421,824
06,06371,063711513,General San Martín,BUENOS AIRES,251,241,500,404,904
06,06371,063711514,General San Martín,BUENOS AIRES,289,282,542,474,1016
06,06371,063711602,General San Martín,BUENOS AIRES,185,158,359,408,767
06,06371,063711609,General San Martín,BUENOS AIRES,374,415,546,540,1086
06,06371,063711710,General San Martín,BUENOS AIRES,412,411,696,616,1312
06,06371,063711809,General San Martín,BUENOS AIRES,279,283,419,380,799
06,06371,063711902,General San Martín,BUENOS AIRES,323,381,393,286,679
06,06371,063711904,General San Martín,BUENOS AIRES,308,371,458,396,854
06,06371,063712204,General San Martín,BUENOS AIRES,328,445,443,365,808
06,06371,063712206,General San Martín,BUENOS AIRES,190,229,239,212,451
06,06371,063712213,General San Martín,BUENOS AIRES,213,274,297,261,558
06,06371,063712309,General San Martín,BUENOS AIRES,271,478,334,241,575
06,06371,063712314,General San Martín,BUENOS AIRES,314,335,485,409,894
06,06371,063712603,General San Martín,BUENOS AIRES,322,323,526,443,969
06,06371,063712402,General San Martín,BUENOS AIRES,227,245,355,346,701
06,06371,063712503,General San Martín,BUENOS AIRES,200,239,285,260,545
06,06371,063712704,General San Martín,BUENOS AIRES,379,366,575,526,1101
06,06371,063712707,General San Martín,BUENOS AIRES,197,221,299,255,554
06,06371,063712802,General San Martín,BUENOS AIRES,47,54,62,64,126
06,06371,063712901,General San Martín,BUENOS AIRES,307,337,401,386,787
06,06371,063712907,General San Martín,BUENOS AIRES,501,459,799,711,1510
06,06371,063713102,General San Martín,BUENOS AIRES,218,234,348,293,641
06,06371,063713202,General San Martín,BUENOS AIRES,442,429,750,689,1439
06,06371,063713204,General San Martín,BUENOS AIRES,358,335,624,631,1255
06,06371,063713212,General San Martín,BUENOS AIRES,370,314,627,592,1219
06,06371,063713214,General San Martín,BUENOS AIRES,463,465,826,784,1610
06,06371,063713215,General San Martín,BUENOS AIRES,290,267,471,458,929
06,06371,063713501,General San Martín,BUENOS AIRES,373,400,641,561,1202
06,06371,063713509,General San Martín,BUENOS AIRES,40,44,76,96,172
06,06371,063713514,General San Martín,BUENOS AIRES,227,196,404,351,755
06,06371,063713602,General San Martín,BUENOS AIRES,345,251,626,585,1211
06,06371,063713605,General San Martín,BUENOS AIRES,296,309,511,493,1004
06,06371,063713701,General San Martín,BUENOS AIRES,302,262,507,518,1025
06,06371,063713710,General San Martín,BUENOS AIRES,448,450,824,827,1651
06,06371,063713712,General San Martín,BUENOS AIRES,371,349,668,689,1357
06,06371,063711104,General San Martín,BUENOS AIRES,337,460,405,303,708
06,06371,063710503,General San Martín,BUENOS AIRES,186,188,267,238,505
06,06371,063710209,General San Martín,BUENOS AIRES,398,419,628,553,1181
06,06371,063710103,General San Martín,BUENOS AIRES,405,374,765,790,1555
06,06371,063710205,General San Martín,BUENOS AIRES,524,513,983,974,1957
06,06371,063710303,General San Martín,BUENOS AIRES,176,158,295,239,534
06,06371,063710307,General San Martín,BUENOS AIRES,336,351,521,485,1006
06,06371,063710310,General San Martín,BUENOS AIRES,238,240,466,378,844
06,06371,063710509,General San Martín,BUENOS AIRES,394,404,629,556,1185
06,06371,063710603,General San Martín,BUENOS AIRES,302,262,497,471,968
06,06371,063710609,General San Martín,BUENOS AIRES,372,326,769,729,1498
06,06371,063710611,General San Martín,BUENOS AIRES,434,428,816,808,1624
06,06371,063710702,General San Martín,BUENOS AIRES,461,456,987,897,1884
06,06371,063710901,General San Martín,BUENOS AIRES,391,385,613,568,1181
06,06371,063710803,General San Martín,BUENOS AIRES,319,355,522,436,958
06,06371,063710805,General San Martín,BUENOS AIRES,303,352,452,402,854
06,06371,063710903,General San Martín,BUENOS AIRES,258,269,441,361,802
06,06371,063710907,General San Martín,BUENOS AIRES,308,300,517,487,1004
06,06371,063711015,General San Martín,BUENOS AIRES,339,378,532,400,932
06,06371,063711201,General San Martín,BUENOS AIRES,384,424,584,487,1071
06,06371,063711205,General San Martín,BUENOS AIRES,227,274,275,261,536
06,06371,063711307,General San Martín,BUENOS AIRES,393,428,604,544,1148
06,06371,063711309,General San Martín,BUENOS AIRES,429,438,688,581,1269
06,06371,063711409,General San Martín,BUENOS AIRES,246,217,480,475,955
06,06371,063711504,General San Martín,BUENOS AIRES,145,130,295,285,580
06,06371,063711508,General San Martín,BUENOS AIRES,182,154,372,382,754
06,06371,063711801,General San Martín,BUENOS AIRES,399,396,591,536,1127
06,06371,063711811,General San Martín,BUENOS AIRES,434,464,651,586,1237
06,06371,063711815,General San Martín,BUENOS AIRES,451,453,755,668,1423
06,06371,063711905,General San Martín,BUENOS AIRES,330,381,483,445,928
06,06371,063711908,General San Martín,BUENOS AIRES,339,367,488,437,925
06,06371,063712004,General San Martín,BUENOS AIRES,404,439,600,545,1145
06,06371,063712007,General San Martín,BUENOS AIRES,405,386,644,562,1206
06,06371,063712104,General San Martín,BUENOS AIRES,176,215,255,219,474
06,06371,063712106,General San Martín,BUENOS AIRES,119,130,202,178,380
06,06371,063712110,General San Martín,BUENOS AIRES,324,342,488,446,934
06,06371,063712114,General San Martín,BUENOS AIRES,292,330,466,373,839
06,06371,063712201,General San Martín,BUENOS AIRES,314,354,437,423,860
06,06371,063712207,General San Martín,BUENOS AIRES,335,357,500,452,952
06,06371,063712310,General San Martín,BUENOS AIRES,200,341,239,206,445
06,06371,063712403,General San Martín,BUENOS AIRES,411,430,614,559,1173
06,06371,063712501,General San Martín,BUENOS AIRES,271,290,402,394,796
06,06371,063712502,General San Martín,BUENOS AIRES,296,318,527,428,955
06,06371,063712602,General San Martín,BUENOS AIRES,236,216,444,345,789
06,06371,063712705,General San Martín,BUENOS AIRES,306,345,472,422,894
06,06371,063712706,General San Martín,BUENOS AIRES,179,182,286,244,530
06,06371,063712803,General San Martín,BUENOS AIRES,32,46,51,38,89
06,06371,063712804,General San Martín,BUENOS AIRES,104,120,152,165,317
06,06371,063712904,General San Martín,BUENOS AIRES,326,375,489,418,907
06,06371,063713003,General San Martín,BUENOS AIRES,348,286,550,561,1111
06,06371,063713007,General San Martín,BUENOS AIRES,222,249,325,290,615
06,06371,063713008,General San Martín,BUENOS AIRES,256,270,338,347,685
06,06371,063713201,General San Martín,BUENOS AIRES,66,107,133,134,267
06,06371,063713305,General San Martín,BUENOS AIRES,424,464,686,594,1280
06,06371,063713310,General San Martín,BUENOS AIRES,199,213,263,234,497
06,06371,063713402,General San Martín,BUENOS AIRES,392,350,625,573,1198
06,06371,063713407,General San Martín,BUENOS AIRES,330,324,543,496,1039
06,06371,063713503,General San Martín,BUENOS AIRES,255,231,426,422,848
06,06371,063713705,General San Martín,BUENOS AIRES,182,153,348,366,714
06,06371,063710508,General San Martín,BUENOS AIRES,194,207,341,301,642
06,06371,063710208,General San Martín,BUENOS AIRES,289,297,457,426,883
06,06371,063710210,General San Martín,BUENOS AIRES,416,392,650,627,1277
06,06371,063710101,General San Martín,BUENOS AIRES,343,271,661,640,1301
06,06371,063710104,General San Martín,BUENOS AIRES,234,246,428,394,822
06,06371,063710201,General San Martín,BUENOS AIRES,403,397,723,664,1387
06,06371,063710207,General San Martín,BUENOS AIRES,256,253,429,374,803
06,06371,063710301,General San Martín,BUENOS AIRES,418,420,717,571,1288
06,06371,063710510,General San Martín,BUENOS AIRES,382,395,624,580,1204
06,06371,063710606,General San Martín,BUENOS AIRES,301,280,479,442,921
06,06371,063710704,General San Martín,BUENOS AIRES,360,305,681,692,1373
06,06371,063710712,General San Martín,BUENOS AIRES,317,361,487,474,961
06,06371,063710802,General San Martín,BUENOS AIRES,371,303,605,547,1152
06,06371,063710905,General San Martín,BUENOS AIRES,317,293,479,444,923
06,06371,063710909,General San Martín,BUENOS AIRES,389,400,625,549,1174
06,06371,063710911,General San Martín,BUENOS AIRES,190,194,276,251,527
06,06371,063711004,General San Martín,BUENOS AIRES,220,236,309,253,562
06,06371,063711008,General San Martín,BUENOS AIRES,301,339,439,388,827
06,06371,063711101,General San Martín,BUENOS AIRES,274,304,399,321,720
06,06371,063711106,General San Martín,BUENOS AIRES,231,328,290,240,530
06,06371,063711109,General San Martín,BUENOS AIRES,181,223,256,230,486
06,06371,063711202,General San Martín,BUENOS AIRES,296,298,426,391,817
06,06371,063711210,General San Martín,BUENOS AIRES,297,415,374,275,649
06,06371,063711312,General San Martín,BUENOS AIRES,373,418,546,551,1097
06,06371,063711512,General San Martín,BUENOS AIRES,291,258,531,521,1052
06,06371,063711603,General San Martín,BUENOS AIRES,174,158,362,367,729
06,06371,063711711,General San Martín,BUENOS AIRES,346,368,532,487,1019
06,06371,063711804,General San Martín,BUENOS AIRES,370,418,519,491,1010
06,06371,063712005,General San Martín,BUENOS AIRES,286,289,424,380,804
06,06371,063712006,General San Martín,BUENOS AIRES,375,407,564,498,1062
06,06371,063712209,General San Martín,BUENOS AIRES,188,242,224,192,416
06,06371,063712301,General San Martín,BUENOS AIRES,297,386,429,337,766
06,06371,063712304,General San Martín,BUENOS AIRES,220,374,301,262,563
06,06371,063712306,General San Martín,BUENOS AIRES,260,312,372,321,693
06,06371,063712404,General San Martín,BUENOS AIRES,176,151,260,242,502
06,06371,063712406,General San Martín,BUENOS AIRES,222,230,306,314,620
06,06371,063712607,General San Martín,BUENOS AIRES,252,299,373,343,716
06,06371,063713001,General San Martín,BUENOS AIRES,292,293,443,406,849
06,06371,063713106,General San Martín,BUENOS AIRES,453,473,685,618,1303
06,06371,063713203,General San Martín,BUENOS AIRES,386,364,686,616,1302
06,06371,063713209,General San Martín,BUENOS AIRES,240,257,382,342,724
06,06371,063713309,General San Martín,BUENOS AIRES,349,341,583,497,1080
06,06371,063713511,General San Martín,BUENOS AIRES,418,385,765,832,1597
06,06371,063713513,General San Martín,BUENOS AIRES,328,334,550,528,1078
06,06371,063713604,General San Martín,BUENOS AIRES,558,489,938,924,1862
06,06371,063713610,General San Martín,BUENOS AIRES,353,392,550,515,1065
06,06371,063713716,General San Martín,BUENOS AIRES,480,455,843,775,1618
06,06371,063713703,General San Martín,BUENOS AIRES,198,191,393,388,781
06,06371,063713704,General San Martín,BUENOS AIRES,143,114,256,250,506
06,06371,063713708,General San Martín,BUENOS AIRES,641,585,1143,1166,2309
06,06371,063711108,General San Martín,BUENOS AIRES,245,342,298,252,550
06,06371,063710504,General San Martín,BUENOS AIRES,245,242,368,326,694
06,06371,063710211,General San Martín,BUENOS AIRES,261,256,444,415,859
06,06371,063710105,General San Martín,BUENOS AIRES,189,173,347,372,719
06,06371,063710108,General San Martín,BUENOS AIRES,111,102,230,251,481
06,06371,063710305,General San Martín,BUENOS AIRES,361,312,521,509,1030
06,06371,063710312,General San Martín,BUENOS AIRES,115,119,225,210,435
06,06371,063710607,General San Martín,BUENOS AIRES,303,262,493,448,941
06,06371,063710710,General San Martín,BUENOS AIRES,222,239,332,304,636
06,06371,063710806,General San Martín,BUENOS AIRES,406,428,683,611,1294
06,06371,063710906,General San Martín,BUENOS AIRES,504,514,796,671,1467
06,06371,063710908,General San Martín,BUENOS AIRES,371,388,613,516,1129
06,06371,063711002,General San Martín,BUENOS AIRES,382,427,583,513,1096
06,06371,063711005,General San Martín,BUENOS AIRES,228,276,349,325,674
06,06371,063711011,General San Martín,BUENOS AIRES,293,347,468,378,846
06,06371,063711012,General San Martín,BUENOS AIRES,108,105,185,191,376
06,06371,063711016,General San Martín,BUENOS AIRES,193,214,308,263,571
06,06371,063711204,General San Martín,BUENOS AIRES,378,412,563,531,1094
06,06371,063711302,General San Martín,BUENOS AIRES,319,350,500,481,981
06,06371,063711411,General San Martín,BUENOS AIRES,278,246,475,436,911
06,06371,063711502,General San Martín,BUENOS AIRES,236,214,509,463,972
06,06371,063711606,General San Martín,BUENOS AIRES,190,165,331,325,656
06,06371,063711607,General San Martín,BUENOS AIRES,250,261,376,347,723
06,06371,063711610,General San Martín,BUENOS AIRES,261,268,468,393,861
06,06371,063711611,General San Martín,BUENOS AIRES,285,273,514,480,994
06,06371,063711712,General San Martín,BUENOS AIRES,258,278,403,376,779
06,06371,063711714,General San Martín,BUENOS AIRES,343,374,527,492,1019
06,06371,063711808,General San Martín,BUENOS AIRES,275,274,455,420,875
06,06371,063711814,General San Martín,BUENOS AIRES,460,493,754,671,1425
06,06371,063712003,General San Martín,BUENOS AIRES,302,297,490,395,885
06,06371,063712107,General San Martín,BUENOS AIRES,274,303,479,391,870
06,06371,063712108,General San Martín,BUENOS AIRES,375,428,604,526,1130
06,06371,063712109,General San Martín,BUENOS AIRES,336,410,437,396,833
06,06371,063712205,General San Martín,BUENOS AIRES,211,226,304,271,575
06,06371,063712208,General San Martín,BUENOS AIRES,230,306,320,230,550
06,06371,063712211,General San Martín,BUENOS AIRES,134,259,152,126,278
06,06371,063712212,General San Martín,BUENOS AIRES,208,269,239,227,466
06,06371,063712405,General San Martín,BUENOS AIRES,205,213,319,297,616
06,06371,063712507,General San Martín,BUENOS AIRES,327,348,511,446,957
06,06371,063712606,General San Martín,BUENOS AIRES,321,301,539,524,1063
06,06371,063712608,General San Martín,BUENOS AIRES,248,266,385,353,738
06,06371,063712902,General San Martín,BUENOS AIRES,205,306,274,218,492
06,06371,063713005,General San Martín,BUENOS AIRES,297,336,441,396,837
06,06371,063713006,General San Martín,BUENOS AIRES,297,327,661,578,1239
06,06371,063713101,General San Martín,BUENOS AIRES,331,337,536,468,1004
06,06371,063713105,General San Martín,BUENOS AIRES,301,300,470,414,884
06,06371,063713206,General San Martín,BUENOS AIRES,403,389,512,455,967
06,06371,063713306,General San Martín,BUENOS AIRES,415,421,705,625,1330
06,06371,063713505,General San Martín,BUENOS AIRES,244,225,422,398,820
06,06371,063710502,General San Martín,BUENOS AIRES,360,316,571,492,1063
06,06371,063713010,General San Martín,BUENOS AIRES,132,119,266,245,511
06,06371,063713108,General San Martín,BUENOS AIRES,304,290,472,416,888
06,06371,063710106,General San Martín,BUENOS AIRES,162,130,349,305,654
06,06371,063710107,General San Martín,BUENOS AIRES,102,101,196,222,418
06,06371,063710203,General San Martín,BUENOS AIRES,426,406,627,586,1213
06,06371,063710401,General San Martín,BUENOS AIRES,478,465,758,620,1378
06,06371,063710701,General San Martín,BUENOS AIRES,283,299,506,429,935
06,06371,063710706,General San Martín,BUENOS AIRES,426,310,777,782,1559
06,06371,063710808,General San Martín,BUENOS AIRES,359,391,551,500,1051
06,06371,063710810,General San Martín,BUENOS AIRES,340,378,513,464,977
06,06371,063711003,General San Martín,BUENOS AIRES,352,380,525,478,1003
06,06371,063711102,General San Martín,BUENOS AIRES,237,284,411,251,662
06,06371,063711208,General San Martín,BUENOS AIRES,432,495,635,583,1218
06,06371,063711404,General San Martín,BUENOS AIRES,248,254,515,473,988
06,06371,063711412,General San Martín,BUENOS AIRES,281,253,455,405,860
06,06371,063711505,General San Martín,BUENOS AIRES,654,508,1257,1251,2508
06,06371,063711702,General San Martín,BUENOS AIRES,331,364,529,430,959
06,06371,063711704,General San Martín,BUENOS AIRES,321,348,499,461,960
06,06371,063711707,General San Martín,BUENOS AIRES,305,338,434,424,858
06,06371,063711713,General San Martín,BUENOS AIRES,368,406,595,539,1134
06,06371,063711903,General San Martín,BUENOS AIRES,309,379,409,391,800
06,06371,063711907,General San Martín,BUENOS AIRES,370,418,563,466,1029
06,06371,063712203,General San Martín,BUENOS AIRES,276,288,444,406,850
06,06371,063712101,General San Martín,BUENOS AIRES,312,388,540,548,1088
06,06371,063712113,General San Martín,BUENOS AIRES,292,318,426,387,813
06,06371,063712302,General San Martín,BUENOS AIRES,414,446,709,551,1260
06,06371,063712303,General San Martín,BUENOS AIRES,150,281,198,157,355
06,06371,063712316,General San Martín,BUENOS AIRES,426,446,671,577,1248
06,06371,063712317,General San Martín,BUENOS AIRES,278,333,406,383,789
06,06371,063712504,General San Martín,BUENOS AIRES,297,353,485,451,936
06,06371,063712601,General San Martín,BUENOS AIRES,371,400,546,508,1054
06,06371,063712604,General San Martín,BUENOS AIRES,334,360,491,477,968
06,06371,063712703,General San Martín,BUENOS AIRES,524,545,883,881,1764
06,06371,063712905,General San Martín,BUENOS AIRES,404,458,633,580,1213
06,06371,063712908,General San Martín,BUENOS AIRES,654,681,1011,891,1902
06,06371,063713210,General San Martín,BUENOS AIRES,440,413,725,699,1424
06,06371,063713301,General San Martín,BUENOS AIRES,267,266,506,472,978
06,06371,063713405,General San Martín,BUENOS AIRES,460,444,811,793,1604
06,06371,063713406,General San Martín,BUENOS AIRES,284,298,457,430,887
06,06371,063713408,General San Martín,BUENOS AIRES,349,377,540,471,1011
06,06371,063713508,General San Martín,BUENOS AIRES,54,22,112,130,242
06,06371,063711406,General San Martín,BUENOS AIRES,385,370,764,721,1485
06,06371,063711414,General San Martín,BUENOS AIRES,300,237,612,611,1223
06,06371,063711509,General San Martín,BUENOS AIRES,198,212,335,337,672
06,06371,063711701,General San Martín,BUENOS AIRES,362,425,570,508,1078
06,06371,063711706,General San Martín,BUENOS AIRES,333,376,475,434,909
06,06371,063711709,General San Martín,BUENOS AIRES,309,379,495,413,908
06,06371,063711810,General San Martín,BUENOS AIRES,236,242,381,322,703
06,06371,063711901,General San Martín,BUENOS AIRES,210,267,316,240,556
06,06371,063712001,General San Martín,BUENOS AIRES,372,408,527,496,1023
06,06371,063712002,General San Martín,BUENOS AIRES,373,408,602,532,1134
06,06371,063712111,General San Martín,BUENOS AIRES,404,461,571,473,1044
06,06371,063712214,General San Martín,BUENOS AIRES,241,354,315,238,553
06,06371,063712311,General San Martín,BUENOS AIRES,253,330,324,426,750
06,06371,063712312,General San Martín,BUENOS AIRES,233,344,291,366,657
06,06371,063712313,General San Martín,BUENOS AIRES,249,464,328,386,714
06,06371,063712506,General San Martín,BUENOS AIRES,299,330,488,435,923
06,06371,063712508,General San Martín,BUENOS AIRES,292,313,432,405,837
06,06371,063712605,General San Martín,BUENOS AIRES,223,200,354,275,629
06,06371,063712805,General San Martín,BUENOS AIRES,67,72,91,102,193
06,06371,063712807,General San Martín,BUENOS AIRES,83,89,147,113,260
06,06371,063713004,General San Martín,BUENOS AIRES,251,246,392,379,771
06,06371,063713205,General San Martín,BUENOS AIRES,321,337,604,566,1170
06,06371,063713207,General San Martín,BUENOS AIRES,291,294,488,437,925
06,06371,063713208,General San Martín,BUENOS AIRES,456,482,802,703,1505
06,06371,063713211,General San Martín,BUENOS AIRES,412,419,682,693,1375
06,06371,063713303,General San Martín,BUENOS AIRES,415,424,689,676,1365
06,06371,063713304,General San Martín,BUENOS AIRES,307,325,508,469,977
06,06371,063713404,General San Martín,BUENOS AIRES,242,261,354,358,712
06,06371,063713510,General San Martín,BUENOS AIRES,290,227,504,491,995
06,06371,063713601,General San Martín,BUENOS AIRES,603,397,1227,1168,2395
06,06371,063713607,General San Martín,BUENOS AIRES,401,363,749,681,1430
06,06371,063713611,General San Martín,BUENOS AIRES,415,431,607,588,1195
06,06371,063713702,General San Martín,BUENOS AIRES,363,335,693,680,1373
06,06371,063710505,General San Martín,BUENOS AIRES,263,247,398,385,783
06,06371,063710507,General San Martín,BUENOS AIRES,265,286,442,386,828
06,06371,063710212,General San Martín,BUENOS AIRES,268,207,412,388,800
06,06371,063710102,General San Martín,BUENOS AIRES,288,273,490,471,961
06,06371,063710313,General San Martín,BUENOS AIRES,204,212,367,324,691
06,06371,063710405,General San Martín,BUENOS AIRES,356,342,539,509,1048
06,06371,063710605,General San Martín,BUENOS AIRES,250,265,419,383,802
06,06371,063710610,General San Martín,BUENOS AIRES,434,378,781,778,1559
06,06371,063710708,General San Martín,BUENOS AIRES,226,255,381,347,728
06,06371,063710809,General San Martín,BUENOS AIRES,365,386,555,518,1073
06,06371,063710910,General San Martín,BUENOS AIRES,378,413,550,523,1073
06,06371,063710912,General San Martín,BUENOS AIRES,233,263,374,308,682
06,06371,063710915,General San Martín,BUENOS AIRES,201,218,311,297,608
06,06371,063711001,General San Martín,BUENOS AIRES,302,320,438,410,848
06,06371,063711103,General San Martín,BUENOS AIRES,315,371,450,337,787
06,06371,063711805,General San Martín,BUENOS AIRES,340,383,534,459,993
06,06371,063710110,General San Martín,BUENOS AIRES,483,404,870,981,1851
06,06371,063710111,General San Martín,BUENOS AIRES,21,27,33,40,73
06,06371,063710202,General San Martín,BUENOS AIRES,393,388,724,637,1361
06,06371,063710206,General San Martín,BUENOS AIRES,333,290,571,507,1078
06,06371,063710304,General San Martín,BUENOS AIRES,501,418,784,711,1495
06,06371,063710306,General San Martín,BUENOS AIRES,349,315,581,555,1136
06,06371,063710308,General San Martín,BUENOS AIRES,400,382,646,638,1284
06,06371,063710406,General San Martín,BUENOS AIRES,428,429,678,610,1288
06,06371,063710601,General San Martín,BUENOS AIRES,233,237,362,339,701
06,06371,063710705,General San Martín,BUENOS AIRES,287,266,572,513,1085
06,06371,063710707,General San Martín,BUENOS AIRES,534,493,926,873,1799
06,06371,063710812,General San Martín,BUENOS AIRES,354,369,536,499,1035
06,06371,063711105,General San Martín,BUENOS AIRES,280,380,318,254,572
06,06371,063711203,General San Martín,BUENOS AIRES,223,230,307,268,575
06,06371,063711207,General San Martín,BUENOS AIRES,322,329,433,402,835
06,06371,063711209,General San Martín,BUENOS AIRES,273,320,357,322,679
06,06371,063711301,General San Martín,BUENOS AIRES,337,346,544,466,1010
06,06371,063711303,General San Martín,BUENOS AIRES,411,433,618,599,1217
06,06371,063711304,General San Martín,BUENOS AIRES,349,407,531,461,992
06,06371,063711308,General San Martín,BUENOS AIRES,329,373,475,428,903
06,06371,063711402,General San Martín,BUENOS AIRES,288,318,453,400,853
06,06371,063711403,General San Martín,BUENOS AIRES,192,198,346,260,606
06,06371,063711410,General San Martín,BUENOS AIRES,252,213,451,452,903
06,06371,063711510,General San Martín,BUENOS AIRES,124,131,220,226,446
06,06371,063711601,General San Martín,BUENOS AIRES,212,159,482,503,985
06,06371,063711604,General San Martín,BUENOS AIRES,336,297,651,681,1332
06,06371,063711605,General San Martín,BUENOS AIRES,111,63,193,204,397
06,06371,063711608,General San Martín,BUENOS AIRES,341,347,553,516,1069
06,06371,063711613,General San Martín,BUENOS AIRES,345,327,581,519,1100
06,06371,063711614,General San Martín,BUENOS AIRES,265,244,454,436,890
06,06371,063711806,General San Martín,BUENOS AIRES,370,368,611,521,1132
06,06371,063711807,General San Martín,BUENOS AIRES,372,369,606,544,1150
06,06371,063711813,General San Martín,BUENOS AIRES,434,381,755,663,1418
06,06371,063711909,General San Martín,BUENOS AIRES,394,480,556,474,1030
06,06371,063712008,General San Martín,BUENOS AIRES,225,237,350,301,651
06,06371,063712102,General San Martín,BUENOS AIRES,368,444,505,570,1075
06,06371,063712401,General San Martín,BUENOS AIRES,371,384,593,520,1113
06,06371,063712708,General San Martín,BUENOS AIRES,215,252,329,307,636
06,06371,063712801,General San Martín,BUENOS AIRES,172,166,325,338,663
06,06371,063712806,General San Martín,BUENOS AIRES,284,272,536,477,1013
06,06371,063712909,General San Martín,BUENOS AIRES,355,405,485,452,937
06,06371,063713002,General San Martín,BUENOS AIRES,394,413,649,591,1240
06,06371,063713011,General San Martín,BUENOS AIRES,310,351,458,412,870
06,06371,063713103,General San Martín,BUENOS AIRES,398,397,655,566,1221
06,06371,063713104,General San Martín,BUENOS AIRES,171,141,260,214,474
06,06371,063713213,General San Martín,BUENOS AIRES,372,383,604,598,1202
06,06371,063713308,General San Martín,BUENOS AIRES,257,231,427,360,787
06,06371,063713401,General San Martín,BUENOS AIRES,251,272,408,365,773
06,06371,063713403,General San Martín,BUENOS AIRES,160,157,239,210,449
06,06371,063713409,General San Martín,BUENOS AIRES,247,261,370,335,705
06,06371,063713504,General San Martín,BUENOS AIRES,235,223,400,374,774
06,06371,063713512,General San Martín,BUENOS AIRES,292,277,595,539,1134
06,06371,063713603,General San Martín,BUENOS AIRES,402,290,787,844,1631
06,06371,063713608,General San Martín,BUENOS AIRES,347,396,549,502,1051
06,06371,063713706,General San Martín,BUENOS AIRES,207,182,423,398,821
06,06371,063713709,General San Martín,BUENOS AIRES,501,465,887,871,1758
06,06371,063713711,General San Martín,BUENOS AIRES,410,379,880,896,1776
06,06371,063713713,General San Martín,BUENOS AIRES,447,383,821,774,1595
06,06371,063713714,General San Martín,BUENOS AIRES,377,368,691,631,1322
06,06371,063713715,General San Martín,BUENOS AIRES,411,357,698,680,1378
06,06371,063711311,General San Martín,BUENOS AIRES,329,379,469,453,922
06,06371,063710501,General San Martín,BUENOS AIRES,331,248,481,448,929
06,06371,063710506,General San Martín,BUENOS AIRES,379,346,611,513,1124
06,06371,063710309,General San Martín,BUENOS AIRES,292,292,622,518,1140
06,06371,063710314,General San Martín,BUENOS AIRES,230,238,355,307,662
06,06371,063710402,General San Martín,BUENOS AIRES,386,413,583,515,1098
06,06371,063710403,General San Martín,BUENOS AIRES,249,232,407,379,786
06,06371,063710404,General San Martín,BUENOS AIRES,211,228,338,290,628
06,06371,063710604,General San Martín,BUENOS AIRES,235,245,353,340,693
06,06371,063710608,General San Martín,BUENOS AIRES,246,177,415,422,837
06,06371,063710612,General San Martín,BUENOS AIRES,324,311,490,432,922
06,06371,063710703,General San Martín,BUENOS AIRES,335,273,646,605,1251
06,06371,063710711,General San Martín,BUENOS AIRES,228,219,368,336,704
06,06371,063710713,General San Martín,BUENOS AIRES,276,318,437,369,806
06,06371,063710804,General San Martín,BUENOS AIRES,317,343,512,461,973
06,06371,063710811,General San Martín,BUENOS AIRES,326,374,485,430,915
06,06371,063710904,General San Martín,BUENOS AIRES,219,230,367,301,668
06,06371,063710913,General San Martín,BUENOS AIRES,238,261,377,354,731
06,06371,063711006,General San Martín,BUENOS AIRES,361,399,575,543,1118
06,06371,063711014,General San Martín,BUENOS AIRES,304,319,458,385,843
06,06371,063711110,General San Martín,BUENOS AIRES,402,430,598,566,1164
06,06371,063711310,General San Martín,BUENOS AIRES,396,426,611,570,1181
06,06371,063711401,General San Martín,BUENOS AIRES,403,389,670,578,1248
06,06371,063711407,General San Martín,BUENOS AIRES,197,191,425,454,879
06,06371,063711408,General San Martín,BUENOS AIRES,254,244,520,537,1057
06,06371,063711413,General San Martín,BUENOS AIRES,268,298,408,366,774
06,06371,063711511,General San Martín,BUENOS AIRES,381,378,669,644,1313
06,06371,063711612,General San Martín,BUENOS AIRES,128,149,171,140,311
06,06371,063711703,General San Martín,BUENOS AIRES,323,357,493,441,934
06,06371,063711705,General San Martín,BUENOS AIRES,288,327,406,371,777
06,06371,063711708,General San Martín,BUENOS AIRES,304,323,455,399,854
06,06371,063711802,General San Martín,BUENOS AIRES,244,290,351,280,631
06,06371,063711803,General San Martín,BUENOS AIRES,382,467,502,440,942
06,06371,063711812,General San Martín,BUENOS AIRES,227,232,386,328,714
06,06371,063711906,General San Martín,BUENOS AIRES,242,247,435,375,810
06,06371,063712103,General San Martín,BUENOS AIRES,251,337,315,267,582
06,06371,063712105,General San Martín,BUENOS AIRES,421,479,646,591,1237
06,06371,063712112,General San Martín,BUENOS AIRES,200,229,351,289,640
06,06371,063712115,General San Martín,BUENOS AIRES,343,455,553,429,982
06,06371,063712202,General San Martín,BUENOS AIRES,259,345,382,348,730
06,06371,063712210,General San Martín,BUENOS AIRES,189,246,256,193,449
06,06371,063712305,General San Martín,BUENOS AIRES,239,310,285,219,504
06,06371,063712307,General San Martín,BUENOS AIRES,274,342,389,314,703
06,06371,063712315,General San Martín,BUENOS AIRES,433,468,685,595,1280
06,06371,063712407,General San Martín,BUENOS AIRES,235,272,342,304,646
06,06371,063712408,General San Martín,BUENOS AIRES,217,247,318,287,605
06,06371,063712505,General San Martín,BUENOS AIRES,340,368,532,494,1026
06,06371,063712903,General San Martín,BUENOS AIRES,204,257,344,285,629
06,06371,063712701,General San Martín,BUENOS AIRES,245,271,356,330,686
06,06371,063712702,General San Martín,BUENOS AIRES,339,361,543,482,1025
06,06371,063712808,General San Martín,BUENOS AIRES,321,297,556,473,1029
06,06371,063712906,General San Martín,BUENOS AIRES,178,202,300,239,539
06,06371,063713009,General San Martín,BUENOS AIRES,234,261,426,407,833
06,06371,063713107,General San Martín,BUENOS AIRES,288,308,455,394,849
06,06371,063713302,General San Martín,BUENOS AIRES,420,390,838,807,1645
06,06371,063713307,General San Martín,BUENOS AIRES,317,321,513,523,1036
06,06371,063713502,General San Martín,BUENOS AIRES,221,200,369,343,712
06,06371,063713506,General San Martín,BUENOS AIRES,370,409,595,560,1155
06,06371,063713507,General San Martín,BUENOS AIRES,35,20,72,81,153
06,06371,063713606,General San Martín,BUENOS AIRES,299,297,521,560,1081
06,06371,063713609,General San Martín,BUENOS AIRES,496,451,858,762,1620
06,06371,063713707,General San Martín,BUENOS AIRES,450,395,809,800,1609
06,06399,063990304,Guaminí,BUENOS AIRES,226,262,306,269,575
06,06399,063990501,Guaminí,BUENOS AIRES,417,494,599,569,1168
06,06399,063990401,Guaminí,BUENOS AIRES,21,38,38,30,68
06,06399,063990802,Guaminí,BUENOS AIRES,27,44,27,38,65
06,06399,063990503,Guaminí,BUENOS AIRES,46,72,51,65,116
06,06399,063990703,Guaminí,BUENOS AIRES,275,312,419,399,818
06,06399,063990109,Guaminí,BUENOS AIRES,182,212,273,256,529
06,06399,063990303,Guaminí,BUENOS AIRES,134,159,225,214,439
06,06399,063990301,Guaminí,BUENOS AIRES,43,72,50,69,119
06,06399,063990804,Guaminí,BUENOS AIRES,25,27,17,34,51
06,06399,063990101,Guaminí,BUENOS AIRES,281,334,369,342,711
06,06399,063990102,Guaminí,BUENOS AIRES,232,274,322,316,638
06,06399,063990103,Guaminí,BUENOS AIRES,140,176,198,164,362
06,06399,063990704,Guaminí,BUENOS AIRES,272,324,368,371,739
06,06399,063990705,Guaminí,BUENOS AIRES,217,284,304,306,610
06,06399,063990701,Guaminí,BUENOS AIRES,11,29,10,14,24
06,06399,063990502,Guaminí,BUENOS AIRES,156,179,206,227,433
06,06399,063990202,Guaminí,BUENOS AIRES,38,61,48,72,120
06,06399,063990801,Guaminí,BUENOS AIRES,20,39,23,33,56
06,06399,063990104,Guaminí,BUENOS AIRES,23,76,21,41,62
06,06399,063990803,Guaminí,BUENOS AIRES,20,38,21,30,51
06,06399,063990106,Guaminí,BUENOS AIRES,291,332,414,376,790
06,06399,063990402,Guaminí,BUENOS AIRES,18,32,15,38,53
06,06399,063990805,Guaminí,BUENOS AIRES,20,38,23,32,55
06,06399,063990105,Guaminí,BUENOS AIRES,238,323,393,420,813
06,06399,063990504,Guaminí,BUENOS AIRES,68,116,103,116,219
06,06399,063990702,Guaminí,BUENOS AIRES,93,118,127,117,244
06,06399,063990706,Guaminí,BUENOS AIRES,222,262,296,265,561
06,06399,063990201,Guaminí,BUENOS AIRES,11,29,14,15,29
06,06399,063990302,Guaminí,BUENOS AIRES,59,85,66,117,183
06,06399,063990107,Guaminí,BUENOS AIRES,130,146,196,208,404
06,06399,063990108,Guaminí,BUENOS AIRES,178,200,231,229,460
06,06399,063990601,Guaminí,BUENOS AIRES,51,126,70,73,143
06,06399,063990602,Guaminí,BUENOS AIRES,39,74,55,63,118
06,06252,062520403,Escobar,BUENOS AIRES,177,186,306,288,594
06,06252,062520504,Escobar,BUENOS AIRES,434,587,569,537,1106
06,06252,062520112,Escobar,BUENOS AIRES,413,402,661,647,1308
06,06252,062520204,Escobar,BUENOS AIRES,231,364,339,336,675
06,06252,062520215,Escobar,BUENOS AIRES,430,432,810,816,1626
06,06252,062520307,Escobar,BUENOS AIRES,83,77,132,144,276
06,06252,062520407,Escobar,BUENOS AIRES,225,234,356,317,673
06,06252,062520408,Escobar,BUENOS AIRES,475,562,802,746,1548
06,06252,062520610,Escobar,BUENOS AIRES,36,42,48,58,106
06,06252,062520613,Escobar,BUENOS AIRES,185,287,348,366,714
06,06252,062520807,Escobar,BUENOS AIRES,313,336,523,496,1019
06,06252,062521312,Escobar,BUENOS AIRES,332,346,612,577,1189
06,06252,062521403,Escobar,BUENOS AIRES,501,497,1035,1044,2079
06,06252,062521501,Escobar,BUENOS AIRES,4,5,5,6,11
06,06252,062521502,Escobar,BUENOS AIRES,2,2,1,2,3
06,06252,062521506,Escobar,BUENOS AIRES,392,378,757,772,1529
06,06252,062521509,Escobar,BUENOS AIRES,411,380,779,752,1531
06,06252,062521511,Escobar,BUENOS AIRES,380,410,747,718,1465
06,06252,062521515,Escobar,BUENOS AIRES,579,532,1100,948,2048
06,06252,062520106,Escobar,BUENOS AIRES,493,485,931,960,1891
06,06252,062521419,Escobar,BUENOS AIRES,412,410,783,764,1547
06,06252,062520503,Escobar,BUENOS AIRES,357,402,490,419,909
06,06252,062520103,Escobar,BUENOS AIRES,176,171,314,360,674
06,06252,062520108,Escobar,BUENOS AIRES,524,525,876,858,1734
06,06252,062520109,Escobar,BUENOS AIRES,251,295,369,315,684
06,06252,062520201,Escobar,BUENOS AIRES,104,258,136,145,281
06,06252,062520202,Escobar,BUENOS AIRES,141,472,203,223,426
06,06252,062520205,Escobar,BUENOS AIRES,133,235,199,207,406
06,06252,062520208,Escobar,BUENOS AIRES,69,96,101,107,208
06,06252,062520306,Escobar,BUENOS AIRES,379,414,684,686,1370
06,06252,062520402,Escobar,BUENOS AIRES,410,419,714,729,1443
06,06252,062520611,Escobar,BUENOS AIRES,112,222,176,198,374
06,06252,062520612,Escobar,BUENOS AIRES,154,215,233,289,522
06,06252,062520701,Escobar,BUENOS AIRES,335,332,592,549,1141
06,06252,062520705,Escobar,BUENOS AIRES,482,444,978,1026,2004
06,06252,062520707,Escobar,BUENOS AIRES,352,375,680,726,1406
06,06252,062520709,Escobar,BUENOS AIRES,288,291,468,405,873
06,06252,062520806,Escobar,BUENOS AIRES,415,480,659,623,1282
06,06252,062520909,Escobar,BUENOS AIRES,310,288,546,555,1101
06,06252,062520911,Escobar,BUENOS AIRES,493,435,934,910,1844
06,06252,062521001,Escobar,BUENOS AIRES,172,323,271,277,548
06,06252,062521009,Escobar,BUENOS AIRES,317,336,581,544,1125
06,06252,062521109,Escobar,BUENOS AIRES,166,228,261,282,543
06,06252,062521201,Escobar,BUENOS AIRES,350,352,747,713,1460
06,06252,062521308,Escobar,BUENOS AIRES,251,275,446,400,846
06,06252,062521407,Escobar,BUENOS AIRES,310,321,609,576,1185
06,06252,062521508,Escobar,BUENOS AIRES,419,368,856,871,1727
06,06252,062521601,Escobar,BUENOS AIRES,175,487,217,287,504
06,06252,062520203,Escobar,BUENOS AIRES,198,375,334,338,672
06,06252,062520206,Escobar,BUENOS AIRES,130,229,201,208,409
06,06252,062520209,Escobar,BUENOS AIRES,387,389,769,833,1602
06,06252,062520217,Escobar,BUENOS AIRES,294,275,555,497,1052
06,06252,062520302,Escobar,BUENOS AIRES,85,116,127,133,260
06,06252,062520401,Escobar,BUENOS AIRES,347,325,683,641,1324
06,06252,062520506,Escobar,BUENOS AIRES,207,251,284,253,537
06,06252,062520704,Escobar,BUENOS AIRES,459,403,815,867,1682
06,06252,062520804,Escobar,BUENOS AIRES,416,428,821,801,1622
06,06252,062520902,Escobar,BUENOS AIRES,501,509,1011,1040,2051
06,06252,062520905,Escobar,BUENOS AIRES,412,341,779,808,1587
06,06252,062521013,Escobar,BUENOS AIRES,425,524,763,800,1563
06,06252,062521205,Escobar,BUENOS AIRES,505,460,890,918,1808
06,06252,062521309,Escobar,BUENOS AIRES,233,266,378,360,738
06,06252,062521404,Escobar,BUENOS AIRES,309,333,601,651,1252
06,06252,062521416,Escobar,BUENOS AIRES,294,306,547,505,1052
06,06252,062521503,Escobar,BUENOS AIRES,351,324,625,636,1261
06,06252,062521513,Escobar,BUENOS AIRES,248,562,385,374,759
06,06252,062521514,Escobar,BUENOS AIRES,421,321,730,657,1387
06,06252,062520304,Escobar,BUENOS AIRES,232,253,412,368,780
06,06252,062520107,Escobar,BUENOS AIRES,543,584,959,910,1869
06,06252,062520113,Escobar,BUENOS AIRES,335,364,483,441,924
06,06252,062520404,Escobar,BUENOS AIRES,265,275,412,405,817
06,06252,062520207,Escobar,BUENOS AIRES,173,274,322,304,626
06,06252,062520213,Escobar,BUENOS AIRES,253,290,421,390,811
06,06252,062520303,Escobar,BUENOS AIRES,112,191,170,174,344
06,06252,062520305,Escobar,BUENOS AIRES,445,422,886,947,1833
06,06252,062520309,Escobar,BUENOS AIRES,204,253,310,299,609
06,06252,062520405,Escobar,BUENOS AIRES,319,330,509,504,1013
06,06252,062520509,Escobar,BUENOS AIRES,378,377,636,605,1241
06,06252,062520703,Escobar,BUENOS AIRES,420,412,804,746,1550
06,06252,062520803,Escobar,BUENOS AIRES,425,455,811,801,1612
06,06252,062521304,Escobar,BUENOS AIRES,319,332,549,548,1097
06,06252,062520910,Escobar,BUENOS AIRES,399,379,760,748,1508
06,06252,062520912,Escobar,BUENOS AIRES,414,363,839,821,1660
06,06252,062521305,Escobar,BUENOS AIRES,361,367,656,609,1265
06,06252,062521015,Escobar,BUENOS AIRES,199,297,301,287,588
06,06252,062521104,Escobar,BUENOS AIRES,366,406,511,499,1010
06,06252,062521108,Escobar,BUENOS AIRES,97,165,140,158,298
06,06252,062521203,Escobar,BUENOS AIRES,428,385,809,811,1620
06,06252,062521301,Escobar,BUENOS AIRES,223,191,361,381,742
06,06252,062521302,Escobar,BUENOS AIRES,370,381,739,715,1454
06,06252,062521303,Escobar,BUENOS AIRES,387,386,666,659,1325
06,06252,062521405,Escobar,BUENOS AIRES,214,204,363,404,767
06,06252,062521406,Escobar,BUENOS AIRES,221,222,430,426,856
06,06252,062521408,Escobar,BUENOS AIRES,492,514,924,860,1784
06,06252,062521410,Escobar,BUENOS AIRES,300,331,504,462,966
06,06252,062521412,Escobar,BUENOS AIRES,395,416,837,877,1714
06,06252,062521417,Escobar,BUENOS AIRES,292,327,462,470,932
06,06252,062521504,Escobar,BUENOS AIRES,426,453,772,779,1551
06,06252,062521510,Escobar,BUENOS AIRES,194,408,322,300,622
06,06252,062521512,Escobar,BUENOS AIRES,492,439,933,991,1924
06,06252,062520301,Escobar,BUENOS AIRES,52,63,89,94,183
06,06252,062520602,Escobar,BUENOS AIRES,3,4,2,3,5
06,06252,062520101,Escobar,BUENOS AIRES,147,157,289,308,597
06,06252,062520211,Escobar,BUENOS AIRES,272,274,468,438,906
06,06252,062521206,Escobar,BUENOS AIRES,360,374,629,605,1234
06,06252,062520115,Escobar,BUENOS AIRES,310,239,504,505,1009
06,06252,062520502,Escobar,BUENOS AIRES,263,315,372,300,672
06,06252,062520406,Escobar,BUENOS AIRES,244,294,370,317,687
06,06252,062520410,Escobar,BUENOS AIRES,248,351,420,408,828
06,06252,062520411,Escobar,BUENOS AIRES,31,28,58,57,115
06,06252,062520413,Escobar,BUENOS AIRES,357,543,590,612,1202
06,06252,062520601,Escobar,BUENOS AIRES,239,223,458,501,959
06,06252,062520606,Escobar,BUENOS AIRES,291,560,479,472,951
06,06252,062520708,Escobar,BUENOS AIRES,433,418,794,810,1604
06,06252,062520710,Escobar,BUENOS AIRES,262,292,473,439,912
06,06252,062520802,Escobar,BUENOS AIRES,465,501,922,930,1852
06,06252,062520904,Escobar,BUENOS AIRES,427,407,867,859,1726
06,06252,062520908,Escobar,BUENOS AIRES,245,249,411,406,817
06,06252,062521012,Escobar,BUENOS AIRES,388,402,798,794,1592
06,06252,062521107,Escobar,BUENOS AIRES,307,363,513,457,970
06,06252,062521014,Escobar,BUENOS AIRES,225,337,373,385,758
06,06252,062521101,Escobar,BUENOS AIRES,264,276,416,383,799
06,06252,062521105,Escobar,BUENOS AIRES,434,416,687,656,1343
06,06252,062521110,Escobar,BUENOS AIRES,328,400,553,505,1058
06,06252,062521310,Escobar,BUENOS AIRES,219,239,340,329,669
06,06252,062521311,Escobar,BUENOS AIRES,293,314,496,457,953
06,06252,062521402,Escobar,BUENOS AIRES,431,409,775,769,1544
06,06252,062521505,Escobar,BUENOS AIRES,362,364,656,631,1287
06,06252,062520801,Escobar,BUENOS AIRES,60,67,122,125,247
06,06252,062520105,Escobar,BUENOS AIRES,394,408,745,800,1545
06,06252,062520614,Escobar,BUENOS AIRES,199,195,347,372,719
06,06252,062520110,Escobar,BUENOS AIRES,165,193,235,182,417
06,06252,062520212,Escobar,BUENOS AIRES,188,212,326,298,624
06,06252,062520409,Escobar,BUENOS AIRES,509,509,931,933,1864
06,06252,062520507,Escobar,BUENOS AIRES,455,470,677,692,1369
06,06252,062520607,Escobar,BUENOS AIRES,37,45,69,68,137
06,06252,062520609,Escobar,BUENOS AIRES,40,48,72,74,146
06,06252,062520810,Escobar,BUENOS AIRES,157,520,233,245,478
06,06252,062520903,Escobar,BUENOS AIRES,455,418,876,882,1758
06,06252,062521002,Escobar,BUENOS AIRES,42,63,62,70,132
06,06252,062521005,Escobar,BUENOS AIRES,218,237,379,398,777
06,06252,062521010,Escobar,BUENOS AIRES,311,361,556,556,1112
06,06252,062521011,Escobar,BUENOS AIRES,339,331,690,668,1358
06,06252,062521106,Escobar,BUENOS AIRES,281,320,467,464,931
06,06252,062521204,Escobar,BUENOS AIRES,473,413,902,939,1841
06,06252,062521401,Escobar,BUENOS AIRES,340,392,656,735,1391
06,06252,062521414,Escobar,BUENOS AIRES,327,287,637,660,1297
06,06252,062521415,Escobar,BUENOS AIRES,266,257,514,481,995
06,06252,062520102,Escobar,BUENOS AIRES,274,284,495,514,1009
06,06252,062520104,Escobar,BUENOS AIRES,442,456,901,829,1730
06,06252,062520210,Escobar,BUENOS AIRES,218,281,352,336,688
06,06252,062520214,Escobar,BUENOS AIRES,287,311,497,449,946
06,06252,062520308,Escobar,BUENOS AIRES,88,223,127,162,289
06,06252,062520501,Escobar,BUENOS AIRES,399,503,643,528,1171
06,06252,062520508,Escobar,BUENOS AIRES,472,459,766,678,1444
06,06252,062520603,Escobar,BUENOS AIRES,89,63,167,161,328
06,06252,062520604,Escobar,BUENOS AIRES,228,356,401,394,795
06,06252,062520608,Escobar,BUENOS AIRES,25,31,31,39,70
06,06252,062520702,Escobar,BUENOS AIRES,374,374,703,652,1355
06,06252,062520706,Escobar,BUENOS AIRES,566,499,1195,1188,2383
06,06252,062520711,Escobar,BUENOS AIRES,466,535,838,798,1636
06,06252,062520805,Escobar,BUENOS AIRES,401,399,828,815,1643
06,06252,062520808,Escobar,BUENOS AIRES,274,283,485,492,977
06,06252,062521003,Escobar,BUENOS AIRES,340,355,625,635,1260
06,06252,062521016,Escobar,BUENOS AIRES,330,318,627,594,1221
06,06252,062521102,Escobar,BUENOS AIRES,469,506,716,697,1413
06,06252,062521207,Escobar,BUENOS AIRES,420,371,781,778,1559
06,06252,062521208,Escobar,BUENOS AIRES,340,288,720,725,1445
06,06252,062521307,Escobar,BUENOS AIRES,233,261,384,352,736
06,06252,062521411,Escobar,BUENOS AIRES,293,328,504,501,1005
06,06252,062521418,Escobar,BUENOS AIRES,284,303,519,524,1043
06,06252,062521507,Escobar,BUENOS AIRES,394,344,756,725,1481
06,06252,062520111,Escobar,BUENOS AIRES,236,289,338,281,619
06,06252,062520114,Escobar,BUENOS AIRES,267,275,472,401,873
06,06252,062520216,Escobar,BUENOS AIRES,291,295,582,576,1158
06,06252,062520412,Escobar,BUENOS AIRES,535,494,984,1042,2026
06,06252,062520505,Escobar,BUENOS AIRES,288,349,426,365,791
06,06252,062520605,Escobar,BUENOS AIRES,327,350,592,606,1198
06,06252,062520809,Escobar,BUENOS AIRES,85,112,156,155,311
06,06252,062520901,Escobar,BUENOS AIRES,841,985,1593,1579,3172
06,06252,062520906,Escobar,BUENOS AIRES,337,319,645,675,1320
06,06252,062520907,Escobar,BUENOS AIRES,331,330,615,610,1225
06,06252,062520913,Escobar,BUENOS AIRES,637,653,1386,1319,2705
06,06252,062520914,Escobar,BUENOS AIRES,504,462,939,994,1933
06,06252,062521004,Escobar,BUENOS AIRES,343,351,660,626,1286
06,06252,062521006,Escobar,BUENOS AIRES,322,324,560,542,1102
06,06252,062521007,Escobar,BUENOS AIRES,286,283,571,559,1130
06,06252,062521008,Escobar,BUENOS AIRES,218,293,462,466,928
06,06252,062521017,Escobar,BUENOS AIRES,205,275,348,334,682
06,06252,062521103,Escobar,BUENOS AIRES,234,271,323,329,652
06,06252,062521202,Escobar,BUENOS AIRES,520,529,945,979,1924
06,06252,062521306,Escobar,BUENOS AIRES,318,315,576,581,1157
06,06252,062521409,Escobar,BUENOS AIRES,336,380,581,517,1098
06,06252,062521413,Escobar,BUENOS AIRES,590,559,1194,1250,2444
06,06412,064120904,José C. Paz,BUENOS AIRES,357,404,718,785,1503
06,06412,064120107,José C. Paz,BUENOS AIRES,103,133,182,161,343
06,06412,064120109,José C. Paz,BUENOS AIRES,329,425,638,561,1199
06,06412,064120111,José C. Paz,BUENOS AIRES,206,237,380,410,790
06,06412,064120115,José C. Paz,BUENOS AIRES,313,305,594,525,1119
06,06412,064120205,José C. Paz,BUENOS AIRES,421,446,746,729,1475
06,06412,064120206,José C. Paz,BUENOS AIRES,272,282,486,514,1000
06,06412,064120301,José C. Paz,BUENOS AIRES,380,340,694,704,1398
06,06412,064120311,José C. Paz,BUENOS AIRES,348,376,635,568,1203
06,06412,064120501,José C. Paz,BUENOS AIRES,238,258,395,355,750
06,06412,064120509,José C. Paz,BUENOS AIRES,401,406,777,757,1534
06,06412,064120604,José C. Paz,BUENOS AIRES,265,351,526,421,947
06,06412,064120612,José C. Paz,BUENOS AIRES,382,395,640,575,1215
06,06412,064120711,José C. Paz,BUENOS AIRES,396,394,698,698,1396
06,06412,064120807,José C. Paz,BUENOS AIRES,275,283,559,544,1103
06,06412,064120809,José C. Paz,BUENOS AIRES,347,351,617,599,1216
06,06412,064120813,José C. Paz,BUENOS AIRES,372,355,769,756,1525
06,06412,064120905,José C. Paz,BUENOS AIRES,349,387,733,721,1454
06,06412,064121010,José C. Paz,BUENOS AIRES,302,280,610,605,1215
06,06412,064121011,José C. Paz,BUENOS AIRES,331,310,643,608,1251
06,06412,064121018,José C. Paz,BUENOS AIRES,372,376,778,704,1482
06,06412,064121112,José C. Paz,BUENOS AIRES,236,234,464,469,933
06,06412,064121117,José C. Paz,BUENOS AIRES,211,198,417,430,847
06,06412,064121205,José C. Paz,BUENOS AIRES,441,424,890,893,1783
06,06412,064121403,José C. Paz,BUENOS AIRES,485,444,914,896,1810
06,06412,064120405,José C. Paz,BUENOS AIRES,274,277,483,462,945
06,06412,064120712,José C. Paz,BUENOS AIRES,359,330,682,661,1343
06,06412,064120910,José C. Paz,BUENOS AIRES,379,346,693,771,1464
06,06412,064120207,José C. Paz,BUENOS AIRES,331,354,636,610,1246
06,06412,064120208,José C. Paz,BUENOS AIRES,385,352,655,617,1272
06,06412,064120308,José C. Paz,BUENOS AIRES,311,315,552,512,1064
06,06412,064120309,José C. Paz,BUENOS AIRES,291,308,527,450,977
06,06412,064120510,José C. Paz,BUENOS AIRES,399,377,745,715,1460
06,06412,064120511,José C. Paz,BUENOS AIRES,313,314,583,561,1144
06,06412,064120512,José C. Paz,BUENOS AIRES,325,322,546,519,1065
06,06412,064120606,José C. Paz,BUENOS AIRES,410,442,611,599,1210
06,06412,064120607,José C. Paz,BUENOS AIRES,395,390,695,673,1368
06,06412,064120710,José C. Paz,BUENOS AIRES,416,375,741,701,1442
06,06412,064120802,José C. Paz,BUENOS AIRES,400,383,695,659,1354
06,06412,064120810,José C. Paz,BUENOS AIRES,303,283,631,581,1212
06,06412,064120903,José C. Paz,BUENOS AIRES,377,441,727,776,1503
06,06412,064120912,José C. Paz,BUENOS AIRES,226,239,468,493,961
06,06412,064121016,José C. Paz,BUENOS AIRES,335,341,779,726,1505
06,06412,064121101,José C. Paz,BUENOS AIRES,359,277,786,788,1574
06,06412,064121104,José C. Paz,BUENOS AIRES,238,236,528,491,1019
06,06412,064121108,José C. Paz,BUENOS AIRES,274,249,505,556,1061
06,06412,064121113,José C. Paz,BUENOS AIRES,255,246,476,514,990
06,06412,064121119,José C. Paz,BUENOS AIRES,411,388,806,822,1628
06,06412,064121311,José C. Paz,BUENOS AIRES,314,319,595,605,1200
06,06412,064121404,José C. Paz,BUENOS AIRES,280,281,528,543,1071
06,06412,064121407,José C. Paz,BUENOS AIRES,395,377,795,721,1516
06,06412,064121501,José C. Paz,BUENOS AIRES,250,249,457,464,921
06,06412,064121505,José C. Paz,BUENOS AIRES,254,272,464,467,931
06,06412,064121006,José C. Paz,BUENOS AIRES,345,336,677,657,1334
06,06412,064120103,José C. Paz,BUENOS AIRES,63,160,116,107,223
06,06412,064120201,José C. Paz,BUENOS AIRES,136,169,216,234,450
06,06412,064120210,José C. Paz,BUENOS AIRES,334,355,571,488,1059
06,06412,064120211,José C. Paz,BUENOS AIRES,299,312,520,458,978
06,06412,064120305,José C. Paz,BUENOS AIRES,426,713,719,646,1365
06,06412,064120403,José C. Paz,BUENOS AIRES,409,424,770,759,1529
06,06412,064120407,José C. Paz,BUENOS AIRES,354,310,607,577,1184
06,06412,064120410,José C. Paz,BUENOS AIRES,384,415,671,655,1326
06,06412,064120507,José C. Paz,BUENOS AIRES,338,341,557,536,1093
06,06412,064120508,José C. Paz,BUENOS AIRES,371,375,634,580,1214
06,06412,064120714,José C. Paz,BUENOS AIRES,305,276,573,540,1113
06,06412,064120716,José C. Paz,BUENOS AIRES,285,221,497,539,1036
06,06412,064120805,José C. Paz,BUENOS AIRES,267,297,429,392,821
06,06412,064120902,José C. Paz,BUENOS AIRES,269,299,565,549,1114
06,06412,064120909,José C. Paz,BUENOS AIRES,354,362,721,713,1434
06,06412,064121015,José C. Paz,BUENOS AIRES,306,276,636,606,1242
06,06412,064121209,José C. Paz,BUENOS AIRES,414,422,770,811,1581
06,06412,064121412,José C. Paz,BUENOS AIRES,377,367,765,788,1553
06,06412,064120101,José C. Paz,BUENOS AIRES,212,242,359,366,725
06,06412,064120108,José C. Paz,BUENOS AIRES,134,229,230,242,472
06,06412,064120112,José C. Paz,BUENOS AIRES,317,328,622,680,1302
06,06412,064120113,José C. Paz,BUENOS AIRES,300,296,632,616,1248
06,06412,064120202,José C. Paz,BUENOS AIRES,335,366,607,576,1183
06,06412,064120203,José C. Paz,BUENOS AIRES,344,325,651,572,1223
06,06412,064120310,José C. Paz,BUENOS AIRES,334,351,615,508,1123
06,06412,064120404,José C. Paz,BUENOS AIRES,478,467,874,795,1669
06,06412,064120505,José C. Paz,BUENOS AIRES,215,229,335,310,645
06,06412,064120609,José C. Paz,BUENOS AIRES,273,279,507,512,1019
06,06412,064120610,José C. Paz,BUENOS AIRES,269,264,465,482,947
06,06412,064120703,José C. Paz,BUENOS AIRES,412,399,779,770,1549
06,06412,064120704,José C. Paz,BUENOS AIRES,294,288,533,548,1081
06,06412,064120706,José C. Paz,BUENOS AIRES,243,236,499,418,917
06,06412,064120814,José C. Paz,BUENOS AIRES,311,315,666,669,1335
06,06412,064120916,José C. Paz,BUENOS AIRES,203,211,449,432,881
06,06412,064121001,José C. Paz,BUENOS AIRES,401,376,792,758,1550
06,06412,064121019,José C. Paz,BUENOS AIRES,412,418,917,840,1757
06,06412,064121111,José C. Paz,BUENOS AIRES,279,264,579,541,1120
06,06412,064121204,José C. Paz,BUENOS AIRES,458,431,838,835,1673
06,06412,064121206,José C. Paz,BUENOS AIRES,341,339,718,672,1390
06,06412,064121208,José C. Paz,BUENOS AIRES,391,356,767,702,1469
06,06412,064121309,José C. Paz,BUENOS AIRES,295,306,528,505,1033
06,06412,064121310,José C. Paz,BUENOS AIRES,237,241,434,423,857
06,06412,064121312,José C. Paz,BUENOS AIRES,424,409,826,830,1656
06,06412,064121405,José C. Paz,BUENOS AIRES,331,318,590,572,1162
06,06412,064121413,José C. Paz,BUENOS AIRES,299,261,567,559,1126
06,06412,064121502,José C. Paz,BUENOS AIRES,466,445,793,784,1577
06,06412,064121115,José C. Paz,BUENOS AIRES,362,358,671,661,1332
06,06412,064120105,José C. Paz,BUENOS AIRES,99,155,181,201,382
06,06412,064120110,José C. Paz,BUENOS AIRES,406,450,721,713,1434
06,06412,064120114,José C. Paz,BUENOS AIRES,332,350,615,646,1261
06,06412,064120302,José C. Paz,BUENOS AIRES,448,465,825,804,1629
06,06412,064120303,José C. Paz,BUENOS AIRES,441,449,751,701,1452
06,06412,064120304,José C. Paz,BUENOS AIRES,405,388,713,682,1395
06,06412,064120409,José C. Paz,BUENOS AIRES,230,242,383,320,703
06,06412,064120608,José C. Paz,BUENOS AIRES,461,441,848,785,1633
06,06412,064120514,José C. Paz,BUENOS AIRES,297,371,512,446,958
06,06412,064120601,José C. Paz,BUENOS AIRES,171,262,271,248,519
06,06412,064120603,José C. Paz,BUENOS AIRES,292,336,471,383,854
06,06412,064120605,José C. Paz,BUENOS AIRES,282,282,409,357,766
06,06412,064120611,José C. Paz,BUENOS AIRES,475,465,908,820,1728
06,06412,064120613,José C. Paz,BUENOS AIRES,342,338,582,525,1107
06,06412,064120701,José C. Paz,BUENOS AIRES,370,373,737,721,1458
06,06412,064120705,José C. Paz,BUENOS AIRES,274,245,486,484,970
06,06412,064120713,José C. Paz,BUENOS AIRES,374,347,699,701,1400
06,06412,064120918,José C. Paz,BUENOS AIRES,407,413,814,808,1622
06,06412,064121013,José C. Paz,BUENOS AIRES,259,223,480,510,990
06,06412,064121020,José C. Paz,BUENOS AIRES,399,399,826,799,1625
06,06412,064121021,José C. Paz,BUENOS AIRES,330,420,716,673,1389
06,06412,064121110,José C. Paz,BUENOS AIRES,242,225,435,436,871
06,06412,064121116,José C. Paz,BUENOS AIRES,289,277,600,574,1174
06,06412,064121203,José C. Paz,BUENOS AIRES,386,364,764,830,1594
06,06412,064121207,José C. Paz,BUENOS AIRES,448,420,867,886,1753
06,06412,064121302,José C. Paz,BUENOS AIRES,381,364,750,710,1460
06,06412,064121307,José C. Paz,BUENOS AIRES,299,284,631,671,1302
06,06412,064121401,José C. Paz,BUENOS AIRES,250,271,434,419,853
06,06412,064121402,José C. Paz,BUENOS AIRES,326,315,584,575,1159
06,06412,064121508,José C. Paz,BUENOS AIRES,270,255,524,512,1036
06,06412,064121509,José C. Paz,BUENOS AIRES,291,288,534,511,1045
06,06412,064120312,José C. Paz,BUENOS AIRES,159,210,256,228,484
06,06412,064120401,José C. Paz,BUENOS AIRES,407,441,708,694,1402
06,06412,064120402,José C. Paz,BUENOS AIRES,377,372,636,636,1272
06,06412,064120406,José C. Paz,BUENOS AIRES,286,276,511,499,1010
06,06412,064120408,José C. Paz,BUENOS AIRES,205,202,338,366,704
06,06412,064120412,José C. Paz,BUENOS AIRES,506,484,861,793,1654
06,06412,064120503,José C. Paz,BUENOS AIRES,375,391,577,532,1109
06,06412,064120513,José C. Paz,BUENOS AIRES,403,403,683,631,1314
06,06412,064120708,José C. Paz,BUENOS AIRES,294,266,567,538,1105
06,06412,064120709,José C. Paz,BUENOS AIRES,215,226,341,302,643
06,06412,064120717,José C. Paz,BUENOS AIRES,290,258,535,513,1048
06,06412,064120803,José C. Paz,BUENOS AIRES,220,233,382,370,752
06,06412,064120804,José C. Paz,BUENOS AIRES,232,232,451,429,880
06,06412,064120906,José C. Paz,BUENOS AIRES,86,175,142,133,275
06,06412,064121003,José C. Paz,BUENOS AIRES,418,394,784,813,1597
06,06412,064121004,José C. Paz,BUENOS AIRES,448,455,928,833,1761
06,06412,064121005,José C. Paz,BUENOS AIRES,371,365,718,772,1490
06,06412,064121008,José C. Paz,BUENOS AIRES,376,348,729,760,1489
06,06412,064121009,José C. Paz,BUENOS AIRES,280,289,527,498,1025
06,06412,064121012,José C. Paz,BUENOS AIRES,236,232,463,477,940
06,06412,064121014,José C. Paz,BUENOS AIRES,397,377,783,789,1572
06,06412,064121106,José C. Paz,BUENOS AIRES,337,314,663,661,1324
06,06412,064121107,José C. Paz,BUENOS AIRES,269,222,536,546,1082
06,06412,064121109,José C. Paz,BUENOS AIRES,255,257,535,568,1103
06,06412,064121118,José C. Paz,BUENOS AIRES,332,319,689,677,1366
06,06412,064121202,José C. Paz,BUENOS AIRES,343,340,681,678,1359
06,06412,064121301,José C. Paz,BUENOS AIRES,348,342,672,671,1343
06,06412,064121303,José C. Paz,BUENOS AIRES,206,227,394,455,849
06,06412,064121406,José C. Paz,BUENOS AIRES,411,422,747,730,1477
06,06412,064121503,José C. Paz,BUENOS AIRES,505,466,889,851,1740
06,06412,064121504,José C. Paz,BUENOS AIRES,371,371,715,678,1393
06,06412,064121510,José C. Paz,BUENOS AIRES,298,295,528,541,1069
06,06412,064120806,José C. Paz,BUENOS AIRES,316,288,639,618,1257
06,06412,064121007,José C. Paz,BUENOS AIRES,339,331,596,625,1221
06,06412,064120104,José C. Paz,BUENOS AIRES,164,169,290,322,612
06,06412,064120116,José C. Paz,BUENOS AIRES,466,452,892,915,1807
06,06412,064120306,José C. Paz,BUENOS AIRES,332,383,499,463,962
06,06412,064120209,José C. Paz,BUENOS AIRES,416,368,747,691,1438
06,06412,064120313,José C. Paz,BUENOS AIRES,208,244,342,314,656
06,06412,064120411,José C. Paz,BUENOS AIRES,364,334,666,643,1309
06,06412,064120504,José C. Paz,BUENOS AIRES,242,240,394,380,774
06,06412,064120707,José C. Paz,BUENOS AIRES,224,216,445,413,858
06,06412,064120715,José C. Paz,BUENOS AIRES,257,236,491,492,983
06,06412,064120801,José C. Paz,BUENOS AIRES,464,453,790,808,1598
06,06412,064120808,José C. Paz,BUENOS AIRES,258,234,491,487,978
06,06412,064120812,José C. Paz,BUENOS AIRES,284,272,559,537,1096
06,06412,064120815,José C. Paz,BUENOS AIRES,291,251,570,541,1111
06,06412,064120901,José C. Paz,BUENOS AIRES,218,235,449,473,922
06,06412,064120907,José C. Paz,BUENOS AIRES,137,196,247,280,527
06,06412,064120908,José C. Paz,BUENOS AIRES,366,382,742,752,1494
06,06412,064120913,José C. Paz,BUENOS AIRES,240,240,500,495,995
06,06412,064120914,José C. Paz,BUENOS AIRES,426,436,876,842,1718
06,06412,064120915,José C. Paz,BUENOS AIRES,372,382,730,759,1489
06,06412,064120917,José C. Paz,BUENOS AIRES,226,152,403,461,864
06,06412,064121002,José C. Paz,BUENOS AIRES,374,356,730,691,1421
06,06412,064121102,José C. Paz,BUENOS AIRES,323,337,627,606,1233
06,06412,064121114,José C. Paz,BUENOS AIRES,252,244,456,484,940
06,06412,064121120,José C. Paz,BUENOS AIRES,503,448,988,976,1964
06,06412,064121201,José C. Paz,BUENOS AIRES,322,320,626,600,1226
06,06412,064121410,José C. Paz,BUENOS AIRES,345,350,651,652,1303
06,06412,064121507,José C. Paz,BUENOS AIRES,297,305,572,560,1132
06,06412,064121511,José C. Paz,BUENOS AIRES,376,373,714,671,1385
06,06412,064121512,José C. Paz,BUENOS AIRES,462,471,936,900,1836
06,06412,064121306,José C. Paz,BUENOS AIRES,458,460,884,832,1716
06,06412,064120102,José C. Paz,BUENOS AIRES,177,263,278,289,567
06,06412,064120106,José C. Paz,BUENOS AIRES,299,383,497,538,1035
06,06412,064120117,José C. Paz,BUENOS AIRES,433,428,913,932,1845
06,06412,064120118,José C. Paz,BUENOS AIRES,445,404,892,991,1883
06,06412,064120204,José C. Paz,BUENOS AIRES,401,392,773,761,1534
06,06412,064120307,José C. Paz,BUENOS AIRES,419,447,699,669,1368
06,06412,064120502,José C. Paz,BUENOS AIRES,356,390,559,508,1067
06,06412,064120506,José C. Paz,BUENOS AIRES,212,243,357,324,681
06,06412,064120602,José C. Paz,BUENOS AIRES,283,322,485,394,879
06,06412,064120702,José C. Paz,BUENOS AIRES,372,363,767,730,1497
06,06412,064120811,José C. Paz,BUENOS AIRES,293,263,584,509,1093
06,06412,064120911,José C. Paz,BUENOS AIRES,381,368,805,850,1655
06,06412,064121017,José C. Paz,BUENOS AIRES,516,508,1040,1003,2043
06,06412,064121103,José C. Paz,BUENOS AIRES,496,481,926,909,1835
06,06412,064121105,José C. Paz,BUENOS AIRES,402,391,821,781,1602
06,06412,064121304,José C. Paz,BUENOS AIRES,267,273,480,491,971
06,06412,064121305,José C. Paz,BUENOS AIRES,470,401,963,893,1856
06,06412,064121308,José C. Paz,BUENOS AIRES,424,386,801,809,1610
06,06412,064121408,José C. Paz,BUENOS AIRES,407,404,836,793,1629
06,06412,064121409,José C. Paz,BUENOS AIRES,341,333,616,613,1229
06,06412,064121411,José C. Paz,BUENOS AIRES,378,390,730,689,1419
06,06412,064121506,José C. Paz,BUENOS AIRES,299,305,537,561,1098
06,06420,064201508,La Costa,BUENOS AIRES,156,476,241,204,445
06,06420,064200707,La Costa,BUENOS AIRES,68,427,86,83,169
06,06420,064200102,La Costa,BUENOS AIRES,155,219,282,295,577
06,06420,064200201,La Costa,BUENOS AIRES,29,244,40,37,77
06,06420,064200112,La Costa,BUENOS AIRES,58,259,82,73,155
06,06420,064200204,La Costa,BUENOS AIRES,47,278,69,59,128
06,06420,064200405,La Costa,BUENOS AIRES,79,396,114,113,227
06,06420,064200311,La Costa,BUENOS AIRES,135,208,206,205,411
06,06420,064200314,La Costa,BUENOS AIRES,49,210,51,68,119
06,06420,064200410,La Costa,BUENOS AIRES,117,255,169,158,327
06,06420,064200703,La Costa,BUENOS AIRES,13,200,13,15,28
06,06420,064200801,La Costa,BUENOS AIRES,267,347,435,438,873
06,06420,064200806,La Costa,BUENOS AIRES,92,316,142,115,257
06,06420,064200911,La Costa,BUENOS AIRES,64,322,89,85,174
06,06420,064201101,La Costa,BUENOS AIRES,67,227,94,112,206
06,06420,064201105,La Costa,BUENOS AIRES,59,325,100,87,187
06,06420,064201109,La Costa,BUENOS AIRES,39,384,47,43,90
06,06420,064201202,La Costa,BUENOS AIRES,14,58,24,22,46
06,06420,064201204,La Costa,BUENOS AIRES,45,442,67,60,127
06,06420,064201309,La Costa,BUENOS AIRES,47,376,76,57,133
06,06420,064201501,La Costa,BUENOS AIRES,12,276,11,17,28
06,06420,064201506,La Costa,BUENOS AIRES,56,552,80,69,149
06,06420,064201611,La Costa,BUENOS AIRES,171,302,295,295,590
06,06420,064201704,La Costa,BUENOS AIRES,33,431,43,35,78
06,06420,064201710,La Costa,BUENOS AIRES,117,142,196,188,384
06,06420,064201805,La Costa,BUENOS AIRES,23,322,32,27,59
06,06420,064201808,La Costa,BUENOS AIRES,114,339,156,161,317
06,06420,064201811,La Costa,BUENOS AIRES,10,186,7,9,16
06,06420,064201901,La Costa,BUENOS AIRES,10,169,6,8,14
06,06420,064202001,La Costa,BUENOS AIRES,207,380,323,309,632
06,06420,064202007,La Costa,BUENOS AIRES,32,235,33,27,60
06,06420,064202104,La Costa,BUENOS AIRES,145,296,207,203,410
06,06420,064202210,La Costa,BUENOS AIRES,63,273,64,91,155
06,06420,064202204,La Costa,BUENOS AIRES,65,264,98,78,176
06,06420,064200202,La Costa,BUENOS AIRES,37,339,40,41,81
06,06420,064200109,La Costa,BUENOS AIRES,134,283,201,192,393
06,06420,064200115,La Costa,BUENOS AIRES,69,269,83,79,162
06,06420,064200211,La Costa,BUENOS AIRES,63,236,83,72,155
06,06420,064200216,La Costa,BUENOS AIRES,227,405,372,344,716
06,06420,064200304,La Costa,BUENOS AIRES,104,256,157,161,318
06,06420,064200310,La Costa,BUENOS AIRES,72,129,111,109,220
06,06420,064200406,La Costa,BUENOS AIRES,102,440,137,169,306
06,06420,064200319,La Costa,BUENOS AIRES,58,303,82,71,153
06,06420,064200402,La Costa,BUENOS AIRES,71,518,97,86,183
06,06420,064200403,La Costa,BUENOS AIRES,133,270,225,224,449
06,06420,064200409,La Costa,BUENOS AIRES,46,375,61,54,115
06,06420,064200507,La Costa,BUENOS AIRES,174,323,287,261,548
06,06420,064200512,La Costa,BUENOS AIRES,79,273,105,101,206
06,06420,064200601,La Costa,BUENOS AIRES,79,434,101,83,184
06,06420,064200710,La Costa,BUENOS AIRES,41,248,50,40,90
06,06420,064200711,La Costa,BUENOS AIRES,41,324,47,51,98
06,06420,064200808,La Costa,BUENOS AIRES,86,323,125,115,240
06,06420,064200906,La Costa,BUENOS AIRES,60,296,85,79,164
06,06420,064200908,La Costa,BUENOS AIRES,82,234,123,134,257
06,06420,064201004,La Costa,BUENOS AIRES,72,253,90,78,168
06,06420,064201009,La Costa,BUENOS AIRES,59,252,71,79,150
06,06420,064201010,La Costa,BUENOS AIRES,96,637,136,147,283
06,06420,064201012,La Costa,BUENOS AIRES,58,436,90,98,188
06,06420,064201104,La Costa,BUENOS AIRES,67,383,90,94,184
06,06420,064201112,La Costa,BUENOS AIRES,98,235,181,195,376
06,06420,064201212,La Costa,BUENOS AIRES,46,323,64,62,126
06,06420,064201302,La Costa,BUENOS AIRES,44,291,55,48,103
06,06420,064201409,La Costa,BUENOS AIRES,33,636,35,40,75
06,06420,064201509,La Costa,BUENOS AIRES,100,219,149,144,293
06,06420,064201602,La Costa,BUENOS AIRES,19,504,24,26,50
06,06420,064202010,La Costa,BUENOS AIRES,70,314,83,77,160
06,06420,064201806,La Costa,BUENOS AIRES,21,220,28,23,51
06,06420,064201907,La Costa,BUENOS AIRES,148,249,234,221,455
06,06420,064201911,La Costa,BUENOS AIRES,107,380,173,154,327
06,06420,064202004,La Costa,BUENOS AIRES,44,867,58,38,96
06,06420,064202006,La Costa,BUENOS AIRES,51,435,60,62,122
06,06420,064202103,La Costa,BUENOS AIRES,149,291,224,191,415
06,06420,064202107,La Costa,BUENOS AIRES,226,376,372,340,712
06,06420,064202202,La Costa,BUENOS AIRES,237,403,452,397,849
06,06420,064200315,La Costa,BUENOS AIRES,20,129,27,31,58
06,06420,064202214,La Costa,BUENOS AIRES,26,100,32,51,83
06,06420,064200511,La Costa,BUENOS AIRES,83,254,100,99,199
06,06420,064200103,La Costa,BUENOS AIRES,109,241,182,165,347
06,06420,064200106,La Costa,BUENOS AIRES,83,316,111,106,217
06,06420,064200416,La Costa,BUENOS AIRES,70,483,88,69,157
06,06420,064200503,La Costa,BUENOS AIRES,167,380,238,211,449
06,06420,064200509,La Costa,BUENOS AIRES,274,381,467,463,930
06,06420,064200603,La Costa,BUENOS AIRES,69,285,79,58,137
06,06420,064200607,La Costa,BUENOS AIRES,42,477,49,49,98
06,06420,064200610,La Costa,BUENOS AIRES,50,297,63,46,109
06,06420,064200705,La Costa,BUENOS AIRES,54,272,66,61,127
06,06420,064200904,La Costa,BUENOS AIRES,101,241,143,143,286
06,06420,064200905,La Costa,BUENOS AIRES,76,310,104,84,188
06,06420,064200909,La Costa,BUENOS AIRES,50,384,72,63,135
06,06420,064201001,La Costa,BUENOS AIRES,110,175,193,211,404
06,06420,064201002,La Costa,BUENOS AIRES,52,210,73,55,128
06,06420,064201006,La Costa,BUENOS AIRES,111,505,156,169,325
06,06420,064201206,La Costa,BUENOS AIRES,62,338,89,85,174
06,06420,064201305,La Costa,BUENOS AIRES,31,354,37,27,64
06,06420,064201308,La Costa,BUENOS AIRES,39,416,55,43,98
06,06420,064201408,La Costa,BUENOS AIRES,31,339,37,39,76
06,06420,064201502,La Costa,BUENOS AIRES,24,447,41,40,81
06,06420,064201503,La Costa,BUENOS AIRES,30,427,36,37,73
06,06420,064201601,La Costa,BUENOS AIRES,22,445,22,25,47
06,06420,064201609,La Costa,BUENOS AIRES,36,283,41,45,86
06,06420,064201610,La Costa,BUENOS AIRES,37,304,49,41,90
06,06420,064201612,La Costa,BUENOS AIRES,210,486,327,303,630
06,06420,064201708,La Costa,BUENOS AIRES,131,357,203,205,408
06,06420,064201804,La Costa,BUENOS AIRES,23,321,30,21,51
06,06420,064201809,La Costa,BUENOS AIRES,38,251,50,52,102
06,06420,064201810,La Costa,BUENOS AIRES,23,333,24,25,49
06,06420,064201910,La Costa,BUENOS AIRES,136,258,180,168,348
06,06420,064202111,La Costa,BUENOS AIRES,197,243,334,356,690
06,06420,064202205,La Costa,BUENOS AIRES,81,395,106,109,215
06,06420,064202209,La Costa,BUENOS AIRES,129,198,239,245,484
06,06420,064200203,La Costa,BUENOS AIRES,36,238,45,45,90
06,06420,064200207,La Costa,BUENOS AIRES,55,341,54,62,116
06,06420,064200215,La Costa,BUENOS AIRES,132,413,177,147,324
06,06420,064200305,La Costa,BUENOS AIRES,103,262,158,143,301
06,06420,064200418,La Costa,BUENOS AIRES,42,474,47,61,108
06,06420,064200419,La Costa,BUENOS AIRES,78,422,92,100,192
06,06420,064200508,La Costa,BUENOS AIRES,212,311,340,347,687
06,06420,064200602,La Costa,BUENOS AIRES,19,265,18,22,40
06,06420,064200704,La Costa,BUENOS AIRES,40,319,54,47,101
06,06420,064200706,La Costa,BUENOS AIRES,88,350,115,116,231
06,06420,064200803,La Costa,BUENOS AIRES,125,253,185,183,368
06,06420,064200805,La Costa,BUENOS AIRES,150,249,183,176,359
06,06420,064200903,La Costa,BUENOS AIRES,200,317,349,311,660
06,06420,064200912,La Costa,BUENOS AIRES,23,314,29,28,57
06,06420,064201007,La Costa,BUENOS AIRES,130,320,161,172,333
06,06420,064201008,La Costa,BUENOS AIRES,51,507,67,60,127
06,06420,064201115,La Costa,BUENOS AIRES,71,470,87,96,183
06,06420,064201013,La Costa,BUENOS AIRES,110,593,154,153,307
06,06420,064201207,La Costa,BUENOS AIRES,45,387,57,47,104
06,06420,064201403,La Costa,BUENOS AIRES,108,384,171,161,332
06,06420,064201303,La Costa,BUENOS AIRES,44,351,53,66,119
06,06420,064201306,La Costa,BUENOS AIRES,59,313,67,77,144
06,06420,064201402,La Costa,BUENOS AIRES,36,369,38,41,79
06,06420,064201406,La Costa,BUENOS AIRES,25,436,30,32,62
06,06420,064201504,La Costa,BUENOS AIRES,17,412,24,21,45
06,06420,064201701,La Costa,BUENOS AIRES,76,379,94,95,189
06,06420,064202002,La Costa,BUENOS AIRES,130,390,192,166,358
06,06420,064202003,La Costa,BUENOS AIRES,93,339,129,138,267
06,06420,064202008,La Costa,BUENOS AIRES,25,265,32,23,55
06,06420,064202009,La Costa,BUENOS AIRES,53,352,61,64,125
06,06420,064202109,La Costa,BUENOS AIRES,383,424,652,694,1346
06,06420,064202208,La Costa,BUENOS AIRES,69,274,105,110,215
06,06420,064200501,La Costa,BUENOS AIRES,4,6,4,10,14
06,06420,064200108,La Costa,BUENOS AIRES,81,287,120,108,228
06,06420,064200206,La Costa,BUENOS AIRES,26,258,34,33,67
06,06420,064200303,La Costa,BUENOS AIRES,63,334,84,61,145
06,06420,064200317,La Costa,BUENOS AIRES,58,341,60,61,121
06,06420,064200318,La Costa,BUENOS AIRES,39,346,57,55,112
06,06420,064200320,La Costa,BUENOS AIRES,132,285,265,256,521
06,06420,064200407,La Costa,BUENOS AIRES,114,337,167,168,335
06,06420,064200411,La Costa,BUENOS AIRES,101,211,168,141,309
06,06420,064200415,La Costa,BUENOS AIRES,72,450,100,93,193
06,06420,064200611,La Costa,BUENOS AIRES,8,255,9,9,18
06,06420,064200708,La Costa,BUENOS AIRES,53,379,58,51,109
06,06420,064200709,La Costa,BUENOS AIRES,24,337,29,24,53
06,06420,064200807,La Costa,BUENOS AIRES,111,410,162,137,299
06,06420,064201003,La Costa,BUENOS AIRES,29,289,34,24,58
06,06420,064201106,La Costa,BUENOS AIRES,89,216,152,140,292
06,06420,064201114,La Costa,BUENOS AIRES,74,502,79,85,164
06,06420,064201116,La Costa,BUENOS AIRES,115,754,162,167,329
06,06420,064201203,La Costa,BUENOS AIRES,101,762,116,128,244
06,06420,064201205,La Costa,BUENOS AIRES,69,340,89,90,179
06,06420,064201407,La Costa,BUENOS AIRES,23,298,25,25,50
06,06420,064201507,La Costa,BUENOS AIRES,32,477,38,32,70
06,06420,064201604,La Costa,BUENOS AIRES,15,316,17,21,38
06,06420,064201607,La Costa,BUENOS AIRES,16,347,27,19,46
06,06420,064201705,La Costa,BUENOS AIRES,34,493,40,42,82
06,06420,064201709,La Costa,BUENOS AIRES,196,400,349,324,673
06,06420,064201801,La Costa,BUENOS AIRES,16,303,18,25,43
06,06420,064201903,La Costa,BUENOS AIRES,100,367,136,136,272
06,06420,064202102,La Costa,BUENOS AIRES,68,224,93,85,178
06,06420,064202110,La Costa,BUENOS AIRES,200,243,290,333,623
06,06420,064200101,La Costa,BUENOS AIRES,7,10,9,12,21
06,06420,064201209,La Costa,BUENOS AIRES,0,0,5,1,6
06,06420,064200408,La Costa,BUENOS AIRES,57,325,64,61,125
06,06420,064200510,La Costa,BUENOS AIRES,98,203,143,150,293
06,06420,064200105,La Costa,BUENOS AIRES,93,306,116,119,235
06,06420,064200114,La Costa,BUENOS AIRES,68,336,94,78,172
06,06420,064200208,La Costa,BUENOS AIRES,88,416,114,108,222
06,06420,064200209,La Costa,BUENOS AIRES,67,367,88,86,174
06,06420,064200210,La Costa,BUENOS AIRES,59,123,77,71,148
06,06420,064200306,La Costa,BUENOS AIRES,86,274,127,100,227
06,06420,064200308,La Costa,BUENOS AIRES,141,330,204,212,416
06,06420,064200312,La Costa,BUENOS AIRES,92,231,125,122,247
06,06420,064200404,La Costa,BUENOS AIRES,100,307,184,175,359
06,06420,064200414,La Costa,BUENOS AIRES,77,354,102,102,204
06,06420,064200417,La Costa,BUENOS AIRES,38,237,44,48,92
06,06420,064200504,La Costa,BUENOS AIRES,161,286,203,183,386
06,06420,064200604,La Costa,BUENOS AIRES,57,291,79,75,154
06,06420,064200606,La Costa,BUENOS AIRES,15,293,20,11,31
06,06420,064200612,La Costa,BUENOS AIRES,29,400,30,26,56
06,06420,064200809,La Costa,BUENOS AIRES,54,340,66,52,118
06,06420,064200901,La Costa,BUENOS AIRES,332,451,574,574,1148
06,06420,064201011,La Costa,BUENOS AIRES,120,597,169,174,343
06,06420,064201102,La Costa,BUENOS AIRES,47,294,60,58,118
06,06420,064201103,La Costa,BUENOS AIRES,43,336,56,49,105
06,06420,064201110,La Costa,BUENOS AIRES,121,547,185,184,369
06,06420,064201201,La Costa,BUENOS AIRES,117,618,189,171,360
06,06420,064201208,La Costa,BUENOS AIRES,90,803,183,193,376
06,06420,064201211,La Costa,BUENOS AIRES,61,303,81,79,160
06,06420,064201301,La Costa,BUENOS AIRES,24,312,28,32,60
06,06420,064201311,La Costa,BUENOS AIRES,74,401,112,112,224
06,06420,064201401,La Costa,BUENOS AIRES,57,435,67,77,144
06,06420,064201404,La Costa,BUENOS AIRES,168,447,261,244,505
06,06420,064201605,La Costa,BUENOS AIRES,14,374,13,12,25
06,06420,064201606,La Costa,BUENOS AIRES,18,318,23,21,44
06,06420,064202011,La Costa,BUENOS AIRES,46,313,78,66,144
06,06420,064201803,La Costa,BUENOS AIRES,33,479,34,33,67
06,06420,064202013,La Costa,BUENOS AIRES,86,273,113,104,217
06,06420,064202101,La Costa,BUENOS AIRES,80,200,111,87,198
06,06420,064202105,La Costa,BUENOS AIRES,140,265,202,182,384
06,06420,064202106,La Costa,BUENOS AIRES,241,383,368,314,682
06,06420,064202201,La Costa,BUENOS AIRES,168,202,326,333,659
06,06420,064202203,La Costa,BUENOS AIRES,146,318,265,227,492
06,06420,064202206,La Costa,BUENOS AIRES,121,450,192,172,364
06,06420,064202207,La Costa,BUENOS AIRES,65,312,67,94,161
06,06420,064200910,La Costa,BUENOS AIRES,48,342,70,63,133
06,06420,064200104,La Costa,BUENOS AIRES,222,395,418,400,818
06,06420,064200110,La Costa,BUENOS AIRES,181,346,311,301,612
06,06420,064200212,La Costa,BUENOS AIRES,113,325,187,180,367
06,06420,064200214,La Costa,BUENOS AIRES,96,241,125,122,247
06,06420,064200307,La Costa,BUENOS AIRES,97,238,144,135,279
06,06420,064200309,La Costa,BUENOS AIRES,86,180,156,155,311
06,06420,064200316,La Costa,BUENOS AIRES,35,339,44,48,92
06,06420,064200413,La Costa,BUENOS AIRES,61,313,82,87,169
06,06420,064200502,La Costa,BUENOS AIRES,37,292,51,40,91
06,06420,064200505,La Costa,BUENOS AIRES,140,314,214,196,410
06,06420,064200506,La Costa,BUENOS AIRES,228,489,318,298,616
06,06420,064200702,La Costa,BUENOS AIRES,30,377,31,34,65
06,06420,064200802,La Costa,BUENOS AIRES,262,407,430,431,861
06,06420,064200804,La Costa,BUENOS AIRES,120,283,175,173,348
06,06420,064201107,La Costa,BUENOS AIRES,57,387,85,83,168
06,06420,064201111,La Costa,BUENOS AIRES,74,482,99,102,201
06,06420,064201113,La Costa,BUENOS AIRES,80,304,121,124,245
06,06420,064201117,La Costa,BUENOS AIRES,135,290,225,222,447
06,06420,064201210,La Costa,BUENOS AIRES,19,229,14,27,41
06,06420,064201304,La Costa,BUENOS AIRES,16,253,19,21,40
06,06420,064201307,La Costa,BUENOS AIRES,86,502,132,119,251
06,06420,064201405,La Costa,BUENOS AIRES,38,388,56,41,97
06,06420,064201510,La Costa,BUENOS AIRES,164,252,271,265,536
06,06420,064201608,La Costa,BUENOS AIRES,25,286,31,33,64
06,06420,064201703,La Costa,BUENOS AIRES,25,563,30,24,54
06,06420,064201802,La Costa,BUENOS AIRES,15,223,18,17,35
06,06420,064201807,La Costa,BUENOS AIRES,23,280,25,22,47
06,06420,064201905,La Costa,BUENOS AIRES,158,451,234,255,489
06,06420,064201906,La Costa,BUENOS AIRES,178,472,272,267,539
06,06420,064201909,La Costa,BUENOS AIRES,61,273,71,72,143
06,06420,064201912,La Costa,BUENOS AIRES,54,405,71,58,129
06,06420,064202005,La Costa,BUENOS AIRES,44,299,64,52,116
06,06420,064202012,La Costa,BUENOS AIRES,58,500,69,59,128
06,06420,064202108,La Costa,BUENOS AIRES,310,414,573,490,1063
06,06420,064202112,La Costa,BUENOS AIRES,279,342,461,487,948
06,06420,064202212,La Costa,BUENOS AIRES,55,354,62,75,137
06,06420,064200205,La Costa,BUENOS AIRES,23,257,34,29,63
06,06420,064200213,La Costa,BUENOS AIRES,197,306,330,314,644
06,06420,064200107,La Costa,BUENOS AIRES,59,280,82,83,165
06,06420,064200111,La Costa,BUENOS AIRES,121,380,152,142,294
06,06420,064200113,La Costa,BUENOS AIRES,63,390,83,74,157
06,06420,064200116,La Costa,BUENOS AIRES,171,479,239,244,483
06,06420,064200301,La Costa,BUENOS AIRES,76,550,106,94,200
06,06420,064200302,La Costa,BUENOS AIRES,78,325,111,87,198
06,06420,064200313,La Costa,BUENOS AIRES,40,173,55,45,100
06,06420,064200401,La Costa,BUENOS AIRES,53,549,58,58,116
06,06420,064200412,La Costa,BUENOS AIRES,103,296,155,158,313
06,06420,064200605,La Costa,BUENOS AIRES,50,366,60,53,113
06,06420,064200608,La Costa,BUENOS AIRES,77,384,100,89,189
06,06420,064200609,La Costa,BUENOS AIRES,66,398,87,84,171
06,06420,064200701,La Costa,BUENOS AIRES,55,536,51,65,116
06,06420,064200902,La Costa,BUENOS AIRES,163,203,274,306,580
06,06420,064200907,La Costa,BUENOS AIRES,86,446,110,118,228
06,06420,064201005,La Costa,BUENOS AIRES,122,497,186,176,362
06,06420,064201108,La Costa,BUENOS AIRES,39,281,52,44,96
06,06420,064201213,La Costa,BUENOS AIRES,49,325,76,67,143
06,06420,064201214,La Costa,BUENOS AIRES,110,91,208,224,432
06,06420,064201310,La Costa,BUENOS AIRES,77,459,88,97,185
06,06420,064201410,La Costa,BUENOS AIRES,25,333,28,28,56
06,06420,064201505,La Costa,BUENOS AIRES,26,386,26,27,53
06,06420,064201603,La Costa,BUENOS AIRES,30,500,32,37,69
06,06420,064201702,La Costa,BUENOS AIRES,5,46,14,11,25
06,06420,064201706,La Costa,BUENOS AIRES,27,364,27,27,54
06,06420,064201707,La Costa,BUENOS AIRES,44,284,55,47,102
06,06420,064201812,La Costa,BUENOS AIRES,174,617,253,265,518
06,06420,064201904,La Costa,BUENOS AIRES,133,526,215,194,409
06,06420,064201908,La Costa,BUENOS AIRES,79,291,91,93,184
06,06420,064202211,La Costa,BUENOS AIRES,59,302,83,75,158
06,06420,064202213,La Costa,BUENOS AIRES,64,350,81,89,170
06,06420,064201902,La Costa,BUENOS AIRES,17,384,18,20,38
06,06427,064273002,La Matanza,BUENOS AIRES,423,562,593,509,1102
06,06427,064278801,La Matanza,BUENOS AIRES,373,343,724,679,1403
06,06427,064270103,La Matanza,BUENOS AIRES,558,786,595,436,1031
06,06427,064270308,La Matanza,BUENOS AIRES,257,280,384,339,723
06,06427,064270201,La Matanza,BUENOS AIRES,222,278,428,314,742
06,06427,064270502,La Matanza,BUENOS AIRES,276,251,459,419,878
06,06427,064270504,La Matanza,BUENOS AIRES,417,413,718,661,1379
06,06427,064270611,La Matanza,BUENOS AIRES,230,249,363,336,699
06,06427,064270613,La Matanza,BUENOS AIRES,302,242,453,370,823
06,06427,064270702,La Matanza,BUENOS AIRES,413,468,670,589,1259
06,06427,064270704,La Matanza,BUENOS AIRES,362,406,575,503,1078
06,06427,064270706,La Matanza,BUENOS AIRES,283,306,427,412,839
06,06427,064270708,La Matanza,BUENOS AIRES,289,319,435,400,835
06,06427,064270711,La Matanza,BUENOS AIRES,340,304,568,517,1085
06,06427,064270809,La Matanza,BUENOS AIRES,218,250,345,327,672
06,06427,064270904,La Matanza,BUENOS AIRES,585,572,1048,987,2035
06,06427,064270906,La Matanza,BUENOS AIRES,525,411,969,970,1939
06,06427,064270910,La Matanza,BUENOS AIRES,302,276,598,577,1175
06,06427,064271007,La Matanza,BUENOS AIRES,414,426,691,639,1330
06,06427,064271010,La Matanza,BUENOS AIRES,230,276,366,351,717
06,06427,064271207,La Matanza,BUENOS AIRES,246,237,372,392,764
06,06427,064271301,La Matanza,BUENOS AIRES,429,425,693,672,1365
06,06427,064271303,La Matanza,BUENOS AIRES,332,377,500,491,991
06,06427,064271401,La Matanza,BUENOS AIRES,355,299,629,588,1217
06,06427,064271404,La Matanza,BUENOS AIRES,312,232,660,678,1338
06,06427,064271414,La Matanza,BUENOS AIRES,179,188,284,285,569
06,06427,064271415,La Matanza,BUENOS AIRES,301,280,500,432,932
06,06427,064271418,La Matanza,BUENOS AIRES,257,295,401,382,783
06,06427,064271505,La Matanza,BUENOS AIRES,254,265,440,384,824
06,06427,064271610,La Matanza,BUENOS AIRES,236,219,389,388,777
06,06427,064271611,La Matanza,BUENOS AIRES,411,484,594,502,1096
06,06427,064271708,La Matanza,BUENOS AIRES,516,360,1116,980,2096
06,06427,064271813,La Matanza,BUENOS AIRES,1166,935,2571,2486,5057
06,06427,064271908,La Matanza,BUENOS AIRES,422,374,706,613,1319
06,06427,064272005,La Matanza,BUENOS AIRES,184,190,276,258,534
06,06427,064272009,La Matanza,BUENOS AIRES,350,386,530,421,951
06,06427,064272013,La Matanza,BUENOS AIRES,200,307,361,296,657
06,06427,064272104,La Matanza,BUENOS AIRES,483,391,846,773,1619
06,06427,064272309,La Matanza,BUENOS AIRES,602,573,995,931,1926
06,06427,064272604,La Matanza,BUENOS AIRES,419,421,712,651,1363
06,06427,064272703,La Matanza,BUENOS AIRES,264,254,412,366,778
06,06427,064272704,La Matanza,BUENOS AIRES,267,266,410,369,779
06,06427,064272708,La Matanza,BUENOS AIRES,393,444,596,569,1165
06,06427,064272802,La Matanza,BUENOS AIRES,259,296,397,319,716
06,06427,064272803,La Matanza,BUENOS AIRES,274,287,422,382,804
06,06427,064273001,La Matanza,BUENOS AIRES,322,448,407,311,718
06,06427,064273005,La Matanza,BUENOS AIRES,181,226,228,194,422
06,06427,064273012,La Matanza,BUENOS AIRES,241,324,334,278,612
06,06427,064273204,La Matanza,BUENOS AIRES,249,262,395,341,736
06,06427,064273210,La Matanza,BUENOS AIRES,222,239,341,289,630
06,06427,064273308,La Matanza,BUENOS AIRES,288,283,436,409,845
06,06427,064273310,La Matanza,BUENOS AIRES,316,328,505,455,960
06,06427,064273314,La Matanza,BUENOS AIRES,391,390,663,563,1226
06,06427,064273406,La Matanza,BUENOS AIRES,569,603,964,933,1897
06,06427,064273415,La Matanza,BUENOS AIRES,433,457,711,617,1328
06,06427,064273601,La Matanza,BUENOS AIRES,237,266,369,340,709
06,06427,064273603,La Matanza,BUENOS AIRES,283,367,408,363,771
06,06427,064273605,La Matanza,BUENOS AIRES,247,478,377,339,716
06,06427,064273608,La Matanza,BUENOS AIRES,92,91,199,214,413
06,06427,064273612,La Matanza,BUENOS AIRES,179,232,278,252,530
06,06427,064273707,La Matanza,BUENOS AIRES,414,427,763,690,1453
06,06427,064273806,La Matanza,BUENOS AIRES,304,284,557,515,1072
06,06427,064273810,La Matanza,BUENOS AIRES,410,439,677,651,1328
06,06427,064274007,La Matanza,BUENOS AIRES,741,643,1716,1706,3422
06,06427,064274301,La Matanza,BUENOS AIRES,430,464,673,687,1360
06,06427,064274305,La Matanza,BUENOS AIRES,460,459,779,661,1440
06,06427,064274306,La Matanza,BUENOS AIRES,500,519,812,810,1622
06,06427,064274409,La Matanza,BUENOS AIRES,237,277,393,330,723
06,06427,064274506,La Matanza,BUENOS AIRES,268,266,460,420,880
06,06427,064274603,La Matanza,BUENOS AIRES,579,542,1075,1036,2111
06,06427,064274607,La Matanza,BUENOS AIRES,378,362,669,643,1312
06,06427,064274702,La Matanza,BUENOS AIRES,242,73,716,671,1387
06,06427,064274802,La Matanza,BUENOS AIRES,578,538,1074,1031,2105
06,06427,064275009,La Matanza,BUENOS AIRES,302,308,557,477,1034
06,06427,064275101,La Matanza,BUENOS AIRES,313,300,577,559,1136
06,06427,064275113,La Matanza,BUENOS AIRES,392,458,777,716,1493
06,06427,064275114,La Matanza,BUENOS AIRES,500,486,856,798,1654
06,06427,064275209,La Matanza,BUENOS AIRES,450,350,1104,998,2102
06,06427,064275211,La Matanza,BUENOS AIRES,294,229,632,591,1223
06,06427,064275302,La Matanza,BUENOS AIRES,256,222,594,593,1187
06,06427,064275310,La Matanza,BUENOS AIRES,468,454,1009,956,1965
06,06427,064275408,La Matanza,BUENOS AIRES,401,378,700,745,1445
06,06427,064275607,La Matanza,BUENOS AIRES,221,235,367,339,706
06,06427,064275902,La Matanza,BUENOS AIRES,182,130,346,323,669
06,06427,064275904,La Matanza,BUENOS AIRES,257,218,537,486,1023
06,06427,064275911,La Matanza,BUENOS AIRES,355,336,636,626,1262
06,06427,064276015,La Matanza,BUENOS AIRES,272,225,460,465,925
06,06427,064276016,La Matanza,BUENOS AIRES,460,489,806,758,1564
06,06427,064276102,La Matanza,BUENOS AIRES,555,337,1134,1056,2190
06,06427,064276109,La Matanza,BUENOS AIRES,507,389,1052,1046,2098
06,06427,064276303,La Matanza,BUENOS AIRES,325,268,653,618,1271
06,06427,064276312,La Matanza,BUENOS AIRES,375,320,782,745,1527
06,06427,064276406,La Matanza,BUENOS AIRES,319,238,603,576,1179
06,06427,064276411,La Matanza,BUENOS AIRES,261,254,484,440,924
06,06427,064276417,La Matanza,BUENOS AIRES,290,325,509,437,946
06,06427,064276503,La Matanza,BUENOS AIRES,405,294,725,706,1431
06,06427,064276601,La Matanza,BUENOS AIRES,341,248,768,661,1429
06,06427,064276701,La Matanza,BUENOS AIRES,358,323,741,682,1423
06,06427,064276707,La Matanza,BUENOS AIRES,355,280,690,677,1367
06,06427,064276712,La Matanza,BUENOS AIRES,428,307,870,801,1671
06,06427,064276717,La Matanza,BUENOS AIRES,353,309,694,748,1442
06,06427,064276903,La Matanza,BUENOS AIRES,354,299,706,722,1428
06,06427,064276908,La Matanza,BUENOS AIRES,325,283,638,548,1186
06,06427,064277001,La Matanza,BUENOS AIRES,362,192,1052,1046,2098
06,06427,064277012,La Matanza,BUENOS AIRES,390,326,809,820,1629
06,06427,064277016,La Matanza,BUENOS AIRES,269,212,484,471,955
06,06427,064277103,La Matanza,BUENOS AIRES,277,222,506,506,1012
06,06427,064277108,La Matanza,BUENOS AIRES,237,216,438,437,875
06,06427,064277111,La Matanza,BUENOS AIRES,291,290,530,556,1086
06,06427,064277301,La Matanza,BUENOS AIRES,441,379,942,885,1827
06,06427,064277312,La Matanza,BUENOS AIRES,325,251,625,607,1232
06,06427,064277313,La Matanza,BUENOS AIRES,410,353,907,879,1786
06,06427,064277401,La Matanza,BUENOS AIRES,421,366,985,931,1916
06,06427,064277415,La Matanza,BUENOS AIRES,342,237,804,771,1575
06,06427,064277603,La Matanza,BUENOS AIRES,637,476,1290,1294,2584
06,06427,064277605,La Matanza,BUENOS AIRES,512,416,953,918,1871
06,06427,064277609,La Matanza,BUENOS AIRES,452,400,951,981,1932
06,06427,064277618,La Matanza,BUENOS AIRES,298,282,517,561,1078
06,06427,064277701,La Matanza,BUENOS AIRES,388,350,734,707,1441
06,06427,064277709,La Matanza,BUENOS AIRES,268,240,540,460,1000
06,06427,064277710,La Matanza,BUENOS AIRES,448,395,855,862,1717
06,06427,064277712,La Matanza,BUENOS AIRES,506,446,959,950,1909
06,06427,064277904,La Matanza,BUENOS AIRES,343,318,678,701,1379
06,06427,064277907,La Matanza,BUENOS AIRES,246,208,481,472,953
06,06427,064278013,La Matanza,BUENOS AIRES,209,210,453,453,906
06,06427,064278110,La Matanza,BUENOS AIRES,117,95,256,264,520
06,06427,064278111,La Matanza,BUENOS AIRES,280,283,574,577,1151
06,06427,064278210,La Matanza,BUENOS AIRES,360,291,730,715,1445
06,06427,064278302,La Matanza,BUENOS AIRES,367,341,762,739,1501
06,06427,064278307,La Matanza,BUENOS AIRES,302,283,583,595,1178
06,06427,064278312,La Matanza,BUENOS AIRES,367,310,679,730,1409
06,06427,064278407,La Matanza,BUENOS AIRES,385,376,743,807,1550
06,06427,064278409,La Matanza,BUENOS AIRES,550,491,1139,1182,2321
06,06427,064278503,La Matanza,BUENOS AIRES,403,365,775,823,1598
06,06427,064278510,La Matanza,BUENOS AIRES,282,285,474,458,932
06,06427,064278604,La Matanza,BUENOS AIRES,373,312,663,660,1323
06,06427,064278607,La Matanza,BUENOS AIRES,436,387,828,797,1625
06,06427,064278813,La Matanza,BUENOS AIRES,399,392,749,735,1484
06,06427,064278804,La Matanza,BUENOS AIRES,561,348,1102,962,2064
06,06427,064278806,La Matanza,BUENOS AIRES,292,281,533,510,1043
06,06427,064278903,La Matanza,BUENOS AIRES,549,487,1141,1152,2293
06,06427,064279007,La Matanza,BUENOS AIRES,300,302,501,486,987
06,06427,064278909,La Matanza,BUENOS AIRES,262,231,550,521,1071
06,06427,064278911,La Matanza,BUENOS AIRES,545,505,1031,1057,2088
06,06427,064279001,La Matanza,BUENOS AIRES,492,454,849,807,1656
06,06427,064279005,La Matanza,BUENOS AIRES,276,264,515,547,1062
06,06427,064279101,La Matanza,BUENOS AIRES,531,299,1122,1152,2274
06,06427,064279215,La Matanza,BUENOS AIRES,249,252,497,502,999
06,06427,064279202,La Matanza,BUENOS AIRES,416,381,888,889,1777
06,06427,064279211,La Matanza,BUENOS AIRES,397,391,898,848,1746
06,06427,064279302,La Matanza,BUENOS AIRES,406,364,846,974,1820
06,06427,064279305,La Matanza,BUENOS AIRES,391,379,760,800,1560
06,06427,064279307,La Matanza,BUENOS AIRES,448,435,953,890,1843
06,06427,064279311,La Matanza,BUENOS AIRES,486,481,980,985,1965
06,06427,064279413,La Matanza,BUENOS AIRES,399,383,765,788,1553
06,06427,064279601,La Matanza,BUENOS AIRES,452,404,951,973,1924
06,06427,064279603,La Matanza,BUENOS AIRES,409,349,821,873,1694
06,06427,064279611,La Matanza,BUENOS AIRES,312,313,666,609,1275
06,06427,064279704,La Matanza,BUENOS AIRES,447,483,940,917,1857
06,06427,064279706,La Matanza,BUENOS AIRES,492,501,1078,1042,2120
06,06427,064279708,La Matanza,BUENOS AIRES,387,408,843,778,1621
06,06427,064279709,La Matanza,BUENOS AIRES,278,318,537,552,1089
06,06427,064270909,La Matanza,BUENOS AIRES,180,143,322,336,658
06,06427,064271901,La Matanza,BUENOS AIRES,235,220,462,352,814
06,06427,064275201,La Matanza,BUENOS AIRES,453,411,1098,917,2015
06,06427,064276705,La Matanza,BUENOS AIRES,312,260,723,745,1468
06,06427,064278715,La Matanza,BUENOS AIRES,230,224,478,441,919
06,06427,064279213,La Matanza,BUENOS AIRES,347,348,702,667,1369
06,06427,064279306,La Matanza,BUENOS AIRES,543,510,1034,1077,2111
06,06427,064270104,La Matanza,BUENOS AIRES,117,165,137,126,263
06,06427,064270105,La Matanza,BUENOS AIRES,138,226,132,97,229
06,06427,064270107,La Matanza,BUENOS AIRES,446,604,538,413,951
06,06427,064270108,La Matanza,BUENOS AIRES,280,331,364,291,655
06,06427,064270102,La Matanza,BUENOS AIRES,207,279,216,148,364
06,06427,064270112,La Matanza,BUENOS AIRES,281,380,366,320,686
06,06427,064270311,La Matanza,BUENOS AIRES,314,365,470,426,896
06,06427,064270312,La Matanza,BUENOS AIRES,406,541,530,424,954
06,06427,064270405,La Matanza,BUENOS AIRES,356,346,560,455,1015
06,06427,064270407,La Matanza,BUENOS AIRES,344,360,522,473,995
06,06427,064270501,La Matanza,BUENOS AIRES,518,464,865,796,1661
06,06427,064270505,La Matanza,BUENOS AIRES,459,464,730,649,1379
06,06427,064270606,La Matanza,BUENOS AIRES,249,267,357,328,685
06,06427,064270610,La Matanza,BUENOS AIRES,239,241,373,360,733
06,06427,064270705,La Matanza,BUENOS AIRES,356,374,627,563,1190
06,06427,064270901,La Matanza,BUENOS AIRES,437,445,765,729,1494
06,06427,064270905,La Matanza,BUENOS AIRES,445,465,827,752,1579
06,06427,064270908,La Matanza,BUENOS AIRES,339,346,583,521,1104
06,06427,064271002,La Matanza,BUENOS AIRES,255,263,464,399,863
06,06427,064271106,La Matanza,BUENOS AIRES,423,412,671,604,1275
06,06427,064271408,La Matanza,BUENOS AIRES,870,569,1782,1823,3605
06,06427,064271409,La Matanza,BUENOS AIRES,393,309,677,657,1334
06,06427,064271515,La Matanza,BUENOS AIRES,320,312,513,471,984
06,06427,064271613,La Matanza,BUENOS AIRES,146,199,250,248,498
06,06427,064271801,La Matanza,BUENOS AIRES,449,415,939,912,1851
06,06427,064271802,La Matanza,BUENOS AIRES,475,275,1055,1024,2079
06,06427,064271808,La Matanza,BUENOS AIRES,530,439,1228,1149,2377
06,06427,064271904,La Matanza,BUENOS AIRES,268,273,473,465,938
06,06427,064271906,La Matanza,BUENOS AIRES,370,383,663,647,1310
06,06427,064272008,La Matanza,BUENOS AIRES,309,345,409,365,774
06,06427,064272106,La Matanza,BUENOS AIRES,366,293,612,605,1217
06,06427,064272207,La Matanza,BUENOS AIRES,442,452,687,645,1332
06,06427,064272208,La Matanza,BUENOS AIRES,309,334,479,468,947
06,06427,064272307,La Matanza,BUENOS AIRES,406,425,668,591,1259
06,06427,064272310,La Matanza,BUENOS AIRES,540,485,837,830,1667
06,06427,064272407,La Matanza,BUENOS AIRES,542,440,951,898,1849
06,06427,064272409,La Matanza,BUENOS AIRES,378,407,631,554,1185
06,06427,064272410,La Matanza,BUENOS AIRES,250,213,503,451,954
06,06427,064272502,La Matanza,BUENOS AIRES,285,315,430,423,853
06,06427,064272606,La Matanza,BUENOS AIRES,240,250,380,350,730
06,06427,064272706,La Matanza,BUENOS AIRES,374,401,548,482,1030
06,06427,064272806,La Matanza,BUENOS AIRES,385,417,640,553,1193
06,06427,064272908,La Matanza,BUENOS AIRES,420,482,702,607,1309
06,06427,064273004,La Matanza,BUENOS AIRES,341,517,373,276,649
06,06427,064273009,La Matanza,BUENOS AIRES,202,259,264,188,452
06,06427,064273013,La Matanza,BUENOS AIRES,318,382,514,443,957
06,06427,064273107,La Matanza,BUENOS AIRES,283,301,425,373,798
06,06427,064273201,La Matanza,BUENOS AIRES,252,285,385,315,700
06,06427,064273211,La Matanza,BUENOS AIRES,265,286,393,352,745
06,06427,064273212,La Matanza,BUENOS AIRES,214,226,344,306,650
06,06427,064273307,La Matanza,BUENOS AIRES,212,234,316,280,596
06,06427,064273402,La Matanza,BUENOS AIRES,268,306,439,413,852
06,06427,064273410,La Matanza,BUENOS AIRES,237,259,383,367,750
06,06427,064273501,La Matanza,BUENOS AIRES,401,461,622,571,1193
06,06427,064273511,La Matanza,BUENOS AIRES,417,445,664,592,1256
06,06427,064273512,La Matanza,BUENOS AIRES,399,414,629,560,1189
06,06427,064273606,La Matanza,BUENOS AIRES,203,143,433,410,843
06,06427,064273607,La Matanza,BUENOS AIRES,165,155,261,211,472
06,06427,064273804,La Matanza,BUENOS AIRES,235,215,462,482,944
06,06427,064273809,La Matanza,BUENOS AIRES,188,190,271,271,542
06,06427,064273903,La Matanza,BUENOS AIRES,257,222,444,454,898
06,06427,064273910,La Matanza,BUENOS AIRES,322,269,577,549,1126
06,06427,064274005,La Matanza,BUENOS AIRES,376,388,700,705,1405
06,06427,064274105,La Matanza,BUENOS AIRES,386,417,653,610,1263
06,06427,064274108,La Matanza,BUENOS AIRES,667,576,1318,1310,2628
06,06427,064274211,La Matanza,BUENOS AIRES,297,277,526,484,1010
06,06427,064274309,La Matanza,BUENOS AIRES,379,392,625,550,1175
06,06427,064274310,La Matanza,BUENOS AIRES,313,318,516,478,994
06,06427,064274402,La Matanza,BUENOS AIRES,295,268,513,468,981
06,06427,064274405,La Matanza,BUENOS AIRES,214,185,318,299,617
06,06427,064274406,La Matanza,BUENOS AIRES,266,287,424,399,823
06,06427,064274408,La Matanza,BUENOS AIRES,248,231,382,336,718
06,06427,064274609,La Matanza,BUENOS AIRES,1228,1194,2231,2150,4381
06,06427,064274712,La Matanza,BUENOS AIRES,511,96,1419,1294,2713
06,06427,064274908,La Matanza,BUENOS AIRES,375,347,774,716,1490
06,06427,064274808,La Matanza,BUENOS AIRES,527,416,950,863,1813
06,06427,064274810,La Matanza,BUENOS AIRES,475,402,884,861,1745
06,06427,064274814,La Matanza,BUENOS AIRES,487,470,895,829,1724
06,06427,064274905,La Matanza,BUENOS AIRES,378,342,718,683,1401
06,06427,064274912,La Matanza,BUENOS AIRES,262,255,512,555,1067
06,06427,064275007,La Matanza,BUENOS AIRES,405,395,687,633,1320
06,06427,064275008,La Matanza,BUENOS AIRES,301,299,539,526,1065
06,06427,064275112,La Matanza,BUENOS AIRES,383,408,578,543,1121
06,06427,064275203,La Matanza,BUENOS AIRES,337,282,712,710,1422
06,06427,064275204,La Matanza,BUENOS AIRES,419,387,827,775,1602
06,06427,064275308,La Matanza,BUENOS AIRES,452,415,899,840,1739
06,06427,064275309,La Matanza,BUENOS AIRES,211,189,406,369,775
06,06427,064275406,La Matanza,BUENOS AIRES,272,274,517,517,1034
06,06427,064275507,La Matanza,BUENOS AIRES,268,286,431,409,840
06,06427,064275602,La Matanza,BUENOS AIRES,512,477,873,890,1763
06,06427,064275608,La Matanza,BUENOS AIRES,381,440,624,536,1160
06,06427,064275701,La Matanza,BUENOS AIRES,388,358,700,638,1338
06,06427,064275907,La Matanza,BUENOS AIRES,243,198,468,413,881
06,06427,064275908,La Matanza,BUENOS AIRES,336,309,613,614,1227
06,06427,064275910,La Matanza,BUENOS AIRES,362,347,609,594,1203
06,06427,064276002,La Matanza,BUENOS AIRES,391,328,862,696,1558
06,06427,064276003,La Matanza,BUENOS AIRES,315,274,867,560,1427
06,06427,064276011,La Matanza,BUENOS AIRES,437,376,962,812,1774
06,06427,064276107,La Matanza,BUENOS AIRES,413,233,896,830,1726
06,06427,064276204,La Matanza,BUENOS AIRES,335,309,625,621,1246
06,06427,064276207,La Matanza,BUENOS AIRES,335,268,631,608,1239
06,06427,064276211,La Matanza,BUENOS AIRES,314,132,725,689,1414
06,06427,064276214,La Matanza,BUENOS AIRES,240,197,445,412,857
06,06427,064276402,La Matanza,BUENOS AIRES,254,158,514,501,1015
06,06427,064276407,La Matanza,BUENOS AIRES,445,391,935,921,1856
06,06427,064276415,La Matanza,BUENOS AIRES,372,205,850,791,1641
06,06427,064276416,La Matanza,BUENOS AIRES,422,123,1257,1129,2386
06,06427,064276516,La Matanza,BUENOS AIRES,496,455,948,872,1820
06,06427,064276517,La Matanza,BUENOS AIRES,534,494,995,974,1969
06,06427,064276706,La Matanza,BUENOS AIRES,416,326,835,826,1661
06,06427,064277010,La Matanza,BUENOS AIRES,293,260,550,542,1092
06,06427,064277017,La Matanza,BUENOS AIRES,262,195,492,472,964
06,06427,064277106,La Matanza,BUENOS AIRES,273,286,459,444,903
06,06427,064277114,La Matanza,BUENOS AIRES,410,331,829,826,1655
06,06427,064277115,La Matanza,BUENOS AIRES,367,330,738,708,1446
06,06427,064277203,La Matanza,BUENOS AIRES,247,231,517,465,982
06,06427,064277205,La Matanza,BUENOS AIRES,406,326,792,798,1590
06,06427,064277208,La Matanza,BUENOS AIRES,266,232,479,511,990
06,06427,064277210,La Matanza,BUENOS AIRES,312,285,619,584,1203
06,06427,064277212,La Matanza,BUENOS AIRES,373,333,712,702,1414
06,06427,064277306,La Matanza,BUENOS AIRES,435,377,810,800,1610
06,06427,064277309,La Matanza,BUENOS AIRES,509,373,1006,1016,2022
06,06427,064277417,La Matanza,BUENOS AIRES,331,316,664,671,1335
06,06427,064277501,La Matanza,BUENOS AIRES,520,267,1140,1048,2188
06,06427,064277512,La Matanza,BUENOS AIRES,356,305,741,734,1475
06,06427,064277811,La Matanza,BUENOS AIRES,302,281,620,574,1194
06,06427,064277801,La Matanza,BUENOS AIRES,653,178,1593,1665,3258
06,06427,064277806,La Matanza,BUENOS AIRES,316,249,602,617,1219
06,06427,064277808,La Matanza,BUENOS AIRES,267,232,565,535,1100
06,06427,064277812,La Matanza,BUENOS AIRES,411,385,831,794,1625
06,06427,064277813,La Matanza,BUENOS AIRES,438,370,878,903,1781
06,06427,064277908,La Matanza,BUENOS AIRES,264,241,528,474,1002
06,06427,064279217,La Matanza,BUENOS AIRES,229,221,497,520,1017
06,06427,064278304,La Matanza,BUENOS AIRES,477,338,902,934,1836
06,06427,064278309,La Matanza,BUENOS AIRES,334,294,696,689,1385
06,06427,064278501,La Matanza,BUENOS AIRES,546,496,1122,1111,2233
06,06427,064278506,La Matanza,BUENOS AIRES,416,385,768,691,1459
06,06427,064278511,La Matanza,BUENOS AIRES,441,371,805,735,1540
06,06427,064278611,La Matanza,BUENOS AIRES,329,272,641,630,1271
06,06427,064278703,La Matanza,BUENOS AIRES,271,266,472,504,976
06,06427,064278705,La Matanza,BUENOS AIRES,495,456,911,851,1762
06,06427,064278803,La Matanza,BUENOS AIRES,543,442,1074,1045,2119
06,06427,064278805,La Matanza,BUENOS AIRES,644,386,1269,1322,2591
06,06427,064278901,La Matanza,BUENOS AIRES,812,405,1936,1864,3800
06,06427,064278913,La Matanza,BUENOS AIRES,546,530,1069,1093,2162
06,06427,064279002,La Matanza,BUENOS AIRES,520,450,980,962,1942
06,06427,064279004,La Matanza,BUENOS AIRES,325,280,639,636,1275
06,06427,064279013,La Matanza,BUENOS AIRES,248,269,484,470,954
06,06427,064279105,La Matanza,BUENOS AIRES,283,257,475,480,955
06,06427,064279115,La Matanza,BUENOS AIRES,111,245,200,204,404
06,06427,064279206,La Matanza,BUENOS AIRES,492,541,1094,1067,2161
06,06427,064279207,La Matanza,BUENOS AIRES,526,534,1160,1184,2344
06,06427,064279210,La Matanza,BUENOS AIRES,421,417,919,902,1821
06,06427,064279304,La Matanza,BUENOS AIRES,393,366,818,861,1679
06,06427,064279308,La Matanza,BUENOS AIRES,446,455,866,897,1763
06,06427,064279314,La Matanza,BUENOS AIRES,463,436,922,871,1793
06,06427,064279412,La Matanza,BUENOS AIRES,435,406,845,879,1724
06,06427,064279509,La Matanza,BUENOS AIRES,386,340,778,788,1566
06,06427,064279713,La Matanza,BUENOS AIRES,273,284,495,470,965
06,06427,064279607,La Matanza,BUENOS AIRES,326,283,659,690,1349
06,06427,064279703,La Matanza,BUENOS AIRES,475,408,1123,1095,2218
06,06427,064279718,La Matanza,BUENOS AIRES,193,201,361,352,713
06,06427,064279722,La Matanza,BUENOS AIRES,205,226,396,403,799
06,06427,064275504,La Matanza,BUENOS AIRES,271,248,473,432,905
06,06427,064274902,La Matanza,BUENOS AIRES,314,302,597,561,1158
06,06427,064275609,La Matanza,BUENOS AIRES,347,292,619,603,1222
06,06427,064277505,La Matanza,BUENOS AIRES,493,456,1007,1074,2081
06,06427,064270106,La Matanza,BUENOS AIRES,453,603,590,440,1030
06,06427,064270204,La Matanza,BUENOS AIRES,353,518,408,270,678
06,06427,064270211,La Matanza,BUENOS AIRES,86,142,108,90,198
06,06427,064270215,La Matanza,BUENOS AIRES,181,258,231,213,444
06,06427,064270216,La Matanza,BUENOS AIRES,177,302,205,173,378
06,06427,064270302,La Matanza,BUENOS AIRES,390,562,460,381,841
06,06427,064270303,La Matanza,BUENOS AIRES,218,253,309,240,549
06,06427,064270310,La Matanza,BUENOS AIRES,382,644,469,342,811
06,06427,064270409,La Matanza,BUENOS AIRES,427,423,679,642,1321
06,06427,064270506,La Matanza,BUENOS AIRES,392,355,681,582,1263
06,06427,064270808,La Matanza,BUENOS AIRES,209,229,364,343,707
06,06427,064271108,La Matanza,BUENOS AIRES,413,395,695,669,1364
06,06427,064271302,La Matanza,BUENOS AIRES,451,504,755,736,1491
06,06427,064271306,La Matanza,BUENOS AIRES,246,269,438,445,883
06,06427,064271307,La Matanza,BUENOS AIRES,282,341,425,392,817
06,06427,064271402,La Matanza,BUENOS AIRES,318,311,605,571,1176
06,06427,064271411,La Matanza,BUENOS AIRES,858,664,1501,1490,2991
06,06427,064271419,La Matanza,BUENOS AIRES,323,342,540,535,1075
06,06427,064271507,La Matanza,BUENOS AIRES,257,235,438,374,812
06,06427,064271509,La Matanza,BUENOS AIRES,258,254,422,375,797
06,06427,064271512,La Matanza,BUENOS AIRES,413,376,673,627,1300
06,06427,064271513,La Matanza,BUENOS AIRES,242,229,405,340,745
06,06427,064271602,La Matanza,BUENOS AIRES,475,544,691,598,1289
06,06427,064271607,La Matanza,BUENOS AIRES,388,345,703,666,1369
06,06427,064271804,La Matanza,BUENOS AIRES,641,491,1506,1387,2893
06,06427,064271805,La Matanza,BUENOS AIRES,1080,910,2449,2255,4704
06,06427,064271905,La Matanza,BUENOS AIRES,238,213,395,376,771
06,06427,064272102,La Matanza,BUENOS AIRES,449,410,836,765,1601
06,06427,064272108,La Matanza,BUENOS AIRES,399,427,656,625,1281
06,06427,064272301,La Matanza,BUENOS AIRES,150,156,220,206,426
06,06427,064272408,La Matanza,BUENOS AIRES,397,438,620,544,1164
06,06427,064272514,La Matanza,BUENOS AIRES,180,193,274,269,543
06,06427,064272804,La Matanza,BUENOS AIRES,280,303,427,403,830
06,06427,064272805,La Matanza,BUENOS AIRES,262,269,410,357,767
06,06427,064272811,La Matanza,BUENOS AIRES,348,398,534,454,988
06,06427,064272902,La Matanza,BUENOS AIRES,366,429,583,494,1077
06,06427,064272903,La Matanza,BUENOS AIRES,232,286,360,311,671
06,06427,064272909,La Matanza,BUENOS AIRES,195,222,291,252,543
06,06427,064272913,La Matanza,BUENOS AIRES,292,325,540,464,1004
06,06427,064273011,La Matanza,BUENOS AIRES,170,227,203,158,361
06,06427,064273203,La Matanza,BUENOS AIRES,262,319,385,324,709
06,06427,064273205,La Matanza,BUENOS AIRES,389,440,613,533,1146
06,06427,064273207,La Matanza,BUENOS AIRES,366,392,583,496,1079
06,06427,064273303,La Matanza,BUENOS AIRES,215,234,362,303,665
06,06427,064273413,La Matanza,BUENOS AIRES,311,311,486,429,915
06,06427,064273504,La Matanza,BUENOS AIRES,245,288,399,323,722
06,06427,064273703,La Matanza,BUENOS AIRES,212,215,348,328,676
06,06427,064273710,La Matanza,BUENOS AIRES,579,444,1069,980,2049
06,06427,064273802,La Matanza,BUENOS AIRES,378,279,713,746,1459
06,06427,064273901,La Matanza,BUENOS AIRES,485,374,855,880,1735
06,06427,064274001,La Matanza,BUENOS AIRES,342,287,705,641,1346
06,06427,064274002,La Matanza,BUENOS AIRES,458,441,893,834,1727
06,06427,064274003,La Matanza,BUENOS AIRES,262,262,538,484,1022
06,06427,064274010,La Matanza,BUENOS AIRES,552,506,1075,1027,2102
06,06427,064274107,La Matanza,BUENOS AIRES,924,681,1999,1981,3980
06,06427,064274201,La Matanza,BUENOS AIRES,426,457,765,730,1495
06,06427,064274207,La Matanza,BUENOS AIRES,296,289,478,452,930
06,06427,064274302,La Matanza,BUENOS AIRES,440,455,735,664,1399
06,06427,064274606,La Matanza,BUENOS AIRES,606,596,1033,998,2031
06,06427,064274612,La Matanza,BUENOS AIRES,406,485,799,753,1552
06,06427,064274710,La Matanza,BUENOS AIRES,318,286,569,561,1130
06,06427,064274801,La Matanza,BUENOS AIRES,172,160,509,507,1016
06,06427,064274811,La Matanza,BUENOS AIRES,517,444,931,872,1803
06,06427,064274906,La Matanza,BUENOS AIRES,619,611,1410,1300,2710
06,06427,064275012,La Matanza,BUENOS AIRES,487,539,827,696,1523
06,06427,064275103,La Matanza,BUENOS AIRES,296,301,503,473,976
06,06427,064275108,La Matanza,BUENOS AIRES,541,508,906,822,1728
06,06427,064275109,La Matanza,BUENOS AIRES,405,438,670,642,1312
06,06427,064275110,La Matanza,BUENOS AIRES,371,390,678,674,1352
06,06427,064275206,La Matanza,BUENOS AIRES,395,312,890,819,1709
06,06427,064275212,La Matanza,BUENOS AIRES,354,253,797,831,1628
06,06427,064275301,La Matanza,BUENOS AIRES,522,431,1150,1056,2206
06,06427,064275304,La Matanza,BUENOS AIRES,457,414,1025,1062,2087
06,06427,064275502,La Matanza,BUENOS AIRES,268,276,419,375,794
06,06427,064275508,La Matanza,BUENOS AIRES,345,361,590,566,1156
06,06427,064275513,La Matanza,BUENOS AIRES,454,377,853,795,1648
06,06427,064275704,La Matanza,BUENOS AIRES,315,279,607,549,1156
06,06427,064275705,La Matanza,BUENOS AIRES,327,266,612,620,1232
06,06427,064275710,La Matanza,BUENOS AIRES,308,241,569,548,1117
06,06427,064275712,La Matanza,BUENOS AIRES,426,406,771,716,1487
06,06427,064275813,La Matanza,BUENOS AIRES,282,190,538,498,1036
06,06427,064276001,La Matanza,BUENOS AIRES,488,416,1107,921,2028
06,06427,064276005,La Matanza,BUENOS AIRES,525,479,1066,835,1901
06,06427,064276108,La Matanza,BUENOS AIRES,470,364,963,909,1872
06,06427,064276113,La Matanza,BUENOS AIRES,340,302,641,610,1251
06,06427,064276203,La Matanza,BUENOS AIRES,326,279,635,608,1243
06,06427,064276215,La Matanza,BUENOS AIRES,315,246,567,533,1100
06,06427,064276216,La Matanza,BUENOS AIRES,418,343,761,738,1499
06,06427,064276413,La Matanza,BUENOS AIRES,232,186,471,434,905
06,06427,064276414,La Matanza,BUENOS AIRES,301,247,573,552,1125
06,06427,064276509,La Matanza,BUENOS AIRES,234,185,449,429,878
06,06427,064276511,La Matanza,BUENOS AIRES,556,429,1077,1094,2171
06,06427,064276604,La Matanza,BUENOS AIRES,420,361,892,806,1698
06,06427,064276609,La Matanza,BUENOS AIRES,302,268,606,555,1161
06,06427,064276718,La Matanza,BUENOS AIRES,425,339,909,851,1760
06,06427,064276802,La Matanza,BUENOS AIRES,360,371,721,662,1383
06,06427,064276803,La Matanza,BUENOS AIRES,208,234,429,370,799
06,06427,064276806,La Matanza,BUENOS AIRES,385,374,688,634,1322
06,06427,064276907,La Matanza,BUENOS AIRES,392,348,729,758,1487
06,06427,064276911,La Matanza,BUENOS AIRES,262,253,430,396,826
06,06427,064276914,La Matanza,BUENOS AIRES,380,330,717,732,1449
06,06427,064276915,La Matanza,BUENOS AIRES,409,371,739,754,1493
06,06427,064276916,La Matanza,BUENOS AIRES,307,291,601,580,1181
06,06427,064277006,La Matanza,BUENOS AIRES,315,246,634,592,1226
06,06427,064277007,La Matanza,BUENOS AIRES,269,208,546,508,1054
06,06427,064277014,La Matanza,BUENOS AIRES,324,321,598,585,1183
06,06427,064277101,La Matanza,BUENOS AIRES,397,368,642,664,1306
06,06427,064277303,La Matanza,BUENOS AIRES,361,299,701,687,1388
06,06427,064277206,La Matanza,BUENOS AIRES,273,245,508,534,1042
06,06427,064277209,La Matanza,BUENOS AIRES,355,296,623,650,1273
06,06427,064277403,La Matanza,BUENOS AIRES,433,312,919,971,1890
06,06427,064277404,La Matanza,BUENOS AIRES,312,190,920,837,1757
06,06427,064277406,La Matanza,BUENOS AIRES,497,450,1044,938,1982
06,06427,064277413,La Matanza,BUENOS AIRES,300,264,607,570,1177
06,06427,064277507,La Matanza,BUENOS AIRES,436,391,851,826,1677
06,06427,064277509,La Matanza,BUENOS AIRES,319,254,697,663,1360
06,06427,064277511,La Matanza,BUENOS AIRES,434,386,979,983,1962
06,06427,064277515,La Matanza,BUENOS AIRES,370,331,753,759,1512
06,06427,064277516,La Matanza,BUENOS AIRES,392,356,794,806,1600
06,06427,064277703,La Matanza,BUENOS AIRES,516,377,939,909,1848
06,06427,064277704,La Matanza,BUENOS AIRES,545,494,1001,949,1950
06,06427,064277805,La Matanza,BUENOS AIRES,453,418,913,845,1758
06,06427,064277807,La Matanza,BUENOS AIRES,427,403,807,814,1621
06,06427,064277902,La Matanza,BUENOS AIRES,295,268,519,523,1042
06,06427,064277905,La Matanza,BUENOS AIRES,490,446,906,939,1845
06,06427,064277906,La Matanza,BUENOS AIRES,331,306,601,593,1194
06,06427,064278004,La Matanza,BUENOS AIRES,290,264,535,529,1064
06,06427,064278009,La Matanza,BUENOS AIRES,313,256,677,666,1343
06,06427,064278011,La Matanza,BUENOS AIRES,247,219,518,516,1034
06,06427,064278202,La Matanza,BUENOS AIRES,309,278,629,622,1251
06,06427,064278203,La Matanza,BUENOS AIRES,380,345,761,786,1547
06,06427,064278308,La Matanza,BUENOS AIRES,339,319,708,715,1423
06,06427,064278313,La Matanza,BUENOS AIRES,447,413,886,814,1700
06,06427,064278413,La Matanza,BUENOS AIRES,518,435,1011,1012,2023
06,06427,064278416,La Matanza,BUENOS AIRES,422,416,826,790,1616
06,06427,064278417,La Matanza,BUENOS AIRES,440,451,903,866,1769
06,06427,064278502,La Matanza,BUENOS AIRES,506,482,1029,1078,2107
06,06427,064278612,La Matanza,BUENOS AIRES,313,299,574,568,1142
06,06427,064278707,La Matanza,BUENOS AIRES,338,305,645,680,1325
06,06427,064278709,La Matanza,BUENOS AIRES,293,233,574,560,1134
06,06427,064278712,La Matanza,BUENOS AIRES,297,246,491,471,962
06,06427,064278810,La Matanza,BUENOS AIRES,395,366,686,682,1368
06,06427,064279006,La Matanza,BUENOS AIRES,347,327,614,677,1291
06,06427,064279315,La Matanza,BUENOS AIRES,486,532,963,946,1909
06,06427,064279403,La Matanza,BUENOS AIRES,481,437,987,929,1916
06,06427,064279411,La Matanza,BUENOS AIRES,454,411,829,874,1703
06,06427,064279501,La Matanza,BUENOS AIRES,322,297,628,691,1319
06,06427,064279502,La Matanza,BUENOS AIRES,425,401,861,876,1737
06,06427,064279510,La Matanza,BUENOS AIRES,453,441,878,863,1741
06,06427,064279513,La Matanza,BUENOS AIRES,385,380,788,761,1549
06,06427,064279613,La Matanza,BUENOS AIRES,40,50,77,75,152
06,06427,064279616,La Matanza,BUENOS AIRES,143,233,249,250,499
06,06427,064279701,La Matanza,BUENOS AIRES,326,332,644,685,1329
06,06427,064279705,La Matanza,BUENOS AIRES,208,228,444,421,865
06,06427,064271420,La Matanza,BUENOS AIRES,239,204,408,354,762
06,06427,064274006,La Matanza,BUENOS AIRES,378,358,737,668,1405
06,06427,064275005,La Matanza,BUENOS AIRES,367,378,610,567,1177
06,06427,064276513,La Matanza,BUENOS AIRES,272,251,542,556,1098
06,06427,064279012,La Matanza,BUENOS AIRES,262,199,508,509,1017
06,06427,064279110,La Matanza,BUENOS AIRES,188,185,395,368,763
06,06427,064270202,La Matanza,BUENOS AIRES,194,204,301,299,600
06,06427,064270210,La Matanza,BUENOS AIRES,282,385,364,310,674
06,06427,064270212,La Matanza,BUENOS AIRES,195,221,367,324,691
06,06427,064270214,La Matanza,BUENOS AIRES,184,238,260,228,488
06,06427,064270306,La Matanza,BUENOS AIRES,344,388,574,452,1026
06,06427,064270402,La Matanza,BUENOS AIRES,388,396,603,548,1151
06,06427,064270510,La Matanza,BUENOS AIRES,310,307,474,426,900
06,06427,064270608,La Matanza,BUENOS AIRES,208,225,295,297,592
06,06427,064270803,La Matanza,BUENOS AIRES,364,377,590,546,1136
06,06427,064270804,La Matanza,BUENOS AIRES,442,457,792,716,1508
06,06427,064270903,La Matanza,BUENOS AIRES,550,554,995,981,1976
06,06427,064271006,La Matanza,BUENOS AIRES,354,357,625,538,1163
06,06427,064271011,La Matanza,BUENOS AIRES,199,223,319,274,593
06,06427,064271101,La Matanza,BUENOS AIRES,439,413,674,623,1297
06,06427,064271105,La Matanza,BUENOS AIRES,346,330,564,477,1041
06,06427,064271210,La Matanza,BUENOS AIRES,235,225,386,349,735
06,06427,064271410,La Matanza,BUENOS AIRES,818,673,1475,1429,2904
06,06427,064271416,La Matanza,BUENOS AIRES,401,396,676,652,1328
06,06427,064271502,La Matanza,BUENOS AIRES,253,213,438,403,841
06,06427,064271503,La Matanza,BUENOS AIRES,269,291,391,327,718
06,06427,064271506,La Matanza,BUENOS AIRES,298,291,531,443,974
06,06427,064271604,La Matanza,BUENOS AIRES,336,220,627,598,1225
06,06427,064271705,La Matanza,BUENOS AIRES,259,219,463,446,909
06,06427,064271612,La Matanza,BUENOS AIRES,388,465,555,478,1033
06,06427,064271701,La Matanza,BUENOS AIRES,382,429,610,588,1198
06,06427,064271703,La Matanza,BUENOS AIRES,423,257,679,705,1384
06,06427,064271706,La Matanza,BUENOS AIRES,214,172,506,498,1004
06,06427,064271711,La Matanza,BUENOS AIRES,1016,736,2222,2217,4439
06,06427,064271803,La Matanza,BUENOS AIRES,272,165,710,695,1405
06,06427,064271806,La Matanza,BUENOS AIRES,43,23,114,109,223
06,06427,064271807,La Matanza,BUENOS AIRES,562,434,1258,1202,2460
06,06427,064271809,La Matanza,BUENOS AIRES,692,503,1542,1500,3042
06,06427,064271902,La Matanza,BUENOS AIRES,212,221,356,333,689
06,06427,064271907,La Matanza,BUENOS AIRES,378,399,609,571,1180
06,06427,064271910,La Matanza,BUENOS AIRES,335,330,555,493,1048
06,06427,064272002,La Matanza,BUENOS AIRES,251,254,450,432,882
06,06427,064276304,La Matanza,BUENOS AIRES,291,270,598,554,1152
06,06427,064272012,La Matanza,BUENOS AIRES,114,119,225,179,404
06,06427,064272304,La Matanza,BUENOS AIRES,558,582,890,819,1709
06,06427,064272305,La Matanza,BUENOS AIRES,416,434,627,555,1182
06,06427,064272401,La Matanza,BUENOS AIRES,408,443,659,604,1263
06,06427,064272402,La Matanza,BUENOS AIRES,188,57,438,427,865
06,06427,064272406,La Matanza,BUENOS AIRES,362,337,605,575,1180
06,06427,064272511,La Matanza,BUENOS AIRES,773,623,1509,1481,2990
06,06427,064272515,La Matanza,BUENOS AIRES,313,304,471,484,955
06,06427,064272705,La Matanza,BUENOS AIRES,274,288,443,373,816
06,06427,064272904,La Matanza,BUENOS AIRES,244,232,376,339,715
06,06427,064273008,La Matanza,BUENOS AIRES,189,268,232,187,419
06,06427,064273010,La Matanza,BUENOS AIRES,306,394,362,358,720
06,06427,064273101,La Matanza,BUENOS AIRES,295,400,353,291,644
06,06427,064273102,La Matanza,BUENOS AIRES,309,366,459,394,853
06,06427,064273110,La Matanza,BUENOS AIRES,287,327,420,388,808
06,06427,064273209,La Matanza,BUENOS AIRES,216,277,319,289,608
06,06427,064273306,La Matanza,BUENOS AIRES,182,209,262,227,489
06,06427,064273403,La Matanza,BUENOS AIRES,505,557,805,699,1504
06,06427,064273412,La Matanza,BUENOS AIRES,481,438,773,680,1453
06,06427,064273503,La Matanza,BUENOS AIRES,214,255,407,330,737
06,06427,064273509,La Matanza,BUENOS AIRES,477,511,767,671,1438
06,06427,064273907,La Matanza,BUENOS AIRES,300,260,546,495,1041
06,06427,064274011,La Matanza,BUENOS AIRES,461,403,915,850,1765
06,06427,064274103,La Matanza,BUENOS AIRES,604,575,1137,1075,2212
06,06427,064274109,La Matanza,BUENOS AIRES,604,528,1152,1208,2360
06,06427,064274206,La Matanza,BUENOS AIRES,320,283,555,494,1049
06,06427,064274209,La Matanza,BUENOS AIRES,518,503,837,851,1688
06,06427,064274403,La Matanza,BUENOS AIRES,464,425,782,719,1501
06,06427,064274407,La Matanza,BUENOS AIRES,200,209,357,299,656
06,06427,064274411,La Matanza,BUENOS AIRES,212,202,351,308,659
06,06427,064274510,La Matanza,BUENOS AIRES,330,336,637,573,1210
06,06427,064274605,La Matanza,BUENOS AIRES,559,508,939,961,1900
06,06427,064274706,La Matanza,BUENOS AIRES,167,58,459,424,883
06,06427,064275605,La Matanza,BUENOS AIRES,268,227,573,479,1052
06,06427,064274901,La Matanza,BUENOS AIRES,548,515,1171,1042,2213
06,06427,064274910,La Matanza,BUENOS AIRES,379,318,807,805,1612
06,06427,064274911,La Matanza,BUENOS AIRES,223,248,468,460,928
06,06427,064275003,La Matanza,BUENOS AIRES,385,365,625,599,1224
06,06427,064275010,La Matanza,BUENOS AIRES,345,336,628,580,1208
06,06427,064275303,La Matanza,BUENOS AIRES,228,196,503,513,1016
06,06427,064275307,La Matanza,BUENOS AIRES,434,400,967,870,1837
06,06427,064275410,La Matanza,BUENOS AIRES,945,785,1934,1910,3844
06,06427,064275505,La Matanza,BUENOS AIRES,451,433,818,691,1509
06,06427,064275512,La Matanza,BUENOS AIRES,501,421,1035,912,1947
06,06427,064275604,La Matanza,BUENOS AIRES,260,228,468,468,936
06,06427,064275610,La Matanza,BUENOS AIRES,427,438,731,654,1385
06,06427,064275613,La Matanza,BUENOS AIRES,292,296,542,476,1018
06,06427,064275708,La Matanza,BUENOS AIRES,276,240,538,475,1013
06,06427,064275715,La Matanza,BUENOS AIRES,207,196,397,366,763
06,06427,064275804,La Matanza,BUENOS AIRES,382,327,711,693,1404
06,06427,064275809,La Matanza,BUENOS AIRES,151,115,305,251,556
06,06427,064275812,La Matanza,BUENOS AIRES,281,234,499,478,977
06,06427,064275814,La Matanza,BUENOS AIRES,259,210,448,443,891
06,06427,064275906,La Matanza,BUENOS AIRES,236,245,444,438,882
06,06427,064275909,La Matanza,BUENOS AIRES,274,266,475,438,913
06,06427,064276112,La Matanza,BUENOS AIRES,305,203,591,545,1136
06,06427,064276103,La Matanza,BUENOS AIRES,470,347,907,747,1654
06,06427,064276104,La Matanza,BUENOS AIRES,549,487,992,960,1952
06,06427,064276201,La Matanza,BUENOS AIRES,311,254,606,556,1162
06,06427,064276205,La Matanza,BUENOS AIRES,650,524,1370,1251,2621
06,06427,064276206,La Matanza,BUENOS AIRES,339,320,654,618,1272
06,06427,064276208,La Matanza,BUENOS AIRES,258,247,406,423,829
06,06427,064276212,La Matanza,BUENOS AIRES,340,307,606,589,1195
06,06427,064276311,La Matanza,BUENOS AIRES,511,350,1186,1059,2245
06,06427,064276404,La Matanza,BUENOS AIRES,285,215,519,539,1058
06,06427,064276405,La Matanza,BUENOS AIRES,329,233,679,695,1374
06,06427,064276408,La Matanza,BUENOS AIRES,298,204,534,560,1094
06,06427,064276502,La Matanza,BUENOS AIRES,493,345,1019,1012,2031
06,06427,064276505,La Matanza,BUENOS AIRES,234,203,516,467,983
06,06427,064276507,La Matanza,BUENOS AIRES,478,348,954,1020,1974
06,06427,064276607,La Matanza,BUENOS AIRES,305,286,578,506,1084
06,06427,064276804,La Matanza,BUENOS AIRES,267,258,509,463,972
06,06427,064276809,La Matanza,BUENOS AIRES,321,321,573,558,1131
06,06427,064277002,La Matanza,BUENOS AIRES,341,309,670,664,1334
06,06427,064277003,La Matanza,BUENOS AIRES,325,283,661,646,1307
06,06427,064277009,La Matanza,BUENOS AIRES,298,162,649,681,1330
06,06427,064277105,La Matanza,BUENOS AIRES,236,188,436,425,861
06,06427,064277109,La Matanza,BUENOS AIRES,260,225,494,445,939
06,06427,064277201,La Matanza,BUENOS AIRES,572,268,1312,1281,2593
06,06427,064277207,La Matanza,BUENOS AIRES,298,272,532,560,1092
06,06427,064277304,La Matanza,BUENOS AIRES,297,278,598,638,1236
06,06427,064277307,La Matanza,BUENOS AIRES,579,274,1723,1519,3242
06,06427,064277310,La Matanza,BUENOS AIRES,476,463,1007,1021,2028
06,06427,064277314,La Matanza,BUENOS AIRES,287,238,655,650,1305
06,06427,064277402,La Matanza,BUENOS AIRES,539,472,1132,1078,2210
06,06427,064277411,La Matanza,BUENOS AIRES,631,427,1646,1461,3107
06,06427,064277416,La Matanza,BUENOS AIRES,280,247,605,590,1195
06,06427,064277606,La Matanza,BUENOS AIRES,466,411,836,793,1629
06,06427,064277607,La Matanza,BUENOS AIRES,573,436,1180,1138,2318
06,06427,064277608,La Matanza,BUENOS AIRES,511,454,1005,988,1993
06,06427,064277702,La Matanza,BUENOS AIRES,440,416,834,796,1630
06,06427,064277713,La Matanza,BUENOS AIRES,339,309,579,598,1177
06,06427,064277716,La Matanza,BUENOS AIRES,293,287,542,494,1036
06,06427,064278007,La Matanza,BUENOS AIRES,350,290,703,727,1430
06,06427,064278010,La Matanza,BUENOS AIRES,205,207,418,404,822
06,06427,064278012,La Matanza,BUENOS AIRES,251,255,521,532,1053
06,06427,064278015,La Matanza,BUENOS AIRES,230,209,474,449,923
06,06427,064278102,La Matanza,BUENOS AIRES,347,249,695,656,1351
06,06427,064278201,La Matanza,BUENOS AIRES,461,359,994,1035,2029
06,06427,064278208,La Matanza,BUENOS AIRES,420,343,894,865,1759
06,06427,064278211,La Matanza,BUENOS AIRES,318,238,709,740,1449
06,06427,064278303,La Matanza,BUENOS AIRES,413,348,846,763,1609
06,06427,064278402,La Matanza,BUENOS AIRES,260,388,513,537,1050
06,06427,064278403,La Matanza,BUENOS AIRES,342,261,654,677,1331
06,06427,064278410,La Matanza,BUENOS AIRES,337,314,701,726,1427
06,06427,064278504,La Matanza,BUENOS AIRES,300,323,604,574,1178
06,06427,064278508,La Matanza,BUENOS AIRES,247,237,462,399,861
06,06427,064278509,La Matanza,BUENOS AIRES,512,483,904,890,1794
06,06427,064278602,La Matanza,BUENOS AIRES,318,327,596,573,1169
06,06427,064278608,La Matanza,BUENOS AIRES,275,278,552,545,1097
06,06427,064278609,La Matanza,BUENOS AIRES,317,298,636,577,1213
06,06427,064278702,La Matanza,BUENOS AIRES,325,285,652,604,1256
06,06427,064278710,La Matanza,BUENOS AIRES,353,306,649,656,1305
06,06427,064278807,La Matanza,BUENOS AIRES,340,327,654,607,1261
06,06427,064279008,La Matanza,BUENOS AIRES,373,357,715,703,1418
06,06427,064278908,La Matanza,BUENOS AIRES,535,445,1030,1098,2128
06,06427,064279107,La Matanza,BUENOS AIRES,342,299,611,592,1203
06,06427,064279111,La Matanza,BUENOS AIRES,261,196,445,428,873
06,06427,064279113,La Matanza,BUENOS AIRES,164,269,235,237,472
06,06427,064279204,La Matanza,BUENOS AIRES,447,418,968,956,1924
06,06427,064279303,La Matanza,BUENOS AIRES,334,308,737,737,1474
06,06427,064279401,La Matanza,BUENOS AIRES,477,380,1067,979,2046
06,06427,064279402,La Matanza,BUENOS AIRES,444,407,945,899,1844
06,06427,064279405,La Matanza,BUENOS AIRES,515,491,1178,1195,2373
06,06427,064279602,La Matanza,BUENOS AIRES,389,397,844,837,1681
06,06427,064279605,La Matanza,BUENOS AIRES,462,244,1028,1075,2103
06,06427,064279702,La Matanza,BUENOS AIRES,934,405,2255,2348,4603
06,06427,064279707,La Matanza,BUENOS AIRES,412,422,922,952,1874
06,06427,064278412,La Matanza,BUENOS AIRES,401,411,719,733,1452
06,06427,064270607,La Matanza,BUENOS AIRES,241,247,369,318,687
06,06427,064275102,La Matanza,BUENOS AIRES,328,324,610,590,1200
06,06427,064279109,La Matanza,BUENOS AIRES,297,269,547,574,1121
06,06427,064279214,La Matanza,BUENOS AIRES,412,399,791,813,1604
06,06427,064270109,La Matanza,BUENOS AIRES,262,297,290,305,595
06,06427,064270113,La Matanza,BUENOS AIRES,307,330,427,375,802
06,06427,064270207,La Matanza,BUENOS AIRES,259,386,315,248,563
06,06427,064270208,La Matanza,BUENOS AIRES,251,306,331,293,624
06,06427,064270404,La Matanza,BUENOS AIRES,312,332,458,387,845
06,06427,064270406,La Matanza,BUENOS AIRES,322,352,510,483,993
06,06427,064270603,La Matanza,BUENOS AIRES,319,310,524,528,1052
06,06427,064270604,La Matanza,BUENOS AIRES,574,501,991,881,1872
06,06427,064270605,La Matanza,BUENOS AIRES,212,196,327,280,607
06,06427,064270701,La Matanza,BUENOS AIRES,408,438,665,570,1235
06,06427,064270801,La Matanza,BUENOS AIRES,393,371,716,663,1379
06,06427,064270802,La Matanza,BUENOS AIRES,421,465,724,619,1343
06,06427,064270805,La Matanza,BUENOS AIRES,349,370,644,562,1206
06,06427,064270810,La Matanza,BUENOS AIRES,456,426,840,787,1627
06,06427,064271001,La Matanza,BUENOS AIRES,473,458,800,690,1490
06,06427,064271005,La Matanza,BUENOS AIRES,400,418,679,669,1348
06,06427,064271008,La Matanza,BUENOS AIRES,390,420,677,604,1281
06,06427,064271012,La Matanza,BUENOS AIRES,410,412,698,609,1307
06,06427,064271202,La Matanza,BUENOS AIRES,438,499,716,619,1335
06,06427,064271204,La Matanza,BUENOS AIRES,216,244,354,324,678
06,06427,064271417,La Matanza,BUENOS AIRES,258,230,448,432,880
06,06427,064271504,La Matanza,BUENOS AIRES,419,465,664,539,1203
06,06427,064271508,La Matanza,BUENOS AIRES,269,261,427,426,853
06,06427,064271510,La Matanza,BUENOS AIRES,271,215,413,414,827
06,06427,064271707,La Matanza,BUENOS AIRES,1370,1068,2971,2881,5852
06,06427,064271709,La Matanza,BUENOS AIRES,275,238,598,483,1081
06,06427,064271811,La Matanza,BUENOS AIRES,447,378,896,934,1830
06,06427,064271812,La Matanza,BUENOS AIRES,67,60,185,182,367
06,06427,064272001,La Matanza,BUENOS AIRES,242,219,519,566,1085
06,06427,064272004,La Matanza,BUENOS AIRES,229,260,363,354,717
06,06427,064272016,La Matanza,BUENOS AIRES,653,476,1335,1197,2532
06,06427,064272101,La Matanza,BUENOS AIRES,437,435,792,703,1495
06,06427,064272103,La Matanza,BUENOS AIRES,498,458,879,827,1706
06,06427,064272107,La Matanza,BUENOS AIRES,320,361,519,473,992
06,06427,064272201,La Matanza,BUENOS AIRES,279,264,468,448,916
06,06427,064272209,La Matanza,BUENOS AIRES,392,439,622,586,1208
06,06427,064272303,La Matanza,BUENOS AIRES,609,591,984,888,1872
06,06427,064272306,La Matanza,BUENOS AIRES,418,431,700,608,1308
06,06427,064272512,La Matanza,BUENOS AIRES,849,702,1677,1616,3293
06,06427,064272611,La Matanza,BUENOS AIRES,426,427,650,583,1233
06,06427,064272801,La Matanza,BUENOS AIRES,385,423,579,492,1071
06,06427,064272809,La Matanza,BUENOS AIRES,246,258,399,353,752
06,06427,064272812,La Matanza,BUENOS AIRES,396,419,584,502,1086
06,06427,064272914,La Matanza,BUENOS AIRES,382,416,627,579,1206
06,06427,064273202,La Matanza,BUENOS AIRES,271,311,446,375,821
06,06427,064273312,La Matanza,BUENOS AIRES,508,542,821,736,1557
06,06427,064273313,La Matanza,BUENOS AIRES,300,325,491,428,919
06,06427,064273411,La Matanza,BUENOS AIRES,255,297,380,320,700
06,06427,064273506,La Matanza,BUENOS AIRES,408,430,643,606,1249
06,06427,064273508,La Matanza,BUENOS AIRES,343,354,597,542,1139
06,06427,064273602,La Matanza,BUENOS AIRES,334,378,549,471,1020
06,06427,064273702,La Matanza,BUENOS AIRES,211,202,331,354,685
06,06427,064273902,La Matanza,BUENOS AIRES,327,291,619,614,1233
06,06427,064273904,La Matanza,BUENOS AIRES,404,372,756,669,1425
06,06427,064273908,La Matanza,BUENOS AIRES,22,13,35,60,95
06,06427,064274106,La Matanza,BUENOS AIRES,374,337,837,864,1701
06,06427,064274205,La Matanza,BUENOS AIRES,394,377,770,736,1506
06,06427,064274210,La Matanza,BUENOS AIRES,253,238,434,383,817
06,06427,064274303,La Matanza,BUENOS AIRES,444,417,767,694,1461
06,06427,064274304,La Matanza,BUENOS AIRES,381,432,603,543,1146
06,06427,064274308,La Matanza,BUENOS AIRES,366,372,607,534,1141
06,06427,064274311,La Matanza,BUENOS AIRES,295,315,535,503,1038
06,06427,064274404,La Matanza,BUENOS AIRES,432,451,702,615,1317
06,06427,064274503,La Matanza,BUENOS AIRES,308,328,478,467,945
06,06427,064274602,La Matanza,BUENOS AIRES,227,202,489,507,996
06,06427,064274613,La Matanza,BUENOS AIRES,451,423,837,785,1622
06,06427,064274704,La Matanza,BUENOS AIRES,225,217,381,359,740
06,06427,064274805,La Matanza,BUENOS AIRES,304,326,506,417,923
06,06427,064274813,La Matanza,BUENOS AIRES,415,385,709,658,1367
06,06427,064274903,La Matanza,BUENOS AIRES,351,300,729,681,1410
06,06427,064275006,La Matanza,BUENOS AIRES,475,456,802,784,1586
06,06427,064275105,La Matanza,BUENOS AIRES,317,281,574,534,1108
06,06427,064275205,La Matanza,BUENOS AIRES,448,386,877,879,1756
06,06427,064275207,La Matanza,BUENOS AIRES,376,319,714,706,1420
06,06427,064275405,La Matanza,BUENOS AIRES,298,283,572,532,1104
06,06427,064275601,La Matanza,BUENOS AIRES,293,295,543,523,1066
06,06427,064275711,La Matanza,BUENOS AIRES,275,190,502,476,978
06,06427,064275714,La Matanza,BUENOS AIRES,231,193,435,414,849
06,06427,064275806,La Matanza,BUENOS AIRES,248,211,452,423,875
06,06427,064275807,La Matanza,BUENOS AIRES,347,316,694,669,1363
06,06427,064275815,La Matanza,BUENOS AIRES,543,82,1200,1181,2381
06,06427,064275903,La Matanza,BUENOS AIRES,561,418,1065,1001,2066
06,06427,064276004,La Matanza,BUENOS AIRES,319,298,639,572,1211
06,06427,064276017,La Matanza,BUENOS AIRES,312,294,542,518,1060
06,06427,064276101,La Matanza,BUENOS AIRES,532,512,1011,939,1950
06,06427,064276105,La Matanza,BUENOS AIRES,582,499,1156,1157,2313
06,06427,064276106,La Matanza,BUENOS AIRES,375,287,798,848,1646
06,06427,064276209,La Matanza,BUENOS AIRES,340,263,696,609,1305
06,06427,064276210,La Matanza,BUENOS AIRES,554,446,1055,998,2053
06,06427,064276403,La Matanza,BUENOS AIRES,438,248,908,876,1784
06,06427,064276409,La Matanza,BUENOS AIRES,495,385,901,860,1761
06,06427,064276501,La Matanza,BUENOS AIRES,492,403,1088,1110,2198
06,06427,064276506,La Matanza,BUENOS AIRES,335,139,799,687,1486
06,06427,064276602,La Matanza,BUENOS AIRES,323,293,648,642,1290
06,06427,064276702,La Matanza,BUENOS AIRES,470,274,1055,1038,2093
06,06427,064276703,La Matanza,BUENOS AIRES,288,282,573,572,1145
06,06427,064276715,La Matanza,BUENOS AIRES,299,217,706,684,1390
06,06427,064276810,La Matanza,BUENOS AIRES,261,267,463,451,914
06,06427,064276901,La Matanza,BUENOS AIRES,289,218,566,571,1137
06,06427,064276910,La Matanza,BUENOS AIRES,221,228,370,301,671
06,06427,064276912,La Matanza,BUENOS AIRES,268,258,505,439,944
06,06427,064277008,La Matanza,BUENOS AIRES,389,270,801,823,1624
06,06427,064277015,La Matanza,BUENOS AIRES,244,224,502,423,925
06,06427,064277107,La Matanza,BUENOS AIRES,469,434,854,804,1658
06,06427,064277116,La Matanza,BUENOS AIRES,420,399,800,814,1614
06,06427,064277315,La Matanza,BUENOS AIRES,300,268,697,702,1399
06,06427,064277408,La Matanza,BUENOS AIRES,391,311,789,800,1589
06,06427,064277410,La Matanza,BUENOS AIRES,384,282,915,874,1789
06,06427,064277414,La Matanza,BUENOS AIRES,413,380,839,866,1705
06,06427,064277503,La Matanza,BUENOS AIRES,410,317,806,792,1598
06,06427,064277504,La Matanza,BUENOS AIRES,520,331,1114,1119,2233
06,06427,064277513,La Matanza,BUENOS AIRES,357,278,769,760,1529
06,06427,064277514,La Matanza,BUENOS AIRES,321,267,624,633,1257
06,06427,064277601,La Matanza,BUENOS AIRES,464,418,905,889,1794
06,06427,064277810,La Matanza,BUENOS AIRES,357,284,688,764,1452
06,06427,064277611,La Matanza,BUENOS AIRES,597,472,1148,1164,2312
06,06427,064277612,La Matanza,BUENOS AIRES,578,472,1183,1189,2372
06,06427,064277614,La Matanza,BUENOS AIRES,284,246,567,576,1143
06,06427,064277615,La Matanza,BUENOS AIRES,491,407,1016,1039,2055
06,06427,064277616,La Matanza,BUENOS AIRES,493,421,1047,1015,2062
06,06427,064277707,La Matanza,BUENOS AIRES,360,292,701,704,1405
06,06427,064277909,La Matanza,BUENOS AIRES,297,291,517,508,1025
06,06427,064277910,La Matanza,BUENOS AIRES,462,358,844,813,1657
06,06427,064278002,La Matanza,BUENOS AIRES,475,441,866,945,1811
06,06427,064278014,La Matanza,BUENOS AIRES,272,220,594,566,1160
06,06427,064278104,La Matanza,BUENOS AIRES,318,234,726,726,1452
06,06427,064278112,La Matanza,BUENOS AIRES,65,65,144,131,275
06,06427,064278205,La Matanza,BUENOS AIRES,415,244,949,937,1886
06,06427,064278207,La Matanza,BUENOS AIRES,482,419,1042,1028,2070
06,06427,064278213,La Matanza,BUENOS AIRES,349,334,657,646,1303
06,06427,064278406,La Matanza,BUENOS AIRES,334,332,626,601,1227
06,06427,064278603,La Matanza,BUENOS AIRES,361,385,673,644,1317
06,06427,064278610,La Matanza,BUENOS AIRES,303,311,563,565,1128
06,06427,064278701,La Matanza,BUENOS AIRES,342,312,628,627,1255
06,06427,064278711,La Matanza,BUENOS AIRES,45,44,78,79,157
06,06427,064278802,La Matanza,BUENOS AIRES,546,527,1059,1008,2067
06,06427,064278904,La Matanza,BUENOS AIRES,588,520,1178,1183,2361
06,06427,064278912,La Matanza,BUENOS AIRES,538,476,1143,1107,2250
06,06427,064279003,La Matanza,BUENOS AIRES,236,197,482,403,885
06,06427,064279103,La Matanza,BUENOS AIRES,434,340,879,904,1783
06,06427,064279216,La Matanza,BUENOS AIRES,367,323,720,690,1410
06,06427,064279201,La Matanza,BUENOS AIRES,389,393,864,873,1737
06,06427,064279203,La Matanza,BUENOS AIRES,235,238,477,516,993
06,06427,064279205,La Matanza,BUENOS AIRES,432,388,912,894,1806
06,06427,064279212,La Matanza,BUENOS AIRES,371,380,670,624,1294
06,06427,064279219,La Matanza,BUENOS AIRES,413,404,817,800,1617
06,06427,064279301,La Matanza,BUENOS AIRES,363,338,785,838,1623
06,06427,064279407,La Matanza,BUENOS AIRES,309,272,680,687,1367
06,06427,064279508,La Matanza,BUENOS AIRES,470,377,1127,1171,2298
06,06427,064279514,La Matanza,BUENOS AIRES,389,376,785,801,1586
06,06427,064279715,La Matanza,BUENOS AIRES,216,231,398,372,770
06,06427,064279717,La Matanza,BUENOS AIRES,277,293,531,576,1107
06,06427,064279719,La Matanza,BUENOS AIRES,216,247,384,415,799
06,06427,064275811,La Matanza,BUENOS AIRES,234,204,423,443,866
06,06427,064276008,La Matanza,BUENOS AIRES,582,500,1203,1052,2255
06,06427,064276010,La Matanza,BUENOS AIRES,384,334,854,704,1558
06,06427,064276012,La Matanza,BUENOS AIRES,309,226,762,565,1327
06,06427,064276018,La Matanza,BUENOS AIRES,295,264,589,522,1111
06,06427,064276110,La Matanza,BUENOS AIRES,553,388,1150,1060,2210
06,06427,064276306,La Matanza,BUENOS AIRES,411,383,838,741,1579
06,06427,064276308,La Matanza,BUENOS AIRES,491,436,878,777,1655
06,06427,064276310,La Matanza,BUENOS AIRES,644,519,1436,1241,2677
06,06427,064276401,La Matanza,BUENOS AIRES,252,204,541,515,1056
06,06427,064276410,La Matanza,BUENOS AIRES,484,384,989,924,1913
06,06427,064276508,La Matanza,BUENOS AIRES,271,201,491,499,990
06,06427,064276512,La Matanza,BUENOS AIRES,301,240,605,538,1143
06,06427,064276514,La Matanza,BUENOS AIRES,309,251,607,583,1190
06,06427,064276515,La Matanza,BUENOS AIRES,406,317,746,787,1533
06,06427,064276603,La Matanza,BUENOS AIRES,554,425,1182,1151,2333
06,06427,064276606,La Matanza,BUENOS AIRES,304,301,586,564,1150
06,06427,064276611,La Matanza,BUENOS AIRES,324,288,608,621,1229
06,06427,064276906,La Matanza,BUENOS AIRES,312,219,638,643,1281
06,06427,064276917,La Matanza,BUENOS AIRES,385,301,745,719,1464
06,06427,064277004,La Matanza,BUENOS AIRES,479,427,957,937,1894
06,06427,064277018,La Matanza,BUENOS AIRES,249,186,432,448,880
06,06427,064277110,La Matanza,BUENOS AIRES,226,198,413,389,802
06,06427,064277113,La Matanza,BUENOS AIRES,364,293,822,815,1637
06,06427,064277211,La Matanza,BUENOS AIRES,477,469,914,891,1805
06,06427,064277311,La Matanza,BUENOS AIRES,286,201,573,564,1137
06,06427,064277405,La Matanza,BUENOS AIRES,427,309,840,749,1589
06,06427,064277412,La Matanza,BUENOS AIRES,440,431,876,836,1712
06,06427,064277506,La Matanza,BUENOS AIRES,418,225,839,880,1719
06,06427,064277809,La Matanza,BUENOS AIRES,319,310,582,624,1206
06,06427,064277508,La Matanza,BUENOS AIRES,396,354,737,779,1516
06,06427,064277602,La Matanza,BUENOS AIRES,535,238,1169,1081,2250
06,06427,064272014,La Matanza,BUENOS AIRES,684,427,1435,1329,2764
06,06427,064279112,La Matanza,BUENOS AIRES,561,387,930,1389,2319
06,06427,064279711,La Matanza,BUENOS AIRES,108,151,174,181,355
06,06427,064271109,La Matanza,BUENOS AIRES,393,379,661,604,1265
06,06427,064276305,La Matanza,BUENOS AIRES,283,248,608,561,1169
06,06427,064277005,La Matanza,BUENOS AIRES,397,357,836,801,1637
06,06427,064270305,La Matanza,BUENOS AIRES,262,323,372,337,709
06,06427,064270307,La Matanza,BUENOS AIRES,268,308,403,341,744
06,06427,064270309,La Matanza,BUENOS AIRES,204,232,319,257,576
06,06427,064270403,La Matanza,BUENOS AIRES,475,511,709,696,1405
06,06427,064270507,La Matanza,BUENOS AIRES,447,441,750,656,1406
06,06427,064270511,La Matanza,BUENOS AIRES,320,327,516,460,976
06,06427,064270612,La Matanza,BUENOS AIRES,265,261,404,398,802
06,06427,064270614,La Matanza,BUENOS AIRES,276,243,449,356,805
06,06427,064270707,La Matanza,BUENOS AIRES,229,297,324,300,624
06,06427,064270712,La Matanza,BUENOS AIRES,409,386,705,664,1369
06,06427,064270806,La Matanza,BUENOS AIRES,487,482,806,777,1583
06,06427,064270807,La Matanza,BUENOS AIRES,392,430,646,625,1271
06,06427,064270812,La Matanza,BUENOS AIRES,464,457,744,768,1512
06,06427,064270902,La Matanza,BUENOS AIRES,390,420,654,653,1307
06,06427,064270907,La Matanza,BUENOS AIRES,379,386,659,634,1293
06,06427,064270912,La Matanza,BUENOS AIRES,282,256,587,585,1172
06,06427,064271107,La Matanza,BUENOS AIRES,359,340,557,529,1086
06,06427,064271110,La Matanza,BUENOS AIRES,275,266,461,411,872
06,06427,064271309,La Matanza,BUENOS AIRES,286,311,564,498,1062
06,06427,064271311,La Matanza,BUENOS AIRES,437,509,696,655,1351
06,06427,064271407,La Matanza,BUENOS AIRES,530,404,1108,936,2044
06,06427,064271501,La Matanza,BUENOS AIRES,284,295,510,408,918
06,06427,064271511,La Matanza,BUENOS AIRES,246,189,371,383,754
06,06427,064271605,La Matanza,BUENOS AIRES,640,489,1061,1062,2123
06,06427,064271608,La Matanza,BUENOS AIRES,254,234,493,447,940
06,06427,064271710,La Matanza,BUENOS AIRES,549,475,1173,1094,2267
06,06427,064271810,La Matanza,BUENOS AIRES,442,365,957,956,1913
06,06427,064271903,La Matanza,BUENOS AIRES,476,454,749,764,1513
06,06427,064272007,La Matanza,BUENOS AIRES,280,290,390,347,737
06,06427,064272202,La Matanza,BUENOS AIRES,241,228,404,352,756
06,06427,064272205,La Matanza,BUENOS AIRES,362,296,536,524,1060
06,06427,064272308,La Matanza,BUENOS AIRES,467,467,789,721,1510
06,06427,064272404,La Matanza,BUENOS AIRES,242,135,539,514,1053
06,06427,064272405,La Matanza,BUENOS AIRES,473,313,1123,1065,2188
06,06427,064272504,La Matanza,BUENOS AIRES,316,316,532,476,1008
06,06427,064272601,La Matanza,BUENOS AIRES,242,258,364,292,656
06,06427,064272810,La Matanza,BUENOS AIRES,432,481,653,570,1223
06,06427,064272907,La Matanza,BUENOS AIRES,434,495,685,631,1316
06,06427,064273104,La Matanza,BUENOS AIRES,316,363,494,399,893
06,06427,064273106,La Matanza,BUENOS AIRES,393,445,550,474,1024
06,06427,064273109,La Matanza,BUENOS AIRES,266,333,371,377,748
06,06427,064273208,La Matanza,BUENOS AIRES,430,473,675,627,1302
06,06427,064273302,La Matanza,BUENOS AIRES,411,464,611,517,1128
06,06427,064273315,La Matanza,BUENOS AIRES,296,321,467,382,849
06,06427,064273401,La Matanza,BUENOS AIRES,351,386,533,518,1051
06,06427,064273513,La Matanza,BUENOS AIRES,279,312,451,385,836
06,06427,064273604,La Matanza,BUENOS AIRES,212,411,387,317,704
06,06427,064273609,La Matanza,BUENOS AIRES,380,487,556,493,1049
06,06427,064273704,La Matanza,BUENOS AIRES,461,534,747,641,1388
06,06427,064273705,La Matanza,BUENOS AIRES,289,256,478,440,918
06,06427,064273808,La Matanza,BUENOS AIRES,439,438,705,623,1328
06,06427,064273909,La Matanza,BUENOS AIRES,422,432,721,674,1395
06,06427,064274104,La Matanza,BUENOS AIRES,424,422,686,691,1377
06,06427,064274208,La Matanza,BUENOS AIRES,261,265,408,383,791
06,06427,064274401,La Matanza,BUENOS AIRES,528,430,975,913,1888
06,06427,064274501,La Matanza,BUENOS AIRES,551,547,954,876,1830
06,06427,064274504,La Matanza,BUENOS AIRES,476,518,735,734,1469
06,06427,064274505,La Matanza,BUENOS AIRES,320,333,519,483,1002
06,06427,064274507,La Matanza,BUENOS AIRES,520,474,907,871,1778
06,06427,064274509,La Matanza,BUENOS AIRES,311,355,490,502,992
06,06427,064274604,La Matanza,BUENOS AIRES,583,516,1083,967,2050
06,06427,064274907,La Matanza,BUENOS AIRES,463,353,921,910,1831
06,06427,064274610,La Matanza,BUENOS AIRES,329,353,573,565,1138
06,06427,064274611,La Matanza,BUENOS AIRES,377,351,661,603,1264
06,06427,064274705,La Matanza,BUENOS AIRES,262,223,449,438,887
06,06427,064274708,La Matanza,BUENOS AIRES,156,25,461,459,920
06,06427,064274709,La Matanza,BUENOS AIRES,245,266,431,363,794
06,06427,064274806,La Matanza,BUENOS AIRES,615,576,1147,1024,2171
06,06427,064274809,La Matanza,BUENOS AIRES,472,422,813,800,1613
06,06427,064275001,La Matanza,BUENOS AIRES,420,417,700,679,1379
06,06427,064275002,La Matanza,BUENOS AIRES,329,328,565,549,1114
06,06427,064275013,La Matanza,BUENOS AIRES,251,261,468,452,920
06,06427,064275106,La Matanza,BUENOS AIRES,259,198,480,470,950
06,06427,064275111,La Matanza,BUENOS AIRES,384,398,618,573,1191
06,06427,064275306,La Matanza,BUENOS AIRES,535,505,1219,1063,2282
06,06427,064275401,La Matanza,BUENOS AIRES,434,388,903,822,1725
06,06427,064275501,La Matanza,BUENOS AIRES,269,220,483,415,898
06,06427,064275503,La Matanza,BUENOS AIRES,255,226,425,371,796
06,06427,064275702,La Matanza,BUENOS AIRES,332,293,618,597,1215
06,06427,064275713,La Matanza,BUENOS AIRES,448,364,852,824,1676
06,06427,064275801,La Matanza,BUENOS AIRES,501,422,882,852,1734
06,06427,064275803,La Matanza,BUENOS AIRES,370,376,667,660,1327
06,06427,064275808,La Matanza,BUENOS AIRES,475,419,853,840,1693
06,06427,064275810,La Matanza,BUENOS AIRES,313,309,566,555,1121
06,06427,064277604,La Matanza,BUENOS AIRES,503,440,1003,1020,2023
06,06427,064277610,La Matanza,BUENOS AIRES,502,394,979,950,1929
06,06427,064277706,La Matanza,BUENOS AIRES,486,400,952,938,1890
06,06427,064277802,La Matanza,BUENOS AIRES,616,423,1502,1524,3026
06,06427,064277903,La Matanza,BUENOS AIRES,339,279,672,585,1257
06,06427,064278001,La Matanza,BUENOS AIRES,809,267,1987,1850,3837
06,06427,064278101,La Matanza,BUENOS AIRES,462,348,987,932,1919
06,06427,064278103,La Matanza,BUENOS AIRES,373,318,742,786,1528
06,06427,064278105,La Matanza,BUENOS AIRES,236,170,481,535,1016
06,06427,064278106,La Matanza,BUENOS AIRES,202,138,409,416,825
06,06427,064278107,La Matanza,BUENOS AIRES,205,116,411,414,825
06,06427,064278109,La Matanza,BUENOS AIRES,106,100,214,207,421
06,06427,064278301,La Matanza,BUENOS AIRES,375,383,693,654,1347
06,06427,064278314,La Matanza,BUENOS AIRES,368,349,727,676,1403
06,06427,064278401,La Matanza,BUENOS AIRES,243,388,462,473,935
06,06427,064278601,La Matanza,BUENOS AIRES,409,436,699,649,1348
06,06427,064278415,La Matanza,BUENOS AIRES,549,555,1173,1187,2360
06,06427,064278505,La Matanza,BUENOS AIRES,315,266,631,590,1221
06,06427,064278512,La Matanza,BUENOS AIRES,407,337,785,804,1589
06,06427,064278513,La Matanza,BUENOS AIRES,466,420,923,921,1844
06,06427,064278605,La Matanza,BUENOS AIRES,308,302,592,576,1168
06,06427,064278706,La Matanza,BUENOS AIRES,295,281,569,519,1088
06,06427,064278812,La Matanza,BUENOS AIRES,339,323,616,536,1152
06,06427,064278905,La Matanza,BUENOS AIRES,522,508,1069,1094,2163
06,06427,064278906,La Matanza,BUENOS AIRES,479,406,1007,1003,2010
06,06427,064278910,La Matanza,BUENOS AIRES,345,287,712,690,1402
06,06427,064279010,La Matanza,BUENOS AIRES,607,603,1256,1216,2472
06,06427,064279102,La Matanza,BUENOS AIRES,318,141,543,560,1103
06,06427,064279104,La Matanza,BUENOS AIRES,374,330,725,708,1433
06,06427,064279114,La Matanza,BUENOS AIRES,132,177,203,222,425
06,06427,064279209,La Matanza,BUENOS AIRES,441,424,933,951,1884
06,06427,064279406,La Matanza,BUENOS AIRES,572,522,1392,1334,2726
06,06427,064279505,La Matanza,BUENOS AIRES,477,447,969,996,1965
06,06427,064279506,La Matanza,BUENOS AIRES,424,403,869,895,1764
06,06427,064279604,La Matanza,BUENOS AIRES,614,348,1407,1451,2858
06,06427,064279606,La Matanza,BUENOS AIRES,506,489,1004,992,1996
06,06427,064279615,La Matanza,BUENOS AIRES,248,292,435,463,898
06,06427,064279716,La Matanza,BUENOS AIRES,133,142,283,318,601
06,06427,064279724,La Matanza,BUENOS AIRES,255,270,424,473,897
06,06427,064275115,La Matanza,BUENOS AIRES,85,86,156,174,330
06,06427,064270203,La Matanza,BUENOS AIRES,144,244,173,136,309
06,06427,064272206,La Matanza,BUENOS AIRES,308,226,569,567,1136
06,06427,064275107,La Matanza,BUENOS AIRES,331,288,625,596,1221
06,06427,064278714,La Matanza,BUENOS AIRES,315,289,550,558,1108
06,06427,064279511,La Matanza,BUENOS AIRES,411,388,813,896,1709
06,06427,064270101,La Matanza,BUENOS AIRES,220,299,236,178,414
06,06427,064270111,La Matanza,BUENOS AIRES,336,389,490,407,897
06,06427,064270206,La Matanza,BUENOS AIRES,176,246,193,181,374
06,06427,064270209,La Matanza,BUENOS AIRES,307,382,357,296,653
06,06427,064270213,La Matanza,BUENOS AIRES,238,306,297,230,527
06,06427,064270217,La Matanza,BUENOS AIRES,246,334,327,299,626
06,06427,064270401,La Matanza,BUENOS AIRES,301,302,486,455,941
06,06427,064270508,La Matanza,BUENOS AIRES,257,264,376,323,699
06,06427,064270602,La Matanza,BUENOS AIRES,510,485,873,802,1675
06,06427,064270703,La Matanza,BUENOS AIRES,334,386,515,494,1009
06,06427,064270710,La Matanza,BUENOS AIRES,509,464,927,845,1772
06,06427,064271003,La Matanza,BUENOS AIRES,258,231,428,409,837
06,06427,064271004,La Matanza,BUENOS AIRES,421,466,733,675,1408
06,06427,064271009,La Matanza,BUENOS AIRES,476,458,814,777,1591
06,06427,064271103,La Matanza,BUENOS AIRES,472,431,761,759,1520
06,06427,064271104,La Matanza,BUENOS AIRES,366,378,579,506,1085
06,06427,064271111,La Matanza,BUENOS AIRES,267,289,465,357,822
06,06427,064271201,La Matanza,BUENOS AIRES,464,501,741,710,1451
06,06427,064271205,La Matanza,BUENOS AIRES,371,379,642,593,1235
06,06427,064271206,La Matanza,BUENOS AIRES,436,438,662,630,1292
06,06427,064271208,La Matanza,BUENOS AIRES,217,226,342,312,654
06,06427,064271304,La Matanza,BUENOS AIRES,510,511,992,931,1923
06,06427,064271305,La Matanza,BUENOS AIRES,525,563,967,913,1880
06,06427,064271308,La Matanza,BUENOS AIRES,282,348,505,492,997
06,06427,064271310,La Matanza,BUENOS AIRES,401,469,698,637,1335
06,06427,064271405,La Matanza,BUENOS AIRES,399,227,848,832,1680
06,06427,064271406,La Matanza,BUENOS AIRES,146,119,276,240,516
06,06427,064271413,La Matanza,BUENOS AIRES,797,867,1292,1242,2534
06,06427,064271601,La Matanza,BUENOS AIRES,429,458,673,631,1304
06,06427,064271603,La Matanza,BUENOS AIRES,406,396,705,632,1337
06,06427,064271606,La Matanza,BUENOS AIRES,372,304,715,699,1414
06,06427,064271702,La Matanza,BUENOS AIRES,327,349,464,408,872
06,06427,064271909,La Matanza,BUENOS AIRES,399,425,716,656,1372
06,06427,064272003,La Matanza,BUENOS AIRES,274,309,475,429,904
06,06427,064272006,La Matanza,BUENOS AIRES,330,351,568,545,1113
06,06427,064272010,La Matanza,BUENOS AIRES,298,324,533,508,1041
06,06427,064272011,La Matanza,BUENOS AIRES,459,459,744,658,1402
06,06427,064272015,La Matanza,BUENOS AIRES,330,280,672,624,1296
06,06427,064272105,La Matanza,BUENOS AIRES,315,304,541,500,1041
06,06427,064272203,La Matanza,BUENOS AIRES,438,376,735,689,1424
06,06427,064272204,La Matanza,BUENOS AIRES,405,362,679,659,1338
06,06427,064272302,La Matanza,BUENOS AIRES,358,391,628,531,1159
06,06427,064272501,La Matanza,BUENOS AIRES,236,252,359,334,693
06,06427,064272506,La Matanza,BUENOS AIRES,303,300,503,445,948
06,06427,064272507,La Matanza,BUENOS AIRES,214,221,307,270,577
06,06427,064272510,La Matanza,BUENOS AIRES,964,694,1988,1939,3927
06,06427,064272513,La Matanza,BUENOS AIRES,184,204,286,257,543
06,06427,064272603,La Matanza,BUENOS AIRES,436,441,727,645,1372
06,06427,064272608,La Matanza,BUENOS AIRES,409,425,613,521,1134
06,06427,064272701,La Matanza,BUENOS AIRES,582,561,919,834,1753
06,06427,064272709,La Matanza,BUENOS AIRES,459,453,735,660,1395
06,06427,064272901,La Matanza,BUENOS AIRES,396,449,624,541,1165
06,06427,064272905,La Matanza,BUENOS AIRES,368,473,505,448,953
06,06427,064272906,La Matanza,BUENOS AIRES,326,364,504,440,944
06,06427,064272911,La Matanza,BUENOS AIRES,412,456,694,649,1343
06,06427,064273006,La Matanza,BUENOS AIRES,339,536,497,375,872
06,06427,064273007,La Matanza,BUENOS AIRES,354,457,468,390,858
06,06427,064273103,La Matanza,BUENOS AIRES,332,365,583,489,1072
06,06427,064273108,La Matanza,BUENOS AIRES,172,203,255,210,465
06,06427,064273309,La Matanza,BUENOS AIRES,262,262,408,357,765
06,06427,064273404,La Matanza,BUENOS AIRES,331,364,502,451,953
06,06427,064273405,La Matanza,BUENOS AIRES,343,375,557,475,1032
06,06427,064273407,La Matanza,BUENOS AIRES,357,374,624,513,1137
06,06427,064273409,La Matanza,BUENOS AIRES,420,475,642,583,1225
06,06427,064273507,La Matanza,BUENOS AIRES,278,292,390,334,724
06,06427,064273510,La Matanza,BUENOS AIRES,250,290,394,350,744
06,06427,064273610,La Matanza,BUENOS AIRES,309,394,463,411,874
06,06427,064273611,La Matanza,BUENOS AIRES,355,439,491,446,937
06,06427,064273709,La Matanza,BUENOS AIRES,456,444,773,732,1505
06,06427,064273803,La Matanza,BUENOS AIRES,578,538,1205,1094,2299
06,06427,064273805,La Matanza,BUENOS AIRES,305,284,567,548,1115
06,06427,064273906,La Matanza,BUENOS AIRES,293,274,523,482,1005
06,06427,064273911,La Matanza,BUENOS AIRES,343,263,596,606,1202
06,06427,064274008,La Matanza,BUENOS AIRES,596,514,1258,1229,2487
06,06427,064274101,La Matanza,BUENOS AIRES,603,481,1096,1117,2213
06,06427,064274412,La Matanza,BUENOS AIRES,447,438,757,701,1458
06,06427,064274508,La Matanza,BUENOS AIRES,510,534,904,859,1763
06,06427,064274601,La Matanza,BUENOS AIRES,386,419,690,605,1295
06,06427,064274608,La Matanza,BUENOS AIRES,226,183,394,395,789
06,06427,064274703,La Matanza,BUENOS AIRES,143,45,405,376,781
06,06427,064274807,La Matanza,BUENOS AIRES,419,408,723,675,1398
06,06427,064274812,La Matanza,BUENOS AIRES,538,520,975,889,1864
06,06427,064274904,La Matanza,BUENOS AIRES,390,320,819,768,1587
06,06427,064275213,La Matanza,BUENOS AIRES,472,354,972,991,1963
06,06427,064275202,La Matanza,BUENOS AIRES,493,452,1032,974,2006
06,06427,064275208,La Matanza,BUENOS AIRES,374,310,791,778,1569
06,06427,064275305,La Matanza,BUENOS AIRES,607,468,1199,1210,2409
06,06427,064275403,La Matanza,BUENOS AIRES,334,247,685,638,1323
06,06427,064275411,La Matanza,BUENOS AIRES,332,280,629,638,1267
06,06427,064275412,La Matanza,BUENOS AIRES,481,462,844,807,1651
06,06427,064275510,La Matanza,BUENOS AIRES,425,327,815,837,1652
06,06427,064275511,La Matanza,BUENOS AIRES,494,362,944,868,1812
06,06427,064275703,La Matanza,BUENOS AIRES,292,246,572,523,1095
06,06427,064275709,La Matanza,BUENOS AIRES,212,201,359,371,730
06,06427,064275805,La Matanza,BUENOS AIRES,248,195,430,460,890
06,06427,064275905,La Matanza,BUENOS AIRES,504,422,1004,928,1932
06,06427,064275912,La Matanza,BUENOS AIRES,296,263,519,525,1044
06,06427,064275913,La Matanza,BUENOS AIRES,298,293,524,491,1015
06,06427,064276006,La Matanza,BUENOS AIRES,555,468,1189,982,2171
06,06427,064276009,La Matanza,BUENOS AIRES,472,384,1040,893,1933
06,06427,064276013,La Matanza,BUENOS AIRES,272,267,522,475,997
06,06427,064276213,La Matanza,BUENOS AIRES,383,286,780,706,1486
06,06427,064276301,La Matanza,BUENOS AIRES,472,455,961,850,1811
06,06427,064276302,La Matanza,BUENOS AIRES,104,67,247,234,481
06,06427,064276412,La Matanza,BUENOS AIRES,369,286,723,701,1424
06,06427,064276510,La Matanza,BUENOS AIRES,279,229,586,578,1164
06,06427,064276605,La Matanza,BUENOS AIRES,484,386,915,856,1771
06,06427,064276608,La Matanza,BUENOS AIRES,335,302,646,608,1254
06,06427,064276704,La Matanza,BUENOS AIRES,840,656,1801,1828,3629
06,06427,064276708,La Matanza,BUENOS AIRES,342,264,656,616,1272
06,06427,064276710,La Matanza,BUENOS AIRES,250,225,485,494,979
06,06427,064276711,La Matanza,BUENOS AIRES,314,237,612,585,1197
06,06427,064276716,La Matanza,BUENOS AIRES,289,217,706,636,1342
06,06427,064276807,La Matanza,BUENOS AIRES,299,244,497,505,1002
06,06427,064276808,La Matanza,BUENOS AIRES,340,287,566,564,1130
06,06427,064276909,La Matanza,BUENOS AIRES,523,480,994,912,1906
06,06427,064277011,La Matanza,BUENOS AIRES,287,277,519,529,1048
06,06427,064277102,La Matanza,BUENOS AIRES,427,400,776,708,1484
06,06427,064277104,La Matanza,BUENOS AIRES,240,191,455,455,910
06,06427,064277204,La Matanza,BUENOS AIRES,350,291,680,632,1312
06,06427,064277308,La Matanza,BUENOS AIRES,510,457,987,1002,1989
06,06427,064277316,La Matanza,BUENOS AIRES,329,299,639,701,1340
06,06427,064277407,La Matanza,BUENOS AIRES,436,395,838,845,1683
06,06427,064277502,La Matanza,BUENOS AIRES,579,331,1328,1323,2651
06,06427,064277510,La Matanza,BUENOS AIRES,471,382,910,971,1881
06,06427,064277705,La Matanza,BUENOS AIRES,301,249,615,577,1192
06,06427,064277708,La Matanza,BUENOS AIRES,306,256,559,534,1093
06,06427,064277714,La Matanza,BUENOS AIRES,301,279,535,546,1081
06,06427,064277715,La Matanza,BUENOS AIRES,268,249,524,480,1004
06,06427,064277901,La Matanza,BUENOS AIRES,568,317,1285,1301,2586
06,06427,064277911,La Matanza,BUENOS AIRES,495,470,943,931,1874
06,06427,064278008,La Matanza,BUENOS AIRES,458,381,876,892,1768
06,06427,064278016,La Matanza,BUENOS AIRES,293,259,622,645,1267
06,06427,064278108,La Matanza,BUENOS AIRES,35,23,67,77,144
06,06427,064278204,La Matanza,BUENOS AIRES,312,286,638,579,1217
06,06427,064278206,La Matanza,BUENOS AIRES,433,57,1019,1051,2070
06,06427,064278209,La Matanza,BUENOS AIRES,747,378,1654,1637,3291
06,06427,064278310,La Matanza,BUENOS AIRES,355,326,707,729,1436
06,06427,064278311,La Matanza,BUENOS AIRES,351,321,657,629,1286
06,06427,064278404,La Matanza,BUENOS AIRES,399,395,824,796,1620
06,06427,064278405,La Matanza,BUENOS AIRES,508,483,929,973,1902
06,06427,064278408,La Matanza,BUENOS AIRES,403,390,838,813,1651
06,06427,064278613,La Matanza,BUENOS AIRES,386,351,784,696,1480
06,06427,064278704,La Matanza,BUENOS AIRES,382,355,712,705,1417
06,06427,064278708,La Matanza,BUENOS AIRES,477,476,824,872,1696
06,06427,064278713,La Matanza,BUENOS AIRES,336,334,595,590,1185
06,06427,064278902,La Matanza,BUENOS AIRES,572,298,1252,1284,2536
06,06427,064278907,La Matanza,BUENOS AIRES,561,507,1172,1299,2471
06,06427,064278914,La Matanza,BUENOS AIRES,559,498,1190,1248,2438
06,06427,064279009,La Matanza,BUENOS AIRES,599,574,1336,1280,2616
06,06427,064279011,La Matanza,BUENOS AIRES,295,289,547,549,1096
06,06427,064279106,La Matanza,BUENOS AIRES,308,314,552,503,1055
06,06427,064279108,La Matanza,BUENOS AIRES,374,319,673,706,1379
06,06427,064279208,La Matanza,BUENOS AIRES,488,494,1046,1048,2094
06,06427,064279309,La Matanza,BUENOS AIRES,451,455,832,757,1589
06,06427,064279310,La Matanza,BUENOS AIRES,445,462,803,739,1542
06,06427,064279312,La Matanza,BUENOS AIRES,415,404,827,769,1596
06,06427,064279313,La Matanza,BUENOS AIRES,453,426,896,910,1806
06,06427,064279409,La Matanza,BUENOS AIRES,426,419,786,786,1572
06,06427,064279410,La Matanza,BUENOS AIRES,380,381,740,735,1475
06,06427,064279503,La Matanza,BUENOS AIRES,485,456,1079,1032,2111
06,06427,064279610,La Matanza,BUENOS AIRES,498,509,1077,1124,2201
06,06427,064279612,La Matanza,BUENOS AIRES,391,375,832,885,1717
06,06427,064279614,La Matanza,BUENOS AIRES,437,376,926,976,1902
06,06427,064279714,La Matanza,BUENOS AIRES,377,402,679,729,1408
06,06427,064279712,La Matanza,BUENOS AIRES,140,138,293,277,570
06,06427,064279723,La Matanza,BUENOS AIRES,289,274,585,587,1172
06,06427,064276801,La Matanza,BUENOS AIRES,288,270,560,522,1082
06,06427,064277613,La Matanza,BUENOS AIRES,239,270,485,451,936
06,06427,064279608,La Matanza,BUENOS AIRES,477,457,940,949,1889
06,06427,064270110,La Matanza,BUENOS AIRES,307,389,432,366,798
06,06427,064270205,La Matanza,BUENOS AIRES,226,325,267,222,489
06,06427,064270218,La Matanza,BUENOS AIRES,310,360,437,364,801
06,06427,064270301,La Matanza,BUENOS AIRES,253,269,343,258,601
06,06427,064270304,La Matanza,BUENOS AIRES,233,274,319,274,593
06,06427,064270408,La Matanza,BUENOS AIRES,355,366,549,513,1062
06,06427,064270503,La Matanza,BUENOS AIRES,269,293,447,427,874
06,06427,064270509,La Matanza,BUENOS AIRES,240,250,383,326,709
06,06427,064270601,La Matanza,BUENOS AIRES,346,317,591,520,1111
06,06427,064270609,La Matanza,BUENOS AIRES,386,414,600,536,1136
06,06427,064270709,La Matanza,BUENOS AIRES,326,350,483,436,919
06,06427,064270713,La Matanza,BUENOS AIRES,296,258,519,525,1044
06,06427,064270811,La Matanza,BUENOS AIRES,409,418,700,627,1327
06,06427,064270911,La Matanza,BUENOS AIRES,343,271,609,570,1179
06,06427,064271102,La Matanza,BUENOS AIRES,377,366,631,547,1178
06,06427,064271203,La Matanza,BUENOS AIRES,174,235,285,258,543
06,06427,064271209,La Matanza,BUENOS AIRES,240,246,421,348,769
06,06427,064271403,La Matanza,BUENOS AIRES,318,203,651,619,1270
06,06427,064271412,La Matanza,BUENOS AIRES,219,124,448,445,893
06,06427,064271514,La Matanza,BUENOS AIRES,324,218,569,605,1174
06,06427,064271609,La Matanza,BUENOS AIRES,386,364,736,665,1401
06,06427,064271704,La Matanza,BUENOS AIRES,246,219,495,421,916
06,06427,064272311,La Matanza,BUENOS AIRES,589,543,931,865,1796
06,06427,064272403,La Matanza,BUENOS AIRES,411,161,1126,1142,2268
06,06427,064272503,La Matanza,BUENOS AIRES,391,395,595,564,1159
06,06427,064272505,La Matanza,BUENOS AIRES,511,372,1086,1083,2169
06,06427,064272508,La Matanza,BUENOS AIRES,153,157,273,236,509
06,06427,064272509,La Matanza,BUENOS AIRES,387,419,570,543,1113
06,06427,064272602,La Matanza,BUENOS AIRES,310,309,539,505,1044
06,06427,064272605,La Matanza,BUENOS AIRES,332,331,559,512,1071
06,06427,064272607,La Matanza,BUENOS AIRES,511,453,849,740,1589
06,06427,064272609,La Matanza,BUENOS AIRES,381,377,626,575,1201
06,06427,064272610,La Matanza,BUENOS AIRES,361,366,537,473,1010
06,06427,064272702,La Matanza,BUENOS AIRES,195,205,304,282,586
06,06427,064272707,La Matanza,BUENOS AIRES,412,421,619,558,1177
06,06427,064272807,La Matanza,BUENOS AIRES,395,477,585,511,1096
06,06427,064272808,La Matanza,BUENOS AIRES,305,361,457,427,884
06,06427,064272910,La Matanza,BUENOS AIRES,215,246,304,277,581
06,06427,064272912,La Matanza,BUENOS AIRES,432,466,697,601,1298
06,06427,064273003,La Matanza,BUENOS AIRES,281,395,378,317,695
06,06427,064273105,La Matanza,BUENOS AIRES,429,491,693,583,1276
06,06427,064273206,La Matanza,BUENOS AIRES,287,326,394,373,767
06,06427,064273301,La Matanza,BUENOS AIRES,242,282,362,328,690
06,06427,064273304,La Matanza,BUENOS AIRES,150,170,210,180,390
06,06427,064273305,La Matanza,BUENOS AIRES,211,231,319,293,612
06,06427,064273311,La Matanza,BUENOS AIRES,327,357,515,458,973
06,06427,064273408,La Matanza,BUENOS AIRES,336,378,519,439,958
06,06427,064273414,La Matanza,BUENOS AIRES,308,328,490,451,941
06,06427,064273502,La Matanza,BUENOS AIRES,238,294,421,354,775
06,06427,064273505,La Matanza,BUENOS AIRES,326,331,564,463,1027
06,06427,064273701,La Matanza,BUENOS AIRES,188,226,281,280,561
06,06427,064273706,La Matanza,BUENOS AIRES,598,723,922,814,1736
06,06427,064273708,La Matanza,BUENOS AIRES,375,393,576,592,1168
06,06427,064273801,La Matanza,BUENOS AIRES,363,333,741,654,1395
06,06427,064273807,La Matanza,BUENOS AIRES,422,381,725,648,1373
06,06427,064273905,La Matanza,BUENOS AIRES,397,344,764,720,1484
06,06427,064274004,La Matanza,BUENOS AIRES,446,408,887,809,1696
06,06427,064274009,La Matanza,BUENOS AIRES,215,235,381,378,759
06,06427,064274012,La Matanza,BUENOS AIRES,237,238,449,447,896
06,06427,064274102,La Matanza,BUENOS AIRES,659,501,1313,1200,2513
06,06427,064274110,La Matanza,BUENOS AIRES,323,268,615,675,1290
06,06427,064274202,La Matanza,BUENOS AIRES,476,414,928,826,1754
06,06427,064274203,La Matanza,BUENOS AIRES,604,497,1146,1130,2276
06,06427,064274204,La Matanza,BUENOS AIRES,584,579,1124,1028,2152
06,06427,064274307,La Matanza,BUENOS AIRES,382,335,669,551,1220
06,06427,064274410,La Matanza,BUENOS AIRES,310,322,527,472,999
06,06427,064274502,La Matanza,BUENOS AIRES,373,394,626,595,1221
06,06427,064274511,La Matanza,BUENOS AIRES,364,387,612,570,1182
06,06427,064274701,La Matanza,BUENOS AIRES,301,275,497,487,984
06,06427,064274707,La Matanza,BUENOS AIRES,222,36,606,665,1271
06,06427,064274711,La Matanza,BUENOS AIRES,295,245,502,454,956
06,06427,064274803,La Matanza,BUENOS AIRES,473,428,909,848,1757
06,06427,064274804,La Matanza,BUENOS AIRES,379,365,679,665,1344
06,06427,064274909,La Matanza,BUENOS AIRES,537,465,1064,1065,2129
06,06427,064275004,La Matanza,BUENOS AIRES,412,402,680,632,1312
06,06427,064275011,La Matanza,BUENOS AIRES,399,376,699,641,1340
06,06427,064275104,La Matanza,BUENOS AIRES,314,328,540,500,1040
06,06427,064275210,La Matanza,BUENOS AIRES,297,242,678,645,1323
06,06427,064275402,La Matanza,BUENOS AIRES,560,461,1166,1075,2241
06,06427,064275404,La Matanza,BUENOS AIRES,305,228,630,572,1202
06,06427,064275407,La Matanza,BUENOS AIRES,415,358,798,824,1622
06,06427,064275409,La Matanza,BUENOS AIRES,467,467,849,894,1743
06,06427,064275506,La Matanza,BUENOS AIRES,461,400,808,783,1591
06,06427,064275509,La Matanza,BUENOS AIRES,310,286,618,584,1202
06,06427,064275603,La Matanza,BUENOS AIRES,1157,321,3108,2787,5895
06,06427,064275606,La Matanza,BUENOS AIRES,488,476,837,834,1671
06,06427,064275611,La Matanza,BUENOS AIRES,373,390,607,530,1137
06,06427,064275612,La Matanza,BUENOS AIRES,433,462,776,639,1415
06,06427,064275706,La Matanza,BUENOS AIRES,433,378,813,727,1540
06,06427,064275707,La Matanza,BUENOS AIRES,452,413,767,742,1509
06,06427,064275802,La Matanza,BUENOS AIRES,434,393,782,774,1556
06,06427,064275901,La Matanza,BUENOS AIRES,543,434,991,991,1982
06,06427,064276007,La Matanza,BUENOS AIRES,518,403,1041,971,2012
06,06427,064276014,La Matanza,BUENOS AIRES,258,218,380,386,766
06,06427,064276111,La Matanza,BUENOS AIRES,301,280,522,519,1041
06,06427,064276114,La Matanza,BUENOS AIRES,387,394,690,682,1372
06,06427,064276202,La Matanza,BUENOS AIRES,425,340,882,759,1641
06,06427,064276307,La Matanza,BUENOS AIRES,364,310,734,657,1391
06,06427,064276309,La Matanza,BUENOS AIRES,551,446,1139,973,2112
06,06427,064276504,La Matanza,BUENOS AIRES,529,386,1142,1120,2262
06,06427,064276610,La Matanza,BUENOS AIRES,346,317,657,638,1295
06,06427,064276709,La Matanza,BUENOS AIRES,282,230,570,581,1151
06,06427,064276713,La Matanza,BUENOS AIRES,306,266,688,649,1337
06,06427,064276714,La Matanza,BUENOS AIRES,279,271,605,636,1241
06,06427,064276805,La Matanza,BUENOS AIRES,267,315,458,439,897
06,06427,064276902,La Matanza,BUENOS AIRES,370,318,796,757,1553
06,06427,064276904,La Matanza,BUENOS AIRES,379,329,793,755,1548
06,06427,064276905,La Matanza,BUENOS AIRES,654,394,1444,1452,2896
06,06427,064276913,La Matanza,BUENOS AIRES,459,449,818,804,1622
06,06427,064277013,La Matanza,BUENOS AIRES,256,228,432,441,873
06,06427,064277112,La Matanza,BUENOS AIRES,494,462,905,922,1827
06,06427,064277202,La Matanza,BUENOS AIRES,279,282,550,542,1092
06,06427,064277302,La Matanza,BUENOS AIRES,507,448,1027,1021,2048
06,06427,064277305,La Matanza,BUENOS AIRES,397,309,806,772,1578
06,06427,064277409,La Matanza,BUENOS AIRES,276,254,547,477,1024
06,06427,064277418,La Matanza,BUENOS AIRES,1043,733,2412,2272,4684
06,06427,064277617,La Matanza,BUENOS AIRES,276,278,573,580,1153
06,06427,064277711,La Matanza,BUENOS AIRES,355,317,679,652,1331
06,06427,064277803,La Matanza,BUENOS AIRES,416,314,779,799,1578
06,06427,064277804,La Matanza,BUENOS AIRES,342,289,652,622,1274
06,06427,064278003,La Matanza,BUENOS AIRES,465,419,991,1004,1995
06,06427,064278005,La Matanza,BUENOS AIRES,411,273,829,807,1636
06,06427,064278006,La Matanza,BUENOS AIRES,470,432,904,974,1878
06,06427,064278212,La Matanza,BUENOS AIRES,301,251,576,586,1162
06,06427,064278305,La Matanza,BUENOS AIRES,506,224,1088,1029,2117
06,06427,064278306,La Matanza,BUENOS AIRES,401,339,819,791,1610
06,06427,064278411,La Matanza,BUENOS AIRES,454,454,948,968,1916
06,06427,064278414,La Matanza,BUENOS AIRES,243,282,425,467,892
06,06427,064278507,La Matanza,BUENOS AIRES,431,346,867,796,1663
06,06427,064278606,La Matanza,BUENOS AIRES,309,303,570,519,1089
06,06427,064278614,La Matanza,BUENOS AIRES,374,340,748,722,1470
06,06427,064278808,La Matanza,BUENOS AIRES,440,404,857,811,1668
06,06427,064278809,La Matanza,BUENOS AIRES,427,394,798,828,1626
06,06427,064278811,La Matanza,BUENOS AIRES,203,200,386,365,751
06,06427,064279218,La Matanza,BUENOS AIRES,228,210,429,450,879
06,06427,064279014,La Matanza,BUENOS AIRES,333,311,693,696,1389
06,06427,064279116,La Matanza,BUENOS AIRES,87,180,143,153,296
06,06427,064279404,La Matanza,BUENOS AIRES,470,458,1034,993,2027
06,06427,064279408,La Matanza,BUENOS AIRES,310,321,612,610,1222
06,06427,064279504,La Matanza,BUENOS AIRES,575,537,1210,1236,2446
06,06427,064279507,La Matanza,BUENOS AIRES,940,732,2346,2395,4741
06,06427,064279512,La Matanza,BUENOS AIRES,566,514,1128,1103,2231
06,06427,064279609,La Matanza,BUENOS AIRES,514,534,1017,1037,2054
06,06427,064279710,La Matanza,BUENOS AIRES,225,262,439,443,882
06,06427,064279720,La Matanza,BUENOS AIRES,358,367,715,729,1444
06,06427,064279721,La Matanza,BUENOS AIRES,328,378,588,628,1216
06,06287,062870403,General Alvear,BUENOS AIRES,91,106,136,142,278
06,06287,062870302,General Alvear,BUENOS AIRES,14,30,18,23,41
06,06287,062870201,General Alvear,BUENOS AIRES,57,89,56,83,139
06,06287,062870413,General Alvear,BUENOS AIRES,350,400,512,472,984
06,06287,062870502,General Alvear,BUENOS AIRES,60,101,73,146,219
06,06287,062870416,General Alvear,BUENOS AIRES,28,60,33,1435,1468
06,06287,062870601,General Alvear,BUENOS AIRES,66,108,96,127,223
06,06287,062870415,General Alvear,BUENOS AIRES,279,313,528,536,1064
06,06287,062870101,General Alvear,BUENOS AIRES,91,160,97,148,245
06,06287,062870417,General Alvear,BUENOS AIRES,7,11,1,10,11
06,06287,062870702,General Alvear,BUENOS AIRES,48,80,47,78,125
06,06287,062870406,General Alvear,BUENOS AIRES,199,236,287,225,512
06,06287,062870409,General Alvear,BUENOS AIRES,124,153,191,200,391
06,06287,062870412,General Alvear,BUENOS AIRES,190,228,260,219,479
06,06287,062870414,General Alvear,BUENOS AIRES,223,260,339,281,620
06,06287,062870701,General Alvear,BUENOS AIRES,45,72,51,75,126
06,06287,062870408,General Alvear,BUENOS AIRES,205,214,337,343,680
06,06287,062870410,General Alvear,BUENOS AIRES,132,154,185,176,361
06,06287,062870411,General Alvear,BUENOS AIRES,271,324,387,350,737
06,06287,062870301,General Alvear,BUENOS AIRES,9,19,8,12,20
06,06287,062870402,General Alvear,BUENOS AIRES,9,22,17,11,28
06,06287,062870501,General Alvear,BUENOS AIRES,27,43,24,47,71
06,06287,062870401,General Alvear,BUENOS AIRES,66,98,101,128,229
06,06287,062870404,General Alvear,BUENOS AIRES,178,196,295,295,590
06,06287,062870405,General Alvear,BUENOS AIRES,291,333,427,387,814
06,06287,062870407,General Alvear,BUENOS AIRES,248,289,344,331,675
06,06294,062940603,General Arenales,BUENOS AIRES,216,264,296,251,547
06,06294,062940808,General Arenales,BUENOS AIRES,248,286,382,331,713
06,06294,062940210,General Arenales,BUENOS AIRES,10,31,9,21,30
06,06294,062940103,General Arenales,BUENOS AIRES,0,17,0,0,0
06,06294,062940207,General Arenales,BUENOS AIRES,8,11,8,14,22
06,06294,062940704,General Arenales,BUENOS AIRES,8,26,10,18,28
06,06294,062940813,General Arenales,BUENOS AIRES,1,1,1,2,3
06,06294,062940606,General Arenales,BUENOS AIRES,17,33,26,27,53
06,06294,062940608,General Arenales,BUENOS AIRES,71,102,115,107,222
06,06294,062940501,General Arenales,BUENOS AIRES,27,32,41,49,90
06,06294,062940203,General Arenales,BUENOS AIRES,383,439,553,564,1117
06,06294,062940407,General Arenales,BUENOS AIRES,9,12,7,13,20
06,06294,062940609,General Arenales,BUENOS AIRES,123,150,166,178,344
06,06294,062940610,General Arenales,BUENOS AIRES,133,163,172,193,365
06,06294,062940807,General Arenales,BUENOS AIRES,218,241,372,324,696
06,06294,062940505,General Arenales,BUENOS AIRES,13,27,22,27,49
06,06294,062940605,General Arenales,BUENOS AIRES,4,32,4,7,11
06,06294,062940705,General Arenales,BUENOS AIRES,9,24,8,15,23
06,06294,062940202,General Arenales,BUENOS AIRES,98,117,149,159,308
06,06294,062940406,General Arenales,BUENOS AIRES,52,170,79,82,161
06,06294,062940810,General Arenales,BUENOS AIRES,108,131,171,186,357
06,06294,062940504,General Arenales,BUENOS AIRES,4,14,3,6,9
06,06294,062940208,General Arenales,BUENOS AIRES,1,11,1,1,2
06,06294,062940814,General Arenales,BUENOS AIRES,7,26,8,14,22
06,06294,062940209,General Arenales,BUENOS AIRES,11,19,15,17,32
06,06294,062940402,General Arenales,BUENOS AIRES,331,391,466,459,925
06,06294,062940602,General Arenales,BUENOS AIRES,146,166,200,173,373
06,06294,062940805,General Arenales,BUENOS AIRES,143,177,178,168,346
06,06294,062940809,General Arenales,BUENOS AIRES,56,71,96,105,201
06,06294,062940102,General Arenales,BUENOS AIRES,2,22,3,7,10
06,06294,062940301,General Arenales,BUENOS AIRES,10,13,13,11,24
06,06294,062940204,General Arenales,BUENOS AIRES,336,403,462,425,887
06,06294,062940404,General Arenales,BUENOS AIRES,162,184,250,198,448
06,06294,062940601,General Arenales,BUENOS AIRES,263,306,383,329,712
06,06294,062940803,General Arenales,BUENOS AIRES,199,231,272,252,524
06,06294,062940502,General Arenales,BUENOS AIRES,5,28,6,7,13
06,06294,062940702,General Arenales,BUENOS AIRES,12,24,12,18,30
06,06294,062940703,General Arenales,BUENOS AIRES,7,16,7,9,16
06,06294,062940211,General Arenales,BUENOS AIRES,96,119,132,133,265
06,06294,062940403,General Arenales,BUENOS AIRES,389,465,546,487,1033
06,06294,062940806,General Arenales,BUENOS AIRES,162,183,208,191,399
06,06294,062940205,General Arenales,BUENOS AIRES,20,47,28,35,63
06,06294,062940607,General Arenales,BUENOS AIRES,15,28,20,24,44
06,06294,062940701,General Arenales,BUENOS AIRES,7,14,3,8,11
06,06294,062940812,General Arenales,BUENOS AIRES,3,14,3,8,11
06,06294,062940801,General Arenales,BUENOS AIRES,64,82,91,82,173
06,06294,062940408,General Arenales,BUENOS AIRES,305,349,483,441,924
06,06294,062940405,General Arenales,BUENOS AIRES,38,50,55,52,107
06,06294,062940604,General Arenales,BUENOS AIRES,131,167,212,187,399
06,06294,062940802,General Arenales,BUENOS AIRES,206,236,275,253,528
06,06294,062940101,General Arenales,BUENOS AIRES,9,30,4,13,17
06,06294,062940206,General Arenales,BUENOS AIRES,8,35,14,14,28
06,06294,062940302,General Arenales,BUENOS AIRES,5,8,3,8,11
06,06294,062940303,General Arenales,BUENOS AIRES,7,22,6,7,13
06,06294,062940804,General Arenales,BUENOS AIRES,126,140,157,155,312
06,06294,062940401,General Arenales,BUENOS AIRES,233,258,369,334,703
06,06294,062940503,General Arenales,BUENOS AIRES,5,34,5,7,12
06,06294,062940201,General Arenales,BUENOS AIRES,6,16,3,8,11
06,06294,062940506,General Arenales,BUENOS AIRES,26,58,33,37,70
06,06294,062940706,General Arenales,BUENOS AIRES,0,14,0,0,0
06,06294,062940811,General Arenales,BUENOS AIRES,3,11,6,4,10
06,06294,062940815,General Arenales,BUENOS AIRES,12,28,13,13,26
06,06301,063010509,General Belgrano,BUENOS AIRES,259,308,387,352,739
06,06301,063010803,General Belgrano,BUENOS AIRES,57,123,76,84,160
06,06301,063010401,General Belgrano,BUENOS AIRES,60,95,65,100,165
06,06301,063010815,General Belgrano,BUENOS AIRES,9,18,8,13,21
06,06301,063010507,General Belgrano,BUENOS AIRES,187,223,292,268,560
06,06301,063010805,General Belgrano,BUENOS AIRES,191,410,289,280,569
06,06301,063010501,General Belgrano,BUENOS AIRES,5,22,7,12,19
06,06301,063010601,General Belgrano,BUENOS AIRES,78,164,97,188,285
06,06301,063010701,General Belgrano,BUENOS AIRES,78,125,107,126,233
06,06301,063010508,General Belgrano,BUENOS AIRES,246,276,362,301,663
06,06301,063010511,General Belgrano,BUENOS AIRES,287,346,380,308,688
06,06301,063010811,General Belgrano,BUENOS AIRES,280,341,417,329,746
06,06301,063010812,General Belgrano,BUENOS AIRES,358,418,524,489,1013
06,06301,063010814,General Belgrano,BUENOS AIRES,222,266,308,339,647
06,06301,063010510,General Belgrano,BUENOS AIRES,242,290,372,304,676
06,06301,063010804,General Belgrano,BUENOS AIRES,55,172,59,69,128
06,06301,063010807,General Belgrano,BUENOS AIRES,117,179,230,206,436
06,06301,063010201,General Belgrano,BUENOS AIRES,48,77,58,69,127
06,06301,063010101,General Belgrano,BUENOS AIRES,195,267,259,303,562
06,06301,063010506,General Belgrano,BUENOS AIRES,222,260,325,299,624
06,06301,063010504,General Belgrano,BUENOS AIRES,219,267,346,330,676
06,06301,063010813,General Belgrano,BUENOS AIRES,234,278,357,364,721
06,06301,063010801,General Belgrano,BUENOS AIRES,91,147,147,201,348
06,06301,063010505,General Belgrano,BUENOS AIRES,222,271,342,346,688
06,06301,063010512,General Belgrano,BUENOS AIRES,337,390,496,427,923
06,06301,063010514,General Belgrano,BUENOS AIRES,188,201,328,306,634
06,06301,063010802,General Belgrano,BUENOS AIRES,41,88,65,68,133
06,06301,063010808,General Belgrano,BUENOS AIRES,281,331,401,333,734
06,06301,063010809,General Belgrano,BUENOS AIRES,248,313,341,285,626
06,06301,063010810,General Belgrano,BUENOS AIRES,146,184,215,210,425
06,06301,063010502,General Belgrano,BUENOS AIRES,55,94,86,119,205
06,06301,063010503,General Belgrano,BUENOS AIRES,29,43,45,48,93
06,06301,063010513,General Belgrano,BUENOS AIRES,401,462,669,583,1252
06,06301,063010806,General Belgrano,BUENOS AIRES,276,452,386,357,743
06,06301,063010301,General Belgrano,BUENOS AIRES,44,61,36,67,103
06,06315,063150111,General Juan Madariaga,BUENOS AIRES,453,522,680,650,1330
06,06315,063150113,General Juan Madariaga,BUENOS AIRES,333,388,575,508,1083
06,06315,063150116,General Juan Madariaga,BUENOS AIRES,199,225,332,310,642
06,06315,063150501,General Juan Madariaga,BUENOS AIRES,78,139,98,100,198
06,06315,063150303,General Juan Madariaga,BUENOS AIRES,143,203,209,251,460
06,06315,063150112,General Juan Madariaga,BUENOS AIRES,304,352,527,526,1053
06,06315,063150118,General Juan Madariaga,BUENOS AIRES,289,348,500,456,956
06,06315,063150301,General Juan Madariaga,BUENOS AIRES,261,325,485,448,933
06,06315,063150201,General Juan Madariaga,BUENOS AIRES,56,105,66,95,161
06,06315,063150106,General Juan Madariaga,BUENOS AIRES,311,383,488,438,926
06,06315,063150107,General Juan Madariaga,BUENOS AIRES,200,222,366,326,692
06,06315,063150110,General Juan Madariaga,BUENOS AIRES,376,437,530,467,997
06,06315,063150401,General Juan Madariaga,BUENOS AIRES,84,163,76,117,193
06,06315,063150108,General Juan Madariaga,BUENOS AIRES,227,254,412,386,798
06,06315,063150109,General Juan Madariaga,BUENOS AIRES,368,443,595,465,1060
06,06315,063150302,General Juan Madariaga,BUENOS AIRES,105,124,181,185,366
06,06315,063150601,General Juan Madariaga,BUENOS AIRES,122,156,143,190,333
06,06315,063150104,General Juan Madariaga,BUENOS AIRES,315,381,453,345,798
06,06315,063150115,General Juan Madariaga,BUENOS AIRES,261,304,458,458,916
06,06315,063150701,General Juan Madariaga,BUENOS AIRES,38,53,32,49,81
06,06315,063150117,General Juan Madariaga,BUENOS AIRES,194,218,381,368,749
06,06315,063150502,General Juan Madariaga,BUENOS AIRES,122,178,142,200,342
06,06315,063150103,General Juan Madariaga,BUENOS AIRES,180,211,320,310,630
06,06315,063150101,General Juan Madariaga,BUENOS AIRES,234,246,360,350,710
06,06315,063150102,General Juan Madariaga,BUENOS AIRES,386,442,625,492,1117
06,06315,063150105,General Juan Madariaga,BUENOS AIRES,321,402,506,393,899
06,06315,063150114,General Juan Madariaga,BUENOS AIRES,372,412,680,644,1324
06,06343,063430602,General Paz,BUENOS AIRES,97,385,126,134,260
06,06343,063430101,General Paz,BUENOS AIRES,234,273,335,322,657
06,06343,063430710,General Paz,BUENOS AIRES,340,469,528,477,1005
06,06343,063430501,General Paz,BUENOS AIRES,16,46,25,28,53
06,06343,063430104,General Paz,BUENOS AIRES,21,29,26,37,63
06,06343,063430201,General Paz,BUENOS AIRES,44,76,53,79,132
06,06343,063430604,General Paz,BUENOS AIRES,11,28,15,20,35
06,06343,063430701,General Paz,BUENOS AIRES,101,144,170,165,335
06,06343,063430702,General Paz,BUENOS AIRES,179,208,304,309,613
06,06343,063430105,General Paz,BUENOS AIRES,25,44,41,46,87
06,06343,063430402,General Paz,BUENOS AIRES,30,60,45,50,95
06,06343,063430502,General Paz,BUENOS AIRES,20,35,26,27,53
06,06343,063430703,General Paz,BUENOS AIRES,277,317,428,374,802
06,06343,063430401,General Paz,BUENOS AIRES,27,56,43,41,84
06,06343,063430303,General Paz,BUENOS AIRES,19,36,23,26,49
06,06343,063430802,General Paz,BUENOS AIRES,18,31,21,35,56
06,06343,063430706,General Paz,BUENOS AIRES,263,294,406,386,792
06,06343,063430712,General Paz,BUENOS AIRES,182,239,270,288,558
06,06343,063430301,General Paz,BUENOS AIRES,30,62,37,46,83
06,06343,063430711,General Paz,BUENOS AIRES,215,253,337,354,691
06,06343,063430103,General Paz,BUENOS AIRES,66,96,102,113,215
06,06343,063430605,General Paz,BUENOS AIRES,17,34,22,29,51
06,06343,063430801,General Paz,BUENOS AIRES,16,37,15,23,38
06,06343,063430713,General Paz,BUENOS AIRES,148,254,186,233,419
06,06343,063430601,General Paz,BUENOS AIRES,183,264,278,259,537
06,06343,063430704,General Paz,BUENOS AIRES,136,156,192,197,389
06,06343,063430705,General Paz,BUENOS AIRES,236,272,361,339,700
06,06343,063430707,General Paz,BUENOS AIRES,253,285,379,344,723
06,06343,063430708,General Paz,BUENOS AIRES,164,207,260,242,502
06,06343,063430709,General Paz,BUENOS AIRES,309,385,440,366,806
06,06343,063430102,General Paz,BUENOS AIRES,28,46,38,40,78
06,06343,063430302,General Paz,BUENOS AIRES,16,35,26,23,49
06,06343,063430606,General Paz,BUENOS AIRES,4,10,9,5,14
06,06343,063430503,General Paz,BUENOS AIRES,32,65,35,55,90
06,06343,063430603,General Paz,BUENOS AIRES,25,45,40,48,88
06,06351,063510901,General Pinto,BUENOS AIRES,412,509,575,553,1128
06,06351,063510501,General Pinto,BUENOS AIRES,15,30,26,26,52
06,06351,063511002,General Pinto,BUENOS AIRES,9,22,9,16,25
06,06351,063511003,General Pinto,BUENOS AIRES,12,22,16,16,32
06,06351,063510601,General Pinto,BUENOS AIRES,157,237,250,234,484
06,06351,063510602,General Pinto,BUENOS AIRES,101,272,147,139,286
06,06351,063510104,General Pinto,BUENOS AIRES,11,19,13,13,26
06,06351,063510202,General Pinto,BUENOS AIRES,22,45,29,47,76
06,06351,063510304,General Pinto,BUENOS AIRES,13,41,13,21,34
06,06351,063510801,General Pinto,BUENOS AIRES,21,45,33,40,73
06,06351,063510802,General Pinto,BUENOS AIRES,11,24,12,15,27
06,06351,063510803,General Pinto,BUENOS AIRES,26,45,31,47,78
06,06351,063510102,General Pinto,BUENOS AIRES,135,155,206,192,398
06,06351,063510301,General Pinto,BUENOS AIRES,18,38,16,22,38
06,06351,063510606,General Pinto,BUENOS AIRES,357,380,472,471,943
06,06351,063510402,General Pinto,BUENOS AIRES,13,26,18,19,37
06,06351,063510502,General Pinto,BUENOS AIRES,6,9,9,15,24
06,06351,063510614,General Pinto,BUENOS AIRES,11,28,11,22,33
06,06351,063510103,General Pinto,BUENOS AIRES,140,174,205,208,413
06,06351,063510401,General Pinto,BUENOS AIRES,205,263,296,335,631
06,06351,063510406,General Pinto,BUENOS AIRES,290,343,386,380,766
06,06351,063510201,General Pinto,BUENOS AIRES,50,84,81,95,176
06,06351,063510302,General Pinto,BUENOS AIRES,7,15,12,11,23
06,06351,063510405,General Pinto,BUENOS AIRES,15,30,21,36,57
06,06351,063510612,General Pinto,BUENOS AIRES,4,13,11,6,17
06,06351,063510603,General Pinto,BUENOS AIRES,312,356,454,413,867
06,06351,063510607,General Pinto,BUENOS AIRES,340,399,428,396,824
06,06351,063510303,General Pinto,BUENOS AIRES,4,9,3,9,12
06,06351,063510404,General Pinto,BUENOS AIRES,17,32,19,30,49
06,06351,063510609,General Pinto,BUENOS AIRES,2,9,0,4,4
06,06351,063510703,General Pinto,BUENOS AIRES,9,21,9,12,21
06,06351,063510702,General Pinto,BUENOS AIRES,13,26,22,25,47
06,06351,063510902,General Pinto,BUENOS AIRES,8,18,9,13,22
06,06351,063510903,General Pinto,BUENOS AIRES,45,63,65,73,138
06,06351,063510604,General Pinto,BUENOS AIRES,371,453,499,489,988
06,06351,063510605,General Pinto,BUENOS AIRES,253,282,441,418,859
06,06351,063510608,General Pinto,BUENOS AIRES,97,131,148,152,300
06,06351,063510615,General Pinto,BUENOS AIRES,275,300,516,490,1006
06,06351,063510101,General Pinto,BUENOS AIRES,12,18,17,25,42
06,06351,063510610,General Pinto,BUENOS AIRES,4,15,2,3,5
06,06351,063510403,General Pinto,BUENOS AIRES,18,35,28,32,60
06,06351,063510611,General Pinto,BUENOS AIRES,9,20,12,17,29
06,06351,063510613,General Pinto,BUENOS AIRES,15,26,23,20,43
06,06351,063510701,General Pinto,BUENOS AIRES,16,33,19,30,49
06,06351,063511001,General Pinto,BUENOS AIRES,7,9,10,9,19
06,06434,064343303,Lanús,BUENOS AIRES,345,379,518,467,985
06,06434,064340211,Lanús,BUENOS AIRES,359,429,530,462,992
06,06434,064340212,Lanús,BUENOS AIRES,299,370,438,396,834
06,06434,064340210,Lanús,BUENOS AIRES,211,248,293,250,543
06,06434,064340101,Lanús,BUENOS AIRES,531,418,924,942,1866
06,06434,064340107,Lanús,BUENOS AIRES,263,269,404,383,787
06,06434,064340201,Lanús,BUENOS AIRES,260,275,398,364,762
06,06434,064340203,Lanús,BUENOS AIRES,291,313,452,373,825
06,06434,064340204,Lanús,BUENOS AIRES,217,269,334,313,647
06,06434,064340305,Lanús,BUENOS AIRES,324,400,490,434,924
06,06434,064340308,Lanús,BUENOS AIRES,454,541,701,684,1385
06,06434,064340501,Lanús,BUENOS AIRES,427,457,656,598,1254
06,06434,064340702,Lanús,BUENOS AIRES,270,227,463,431,894
06,06434,064340801,Lanús,BUENOS AIRES,209,222,316,319,635
06,06434,064340802,Lanús,BUENOS AIRES,443,426,743,655,1398
06,06434,064340804,Lanús,BUENOS AIRES,341,297,554,503,1057
06,06434,064340809,Lanús,BUENOS AIRES,259,232,528,537,1065
06,06434,064340810,Lanús,BUENOS AIRES,352,333,721,713,1434
06,06434,064340812,Lanús,BUENOS AIRES,463,413,826,880,1706
06,06434,064340814,Lanús,BUENOS AIRES,223,250,375,362,737
06,06434,064340903,Lanús,BUENOS AIRES,353,303,701,676,1377
06,06434,064340904,Lanús,BUENOS AIRES,228,199,455,427,882
06,06434,064340907,Lanús,BUENOS AIRES,270,239,540,511,1051
06,06434,064341003,Lanús,BUENOS AIRES,196,216,330,270,600
06,06434,064341104,Lanús,BUENOS AIRES,269,286,492,430,922
06,06434,064341106,Lanús,BUENOS AIRES,239,215,464,420,884
06,06434,064341301,Lanús,BUENOS AIRES,342,385,527,453,980
06,06434,064341303,Lanús,BUENOS AIRES,285,321,407,391,798
06,06434,064341304,Lanús,BUENOS AIRES,190,211,303,253,556
06,06434,064341307,Lanús,BUENOS AIRES,298,337,454,371,825
06,06434,064341403,Lanús,BUENOS AIRES,237,286,339,309,648
06,06434,064341407,Lanús,BUENOS AIRES,337,341,506,444,950
06,06434,064341507,Lanús,BUENOS AIRES,246,338,309,280,589
06,06434,064341515,Lanús,BUENOS AIRES,297,373,438,370,808
06,06434,064341604,Lanús,BUENOS AIRES,224,245,310,229,539
06,06434,064341705,Lanús,BUENOS AIRES,298,344,434,353,787
06,06434,064341801,Lanús,BUENOS AIRES,357,387,626,559,1185
06,06434,064341805,Lanús,BUENOS AIRES,317,396,458,395,853
06,06434,064341903,Lanús,BUENOS AIRES,357,412,548,502,1050
06,06434,064342111,Lanús,BUENOS AIRES,210,218,326,264,590
06,06434,064342202,Lanús,BUENOS AIRES,303,211,499,502,1001
06,06434,064342203,Lanús,BUENOS AIRES,190,199,334,312,646
06,06434,064342208,Lanús,BUENOS AIRES,313,225,565,526,1091
06,06434,064342209,Lanús,BUENOS AIRES,340,285,654,678,1332
06,06434,064342314,Lanús,BUENOS AIRES,235,217,484,484,968
06,06434,064342517,Lanús,BUENOS AIRES,253,268,418,383,801
06,06434,064342602,Lanús,BUENOS AIRES,193,180,328,353,681
06,06434,064342610,Lanús,BUENOS AIRES,343,322,677,641,1318
06,06434,064342709,Lanús,BUENOS AIRES,372,384,571,553,1124
06,06434,064342802,Lanús,BUENOS AIRES,392,358,674,653,1327
06,06434,064342903,Lanús,BUENOS AIRES,315,347,467,433,900
06,06434,064342904,Lanús,BUENOS AIRES,305,332,470,391,861
06,06434,064343001,Lanús,BUENOS AIRES,252,266,374,366,740
06,06434,064343004,Lanús,BUENOS AIRES,326,358,472,461,933
06,06434,064343007,Lanús,BUENOS AIRES,347,412,535,453,988
06,06434,064343105,Lanús,BUENOS AIRES,378,487,504,432,936
06,06434,064343109,Lanús,BUENOS AIRES,237,348,271,222,493
06,06434,064343111,Lanús,BUENOS AIRES,191,243,249,190,439
06,06434,064343207,Lanús,BUENOS AIRES,323,361,465,399,864
06,06434,064343304,Lanús,BUENOS AIRES,237,273,363,313,676
06,06434,064343406,Lanús,BUENOS AIRES,260,273,426,377,803
06,06434,064343511,Lanús,BUENOS AIRES,334,299,572,529,1101
06,06434,064343909,Lanús,BUENOS AIRES,240,224,483,465,948
06,06434,064344203,Lanús,BUENOS AIRES,206,228,321,276,597
06,06434,064344304,Lanús,BUENOS AIRES,306,359,461,372,833
06,06434,064344306,Lanús,BUENOS AIRES,290,294,464,389,853
06,06434,064344401,Lanús,BUENOS AIRES,156,161,290,259,549
06,06434,064344506,Lanús,BUENOS AIRES,226,235,416,406,822
06,06434,064344509,Lanús,BUENOS AIRES,246,252,450,422,872
06,06434,064344510,Lanús,BUENOS AIRES,249,239,441,435,876
06,06434,064342102,Lanús,BUENOS AIRES,252,271,406,328,734
06,06434,064344408,Lanús,BUENOS AIRES,224,241,366,324,690
06,06434,064344409,Lanús,BUENOS AIRES,207,223,296,309,605
06,06434,064340209,Lanús,BUENOS AIRES,53,66,86,64,150
06,06434,064340302,Lanús,BUENOS AIRES,294,345,415,352,767
06,06434,064340401,Lanús,BUENOS AIRES,362,425,527,465,992
06,06434,064340503,Lanús,BUENOS AIRES,283,304,392,364,756
06,06434,064340505,Lanús,BUENOS AIRES,333,358,536,491,1027
06,06434,064340606,Lanús,BUENOS AIRES,382,450,558,517,1075
06,06434,064340607,Lanús,BUENOS AIRES,329,364,499,474,973
06,06434,064340711,Lanús,BUENOS AIRES,165,183,282,257,539
06,06434,064340808,Lanús,BUENOS AIRES,88,84,182,167,349
06,06434,064340901,Lanús,BUENOS AIRES,248,254,476,442,918
06,06434,064340902,Lanús,BUENOS AIRES,353,274,679,670,1349
06,06434,064340912,Lanús,BUENOS AIRES,249,216,479,449,928
06,06434,064340913,Lanús,BUENOS AIRES,266,232,496,500,996
06,06434,064341103,Lanús,BUENOS AIRES,247,266,400,415,815
06,06434,064341110,Lanús,BUENOS AIRES,189,203,315,285,600
06,06434,064341206,Lanús,BUENOS AIRES,350,376,570,563,1133
06,06434,064341311,Lanús,BUENOS AIRES,431,430,723,656,1379
06,06434,064341401,Lanús,BUENOS AIRES,286,312,427,369,796
06,06434,064341405,Lanús,BUENOS AIRES,251,314,375,330,705
06,06434,064341509,Lanús,BUENOS AIRES,189,254,269,222,491
06,06434,064341609,Lanús,BUENOS AIRES,339,381,519,424,943
06,06434,064341610,Lanús,BUENOS AIRES,378,420,648,577,1225
06,06434,064341704,Lanús,BUENOS AIRES,297,356,431,395,826
06,06434,064341707,Lanús,BUENOS AIRES,160,194,239,200,439
06,06434,064341711,Lanús,BUENOS AIRES,265,298,388,352,740
06,06434,064341901,Lanús,BUENOS AIRES,341,346,516,466,982
06,06434,064342008,Lanús,BUENOS AIRES,342,352,516,460,976
06,06434,064342210,Lanús,BUENOS AIRES,487,444,794,726,1520
06,06434,064342213,Lanús,BUENOS AIRES,388,383,597,541,1138
06,06434,064342410,Lanús,BUENOS AIRES,283,282,454,368,822
06,06434,064342505,Lanús,BUENOS AIRES,233,235,407,358,765
06,06434,064342507,Lanús,BUENOS AIRES,283,227,566,536,1102
06,06434,064342518,Lanús,BUENOS AIRES,195,205,332,319,651
06,06434,064342615,Lanús,BUENOS AIRES,195,142,354,309,663
06,06434,064342708,Lanús,BUENOS AIRES,280,253,469,394,863
06,06434,064342710,Lanús,BUENOS AIRES,423,424,763,757,1520
06,06434,064342805,Lanús,BUENOS AIRES,271,284,444,412,856
06,06434,064342808,Lanús,BUENOS AIRES,479,478,815,734,1549
06,06434,064342811,Lanús,BUENOS AIRES,230,239,378,333,711
06,06434,064343009,Lanús,BUENOS AIRES,307,352,471,433,904
06,06434,064343106,Lanús,BUENOS AIRES,293,400,339,284,623
06,06434,064343202,Lanús,BUENOS AIRES,315,450,385,328,713
06,06434,064343203,Lanús,BUENOS AIRES,215,319,270,210,480
06,06434,064343205,Lanús,BUENOS AIRES,184,257,260,193,453
06,06434,064343206,Lanús,BUENOS AIRES,161,226,224,201,425
06,06434,064343401,Lanús,BUENOS AIRES,329,374,527,454,981
06,06434,064343407,Lanús,BUENOS AIRES,274,295,432,397,829
06,06434,064343506,Lanús,BUENOS AIRES,285,320,462,404,866
06,06434,064343608,Lanús,BUENOS AIRES,253,253,407,348,755
06,06434,064343806,Lanús,BUENOS AIRES,320,392,493,399,892
06,06434,064343905,Lanús,BUENOS AIRES,310,398,469,383,852
06,06434,064343907,Lanús,BUENOS AIRES,279,310,453,361,814
06,06434,064344003,Lanús,BUENOS AIRES,206,209,324,277,601
06,06434,064344008,Lanús,BUENOS AIRES,372,405,525,438,963
06,06434,064344102,Lanús,BUENOS AIRES,267,299,400,375,775
06,06434,064344108,Lanús,BUENOS AIRES,339,367,504,558,1062
06,06434,064344302,Lanús,BUENOS AIRES,267,308,418,396,814
06,06434,064344410,Lanús,BUENOS AIRES,276,313,430,400,830
06,06434,064344412,Lanús,BUENOS AIRES,378,413,595,547,1142
06,06434,064344511,Lanús,BUENOS AIRES,363,377,579,509,1088
06,06434,064344512,Lanús,BUENOS AIRES,489,512,840,769,1609
06,06434,064342504,Lanús,BUENOS AIRES,197,205,320,317,637
06,06434,064340105,Lanús,BUENOS AIRES,362,384,534,465,999
06,06434,064340108,Lanús,BUENOS AIRES,299,305,451,426,877
06,06434,064340110,Lanús,BUENOS AIRES,313,352,487,435,922
06,06434,064340404,Lanús,BUENOS AIRES,217,256,341,266,607
06,06434,064340504,Lanús,BUENOS AIRES,327,329,464,371,835
06,06434,064340506,Lanús,BUENOS AIRES,257,255,379,361,740
06,06434,064340608,Lanús,BUENOS AIRES,353,400,562,510,1072
06,06434,064340609,Lanús,BUENOS AIRES,338,328,600,604,1204
06,06434,064340707,Lanús,BUENOS AIRES,1286,1168,2133,1936,4069
06,06434,064340803,Lanús,BUENOS AIRES,216,230,387,350,737
06,06434,064340806,Lanús,BUENOS AIRES,486,477,862,868,1730
06,06434,064340911,Lanús,BUENOS AIRES,228,178,429,422,851
06,06434,064340916,Lanús,BUENOS AIRES,306,197,567,575,1142
06,06434,064340918,Lanús,BUENOS AIRES,274,238,523,532,1055
06,06434,064341111,Lanús,BUENOS AIRES,289,298,489,459,948
06,06434,064341207,Lanús,BUENOS AIRES,413,379,677,596,1273
06,06434,064341402,Lanús,BUENOS AIRES,218,278,305,299,604
06,06434,064341404,Lanús,BUENOS AIRES,294,326,429,390,819
06,06434,064341505,Lanús,BUENOS AIRES,235,286,329,307,636
06,06434,064342002,Lanús,BUENOS AIRES,337,347,532,502,1034
06,06434,064342007,Lanús,BUENOS AIRES,240,239,376,359,735
06,06434,064342107,Lanús,BUENOS AIRES,197,217,289,288,577
06,06434,064342110,Lanús,BUENOS AIRES,193,212,305,252,557
06,06434,064342205,Lanús,BUENOS AIRES,260,199,442,403,845
06,06434,064342207,Lanús,BUENOS AIRES,232,217,385,367,752
06,06434,064342409,Lanús,BUENOS AIRES,280,296,454,397,851
06,06434,064342308,Lanús,BUENOS AIRES,358,345,694,646,1340
06,06434,064342501,Lanús,BUENOS AIRES,394,407,677,622,1299
06,06434,064342502,Lanús,BUENOS AIRES,207,231,344,282,626
06,06434,064342601,Lanús,BUENOS AIRES,353,321,681,708,1389
06,06434,064342704,Lanús,BUENOS AIRES,275,247,442,442,884
06,06434,064342603,Lanús,BUENOS AIRES,438,495,713,742,1455
06,06434,064342608,Lanús,BUENOS AIRES,277,213,596,531,1127
06,06434,064342616,Lanús,BUENOS AIRES,262,247,469,526,995
06,06434,064342617,Lanús,BUENOS AIRES,293,189,573,520,1093
06,06434,064342706,Lanús,BUENOS AIRES,332,327,554,482,1036
06,06434,064342803,Lanús,BUENOS AIRES,446,400,782,748,1530
06,06434,064342902,Lanús,BUENOS AIRES,384,432,620,545,1165
06,06434,064343112,Lanús,BUENOS AIRES,238,286,280,244,524
06,06434,064342905,Lanús,BUENOS AIRES,288,321,437,387,824
06,06434,064343006,Lanús,BUENOS AIRES,329,369,484,445,929
06,06434,064343212,Lanús,BUENOS AIRES,238,290,350,276,626
06,06434,064343302,Lanús,BUENOS AIRES,368,397,550,511,1061
06,06434,064343305,Lanús,BUENOS AIRES,324,368,478,403,881
06,06434,064343408,Lanús,BUENOS AIRES,228,256,341,324,665
06,06434,064343409,Lanús,BUENOS AIRES,208,225,316,269,585
06,06434,064343502,Lanús,BUENOS AIRES,201,235,297,249,546
06,06434,064343508,Lanús,BUENOS AIRES,420,250,782,739,1521
06,06434,064343602,Lanús,BUENOS AIRES,391,420,610,526,1136
06,06434,064343703,Lanús,BUENOS AIRES,233,257,348,316,664
06,06434,064343801,Lanús,BUENOS AIRES,168,197,236,230,466
06,06434,064343902,Lanús,BUENOS AIRES,223,281,349,278,627
06,06434,064343903,Lanús,BUENOS AIRES,270,328,438,344,782
06,06434,064344002,Lanús,BUENOS AIRES,364,410,542,485,1027
06,06434,064344007,Lanús,BUENOS AIRES,228,257,358,348,706
06,06434,064344204,Lanús,BUENOS AIRES,284,288,458,440,898
06,06434,064344205,Lanús,BUENOS AIRES,261,236,432,382,814
06,06434,064344208,Lanús,BUENOS AIRES,270,300,506,462,968
06,06434,064344411,Lanús,BUENOS AIRES,257,277,407,352,759
06,06434,064343204,Lanús,BUENOS AIRES,151,275,183,136,319
06,06434,064340708,Lanús,BUENOS AIRES,178,175,286,240,526
06,06434,064341812,Lanús,BUENOS AIRES,199,261,266,234,500
06,06434,064343605,Lanús,BUENOS AIRES,288,325,448,408,856
06,06434,064340710,Lanús,BUENOS AIRES,216,234,361,309,670
06,06434,064340301,Lanús,BUENOS AIRES,340,379,541,444,985
06,06434,064340205,Lanús,BUENOS AIRES,293,363,445,333,778
06,06434,064340207,Lanús,BUENOS AIRES,60,70,81,84,165
06,06434,064340303,Lanús,BUENOS AIRES,522,601,815,714,1529
06,06434,064340307,Lanús,BUENOS AIRES,341,363,526,435,961
06,06434,064340402,Lanús,BUENOS AIRES,286,312,426,400,826
06,06434,064340508,Lanús,BUENOS AIRES,310,337,462,432,894
06,06434,064340604,Lanús,BUENOS AIRES,341,341,530,478,1008
06,06434,064340701,Lanús,BUENOS AIRES,236,226,402,437,839
06,06434,064340705,Lanús,BUENOS AIRES,284,277,489,521,1010
06,06434,064340811,Lanús,BUENOS AIRES,309,260,637,613,1250
06,06434,064340910,Lanús,BUENOS AIRES,294,229,554,496,1050
06,06434,064341005,Lanús,BUENOS AIRES,239,228,365,360,725
06,06434,064341007,Lanús,BUENOS AIRES,332,364,543,506,1049
06,06434,064341107,Lanús,BUENOS AIRES,198,220,345,302,647
06,06434,064341201,Lanús,BUENOS AIRES,345,355,523,468,991
06,06434,064341204,Lanús,BUENOS AIRES,355,400,550,503,1053
06,06434,064341310,Lanús,BUENOS AIRES,334,335,534,480,1014
06,06434,064341312,Lanús,BUENOS AIRES,319,323,546,528,1074
06,06434,064341406,Lanús,BUENOS AIRES,322,345,437,436,873
06,06434,064341502,Lanús,BUENOS AIRES,298,493,371,293,664
06,06434,064341508,Lanús,BUENOS AIRES,249,314,327,251,578
06,06434,064341513,Lanús,BUENOS AIRES,338,450,487,418,905
06,06434,064341605,Lanús,BUENOS AIRES,196,247,264,213,477
06,06434,064341701,Lanús,BUENOS AIRES,268,293,404,341,745
06,06434,064341706,Lanús,BUENOS AIRES,198,231,308,263,571
06,06434,064341904,Lanús,BUENOS AIRES,313,359,466,413,879
06,06434,064341906,Lanús,BUENOS AIRES,325,361,508,455,963
06,06434,064342101,Lanús,BUENOS AIRES,344,345,514,471,985
06,06434,064342103,Lanús,BUENOS AIRES,269,295,359,364,723
06,06434,064342109,Lanús,BUENOS AIRES,213,243,326,280,606
06,06434,064342307,Lanús,BUENOS AIRES,191,158,298,313,611
06,06434,064342404,Lanús,BUENOS AIRES,231,247,362,345,707
06,06434,064342506,Lanús,BUENOS AIRES,247,206,455,486,941
06,06434,064342508,Lanús,BUENOS AIRES,329,335,554,501,1055
06,06434,064342514,Lanús,BUENOS AIRES,249,258,411,359,770
06,06434,064342515,Lanús,BUENOS AIRES,214,205,364,323,687
06,06434,064342605,Lanús,BUENOS AIRES,119,67,266,263,529
06,06434,064342609,Lanús,BUENOS AIRES,220,159,396,464,860
06,06434,064342613,Lanús,BUENOS AIRES,361,289,688,662,1350
06,06434,064342807,Lanús,BUENOS AIRES,260,273,427,399,826
06,06434,064342809,Lanús,BUENOS AIRES,430,405,660,611,1271
06,06434,064342810,Lanús,BUENOS AIRES,385,400,638,545,1183
06,06434,064342909,Lanús,BUENOS AIRES,350,376,560,480,1040
06,06434,064342910,Lanús,BUENOS AIRES,186,220,316,295,611
06,06434,064342911,Lanús,BUENOS AIRES,197,214,297,284,581
06,06434,064343002,Lanús,BUENOS AIRES,222,264,332,311,643
06,06434,064343003,Lanús,BUENOS AIRES,289,331,413,393,806
06,06434,064343005,Lanús,BUENOS AIRES,316,390,451,453,904
06,06434,064343008,Lanús,BUENOS AIRES,240,270,335,314,649
06,06434,064343102,Lanús,BUENOS AIRES,211,236,329,284,613
06,06434,064343107,Lanús,BUENOS AIRES,185,211,255,190,445
06,06434,064343301,Lanús,BUENOS AIRES,285,325,441,410,851
06,06434,064343306,Lanús,BUENOS AIRES,325,349,516,468,984
06,06434,064343413,Lanús,BUENOS AIRES,347,344,580,542,1122
06,06434,064343509,Lanús,BUENOS AIRES,285,291,455,400,855
06,06434,064343607,Lanús,BUENOS AIRES,251,285,388,320,708
06,06434,064343702,Lanús,BUENOS AIRES,295,333,412,355,767
06,06434,064343706,Lanús,BUENOS AIRES,336,368,491,430,921
06,06434,064343904,Lanús,BUENOS AIRES,228,235,326,289,615
06,06434,064344001,Lanús,BUENOS AIRES,348,371,552,526,1078
06,06434,064344005,Lanús,BUENOS AIRES,195,223,298,275,573
06,06434,064344103,Lanús,BUENOS AIRES,392,438,557,523,1080
06,06434,064344104,Lanús,BUENOS AIRES,321,343,524,506,1030
06,06434,064344402,Lanús,BUENOS AIRES,276,251,451,433,884
06,06434,064344404,Lanús,BUENOS AIRES,182,194,328,286,614
06,06434,064344407,Lanús,BUENOS AIRES,456,438,740,671,1411
06,06434,064344502,Lanús,BUENOS AIRES,485,462,876,880,1756
06,06434,064344503,Lanús,BUENOS AIRES,295,247,589,578,1167
06,06434,064340306,Lanús,BUENOS AIRES,260,264,381,338,719
06,06434,064340208,Lanús,BUENOS AIRES,197,224,293,268,561
06,06434,064340304,Lanús,BUENOS AIRES,307,307,496,409,905
06,06434,064340408,Lanús,BUENOS AIRES,144,183,206,188,394
06,06434,064340410,Lanús,BUENOS AIRES,368,420,529,470,999
06,06434,064340502,Lanús,BUENOS AIRES,383,440,633,560,1193
06,06434,064340601,Lanús,BUENOS AIRES,334,391,541,433,974
06,06434,064340704,Lanús,BUENOS AIRES,230,245,360,317,677
06,06434,064340709,Lanús,BUENOS AIRES,177,173,298,280,578
06,06434,064340815,Lanús,BUENOS AIRES,421,406,788,727,1515
06,06434,064340905,Lanús,BUENOS AIRES,222,158,421,402,823
06,06434,064340909,Lanús,BUENOS AIRES,315,204,589,585,1174
06,06434,064340914,Lanús,BUENOS AIRES,381,347,709,675,1384
06,06434,064341001,Lanús,BUENOS AIRES,290,274,520,485,1005
06,06434,064341006,Lanús,BUENOS AIRES,315,329,536,496,1032
06,06434,064341010,Lanús,BUENOS AIRES,342,320,599,598,1197
06,06434,064341011,Lanús,BUENOS AIRES,379,347,828,780,1608
06,06434,064341109,Lanús,BUENOS AIRES,268,256,438,416,854
06,06434,064341112,Lanús,BUENOS AIRES,394,425,638,554,1192
06,06434,064343115,Lanús,BUENOS AIRES,140,213,195,152,347
06,06434,064341205,Lanús,BUENOS AIRES,313,347,480,447,927
06,06434,064341208,Lanús,BUENOS AIRES,324,340,457,423,880
06,06434,064341308,Lanús,BUENOS AIRES,347,418,560,494,1054
06,06434,064341602,Lanús,BUENOS AIRES,284,318,420,381,801
06,06434,064341611,Lanús,BUENOS AIRES,320,343,496,445,941
06,06434,064341613,Lanús,BUENOS AIRES,380,429,597,499,1096
06,06434,064341703,Lanús,BUENOS AIRES,352,417,515,443,958
06,06434,064341803,Lanús,BUENOS AIRES,396,423,604,519,1123
06,06434,064341807,Lanús,BUENOS AIRES,184,259,250,194,444
06,06434,064341814,Lanús,BUENOS AIRES,113,146,146,114,260
06,06434,064341902,Lanús,BUENOS AIRES,367,417,540,500,1040
06,06434,064342004,Lanús,BUENOS AIRES,206,222,305,241,546
06,06434,064342005,Lanús,BUENOS AIRES,318,353,458,394,852
06,06434,064342105,Lanús,BUENOS AIRES,249,254,384,355,739
06,06434,064342106,Lanús,BUENOS AIRES,208,191,345,308,653
06,06434,064342108,Lanús,BUENOS AIRES,252,266,396,370,766
06,06434,064342201,Lanús,BUENOS AIRES,301,293,526,498,1024
06,06434,064342204,Lanús,BUENOS AIRES,311,305,557,523,1080
06,06434,064342206,Lanús,BUENOS AIRES,314,191,540,477,1017
06,06434,064342309,Lanús,BUENOS AIRES,267,247,495,480,975
06,06434,064342311,Lanús,BUENOS AIRES,393,377,695,696,1391
06,06434,064342312,Lanús,BUENOS AIRES,290,200,508,457,965
06,06434,064342401,Lanús,BUENOS AIRES,239,209,435,392,827
06,06434,064342402,Lanús,BUENOS AIRES,201,216,290,302,592
06,06434,064342405,Lanús,BUENOS AIRES,261,278,380,375,755
06,06434,064342510,Lanús,BUENOS AIRES,257,232,440,412,852
06,06434,064342511,Lanús,BUENOS AIRES,294,258,477,452,929
06,06434,064342513,Lanús,BUENOS AIRES,265,276,436,435,871
06,06434,064342604,Lanús,BUENOS AIRES,361,333,707,741,1448
06,06434,064342611,Lanús,BUENOS AIRES,214,187,430,405,835
06,06434,064342702,Lanús,BUENOS AIRES,316,324,484,459,943
06,06434,064342705,Lanús,BUENOS AIRES,190,204,316,256,572
06,06434,064342806,Lanús,BUENOS AIRES,358,325,562,519,1081
06,06434,064342814,Lanús,BUENOS AIRES,283,304,489,460,949
06,06434,064343104,Lanús,BUENOS AIRES,216,248,317,292,609
06,06434,064343213,Lanús,BUENOS AIRES,294,365,405,324,729
06,06434,064343308,Lanús,BUENOS AIRES,248,251,356,326,682
06,06434,064343410,Lanús,BUENOS AIRES,346,362,574,510,1084
06,06434,064343411,Lanús,BUENOS AIRES,347,379,559,489,1048
06,06434,064343503,Lanús,BUENOS AIRES,177,201,282,256,538
06,06434,064343510,Lanús,BUENOS AIRES,294,281,555,532,1087
06,06434,064343513,Lanús,BUENOS AIRES,302,263,504,495,999
06,06434,064343601,Lanús,BUENOS AIRES,366,408,531,536,1067
06,06434,064343701,Lanús,BUENOS AIRES,219,255,350,293,643
06,06434,064343704,Lanús,BUENOS AIRES,303,327,460,422,882
06,06434,064343804,Lanús,BUENOS AIRES,339,427,478,384,862
06,06434,064343908,Lanús,BUENOS AIRES,175,189,248,212,460
06,06434,064344106,Lanús,BUENOS AIRES,316,288,554,541,1095
06,06434,064344303,Lanús,BUENOS AIRES,382,421,575,499,1074
06,06434,064344307,Lanús,BUENOS AIRES,261,291,440,372,812
06,06434,064344308,Lanús,BUENOS AIRES,231,260,377,300,677
06,06434,064344406,Lanús,BUENOS AIRES,463,468,924,902,1826
06,06434,064340405,Lanús,BUENOS AIRES,243,267,349,319,668
06,06434,064340103,Lanús,BUENOS AIRES,267,300,406,372,778
06,06434,064340202,Lanús,BUENOS AIRES,55,59,90,87,177
06,06434,064342407,Lanús,BUENOS AIRES,228,238,371,329,700
06,06434,064340406,Lanús,BUENOS AIRES,360,406,531,473,1004
06,06434,064340407,Lanús,BUENOS AIRES,218,239,330,326,656
06,06434,064340602,Lanús,BUENOS AIRES,307,286,495,450,945
06,06434,064340605,Lanús,BUENOS AIRES,288,304,438,357,795
06,06434,064340706,Lanús,BUENOS AIRES,156,168,260,239,499
06,06434,064340807,Lanús,BUENOS AIRES,224,206,428,445,873
06,06434,064340813,Lanús,BUENOS AIRES,321,297,629,581,1210
06,06434,064340915,Lanús,BUENOS AIRES,359,312,637,576,1213
06,06434,064341012,Lanús,BUENOS AIRES,297,273,524,521,1045
06,06434,064341101,Lanús,BUENOS AIRES,333,319,542,506,1048
06,06434,064341102,Lanús,BUENOS AIRES,393,392,708,623,1331
06,06434,064341114,Lanús,BUENOS AIRES,242,227,414,390,804
06,06434,064341506,Lanús,BUENOS AIRES,200,286,275,225,500
06,06434,064341512,Lanús,BUENOS AIRES,150,236,212,158,370
06,06434,064341606,Lanús,BUENOS AIRES,179,235,267,235,502
06,06434,064341608,Lanús,BUENOS AIRES,193,213,291,266,557
06,06434,064341612,Lanús,BUENOS AIRES,430,466,627,529,1156
06,06434,064341702,Lanús,BUENOS AIRES,328,373,486,427,913
06,06434,064341802,Lanús,BUENOS AIRES,252,261,371,322,693
06,06434,064341811,Lanús,BUENOS AIRES,195,264,233,181,414
06,06434,064341907,Lanús,BUENOS AIRES,315,352,446,415,861
06,06434,064342001,Lanús,BUENOS AIRES,256,277,391,324,715
06,06434,064342003,Lanús,BUENOS AIRES,381,393,600,538,1138
06,06434,064342104,Lanús,BUENOS AIRES,187,201,288,281,569
06,06434,064342113,Lanús,BUENOS AIRES,332,362,507,460,967
06,06434,064342211,Lanús,BUENOS AIRES,305,302,489,441,930
06,06434,064342214,Lanús,BUENOS AIRES,313,269,513,428,941
06,06434,064342306,Lanús,BUENOS AIRES,415,383,739,737,1476
06,06434,064342315,Lanús,BUENOS AIRES,317,224,571,533,1104
06,06434,064342406,Lanús,BUENOS AIRES,244,264,388,327,715
06,06434,064342516,Lanús,BUENOS AIRES,323,337,532,524,1056
06,06434,064342612,Lanús,BUENOS AIRES,220,147,398,412,810
06,06434,064342614,Lanús,BUENOS AIRES,322,271,664,621,1285
06,06434,064342703,Lanús,BUENOS AIRES,433,448,648,600,1248
06,06434,064342707,Lanús,BUENOS AIRES,283,263,475,453,928
06,06434,064342813,Lanús,BUENOS AIRES,234,261,357,337,694
06,06434,064342906,Lanús,BUENOS AIRES,293,327,417,394,811
06,06434,064342907,Lanús,BUENOS AIRES,340,364,537,462,999
06,06434,064342908,Lanús,BUENOS AIRES,285,233,451,423,874
06,06434,064343103,Lanús,BUENOS AIRES,268,324,382,313,695
06,06434,064343110,Lanús,BUENOS AIRES,173,297,214,173,387
06,06434,064343405,Lanús,BUENOS AIRES,225,252,350,350,700
06,06434,064343505,Lanús,BUENOS AIRES,145,154,223,205,428
06,06434,064343604,Lanús,BUENOS AIRES,325,364,477,443,920
06,06434,064343803,Lanús,BUENOS AIRES,335,402,430,385,815
06,06434,064343809,Lanús,BUENOS AIRES,252,303,392,327,719
06,06434,064344101,Lanús,BUENOS AIRES,263,305,411,367,778
06,06434,064344207,Lanús,BUENOS AIRES,261,229,428,362,790
06,06434,064344301,Lanús,BUENOS AIRES,372,403,544,520,1064
06,06434,064344501,Lanús,BUENOS AIRES,335,368,557,524,1081
06,06434,064344505,Lanús,BUENOS AIRES,372,364,667,602,1269
06,06434,064344508,Lanús,BUENOS AIRES,365,296,662,599,1261
06,06434,064343113,Lanús,BUENOS AIRES,297,466,341,303,644
06,06434,064343114,Lanús,BUENOS AIRES,271,357,317,244,561
06,06434,064341004,Lanús,BUENOS AIRES,205,211,381,324,705
06,06434,064343906,Lanús,BUENOS AIRES,281,355,421,351,772
06,06434,064340102,Lanús,BUENOS AIRES,285,296,450,377,827
06,06434,064340109,Lanús,BUENOS AIRES,256,318,377,334,711
06,06434,064340111,Lanús,BUENOS AIRES,309,346,487,400,887
06,06434,064340309,Lanús,BUENOS AIRES,502,574,776,709,1485
06,06434,064340703,Lanús,BUENOS AIRES,304,322,484,426,910
06,06434,064340805,Lanús,BUENOS AIRES,287,306,482,456,938
06,06434,064340906,Lanús,BUENOS AIRES,282,261,549,537,1086
06,06434,064340908,Lanús,BUENOS AIRES,271,242,519,505,1024
06,06434,064341002,Lanús,BUENOS AIRES,167,196,271,238,509
06,06434,064341202,Lanús,BUENOS AIRES,380,423,607,525,1132
06,06434,064341302,Lanús,BUENOS AIRES,219,253,346,302,648
06,06434,064341309,Lanús,BUENOS AIRES,360,375,534,489,1023
06,06434,064341408,Lanús,BUENOS AIRES,347,377,496,430,926
06,06434,064341501,Lanús,BUENOS AIRES,180,252,247,193,440
06,06434,064341503,Lanús,BUENOS AIRES,177,306,207,151,358
06,06434,064341504,Lanús,BUENOS AIRES,218,270,328,277,605
06,06434,064341510,Lanús,BUENOS AIRES,178,248,224,205,429
06,06434,064341511,Lanús,BUENOS AIRES,173,280,222,167,389
06,06434,064341709,Lanús,BUENOS AIRES,250,280,355,305,660
06,06434,064341804,Lanús,BUENOS AIRES,219,267,313,296,609
06,06434,064341806,Lanús,BUENOS AIRES,384,505,505,393,898
06,06434,064341808,Lanús,BUENOS AIRES,261,295,329,284,613
06,06434,064341810,Lanús,BUENOS AIRES,167,224,188,160,348
06,06434,064341813,Lanús,BUENOS AIRES,302,360,429,369,798
06,06434,064341905,Lanús,BUENOS AIRES,354,408,544,488,1032
06,06434,064342006,Lanús,BUENOS AIRES,406,412,639,550,1189
06,06434,064342009,Lanús,BUENOS AIRES,292,317,423,401,824
06,06434,064342112,Lanús,BUENOS AIRES,313,314,513,446,959
06,06434,064342212,Lanús,BUENOS AIRES,311,275,493,418,911
06,06434,064342303,Lanús,BUENOS AIRES,367,352,692,653,1345
06,06434,064342310,Lanús,BUENOS AIRES,257,244,467,457,924
06,06434,064342403,Lanús,BUENOS AIRES,242,249,295,256,551
06,06434,064342503,Lanús,BUENOS AIRES,179,179,296,244,540
06,06434,064342509,Lanús,BUENOS AIRES,225,213,381,336,717
06,06434,064343201,Lanús,BUENOS AIRES,337,420,526,424,950
06,06434,064342606,Lanús,BUENOS AIRES,128,114,258,256,514
06,06434,064342804,Lanús,BUENOS AIRES,308,294,553,464,1017
06,06434,064342812,Lanús,BUENOS AIRES,238,260,401,357,758
06,06434,064342901,Lanús,BUENOS AIRES,357,358,524,512,1036
06,06434,064343108,Lanús,BUENOS AIRES,183,239,234,203,437
06,06434,064343208,Lanús,BUENOS AIRES,273,296,421,351,772
06,06434,064343307,Lanús,BUENOS AIRES,326,368,514,440,954
06,06434,064343404,Lanús,BUENOS AIRES,229,248,376,324,700
06,06434,064343414,Lanús,BUENOS AIRES,309,277,595,595,1190
06,06434,064343501,Lanús,BUENOS AIRES,371,373,585,495,1080
06,06434,064343504,Lanús,BUENOS AIRES,429,431,799,686,1485
06,06434,064343512,Lanús,BUENOS AIRES,164,101,299,335,634
06,06434,064343603,Lanús,BUENOS AIRES,325,369,505,470,975
06,06434,064343606,Lanús,BUENOS AIRES,342,386,575,472,1047
06,06434,064343708,Lanús,BUENOS AIRES,235,283,345,316,661
06,06434,064343807,Lanús,BUENOS AIRES,217,272,265,224,489
06,06434,064344006,Lanús,BUENOS AIRES,221,229,340,314,654
06,06434,064344105,Lanús,BUENOS AIRES,306,330,496,426,922
06,06434,064344305,Lanús,BUENOS AIRES,244,258,407,347,754
06,06434,064344504,Lanús,BUENOS AIRES,320,254,578,556,1134
06,06434,064340104,Lanús,BUENOS AIRES,337,311,465,444,909
06,06434,064340106,Lanús,BUENOS AIRES,380,414,568,497,1065
06,06434,064340206,Lanús,BUENOS AIRES,294,349,444,355,799
06,06434,064340310,Lanús,BUENOS AIRES,326,375,480,449,929
06,06434,064340403,Lanús,BUENOS AIRES,293,352,402,356,758
06,06434,064340409,Lanús,BUENOS AIRES,200,219,291,258,549
06,06434,064340507,Lanús,BUENOS AIRES,355,397,567,476,1043
06,06434,064340603,Lanús,BUENOS AIRES,335,339,559,515,1074
06,06434,064340816,Lanús,BUENOS AIRES,404,412,724,637,1361
06,06434,064340917,Lanús,BUENOS AIRES,211,196,377,373,750
06,06434,064341008,Lanús,BUENOS AIRES,366,393,570,502,1072
06,06434,064341009,Lanús,BUENOS AIRES,350,370,591,560,1151
06,06434,064341105,Lanús,BUENOS AIRES,249,277,443,363,806
06,06434,064341108,Lanús,BUENOS AIRES,220,219,417,357,774
06,06434,064341113,Lanús,BUENOS AIRES,370,406,609,550,1159
06,06434,064341203,Lanús,BUENOS AIRES,342,373,517,436,953
06,06434,064341305,Lanús,BUENOS AIRES,367,391,570,496,1066
06,06434,064341306,Lanús,BUENOS AIRES,278,320,420,345,765
06,06434,064341514,Lanús,BUENOS AIRES,244,336,351,325,676
06,06434,064341601,Lanús,BUENOS AIRES,317,334,480,433,913
06,06434,064341603,Lanús,BUENOS AIRES,300,367,467,380,847
06,06434,064341607,Lanús,BUENOS AIRES,254,314,348,302,650
06,06434,064341708,Lanús,BUENOS AIRES,270,304,389,331,720
06,06434,064341710,Lanús,BUENOS AIRES,131,155,184,147,331
06,06434,064341809,Lanús,BUENOS AIRES,198,250,279,211,490
06,06434,064341908,Lanús,BUENOS AIRES,234,283,370,315,685
06,06434,064341909,Lanús,BUENOS AIRES,279,334,406,363,769
06,06434,064342010,Lanús,BUENOS AIRES,295,287,454,375,829
06,06434,064342408,Lanús,BUENOS AIRES,401,378,688,663,1351
06,06434,064342301,Lanús,BUENOS AIRES,371,343,589,595,1184
06,06434,064342302,Lanús,BUENOS AIRES,284,268,515,492,1007
06,06434,064342304,Lanús,BUENOS AIRES,438,302,764,722,1486
06,06434,064342305,Lanús,BUENOS AIRES,394,370,696,697,1393
06,06434,064342313,Lanús,BUENOS AIRES,14,11,21,22,43
06,06434,064342512,Lanús,BUENOS AIRES,225,216,366,341,707
06,06434,064342607,Lanús,BUENOS AIRES,186,147,345,370,715
06,06434,064342618,Lanús,BUENOS AIRES,342,273,649,656,1305
06,06434,064342619,Lanús,BUENOS AIRES,368,293,705,658,1363
06,06434,064342701,Lanús,BUENOS AIRES,295,308,448,423,871
06,06434,064342801,Lanús,BUENOS AIRES,362,323,626,568,1194
06,06434,064343101,Lanús,BUENOS AIRES,367,417,557,509,1066
06,06434,064343209,Lanús,BUENOS AIRES,349,396,519,469,988
06,06434,064343210,Lanús,BUENOS AIRES,334,374,477,457,934
06,06434,064343211,Lanús,BUENOS AIRES,248,299,366,329,695
06,06434,064343402,Lanús,BUENOS AIRES,376,416,587,512,1099
06,06434,064343403,Lanús,BUENOS AIRES,283,301,465,416,881
06,06434,064343412,Lanús,BUENOS AIRES,492,460,910,811,1721
06,06434,064343507,Lanús,BUENOS AIRES,265,271,432,409,841
06,06434,064343705,Lanús,BUENOS AIRES,320,365,471,458,929
06,06434,064343707,Lanús,BUENOS AIRES,295,340,435,412,847
06,06434,064343802,Lanús,BUENOS AIRES,308,359,474,405,879
06,06434,064343805,Lanús,BUENOS AIRES,267,349,322,270,592
06,06434,064343808,Lanús,BUENOS AIRES,334,384,522,393,915
06,06434,064343901,Lanús,BUENOS AIRES,271,343,368,336,704
06,06434,064344004,Lanús,BUENOS AIRES,158,198,218,207,425
06,06434,064344107,Lanús,BUENOS AIRES,178,198,292,270,562
06,06434,064344201,Lanús,BUENOS AIRES,330,319,607,539,1146
06,06434,064344202,Lanús,BUENOS AIRES,343,320,580,504,1084
06,06434,064344206,Lanús,BUENOS AIRES,273,303,468,451,919
06,06434,064344403,Lanús,BUENOS AIRES,271,257,446,410,856
06,06434,064344405,Lanús,BUENOS AIRES,297,282,628,618,1246
06,06434,064344507,Lanús,BUENOS AIRES,310,306,624,590,1214
06,06385,063850713,General Viamonte,BUENOS AIRES,241,283,345,372,717
06,06385,063850405,General Viamonte,BUENOS AIRES,5,25,5,9,14
06,06385,063850101,General Viamonte,BUENOS AIRES,251,307,346,341,687
06,06385,063850702,General Viamonte,BUENOS AIRES,289,329,440,393,833
06,06385,063850703,General Viamonte,BUENOS AIRES,204,238,274,273,547
06,06385,063850705,General Viamonte,BUENOS AIRES,311,387,433,356,789
06,06385,063850716,General Viamonte,BUENOS AIRES,215,250,322,260,582
06,06385,063850103,General Viamonte,BUENOS AIRES,15,51,21,24,45
06,06385,063850301,General Viamonte,BUENOS AIRES,6,15,6,8,14
06,06385,063851002,General Viamonte,BUENOS AIRES,465,603,824,822,1646
06,06385,063850704,General Viamonte,BUENOS AIRES,302,328,463,476,939
06,06385,063850714,General Viamonte,BUENOS AIRES,284,330,397,397,794
06,06385,063850717,General Viamonte,BUENOS AIRES,218,241,271,227,498
06,06385,063850718,General Viamonte,BUENOS AIRES,53,67,78,98,176
06,06385,063850104,General Viamonte,BUENOS AIRES,1,11,1,1,2
06,06385,063850501,General Viamonte,BUENOS AIRES,7,28,6,12,18
06,06385,063850601,General Viamonte,BUENOS AIRES,19,42,30,24,54
06,06385,063850708,General Viamonte,BUENOS AIRES,309,371,504,377,881
06,06385,063850709,General Viamonte,BUENOS AIRES,270,321,383,411,794
06,06385,063850712,General Viamonte,BUENOS AIRES,47,73,64,85,149
06,06385,063851001,General Viamonte,BUENOS AIRES,316,329,498,438,936
06,06385,063850303,General Viamonte,BUENOS AIRES,13,33,16,18,34
06,06385,063850403,General Viamonte,BUENOS AIRES,13,28,14,21,35
06,06385,063851102,General Viamonte,BUENOS AIRES,19,50,36,68,104
06,06385,063850401,General Viamonte,BUENOS AIRES,63,99,69,85,154
06,06385,063850715,General Viamonte,BUENOS AIRES,272,306,387,354,741
06,06385,063850107,General Viamonte,BUENOS AIRES,225,264,323,323,646
06,06385,063850701,General Viamonte,BUENOS AIRES,319,357,472,461,933
06,06385,063850706,General Viamonte,BUENOS AIRES,207,250,275,244,519
06,06385,063850710,General Viamonte,BUENOS AIRES,265,308,421,445,866
06,06385,063850105,General Viamonte,BUENOS AIRES,9,17,6,10,16
06,06385,063850202,General Viamonte,BUENOS AIRES,12,36,13,19,32
06,06385,063850302,General Viamonte,BUENOS AIRES,8,30,11,19,30
06,06385,063850402,General Viamonte,BUENOS AIRES,19,33,21,27,48
06,06385,063850802,General Viamonte,BUENOS AIRES,18,29,18,30,48
06,06385,063850901,General Viamonte,BUENOS AIRES,30,36,29,54,83
06,06385,063851101,General Viamonte,BUENOS AIRES,16,35,16,31,47
06,06385,063850711,General Viamonte,BUENOS AIRES,209,248,312,260,572
06,06385,063850204,General Viamonte,BUENOS AIRES,11,28,5,15,20
06,06385,063850102,General Viamonte,BUENOS AIRES,14,36,12,20,32
06,06385,063850203,General Viamonte,BUENOS AIRES,20,39,19,29,48
06,06385,063850902,General Viamonte,BUENOS AIRES,25,29,20,47,67
06,06385,063850801,General Viamonte,BUENOS AIRES,33,65,43,60,103
06,06385,063850106,General Viamonte,BUENOS AIRES,184,214,283,289,572
06,06385,063850201,General Viamonte,BUENOS AIRES,117,151,169,158,327
06,06385,063850707,General Viamonte,BUENOS AIRES,327,386,465,385,850
06,06385,063850404,General Viamonte,BUENOS AIRES,10,15,18,18,36
06,06392,063920110,General Villegas,BUENOS AIRES,308,363,468,451,919
06,06392,063920706,General Villegas,BUENOS AIRES,120,131,166,153,319
06,06392,063920707,General Villegas,BUENOS AIRES,113,132,156,138,294
06,06392,063920302,General Villegas,BUENOS AIRES,10,26,17,19,36
06,06392,063920604,General Villegas,BUENOS AIRES,27,36,54,45,99
06,06392,063920704,General Villegas,BUENOS AIRES,17,37,29,30,59
06,06392,063921204,General Villegas,BUENOS AIRES,42,55,59,73,132
06,06392,063921205,General Villegas,BUENOS AIRES,16,31,16,22,38
06,06392,063920605,General Villegas,BUENOS AIRES,54,98,71,95,166
06,06392,063921503,General Villegas,BUENOS AIRES,58,71,69,88,157
06,06392,063920114,General Villegas,BUENOS AIRES,304,337,512,488,1000
06,06392,063920401,General Villegas,BUENOS AIRES,124,158,154,177,331
06,06392,063920708,General Villegas,BUENOS AIRES,150,164,221,204,425
06,06392,063920906,General Villegas,BUENOS AIRES,130,159,212,194,406
06,06392,063920907,General Villegas,BUENOS AIRES,177,215,267,279,546
06,06392,063921201,General Villegas,BUENOS AIRES,284,296,628,638,1266
06,06392,063920805,General Villegas,BUENOS AIRES,27,45,12,38,50
06,06392,063920405,General Villegas,BUENOS AIRES,11,32,18,24,42
06,06392,063920503,General Villegas,BUENOS AIRES,11,18,14,19,33
06,06392,063920701,General Villegas,BUENOS AIRES,12,28,8,18,26
06,06392,063920710,General Villegas,BUENOS AIRES,24,55,23,32,55
06,06392,063921209,General Villegas,BUENOS AIRES,19,25,25,31,56
06,06392,063921303,General Villegas,BUENOS AIRES,26,40,25,42,67
06,06392,063920303,General Villegas,BUENOS AIRES,18,23,22,22,44
06,06392,063920903,General Villegas,BUENOS AIRES,102,147,128,141,269
06,06392,063921207,General Villegas,BUENOS AIRES,109,133,189,189,378
06,06392,063920101,General Villegas,BUENOS AIRES,241,283,408,489,897
06,06392,063920107,General Villegas,BUENOS AIRES,312,362,437,428,865
06,06392,063920109,General Villegas,BUENOS AIRES,367,441,572,527,1099
06,06392,063920111,General Villegas,BUENOS AIRES,248,280,381,364,745
06,06392,063920112,General Villegas,BUENOS AIRES,303,325,434,392,826
06,06392,063920116,General Villegas,BUENOS AIRES,204,241,268,250,518
06,06392,063921206,General Villegas,BUENOS AIRES,247,289,413,423,836
06,06392,063921502,General Villegas,BUENOS AIRES,218,250,321,322,643
06,06392,063920203,General Villegas,BUENOS AIRES,14,18,10,22,32
06,06392,063920204,General Villegas,BUENOS AIRES,6,7,4,12,16
06,06392,063920504,General Villegas,BUENOS AIRES,9,26,6,18,24
06,06392,063920505,General Villegas,BUENOS AIRES,1,11,1,1,2
06,06392,063920709,General Villegas,BUENOS AIRES,23,36,39,47,86
06,06392,063921302,General Villegas,BUENOS AIRES,26,62,34,46,80
06,06392,063921404,General Villegas,BUENOS AIRES,10,21,13,16,29
06,06392,063920902,General Villegas,BUENOS AIRES,77,97,122,136,258
06,06392,063920103,General Villegas,BUENOS AIRES,220,260,292,244,536
06,06392,063920301,General Villegas,BUENOS AIRES,256,296,331,362,693
06,06392,063920702,General Villegas,BUENOS AIRES,204,248,285,269,554
06,06392,063921401,General Villegas,BUENOS AIRES,18,32,32,31,63
06,06392,063921501,General Villegas,BUENOS AIRES,223,257,337,307,644
06,06392,063920603,General Villegas,BUENOS AIRES,7,28,9,14,23
06,06392,063920201,General Villegas,BUENOS AIRES,19,33,17,39,56
06,06392,063920804,General Villegas,BUENOS AIRES,17,47,16,25,41
06,06392,063920905,General Villegas,BUENOS AIRES,20,31,25,31,56
06,06392,063921001,General Villegas,BUENOS AIRES,19,42,28,32,60
06,06392,063921505,General Villegas,BUENOS AIRES,13,24,13,21,34
06,06392,063920106,General Villegas,BUENOS AIRES,385,458,492,436,928
06,06392,063920113,General Villegas,BUENOS AIRES,318,329,511,538,1049
06,06392,063920801,General Villegas,BUENOS AIRES,258,293,378,377,755
06,06392,063920202,General Villegas,BUENOS AIRES,20,24,29,46,75
06,06392,063920306,General Villegas,BUENOS AIRES,29,52,50,52,102
06,06392,063920803,General Villegas,BUENOS AIRES,42,71,58,73,131
06,06392,063920105,General Villegas,BUENOS AIRES,358,427,457,392,849
06,06392,063920108,General Villegas,BUENOS AIRES,320,368,447,409,856
06,06392,063920601,General Villegas,BUENOS AIRES,96,128,119,125,244
06,06392,063920806,General Villegas,BUENOS AIRES,375,419,624,584,1208
06,06392,063920901,General Villegas,BUENOS AIRES,310,358,448,457,905
06,06392,063921506,General Villegas,BUENOS AIRES,147,205,192,231,423
06,06392,063920502,General Villegas,BUENOS AIRES,28,37,33,39,72
06,06392,063920404,General Villegas,BUENOS AIRES,6,14,8,10,18
06,06392,063920305,General Villegas,BUENOS AIRES,21,43,23,32,55
06,06392,063920403,General Villegas,BUENOS AIRES,22,36,23,28,51
06,06392,063920602,General Villegas,BUENOS AIRES,23,37,37,36,73
06,06392,063920802,General Villegas,BUENOS AIRES,31,49,40,52,92
06,06392,063920904,General Villegas,BUENOS AIRES,35,47,45,56,101
06,06392,063921004,General Villegas,BUENOS AIRES,19,32,21,30,51
06,06392,063921006,General Villegas,BUENOS AIRES,8,15,4,13,17
06,06392,063921101,General Villegas,BUENOS AIRES,9,15,10,16,26
06,06392,063921208,General Villegas,BUENOS AIRES,19,21,27,33,60
06,06392,063921301,General Villegas,BUENOS AIRES,24,44,34,47,81
06,06392,063921402,General Villegas,BUENOS AIRES,10,17,9,18,27
06,06392,063921504,General Villegas,BUENOS AIRES,23,29,33,49,82
06,06392,063921507,General Villegas,BUENOS AIRES,11,22,17,15,32
06,06392,063920102,General Villegas,BUENOS AIRES,439,489,640,667,1307
06,06392,063920104,General Villegas,BUENOS AIRES,209,258,297,237,534
06,06392,063920705,General Villegas,BUENOS AIRES,111,125,155,155,310
06,06392,063921203,General Villegas,BUENOS AIRES,300,343,505,532,1037
06,06392,063920304,General Villegas,BUENOS AIRES,6,17,10,14,24
06,06392,063920703,General Villegas,BUENOS AIRES,58,87,78,96,174
06,06392,063921005,General Villegas,BUENOS AIRES,46,73,56,81,137
06,06392,063921103,General Villegas,BUENOS AIRES,2,8,3,4,7
06,06392,063921403,General Villegas,BUENOS AIRES,2,7,2,2,4
06,06392,063920115,General Villegas,BUENOS AIRES,262,307,441,438,879
06,06392,063920501,General Villegas,BUENOS AIRES,6,12,8,10,18
06,06392,063921202,General Villegas,BUENOS AIRES,290,297,466,525,991
06,06392,063921002,General Villegas,BUENOS AIRES,11,20,18,22,40
06,06392,063920402,General Villegas,BUENOS AIRES,12,34,17,17,34
06,06392,063921003,General Villegas,BUENOS AIRES,6,11,9,10,19
06,06392,063921102,General Villegas,BUENOS AIRES,20,24,25,32,57
06,06406,064060201,Hipólito Yrigoyen,BUENOS AIRES,280,317,491,453,944
06,06406,064060205,Hipólito Yrigoyen,BUENOS AIRES,349,415,473,410,883
06,06406,064060107,Hipólito Yrigoyen,BUENOS AIRES,1,5,0,2,2
06,06406,064060212,Hipólito Yrigoyen,BUENOS AIRES,6,23,4,11,15
06,06406,064060301,Hipólito Yrigoyen,BUENOS AIRES,10,18,13,14,27
06,06406,064060209,Hipólito Yrigoyen,BUENOS AIRES,5,25,2,6,8
06,06406,064060213,Hipólito Yrigoyen,BUENOS AIRES,18,54,16,27,43
06,06406,064060304,Hipólito Yrigoyen,BUENOS AIRES,24,25,26,34,60
06,06406,064060306,Hipólito Yrigoyen,BUENOS AIRES,14,29,21,22,43
06,06406,064060214,Hipólito Yrigoyen,BUENOS AIRES,223,253,325,277,602
06,06406,064060103,Hipólito Yrigoyen,BUENOS AIRES,16,11,17,24,41
06,06406,064060105,Hipólito Yrigoyen,BUENOS AIRES,9,22,11,12,23
06,06406,064060307,Hipólito Yrigoyen,BUENOS AIRES,5,16,12,11,23
06,06406,064060309,Hipólito Yrigoyen,BUENOS AIRES,6,9,6,9,15
06,06406,064060206,Hipólito Yrigoyen,BUENOS AIRES,329,381,478,399,877
06,06406,064060302,Hipólito Yrigoyen,BUENOS AIRES,47,65,74,87,161
06,06406,064060207,Hipólito Yrigoyen,BUENOS AIRES,235,279,390,432,822
06,06406,064060216,Hipólito Yrigoyen,BUENOS AIRES,214,251,283,328,611
06,06406,064060104,Hipólito Yrigoyen,BUENOS AIRES,7,10,9,11,20
06,06406,064060215,Hipólito Yrigoyen,BUENOS AIRES,298,351,431,430,861
06,06406,064060102,Hipólito Yrigoyen,BUENOS AIRES,2,6,1,2,3
06,06406,064060303,Hipólito Yrigoyen,BUENOS AIRES,12,14,10,15,25
06,06406,064060202,Hipólito Yrigoyen,BUENOS AIRES,321,364,458,383,841
06,06406,064060204,Hipólito Yrigoyen,BUENOS AIRES,348,375,572,546,1118
06,06406,064060101,Hipólito Yrigoyen,BUENOS AIRES,3,7,5,5,10
06,06406,064060106,Hipólito Yrigoyen,BUENOS AIRES,8,15,13,17,30
06,06406,064060208,Hipólito Yrigoyen,BUENOS AIRES,23,28,22,46,68
06,06406,064060210,Hipólito Yrigoyen,BUENOS AIRES,102,144,203,197,400
06,06406,064060203,Hipólito Yrigoyen,BUENOS AIRES,307,364,394,396,790
06,06406,064060308,Hipólito Yrigoyen,BUENOS AIRES,37,43,37,67,104
06,06406,064060211,Hipólito Yrigoyen,BUENOS AIRES,20,46,29,35,64
06,06406,064060305,Hipólito Yrigoyen,BUENOS AIRES,16,27,20,31,51
06,06408,064080116,Hurlingham,BUENOS AIRES,195,240,326,262,588
06,06408,064080117,Hurlingham,BUENOS AIRES,305,338,570,437,1007
06,06408,064080209,Hurlingham,BUENOS AIRES,510,518,865,746,1611
06,06408,064080307,Hurlingham,BUENOS AIRES,505,476,934,879,1813
06,06408,064080407,Hurlingham,BUENOS AIRES,388,386,758,725,1483
06,06408,064080411,Hurlingham,BUENOS AIRES,322,304,595,530,1125
06,06408,064080502,Hurlingham,BUENOS AIRES,312,283,577,581,1158
06,06408,064080701,Hurlingham,BUENOS AIRES,333,361,517,484,1001
06,06408,064080702,Hurlingham,BUENOS AIRES,267,237,487,454,941
06,06408,064080706,Hurlingham,BUENOS AIRES,323,360,460,431,891
06,06408,064080710,Hurlingham,BUENOS AIRES,260,269,417,422,839
06,06408,064080812,Hurlingham,BUENOS AIRES,202,185,381,340,721
06,06408,064080902,Hurlingham,BUENOS AIRES,225,254,374,357,731
06,06408,064080905,Hurlingham,BUENOS AIRES,351,409,531,506,1037
06,06408,064081008,Hurlingham,BUENOS AIRES,244,268,376,378,754
06,06408,064081107,Hurlingham,BUENOS AIRES,83,82,128,127,255
06,06408,064081202,Hurlingham,BUENOS AIRES,250,318,521,505,1026
06,06408,064081206,Hurlingham,BUENOS AIRES,623,599,1142,1055,2197
06,06408,064081503,Hurlingham,BUENOS AIRES,51,59,95,80,175
06,06408,064080113,Hurlingham,BUENOS AIRES,411,419,683,642,1325
06,06408,064080211,Hurlingham,BUENOS AIRES,332,344,539,484,1023
06,06408,064080304,Hurlingham,BUENOS AIRES,307,295,527,499,1026
06,06408,064080402,Hurlingham,BUENOS AIRES,626,547,1187,1155,2342
06,06408,064080506,Hurlingham,BUENOS AIRES,240,218,439,404,843
06,06408,064080509,Hurlingham,BUENOS AIRES,304,327,552,524,1076
06,06408,064080604,Hurlingham,BUENOS AIRES,274,328,424,382,806
06,06408,064080608,Hurlingham,BUENOS AIRES,284,309,462,384,846
06,06408,064080804,Hurlingham,BUENOS AIRES,205,233,315,300,615
06,06408,064080808,Hurlingham,BUENOS AIRES,336,358,482,427,909
06,06408,064080906,Hurlingham,BUENOS AIRES,363,403,545,475,1020
06,06408,064081102,Hurlingham,BUENOS AIRES,331,317,555,545,1100
06,06408,064081208,Hurlingham,BUENOS AIRES,474,511,810,855,1665
06,06408,064081301,Hurlingham,BUENOS AIRES,452,479,764,706,1470
06,06408,064081303,Hurlingham,BUENOS AIRES,320,297,604,570,1174
06,06408,064081407,Hurlingham,BUENOS AIRES,248,260,395,355,750
06,06408,064081409,Hurlingham,BUENOS AIRES,262,225,453,395,848
06,06408,064081509,Hurlingham,BUENOS AIRES,352,351,542,514,1056
06,06408,064080101,Hurlingham,BUENOS AIRES,373,366,587,522,1109
06,06408,064080109,Hurlingham,BUENOS AIRES,442,446,754,700,1454
06,06408,064080111,Hurlingham,BUENOS AIRES,584,568,936,844,1780
06,06408,064080112,Hurlingham,BUENOS AIRES,416,375,673,641,1314
06,06408,064081203,Hurlingham,BUENOS AIRES,326,336,589,558,1147
06,06408,064080206,Hurlingham,BUENOS AIRES,331,360,478,416,894
06,06408,064080207,Hurlingham,BUENOS AIRES,437,437,656,635,1291
06,06408,064080303,Hurlingham,BUENOS AIRES,381,342,692,683,1375
06,06408,064080309,Hurlingham,BUENOS AIRES,327,339,527,487,1014
06,06408,064080401,Hurlingham,BUENOS AIRES,395,367,801,806,1607
06,06408,064080403,Hurlingham,BUENOS AIRES,264,208,507,477,984
06,06408,064080410,Hurlingham,BUENOS AIRES,582,600,979,903,1882
06,06408,064080507,Hurlingham,BUENOS AIRES,270,247,500,454,954
06,06408,064080601,Hurlingham,BUENOS AIRES,429,461,636,598,1234
06,06408,064080603,Hurlingham,BUENOS AIRES,352,412,523,490,1013
06,06408,064080801,Hurlingham,BUENOS AIRES,328,331,604,531,1135
06,06408,064080811,Hurlingham,BUENOS AIRES,354,356,658,531,1189
06,06408,064081002,Hurlingham,BUENOS AIRES,303,294,506,471,977
06,06408,064081105,Hurlingham,BUENOS AIRES,482,458,933,913,1846
06,06408,064081305,Hurlingham,BUENOS AIRES,264,253,442,394,836
06,06408,064081311,Hurlingham,BUENOS AIRES,363,367,662,616,1278
06,06408,064081401,Hurlingham,BUENOS AIRES,406,355,645,555,1200
06,06408,064081403,Hurlingham,BUENOS AIRES,403,405,694,605,1299
06,06408,064081406,Hurlingham,BUENOS AIRES,246,260,381,403,784
06,06408,064081411,Hurlingham,BUENOS AIRES,300,303,497,485,982
06,06408,064081412,Hurlingham,BUENOS AIRES,312,378,493,471,964
06,06408,064081413,Hurlingham,BUENOS AIRES,328,344,507,490,997
06,06408,064081505,Hurlingham,BUENOS AIRES,492,494,800,668,1468
06,06408,064080115,Hurlingham,BUENOS AIRES,107,115,168,137,305
06,06408,064080103,Hurlingham,BUENOS AIRES,351,370,566,514,1080
06,06408,064080201,Hurlingham,BUENOS AIRES,318,329,563,545,1108
06,06408,064080202,Hurlingham,BUENOS AIRES,373,375,645,541,1186
06,06408,064080203,Hurlingham,BUENOS AIRES,389,363,626,575,1201
06,06408,064080409,Hurlingham,BUENOS AIRES,417,367,709,685,1394
06,06408,064080501,Hurlingham,BUENOS AIRES,262,239,479,448,927
06,06408,064080510,Hurlingham,BUENOS AIRES,253,273,398,416,814
06,06408,064080512,Hurlingham,BUENOS AIRES,241,261,406,364,770
06,06408,064080802,Hurlingham,BUENOS AIRES,324,289,574,583,1157
06,06408,064080803,Hurlingham,BUENOS AIRES,206,230,362,322,684
06,06408,064080813,Hurlingham,BUENOS AIRES,255,263,460,455,915
06,06408,064081004,Hurlingham,BUENOS AIRES,368,403,580,541,1121
06,06408,064081006,Hurlingham,BUENOS AIRES,309,292,546,471,1017
06,06408,064081110,Hurlingham,BUENOS AIRES,184,180,350,340,690
06,06408,064081304,Hurlingham,BUENOS AIRES,289,286,516,482,998
06,06408,064081308,Hurlingham,BUENOS AIRES,314,327,580,527,1107
06,06408,064081309,Hurlingham,BUENOS AIRES,279,263,538,553,1091
06,06408,064081501,Hurlingham,BUENOS AIRES,405,432,613,610,1223
06,06408,064081506,Hurlingham,BUENOS AIRES,106,126,150,123,273
06,06408,064080907,Hurlingham,BUENOS AIRES,434,449,786,684,1470
06,06408,064080107,Hurlingham,BUENOS AIRES,399,407,614,584,1198
06,06408,064080114,Hurlingham,BUENOS AIRES,34,26,64,55,119
06,06408,064080404,Hurlingham,BUENOS AIRES,508,378,924,957,1881
06,06408,064080405,Hurlingham,BUENOS AIRES,360,366,649,614,1263
06,06408,064080406,Hurlingham,BUENOS AIRES,284,274,518,483,1001
06,06408,064080503,Hurlingham,BUENOS AIRES,356,350,609,608,1217
06,06408,064080505,Hurlingham,BUENOS AIRES,135,110,262,227,489
06,06408,064080607,Hurlingham,BUENOS AIRES,344,375,539,490,1029
06,06408,064080609,Hurlingham,BUENOS AIRES,351,402,505,467,972
06,06408,064080704,Hurlingham,BUENOS AIRES,424,406,646,604,1250
06,06408,064080708,Hurlingham,BUENOS AIRES,337,380,492,459,951
06,06408,064080709,Hurlingham,BUENOS AIRES,218,236,351,317,668
06,06408,064080805,Hurlingham,BUENOS AIRES,241,256,389,334,723
06,06408,064080809,Hurlingham,BUENOS AIRES,253,274,400,371,771
06,06408,064080810,Hurlingham,BUENOS AIRES,335,369,529,507,1036
06,06408,064080904,Hurlingham,BUENOS AIRES,261,292,398,349,747
06,06408,064081003,Hurlingham,BUENOS AIRES,436,424,738,653,1391
06,06408,064081109,Hurlingham,BUENOS AIRES,73,78,145,140,285
06,06408,064081312,Hurlingham,BUENOS AIRES,344,335,567,566,1133
06,06408,064081410,Hurlingham,BUENOS AIRES,273,278,461,415,876
06,06408,064080310,Hurlingham,BUENOS AIRES,221,226,394,369,763
06,06408,064080204,Hurlingham,BUENOS AIRES,388,368,697,583,1280
06,06408,064080208,Hurlingham,BUENOS AIRES,488,504,838,807,1645
06,06408,064080302,Hurlingham,BUENOS AIRES,100,96,173,167,340
06,06408,064080305,Hurlingham,BUENOS AIRES,294,302,483,456,939
06,06408,064080504,Hurlingham,BUENOS AIRES,313,305,550,577,1127
06,06408,064080508,Hurlingham,BUENOS AIRES,281,293,493,478,971
06,06408,064080606,Hurlingham,BUENOS AIRES,103,115,161,152,313
06,06408,064080705,Hurlingham,BUENOS AIRES,351,377,544,478,1022
06,06408,064080807,Hurlingham,BUENOS AIRES,267,250,458,403,861
06,06408,064081001,Hurlingham,BUENOS AIRES,325,348,535,464,999
06,06408,064081005,Hurlingham,BUENOS AIRES,442,464,744,645,1389
06,06408,064081108,Hurlingham,BUENOS AIRES,334,335,653,612,1265
06,06408,064081201,Hurlingham,BUENOS AIRES,675,335,1652,1441,3093
06,06408,064081207,Hurlingham,BUENOS AIRES,370,408,651,621,1272
06,06408,064081310,Hurlingham,BUENOS AIRES,375,345,686,691,1377
06,06408,064081502,Hurlingham,BUENOS AIRES,442,444,748,711,1459
06,06408,064081511,Hurlingham,BUENOS AIRES,270,290,416,366,782
06,06408,064080106,Hurlingham,BUENOS AIRES,217,239,324,290,614
06,06408,064080110,Hurlingham,BUENOS AIRES,239,247,371,364,735
06,06408,064080205,Hurlingham,BUENOS AIRES,243,256,375,326,701
06,06408,064080301,Hurlingham,BUENOS AIRES,105,105,198,201,399
06,06408,064080308,Hurlingham,BUENOS AIRES,621,633,1176,1124,2300
06,06408,064080412,Hurlingham,BUENOS AIRES,359,317,622,611,1233
06,06408,064080511,Hurlingham,BUENOS AIRES,271,285,427,410,837
06,06408,064080707,Hurlingham,BUENOS AIRES,94,110,140,133,273
06,06408,064080806,Hurlingham,BUENOS AIRES,310,324,516,509,1025
06,06408,064080814,Hurlingham,BUENOS AIRES,452,461,770,749,1519
06,06408,064080901,Hurlingham,BUENOS AIRES,392,426,595,537,1132
06,06408,064080908,Hurlingham,BUENOS AIRES,374,346,614,554,1168
06,06408,064081101,Hurlingham,BUENOS AIRES,274,276,509,445,954
06,06408,064081103,Hurlingham,BUENOS AIRES,342,370,517,418,935
06,06408,064081104,Hurlingham,BUENOS AIRES,337,357,556,524,1080
06,06408,064081111,Hurlingham,BUENOS AIRES,74,83,129,126,255
06,06408,064081204,Hurlingham,BUENOS AIRES,352,343,682,642,1324
06,06408,064081205,Hurlingham,BUENOS AIRES,488,496,867,824,1691
06,06408,064081209,Hurlingham,BUENOS AIRES,297,325,498,469,967
06,06408,064081307,Hurlingham,BUENOS AIRES,359,353,623,574,1197
06,06408,064081313,Hurlingham,BUENOS AIRES,226,241,411,381,792
06,06408,064081405,Hurlingham,BUENOS AIRES,190,182,305,286,591
06,06408,064081408,Hurlingham,BUENOS AIRES,235,260,409,358,767
06,06408,064081507,Hurlingham,BUENOS AIRES,274,284,467,439,906
06,06408,064081512,Hurlingham,BUENOS AIRES,140,166,234,182,416
06,06408,064081513,Hurlingham,BUENOS AIRES,347,337,535,473,1008
06,06408,064080102,Hurlingham,BUENOS AIRES,288,294,439,365,804
06,06408,064080104,Hurlingham,BUENOS AIRES,394,413,589,506,1095
06,06408,064080105,Hurlingham,BUENOS AIRES,367,390,634,616,1250
06,06408,064080108,Hurlingham,BUENOS AIRES,425,395,723,685,1408
06,06408,064080210,Hurlingham,BUENOS AIRES,447,459,756,690,1446
06,06408,064080306,Hurlingham,BUENOS AIRES,335,339,568,575,1143
06,06408,064080408,Hurlingham,BUENOS AIRES,563,467,1047,1001,2048
06,06408,064080602,Hurlingham,BUENOS AIRES,177,197,299,290,589
06,06408,064080605,Hurlingham,BUENOS AIRES,372,410,555,519,1074
06,06408,064080703,Hurlingham,BUENOS AIRES,263,216,477,449,926
06,06408,064080903,Hurlingham,BUENOS AIRES,282,282,464,419,883
06,06408,064081007,Hurlingham,BUENOS AIRES,415,435,686,644,1330
06,06408,064081106,Hurlingham,BUENOS AIRES,321,345,569,503,1072
06,06408,064081302,Hurlingham,BUENOS AIRES,294,290,585,542,1127
06,06408,064081306,Hurlingham,BUENOS AIRES,385,374,675,635,1310
06,06408,064081402,Hurlingham,BUENOS AIRES,399,394,639,573,1212
06,06408,064081404,Hurlingham,BUENOS AIRES,445,436,748,661,1409
06,06408,064081504,Hurlingham,BUENOS AIRES,342,341,644,579,1223
06,06408,064081508,Hurlingham,BUENOS AIRES,235,237,392,373,765
06,06408,064081510,Hurlingham,BUENOS AIRES,212,222,321,305,626
06,06410,064100108,Ituzaingó,BUENOS AIRES,421,477,680,746,1426
06,06410,064100301,Ituzaingó,BUENOS AIRES,385,413,930,832,1762
06,06410,064100303,Ituzaingó,BUENOS AIRES,251,332,412,400,812
06,06410,064100311,Ituzaingó,BUENOS AIRES,244,259,419,441,860
06,06410,064100401,Ituzaingó,BUENOS AIRES,381,391,668,647,1315
06,06410,064100404,Ituzaingó,BUENOS AIRES,254,286,433,382,815
06,06410,064100602,Ituzaingó,BUENOS AIRES,331,354,668,599,1267
06,06410,064101101,Ituzaingó,BUENOS AIRES,360,423,527,461,988
06,06410,064100716,Ituzaingó,BUENOS AIRES,457,469,790,719,1509
06,06410,064100802,Ituzaingó,BUENOS AIRES,252,276,408,393,801
06,06410,064101008,Ituzaingó,BUENOS AIRES,308,321,491,475,966
06,06410,064101109,Ituzaingó,BUENOS AIRES,393,445,569,514,1083
06,06410,064101204,Ituzaingó,BUENOS AIRES,242,260,374,328,702
06,06410,064101207,Ituzaingó,BUENOS AIRES,271,319,396,350,746
06,06410,064101308,Ituzaingó,BUENOS AIRES,273,303,468,433,901
06,06410,064101311,Ituzaingó,BUENOS AIRES,304,279,523,508,1031
06,06410,064100102,Ituzaingó,BUENOS AIRES,381,353,702,702,1404
06,06410,064100103,Ituzaingó,BUENOS AIRES,384,310,698,684,1382
06,06410,064100104,Ituzaingó,BUENOS AIRES,447,456,767,772,1539
06,06410,064100111,Ituzaingó,BUENOS AIRES,817,902,1453,1408,2861
06,06410,064100205,Ituzaingó,BUENOS AIRES,397,408,703,692,1395
06,06410,064100409,Ituzaingó,BUENOS AIRES,476,459,885,838,1723
06,06410,064100410,Ituzaingó,BUENOS AIRES,246,260,465,443,908
06,06410,064100605,Ituzaingó,BUENOS AIRES,323,361,494,493,987
06,06410,064100702,Ituzaingó,BUENOS AIRES,195,205,296,263,559
06,06410,064100804,Ituzaingó,BUENOS AIRES,259,266,419,402,821
06,06410,064100806,Ituzaingó,BUENOS AIRES,420,448,740,663,1403
06,06410,064100901,Ituzaingó,BUENOS AIRES,398,445,740,577,1317
06,06410,064100907,Ituzaingó,BUENOS AIRES,306,309,475,388,863
06,06410,064101103,Ituzaingó,BUENOS AIRES,294,338,448,383,831
06,06410,064101307,Ituzaingó,BUENOS AIRES,495,507,820,761,1581
06,06410,064100305,Ituzaingó,BUENOS AIRES,365,371,646,613,1259
06,06410,064100306,Ituzaingó,BUENOS AIRES,297,324,488,491,979
06,06410,064100307,Ituzaingó,BUENOS AIRES,276,290,517,482,999
06,06410,064100507,Ituzaingó,BUENOS AIRES,200,193,381,333,714
06,06410,064100508,Ituzaingó,BUENOS AIRES,358,347,653,595,1248
06,06410,064100705,Ituzaingó,BUENOS AIRES,379,401,597,563,1160
06,06410,064100709,Ituzaingó,BUENOS AIRES,305,319,474,472,946
06,06410,064100902,Ituzaingó,BUENOS AIRES,271,301,393,380,773
06,06410,064100906,Ituzaingó,BUENOS AIRES,314,328,488,456,944
06,06410,064101003,Ituzaingó,BUENOS AIRES,357,390,563,532,1095
06,06410,064101005,Ituzaingó,BUENOS AIRES,317,342,540,465,1005
06,06410,064101006,Ituzaingó,BUENOS AIRES,310,336,480,436,916
06,06410,064101007,Ituzaingó,BUENOS AIRES,466,492,766,697,1463
06,06410,064101010,Ituzaingó,BUENOS AIRES,356,395,566,481,1047
06,06410,064101107,Ituzaingó,BUENOS AIRES,297,344,439,428,867
06,06410,064101205,Ituzaingó,BUENOS AIRES,245,257,409,380,789
06,06410,064101208,Ituzaingó,BUENOS AIRES,178,197,285,234,519
06,06410,064101210,Ituzaingó,BUENOS AIRES,226,249,646,788,1434
06,06410,064101301,Ituzaingó,BUENOS AIRES,404,439,643,619,1262
06,06410,064100309,Ituzaingó,BUENOS AIRES,465,422,823,755,1578
06,06410,064100202,Ituzaingó,BUENOS AIRES,297,334,535,491,1026
06,06410,064100204,Ituzaingó,BUENOS AIRES,61,72,94,103,197
06,06410,064100206,Ituzaingó,BUENOS AIRES,88,65,157,156,313
06,06410,064100308,Ituzaingó,BUENOS AIRES,287,297,489,469,958
06,06410,064100411,Ituzaingó,BUENOS AIRES,233,254,394,373,767
06,06410,064100412,Ituzaingó,BUENOS AIRES,369,271,712,628,1340
06,06410,064100503,Ituzaingó,BUENOS AIRES,412,423,678,684,1362
06,06410,064100511,Ituzaingó,BUENOS AIRES,282,279,530,491,1021
06,06410,064100515,Ituzaingó,BUENOS AIRES,487,370,1052,1625,2677
06,06410,064100607,Ituzaingó,BUENOS AIRES,327,371,614,531,1145
06,06410,064100801,Ituzaingó,BUENOS AIRES,227,226,340,344,684
06,06410,064100803,Ituzaingó,BUENOS AIRES,402,430,655,628,1283
06,06410,064100903,Ituzaingó,BUENOS AIRES,440,487,698,640,1338
06,06410,064100909,Ituzaingó,BUENOS AIRES,284,297,445,364,809
06,06410,064101104,Ituzaingó,BUENOS AIRES,291,333,457,385,842
06,06410,064101106,Ituzaingó,BUENOS AIRES,209,290,296,298,594
06,06410,064101202,Ituzaingó,BUENOS AIRES,360,407,533,439,972
06,06410,064101209,Ituzaingó,BUENOS AIRES,224,248,364,338,702
06,06410,064101303,Ituzaingó,BUENOS AIRES,232,224,362,340,702
06,06410,064101306,Ituzaingó,BUENOS AIRES,456,483,735,701,1436
06,06410,064100610,Ituzaingó,BUENOS AIRES,277,302,472,434,906
06,06410,064100107,Ituzaingó,BUENOS AIRES,227,304,392,371,763
06,06410,064100210,Ituzaingó,BUENOS AIRES,287,306,462,422,884
06,06410,064100402,Ituzaingó,BUENOS AIRES,336,341,627,573,1200
06,06410,064100406,Ituzaingó,BUENOS AIRES,364,400,602,603,1205
06,06410,064100416,Ituzaingó,BUENOS AIRES,181,254,289,260,549
06,06410,064100502,Ituzaingó,BUENOS AIRES,297,266,520,517,1037
06,06410,064100506,Ituzaingó,BUENOS AIRES,219,193,398,384,782
06,06410,064100513,Ituzaingó,BUENOS AIRES,394,384,672,625,1297
06,06410,064100601,Ituzaingó,BUENOS AIRES,356,368,654,661,1315
06,06410,064100603,Ituzaingó,BUENOS AIRES,380,410,619,583,1202
06,06410,064100701,Ituzaingó,BUENOS AIRES,222,238,352,302,654
06,06410,064100704,Ituzaingó,BUENOS AIRES,440,471,681,620,1301
06,06410,064100712,Ituzaingó,BUENOS AIRES,282,305,486,429,915
06,06410,064100807,Ituzaingó,BUENOS AIRES,387,417,617,561,1178
06,06410,064101001,Ituzaingó,BUENOS AIRES,420,450,658,599,1257
06,06410,064101002,Ituzaingó,BUENOS AIRES,430,473,667,615,1282
06,06410,064101102,Ituzaingó,BUENOS AIRES,352,412,568,455,1023
06,06410,064101105,Ituzaingó,BUENOS AIRES,200,320,309,261,570
06,06410,064101110,Ituzaingó,BUENOS AIRES,348,382,536,502,1038
06,06410,064101201,Ituzaingó,BUENOS AIRES,331,408,498,411,909
06,06410,064101203,Ituzaingó,BUENOS AIRES,212,237,333,261,594
06,06410,064101213,Ituzaingó,BUENOS AIRES,472,476,784,685,1469
06,06410,064101310,Ituzaingó,BUENOS AIRES,250,257,434,371,805
06,06410,064100109,Ituzaingó,BUENOS AIRES,265,276,459,444,903
06,06410,064100112,Ituzaingó,BUENOS AIRES,349,400,599,568,1167
06,06410,064100209,Ituzaingó,BUENOS AIRES,344,371,543,529,1072
06,06410,064100302,Ituzaingó,BUENOS AIRES,347,338,592,541,1133
06,06410,064100509,Ituzaingó,BUENOS AIRES,385,373,584,586,1170
06,06410,064100606,Ituzaingó,BUENOS AIRES,306,338,511,406,917
06,06410,064100611,Ituzaingó,BUENOS AIRES,223,216,381,344,725
06,06410,064100612,Ituzaingó,BUENOS AIRES,438,470,742,721,1463
06,06410,064100615,Ituzaingó,BUENOS AIRES,334,380,518,442,960
06,06410,064100703,Ituzaingó,BUENOS AIRES,313,341,489,397,886
06,06410,064100706,Ituzaingó,BUENOS AIRES,295,319,415,390,805
06,06410,064100711,Ituzaingó,BUENOS AIRES,301,333,522,452,974
06,06410,064100715,Ituzaingó,BUENOS AIRES,252,257,455,460,915
06,06410,064100805,Ituzaingó,BUENOS AIRES,289,282,510,447,957
06,06410,064100808,Ituzaingó,BUENOS AIRES,316,343,508,459,967
06,06410,064101004,Ituzaingó,BUENOS AIRES,412,422,718,565,1283
06,06410,064101108,Ituzaingó,BUENOS AIRES,299,347,444,435,879
06,06410,064101111,Ituzaingó,BUENOS AIRES,328,352,562,447,1009
06,06410,064101304,Ituzaingó,BUENOS AIRES,223,245,361,334,695
06,06410,064100415,Ituzaingó,BUENOS AIRES,87,89,155,148,303
06,06410,064100101,Ituzaingó,BUENOS AIRES,397,323,735,661,1396
06,06410,064100113,Ituzaingó,BUENOS AIRES,183,263,316,327,643
06,06410,064100201,Ituzaingó,BUENOS AIRES,289,328,466,460,926
06,06410,064100207,Ituzaingó,BUENOS AIRES,242,252,416,370,786
06,06410,064100208,Ituzaingó,BUENOS AIRES,438,429,750,703,1453
06,06410,064100310,Ituzaingó,BUENOS AIRES,301,315,561,551,1112
06,06410,064100403,Ituzaingó,BUENOS AIRES,407,426,669,607,1276
06,06410,064100405,Ituzaingó,BUENOS AIRES,233,253,400,385,785
06,06410,064100407,Ituzaingó,BUENOS AIRES,251,244,427,397,824
06,06410,064100408,Ituzaingó,BUENOS AIRES,291,297,479,448,927
06,06410,064100501,Ituzaingó,BUENOS AIRES,251,250,440,396,836
06,06410,064100504,Ituzaingó,BUENOS AIRES,249,230,422,426,848
06,06410,064100505,Ituzaingó,BUENOS AIRES,289,282,530,545,1075
06,06410,064100512,Ituzaingó,BUENOS AIRES,319,299,585,609,1194
06,06410,064100514,Ituzaingó,BUENOS AIRES,281,217,553,485,1038
06,06410,064100604,Ituzaingó,BUENOS AIRES,358,369,554,497,1051
06,06410,064100609,Ituzaingó,BUENOS AIRES,286,313,436,390,826
06,06410,064100707,Ituzaingó,BUENOS AIRES,464,480,738,762,1500
06,06410,064100708,Ituzaingó,BUENOS AIRES,303,301,515,493,1008
06,06410,064100714,Ituzaingó,BUENOS AIRES,306,282,554,524,1078
06,06410,064100809,Ituzaingó,BUENOS AIRES,464,496,765,694,1459
06,06410,064100908,Ituzaingó,BUENOS AIRES,282,359,439,391,830
06,06410,064101206,Ituzaingó,BUENOS AIRES,286,303,416,393,809
06,06410,064101211,Ituzaingó,BUENOS AIRES,293,314,480,409,889
06,06410,064101309,Ituzaingó,BUENOS AIRES,271,264,439,421,860
06,06410,064100905,Ituzaingó,BUENOS AIRES,417,384,667,582,1249
06,06410,064100105,Ituzaingó,BUENOS AIRES,258,264,442,432,874
06,06410,064100106,Ituzaingó,BUENOS AIRES,231,316,367,371,738
06,06410,064100110,Ituzaingó,BUENOS AIRES,339,407,648,615,1263
06,06410,064100203,Ituzaingó,BUENOS AIRES,226,343,367,373,740
06,06410,064100304,Ituzaingó,BUENOS AIRES,342,327,603,600,1203
06,06410,064100312,Ituzaingó,BUENOS AIRES,155,188,255,253,508
06,06410,064100413,Ituzaingó,BUENOS AIRES,286,287,517,515,1032
06,06410,064100414,Ituzaingó,BUENOS AIRES,375,403,678,648,1326
06,06410,064100510,Ituzaingó,BUENOS AIRES,372,349,696,619,1315
06,06410,064100608,Ituzaingó,BUENOS AIRES,440,454,698,622,1320
06,06410,064100613,Ituzaingó,BUENOS AIRES,440,461,756,654,1410
06,06410,064100614,Ituzaingó,BUENOS AIRES,391,429,579,551,1130
06,06410,064100710,Ituzaingó,BUENOS AIRES,417,445,636,610,1246
06,06410,064100713,Ituzaingó,BUENOS AIRES,394,416,661,589,1250
06,06410,064100904,Ituzaingó,BUENOS AIRES,376,429,580,561,1141
06,06410,064101009,Ituzaingó,BUENOS AIRES,350,334,583,494,1077
06,06410,064101212,Ituzaingó,BUENOS AIRES,300,290,497,474,971
06,06410,064101302,Ituzaingó,BUENOS AIRES,256,285,409,363,772
06,06410,064101305,Ituzaingó,BUENOS AIRES,256,265,416,373,789
06,06469,064690112,Lincoln,BUENOS AIRES,218,252,296,245,541
06,06469,064690208,Lincoln,BUENOS AIRES,394,458,556,511,1067
06,06469,064690802,Lincoln,BUENOS AIRES,49,74,70,86,156
06,06469,064690902,Lincoln,BUENOS AIRES,10,27,10,14,24
06,06469,064690907,Lincoln,BUENOS AIRES,14,25,19,23,42
06,06469,064691102,Lincoln,BUENOS AIRES,10,13,13,20,33
06,06469,064691306,Lincoln,BUENOS AIRES,17,21,25,40,65
06,06469,064691502,Lincoln,BUENOS AIRES,13,25,11,16,27
06,06469,064690304,Lincoln,BUENOS AIRES,27,49,43,51,94
06,06469,064690301,Lincoln,BUENOS AIRES,39,52,52,63,115
06,06469,064690606,Lincoln,BUENOS AIRES,362,411,622,654,1276
06,06469,064690103,Lincoln,BUENOS AIRES,236,257,368,344,712
06,06469,064690105,Lincoln,BUENOS AIRES,246,281,371,346,717
06,06469,064690109,Lincoln,BUENOS AIRES,435,461,651,637,1288
06,06469,064690213,Lincoln,BUENOS AIRES,182,205,258,220,478
06,06469,064690604,Lincoln,BUENOS AIRES,148,170,273,263,536
06,06469,064690807,Lincoln,BUENOS AIRES,188,242,281,280,561
06,06469,064690909,Lincoln,BUENOS AIRES,249,303,340,334,674
06,06469,064691501,Lincoln,BUENOS AIRES,324,390,485,484,969
06,06469,064690502,Lincoln,BUENOS AIRES,4,5,8,7,15
06,06469,064690403,Lincoln,BUENOS AIRES,9,27,22,17,39
06,06469,064690503,Lincoln,BUENOS AIRES,8,15,8,11,19
06,06469,064690908,Lincoln,BUENOS AIRES,18,35,27,36,63
06,06469,064691006,Lincoln,BUENOS AIRES,4,12,4,5,9
06,06469,064691105,Lincoln,BUENOS AIRES,10,23,14,19,33
06,06469,064691303,Lincoln,BUENOS AIRES,31,58,38,58,96
06,06469,064691304,Lincoln,BUENOS AIRES,11,26,17,20,37
06,06469,064691503,Lincoln,BUENOS AIRES,4,19,5,6,11
06,06469,064691504,Lincoln,BUENOS AIRES,2,10,0,2,2
06,06469,064691505,Lincoln,BUENOS AIRES,4,12,6,6,12
06,06469,064690106,Lincoln,BUENOS AIRES,367,420,451,376,827
06,06469,064690108,Lincoln,BUENOS AIRES,355,427,501,386,887
06,06469,064690114,Lincoln,BUENOS AIRES,262,296,398,384,782
06,06469,064690203,Lincoln,BUENOS AIRES,321,354,513,505,1018
06,06469,064690207,Lincoln,BUENOS AIRES,319,402,442,382,824
06,06469,064690212,Lincoln,BUENOS AIRES,264,279,417,461,878
06,06469,064690401,Lincoln,BUENOS AIRES,201,234,266,275,541
06,06469,064690601,Lincoln,BUENOS AIRES,255,277,415,399,814
06,06469,064690801,Lincoln,BUENOS AIRES,228,276,374,393,767
06,06469,064691301,Lincoln,BUENOS AIRES,265,304,363,330,693
06,06469,064690404,Lincoln,BUENOS AIRES,14,32,22,27,49
06,06469,064690501,Lincoln,BUENOS AIRES,11,19,16,19,35
06,06469,064691107,Lincoln,BUENOS AIRES,29,55,30,50,80
06,06469,064690903,Lincoln,BUENOS AIRES,114,153,182,185,367
06,06469,064691106,Lincoln,BUENOS AIRES,186,240,267,265,532
06,06469,064690111,Lincoln,BUENOS AIRES,297,323,435,422,857
06,06469,064690602,Lincoln,BUENOS AIRES,413,427,681,671,1352
06,06469,064690603,Lincoln,BUENOS AIRES,243,257,379,386,765
06,06469,064691007,Lincoln,BUENOS AIRES,171,207,264,276,540
06,06469,064691101,Lincoln,BUENOS AIRES,94,126,119,115,234
06,06469,064690504,Lincoln,BUENOS AIRES,6,12,10,9,19
06,06469,064690804,Lincoln,BUENOS AIRES,38,73,39,49,88
06,06469,064691103,Lincoln,BUENOS AIRES,5,16,2,6,8
06,06469,064691201,Lincoln,BUENOS AIRES,8,11,10,15,25
06,06469,064691403,Lincoln,BUENOS AIRES,24,45,39,36,75
06,06469,064691506,Lincoln,BUENOS AIRES,16,36,24,27,51
06,06469,064690107,Lincoln,BUENOS AIRES,262,338,372,270,642
06,06469,064690113,Lincoln,BUENOS AIRES,261,293,368,362,730
06,06469,064690209,Lincoln,BUENOS AIRES,206,250,303,258,561
06,06469,064690901,Lincoln,BUENOS AIRES,242,295,294,297,591
06,06469,064691302,Lincoln,BUENOS AIRES,435,498,602,613,1215
06,06469,064690303,Lincoln,BUENOS AIRES,10,13,4,9,13
06,06469,064690406,Lincoln,BUENOS AIRES,15,35,21,29,50
06,06469,064690803,Lincoln,BUENOS AIRES,23,32,28,45,73
06,06469,064690904,Lincoln,BUENOS AIRES,11,17,17,24,41
06,06469,064691004,Lincoln,BUENOS AIRES,21,36,30,33,63
06,06469,064691104,Lincoln,BUENOS AIRES,13,28,17,22,39
06,06469,064691203,Lincoln,BUENOS AIRES,12,12,24,22,46
06,06469,064691204,Lincoln,BUENOS AIRES,10,16,12,21,33
06,06469,064690101,Lincoln,BUENOS AIRES,270,288,396,372,768
06,06469,064690102,Lincoln,BUENOS AIRES,346,411,459,404,863
06,06469,064690104,Lincoln,BUENOS AIRES,461,526,614,554,1168
06,06469,064690110,Lincoln,BUENOS AIRES,238,270,351,357,708
06,06469,064690205,Lincoln,BUENOS AIRES,296,331,363,316,679
06,06469,064690206,Lincoln,BUENOS AIRES,216,269,288,264,552
06,06469,064690214,Lincoln,BUENOS AIRES,277,291,460,417,877
06,06469,064690702,Lincoln,BUENOS AIRES,7,14,15,11,26
06,06469,064690905,Lincoln,BUENOS AIRES,6,30,8,8,16
06,06469,064690906,Lincoln,BUENOS AIRES,15,29,20,25,45
06,06469,064691202,Lincoln,BUENOS AIRES,9,12,11,14,25
06,06469,064691402,Lincoln,BUENOS AIRES,10,20,15,13,28
06,06469,064691002,Lincoln,BUENOS AIRES,81,102,147,133,280
06,06469,064691305,Lincoln,BUENOS AIRES,120,187,191,204,395
06,06469,064690204,Lincoln,BUENOS AIRES,394,445,601,489,1090
06,06469,064690211,Lincoln,BUENOS AIRES,262,290,401,414,815
06,06469,064691001,Lincoln,BUENOS AIRES,125,149,178,165,343
06,06469,064691307,Lincoln,BUENOS AIRES,259,304,411,401,812
06,06469,064691005,Lincoln,BUENOS AIRES,3,24,7,6,13
06,06469,064690302,Lincoln,BUENOS AIRES,12,13,19,23,42
06,06469,064690701,Lincoln,BUENOS AIRES,10,12,9,20,29
06,06469,064690805,Lincoln,BUENOS AIRES,23,38,28,42,70
06,06469,064690806,Lincoln,BUENOS AIRES,32,42,42,71,113
06,06469,064691003,Lincoln,BUENOS AIRES,26,48,36,48,84
06,06469,064691404,Lincoln,BUENOS AIRES,12,31,18,26,44
06,06469,064690605,Lincoln,BUENOS AIRES,388,429,677,673,1350
06,06469,064690201,Lincoln,BUENOS AIRES,280,353,395,292,687
06,06469,064690202,Lincoln,BUENOS AIRES,345,402,474,422,896
06,06469,064690210,Lincoln,BUENOS AIRES,279,316,450,389,839
06,06469,064691507,Lincoln,BUENOS AIRES,68,76,82,102,184
06,06469,064691508,Lincoln,BUENOS AIRES,274,339,399,410,809
06,06469,064690305,Lincoln,BUENOS AIRES,10,13,8,15,23
06,06469,064690306,Lincoln,BUENOS AIRES,17,27,8,23,31
06,06469,064690402,Lincoln,BUENOS AIRES,20,44,23,33,56
06,06469,064690405,Lincoln,BUENOS AIRES,12,22,16,24,40
06,06469,064690703,Lincoln,BUENOS AIRES,15,20,22,23,45
06,06469,064691401,Lincoln,BUENOS AIRES,17,33,17,30,47
06,06277,062770105,Florentino Ameghino,BUENOS AIRES,7,16,10,9,19
06,06277,062770206,Florentino Ameghino,BUENOS AIRES,34,68,35,54,89
06,06277,062770109,Florentino Ameghino,BUENOS AIRES,213,253,355,350,705
06,06277,062770111,Florentino Ameghino,BUENOS AIRES,429,483,634,618,1252
06,06277,062770116,Florentino Ameghino,BUENOS AIRES,20,47,23,30,53
06,06277,062770114,Florentino Ameghino,BUENOS AIRES,229,247,332,317,649
06,06277,062770104,Florentino Ameghino,BUENOS AIRES,22,34,30,41,71
06,06277,062770202,Florentino Ameghino,BUENOS AIRES,99,144,141,178,319
06,06277,062770103,Florentino Ameghino,BUENOS AIRES,113,140,173,169,342
06,06277,062770201,Florentino Ameghino,BUENOS AIRES,31,48,46,54,100
06,06277,062770106,Florentino Ameghino,BUENOS AIRES,45,304,48,67,115
06,06277,062770102,Florentino Ameghino,BUENOS AIRES,120,174,161,173,334
06,06277,062770108,Florentino Ameghino,BUENOS AIRES,228,282,430,392,822
06,06277,062770113,Florentino Ameghino,BUENOS AIRES,259,292,344,327,671
06,06277,062770115,Florentino Ameghino,BUENOS AIRES,303,333,462,444,906
06,06277,062770101,Florentino Ameghino,BUENOS AIRES,4,12,1,6,7
06,06277,062770204,Florentino Ameghino,BUENOS AIRES,68,99,90,103,193
06,06277,062770107,Florentino Ameghino,BUENOS AIRES,260,312,396,387,783
06,06277,062770110,Florentino Ameghino,BUENOS AIRES,243,261,397,391,788
06,06277,062770112,Florentino Ameghino,BUENOS AIRES,219,278,295,241,536
06,06277,062770203,Florentino Ameghino,BUENOS AIRES,29,48,36,47,83
06,06277,062770205,Florentino Ameghino,BUENOS AIRES,11,20,11,21,32
06,06308,063080801,General Guido,BUENOS AIRES,12,28,10,21,31
06,06308,063081003,General Guido,BUENOS AIRES,27,43,40,36,76
06,06308,063081002,General Guido,BUENOS AIRES,283,376,421,392,813
06,06308,063080603,General Guido,BUENOS AIRES,31,39,52,61,113
06,06308,063080101,General Guido,BUENOS AIRES,19,29,19,34,53
06,06308,063080701,General Guido,BUENOS AIRES,28,61,30,41,71
06,06308,063080502,General Guido,BUENOS AIRES,85,152,118,129,247
06,06308,063081001,General Guido,BUENOS AIRES,39,101,27,51,78
06,06308,063080602,General Guido,BUENOS AIRES,143,206,218,209,427
06,06308,063080901,General Guido,BUENOS AIRES,35,51,29,54,83
06,06308,063080401,General Guido,BUENOS AIRES,24,49,27,46,73
06,06308,063080301,General Guido,BUENOS AIRES,27,43,28,42,70
06,06308,063080501,General Guido,BUENOS AIRES,101,116,156,142,298
06,06308,063080601,General Guido,BUENOS AIRES,131,154,173,153,326
06,06308,063080604,General Guido,BUENOS AIRES,4,11,3,5,8
06,06308,063080201,General Guido,BUENOS AIRES,16,36,21,28,49
06,06630,066300201,Pila,BUENOS AIRES,11,19,19,19,38
06,06630,066300301,Pila,BUENOS AIRES,43,71,49,82,131
06,06630,066300202,Pila,BUENOS AIRES,280,346,479,440,919
06,06630,066300101,Pila,BUENOS AIRES,110,219,144,167,311
06,06630,066300401,Pila,BUENOS AIRES,48,73,48,70,118
06,06630,066300501,Pila,BUENOS AIRES,69,92,78,106,184
06,06630,066300204,Pila,BUENOS AIRES,162,199,262,212,474
06,06630,066300601,Pila,BUENOS AIRES,134,214,147,209,356
06,06630,066300205,Pila,BUENOS AIRES,185,223,296,272,568
06,06630,066300203,Pila,BUENOS AIRES,173,220,284,257,541
